issue-number,id,actor,event,commit_id,commit_url,created_at,total,additions,deletions
33602,3061722275,"{'login': 'facebook-github-bot', 'id': 6422482, 'node_id': 'MDQ6VXNlcjY0MjI0ODI=', 'avatar_url': 'https://avatars3.githubusercontent.com/u/6422482?v=4', 'gravatar_id': '', 'url': 'https://api.github.com/users/facebook-github-bot', 'html_url': 'https://github.com/facebook-github-bot', 'followers_url': 'https://api.github.com/users/facebook-github-bot/followers', 'following_url': 'https://api.github.com/users/facebook-github-bot/following{/other_user}', 'gists_url': 'https://api.github.com/users/facebook-github-bot/gists{/gist_id}', 'starred_url': 'https://api.github.com/users/facebook-github-bot/starred{/owner}{/repo}', 'subscriptions_url': 'https://api.github.com/users/facebook-github-bot/subscriptions', 'organizations_url': 'https://api.github.com/users/facebook-github-bot/orgs', 'repos_url': 'https://api.github.com/users/facebook-github-bot/repos', 'events_url': 'https://api.github.com/users/facebook-github-bot/events{/privacy}', 'received_events_url': 'https://api.github.com/users/facebook-github-bot/received_events', 'type': 'User', 'site_admin': False}",referenced,ca8e025cdf971b03b5a5c83bb1dc712839da89f0,https://api.github.com/repos/pytorch/pytorch/commits/ca8e025cdf971b03b5a5c83bb1dc712839da89f0,2020-02-21T19:53:18Z,2,1,1
33544,3062212469,"{'login': 'facebook-github-bot', 'id': 6422482, 'node_id': 'MDQ6VXNlcjY0MjI0ODI=', 'avatar_url': 'https://avatars3.githubusercontent.com/u/6422482?v=4', 'gravatar_id': '', 'url': 'https://api.github.com/users/facebook-github-bot', 'html_url': 'https://github.com/facebook-github-bot', 'followers_url': 'https://api.github.com/users/facebook-github-bot/followers', 'following_url': 'https://api.github.com/users/facebook-github-bot/following{/other_user}', 'gists_url': 'https://api.github.com/users/facebook-github-bot/gists{/gist_id}', 'starred_url': 'https://api.github.com/users/facebook-github-bot/starred{/owner}{/repo}', 'subscriptions_url': 'https://api.github.com/users/facebook-github-bot/subscriptions', 'organizations_url': 'https://api.github.com/users/facebook-github-bot/orgs', 'repos_url': 'https://api.github.com/users/facebook-github-bot/repos', 'events_url': 'https://api.github.com/users/facebook-github-bot/events{/privacy}', 'received_events_url': 'https://api.github.com/users/facebook-github-bot/received_events', 'type': 'User', 'site_admin': False}",closed,16d6c17845426294274850f9161e292345f2afa5,https://api.github.com/repos/pytorch/pytorch/commits/16d6c17845426294274850f9161e292345f2afa5,2020-02-21T23:11:28Z,16,3,13
33544,3083148979,"{'login': 'hczhu', 'id': 2289363, 'node_id': 'MDQ6VXNlcjIyODkzNjM=', 'avatar_url': 'https://avatars0.githubusercontent.com/u/2289363?v=4', 'gravatar_id': '', 'url': 'https://api.github.com/users/hczhu', 'html_url': 'https://github.com/hczhu', 'followers_url': 'https://api.github.com/users/hczhu/followers', 'following_url': 'https://api.github.com/users/hczhu/following{/other_user}', 'gists_url': 'https://api.github.com/users/hczhu/gists{/gist_id}', 'starred_url': 'https://api.github.com/users/hczhu/starred{/owner}{/repo}', 'subscriptions_url': 'https://api.github.com/users/hczhu/subscriptions', 'organizations_url': 'https://api.github.com/users/hczhu/orgs', 'repos_url': 'https://api.github.com/users/hczhu/repos', 'events_url': 'https://api.github.com/users/hczhu/events{/privacy}', 'received_events_url': 'https://api.github.com/users/hczhu/received_events', 'type': 'User', 'site_admin': False}",referenced,377688b06402263ee053a61c8916c405db65fdb9,https://api.github.com/repos/pytorch/pytorch/commits/377688b06402263ee053a61c8916c405db65fdb9,2020-02-28T18:58:23Z,16,3,13
33422,3058030645,"{'login': 'facebook-github-bot', 'id': 6422482, 'node_id': 'MDQ6VXNlcjY0MjI0ODI=', 'avatar_url': 'https://avatars3.githubusercontent.com/u/6422482?v=4', 'gravatar_id': '', 'url': 'https://api.github.com/users/facebook-github-bot', 'html_url': 'https://github.com/facebook-github-bot', 'followers_url': 'https://api.github.com/users/facebook-github-bot/followers', 'following_url': 'https://api.github.com/users/facebook-github-bot/following{/other_user}', 'gists_url': 'https://api.github.com/users/facebook-github-bot/gists{/gist_id}', 'starred_url': 'https://api.github.com/users/facebook-github-bot/starred{/owner}{/repo}', 'subscriptions_url': 'https://api.github.com/users/facebook-github-bot/subscriptions', 'organizations_url': 'https://api.github.com/users/facebook-github-bot/orgs', 'repos_url': 'https://api.github.com/users/facebook-github-bot/repos', 'events_url': 'https://api.github.com/users/facebook-github-bot/events{/privacy}', 'received_events_url': 'https://api.github.com/users/facebook-github-bot/received_events', 'type': 'User', 'site_admin': False}",referenced,1a2574734222193c344dffb7904def10db18b874,https://api.github.com/repos/pytorch/pytorch/commits/1a2574734222193c344dffb7904def10db18b874,2020-02-20T20:20:00Z,17,16,1
33401,3048438595,"{'login': 'facebook-github-bot', 'id': 6422482, 'node_id': 'MDQ6VXNlcjY0MjI0ODI=', 'avatar_url': 'https://avatars3.githubusercontent.com/u/6422482?v=4', 'gravatar_id': '', 'url': 'https://api.github.com/users/facebook-github-bot', 'html_url': 'https://github.com/facebook-github-bot', 'followers_url': 'https://api.github.com/users/facebook-github-bot/followers', 'following_url': 'https://api.github.com/users/facebook-github-bot/following{/other_user}', 'gists_url': 'https://api.github.com/users/facebook-github-bot/gists{/gist_id}', 'starred_url': 'https://api.github.com/users/facebook-github-bot/starred{/owner}{/repo}', 'subscriptions_url': 'https://api.github.com/users/facebook-github-bot/subscriptions', 'organizations_url': 'https://api.github.com/users/facebook-github-bot/orgs', 'repos_url': 'https://api.github.com/users/facebook-github-bot/repos', 'events_url': 'https://api.github.com/users/facebook-github-bot/events{/privacy}', 'received_events_url': 'https://api.github.com/users/facebook-github-bot/received_events', 'type': 'User', 'site_admin': False}",closed,4c8064c9e14d7118296b5c378d80fde63a62aeb7,https://api.github.com/repos/pytorch/pytorch/commits/4c8064c9e14d7118296b5c378d80fde63a62aeb7,2020-02-18T19:04:33Z,148,13,135
33300,3062533162,"{'login': 'facebook-github-bot', 'id': 6422482, 'node_id': 'MDQ6VXNlcjY0MjI0ODI=', 'avatar_url': 'https://avatars3.githubusercontent.com/u/6422482?v=4', 'gravatar_id': '', 'url': 'https://api.github.com/users/facebook-github-bot', 'html_url': 'https://github.com/facebook-github-bot', 'followers_url': 'https://api.github.com/users/facebook-github-bot/followers', 'following_url': 'https://api.github.com/users/facebook-github-bot/following{/other_user}', 'gists_url': 'https://api.github.com/users/facebook-github-bot/gists{/gist_id}', 'starred_url': 'https://api.github.com/users/facebook-github-bot/starred{/owner}{/repo}', 'subscriptions_url': 'https://api.github.com/users/facebook-github-bot/subscriptions', 'organizations_url': 'https://api.github.com/users/facebook-github-bot/orgs', 'repos_url': 'https://api.github.com/users/facebook-github-bot/repos', 'events_url': 'https://api.github.com/users/facebook-github-bot/events{/privacy}', 'received_events_url': 'https://api.github.com/users/facebook-github-bot/received_events', 'type': 'User', 'site_admin': False}",referenced,8291e06f8fb14a09e6c3b7a740a182250069242c,https://api.github.com/repos/pytorch/pytorch/commits/8291e06f8fb14a09e6c3b7a740a182250069242c,2020-02-22T06:25:07Z,24,17,7
33300,3083149043,"{'login': 'hczhu', 'id': 2289363, 'node_id': 'MDQ6VXNlcjIyODkzNjM=', 'avatar_url': 'https://avatars0.githubusercontent.com/u/2289363?v=4', 'gravatar_id': '', 'url': 'https://api.github.com/users/hczhu', 'html_url': 'https://github.com/hczhu', 'followers_url': 'https://api.github.com/users/hczhu/followers', 'following_url': 'https://api.github.com/users/hczhu/following{/other_user}', 'gists_url': 'https://api.github.com/users/hczhu/gists{/gist_id}', 'starred_url': 'https://api.github.com/users/hczhu/starred{/owner}{/repo}', 'subscriptions_url': 'https://api.github.com/users/hczhu/subscriptions', 'organizations_url': 'https://api.github.com/users/hczhu/orgs', 'repos_url': 'https://api.github.com/users/hczhu/repos', 'events_url': 'https://api.github.com/users/hczhu/events{/privacy}', 'received_events_url': 'https://api.github.com/users/hczhu/received_events', 'type': 'User', 'site_admin': False}",referenced,01372b120c207149ae0f819534cacdd1c92b84ce,https://api.github.com/repos/pytorch/pytorch/commits/01372b120c207149ae0f819534cacdd1c92b84ce,2020-02-28T18:58:24Z,24,17,7
33270,3036545089,"{'login': 'facebook-github-bot', 'id': 6422482, 'node_id': 'MDQ6VXNlcjY0MjI0ODI=', 'avatar_url': 'https://avatars3.githubusercontent.com/u/6422482?v=4', 'gravatar_id': '', 'url': 'https://api.github.com/users/facebook-github-bot', 'html_url': 'https://github.com/facebook-github-bot', 'followers_url': 'https://api.github.com/users/facebook-github-bot/followers', 'following_url': 'https://api.github.com/users/facebook-github-bot/following{/other_user}', 'gists_url': 'https://api.github.com/users/facebook-github-bot/gists{/gist_id}', 'starred_url': 'https://api.github.com/users/facebook-github-bot/starred{/owner}{/repo}', 'subscriptions_url': 'https://api.github.com/users/facebook-github-bot/subscriptions', 'organizations_url': 'https://api.github.com/users/facebook-github-bot/orgs', 'repos_url': 'https://api.github.com/users/facebook-github-bot/repos', 'events_url': 'https://api.github.com/users/facebook-github-bot/events{/privacy}', 'received_events_url': 'https://api.github.com/users/facebook-github-bot/received_events', 'type': 'User', 'site_admin': False}",referenced,5b922918d023126ad1f468c68577c9b599ad202d,https://api.github.com/repos/pytorch/pytorch/commits/5b922918d023126ad1f468c68577c9b599ad202d,2020-02-13T21:12:56Z,1,1,0
33270,3057290649,"{'login': 'facebook-github-bot', 'id': 6422482, 'node_id': 'MDQ6VXNlcjY0MjI0ODI=', 'avatar_url': 'https://avatars3.githubusercontent.com/u/6422482?v=4', 'gravatar_id': '', 'url': 'https://api.github.com/users/facebook-github-bot', 'html_url': 'https://github.com/facebook-github-bot', 'followers_url': 'https://api.github.com/users/facebook-github-bot/followers', 'following_url': 'https://api.github.com/users/facebook-github-bot/following{/other_user}', 'gists_url': 'https://api.github.com/users/facebook-github-bot/gists{/gist_id}', 'starred_url': 'https://api.github.com/users/facebook-github-bot/starred{/owner}{/repo}', 'subscriptions_url': 'https://api.github.com/users/facebook-github-bot/subscriptions', 'organizations_url': 'https://api.github.com/users/facebook-github-bot/orgs', 'repos_url': 'https://api.github.com/users/facebook-github-bot/repos', 'events_url': 'https://api.github.com/users/facebook-github-bot/events{/privacy}', 'received_events_url': 'https://api.github.com/users/facebook-github-bot/received_events', 'type': 'User', 'site_admin': False}",closed,ffe327f7d9c0bf3f6d2fc64fd4dfb8b2c2013be8,https://api.github.com/repos/pytorch/pytorch/commits/ffe327f7d9c0bf3f6d2fc64fd4dfb8b2c2013be8,2020-02-20T17:10:55Z,16,6,10
33240,3040045651,"{'login': 'facebook-github-bot', 'id': 6422482, 'node_id': 'MDQ6VXNlcjY0MjI0ODI=', 'avatar_url': 'https://avatars3.githubusercontent.com/u/6422482?v=4', 'gravatar_id': '', 'url': 'https://api.github.com/users/facebook-github-bot', 'html_url': 'https://github.com/facebook-github-bot', 'followers_url': 'https://api.github.com/users/facebook-github-bot/followers', 'following_url': 'https://api.github.com/users/facebook-github-bot/following{/other_user}', 'gists_url': 'https://api.github.com/users/facebook-github-bot/gists{/gist_id}', 'starred_url': 'https://api.github.com/users/facebook-github-bot/starred{/owner}{/repo}', 'subscriptions_url': 'https://api.github.com/users/facebook-github-bot/subscriptions', 'organizations_url': 'https://api.github.com/users/facebook-github-bot/orgs', 'repos_url': 'https://api.github.com/users/facebook-github-bot/repos', 'events_url': 'https://api.github.com/users/facebook-github-bot/events{/privacy}', 'received_events_url': 'https://api.github.com/users/facebook-github-bot/received_events', 'type': 'User', 'site_admin': False}",referenced,e9e9331927f2200193c05df25ca6a7ea202b629e,https://api.github.com/repos/pytorch/pytorch/commits/e9e9331927f2200193c05df25ca6a7ea202b629e,2020-02-14T20:33:03Z,15,8,7
33209,3035681482,"{'login': 'facebook-github-bot', 'id': 6422482, 'node_id': 'MDQ6VXNlcjY0MjI0ODI=', 'avatar_url': 'https://avatars3.githubusercontent.com/u/6422482?v=4', 'gravatar_id': '', 'url': 'https://api.github.com/users/facebook-github-bot', 'html_url': 'https://github.com/facebook-github-bot', 'followers_url': 'https://api.github.com/users/facebook-github-bot/followers', 'following_url': 'https://api.github.com/users/facebook-github-bot/following{/other_user}', 'gists_url': 'https://api.github.com/users/facebook-github-bot/gists{/gist_id}', 'starred_url': 'https://api.github.com/users/facebook-github-bot/starred{/owner}{/repo}', 'subscriptions_url': 'https://api.github.com/users/facebook-github-bot/subscriptions', 'organizations_url': 'https://api.github.com/users/facebook-github-bot/orgs', 'repos_url': 'https://api.github.com/users/facebook-github-bot/repos', 'events_url': 'https://api.github.com/users/facebook-github-bot/events{/privacy}', 'received_events_url': 'https://api.github.com/users/facebook-github-bot/received_events', 'type': 'User', 'site_admin': False}",closed,ff7d147732806b2e484007ce3b1fe755bfbc77f2,https://api.github.com/repos/pytorch/pytorch/commits/ff7d147732806b2e484007ce3b1fe755bfbc77f2,2020-02-13T16:49:41Z,56,28,28
33203,3032694589,"{'login': 'facebook-github-bot', 'id': 6422482, 'node_id': 'MDQ6VXNlcjY0MjI0ODI=', 'avatar_url': 'https://avatars3.githubusercontent.com/u/6422482?v=4', 'gravatar_id': '', 'url': 'https://api.github.com/users/facebook-github-bot', 'html_url': 'https://github.com/facebook-github-bot', 'followers_url': 'https://api.github.com/users/facebook-github-bot/followers', 'following_url': 'https://api.github.com/users/facebook-github-bot/following{/other_user}', 'gists_url': 'https://api.github.com/users/facebook-github-bot/gists{/gist_id}', 'starred_url': 'https://api.github.com/users/facebook-github-bot/starred{/owner}{/repo}', 'subscriptions_url': 'https://api.github.com/users/facebook-github-bot/subscriptions', 'organizations_url': 'https://api.github.com/users/facebook-github-bot/orgs', 'repos_url': 'https://api.github.com/users/facebook-github-bot/repos', 'events_url': 'https://api.github.com/users/facebook-github-bot/events{/privacy}', 'received_events_url': 'https://api.github.com/users/facebook-github-bot/received_events', 'type': 'User', 'site_admin': False}",closed,ab14375b08d66452807bc8c2f1c6d8a03ef75704,https://api.github.com/repos/pytorch/pytorch/commits/ab14375b08d66452807bc8c2f1c6d8a03ef75704,2020-02-12T22:25:01Z,10,5,5
33195,3049947429,"{'login': 'facebook-github-bot', 'id': 6422482, 'node_id': 'MDQ6VXNlcjY0MjI0ODI=', 'avatar_url': 'https://avatars3.githubusercontent.com/u/6422482?v=4', 'gravatar_id': '', 'url': 'https://api.github.com/users/facebook-github-bot', 'html_url': 'https://github.com/facebook-github-bot', 'followers_url': 'https://api.github.com/users/facebook-github-bot/followers', 'following_url': 'https://api.github.com/users/facebook-github-bot/following{/other_user}', 'gists_url': 'https://api.github.com/users/facebook-github-bot/gists{/gist_id}', 'starred_url': 'https://api.github.com/users/facebook-github-bot/starred{/owner}{/repo}', 'subscriptions_url': 'https://api.github.com/users/facebook-github-bot/subscriptions', 'organizations_url': 'https://api.github.com/users/facebook-github-bot/orgs', 'repos_url': 'https://api.github.com/users/facebook-github-bot/repos', 'events_url': 'https://api.github.com/users/facebook-github-bot/events{/privacy}', 'received_events_url': 'https://api.github.com/users/facebook-github-bot/received_events', 'type': 'User', 'site_admin': False}",closed,feaa622fc658dd76bbc26fecaf614d4056bbac23,https://api.github.com/repos/pytorch/pytorch/commits/feaa622fc658dd76bbc26fecaf614d4056bbac23,2020-02-19T01:43:51Z,49,48,1
33176,3036489379,"{'login': 'facebook-github-bot', 'id': 6422482, 'node_id': 'MDQ6VXNlcjY0MjI0ODI=', 'avatar_url': 'https://avatars3.githubusercontent.com/u/6422482?v=4', 'gravatar_id': '', 'url': 'https://api.github.com/users/facebook-github-bot', 'html_url': 'https://github.com/facebook-github-bot', 'followers_url': 'https://api.github.com/users/facebook-github-bot/followers', 'following_url': 'https://api.github.com/users/facebook-github-bot/following{/other_user}', 'gists_url': 'https://api.github.com/users/facebook-github-bot/gists{/gist_id}', 'starred_url': 'https://api.github.com/users/facebook-github-bot/starred{/owner}{/repo}', 'subscriptions_url': 'https://api.github.com/users/facebook-github-bot/subscriptions', 'organizations_url': 'https://api.github.com/users/facebook-github-bot/orgs', 'repos_url': 'https://api.github.com/users/facebook-github-bot/repos', 'events_url': 'https://api.github.com/users/facebook-github-bot/events{/privacy}', 'received_events_url': 'https://api.github.com/users/facebook-github-bot/received_events', 'type': 'User', 'site_admin': False}",referenced,0c93c2b142ef3ce46a74d195de0dfd26002f41cd,https://api.github.com/repos/pytorch/pytorch/commits/0c93c2b142ef3ce46a74d195de0dfd26002f41cd,2020-02-13T20:54:14Z,5,4,1
33091,3039139238,"{'login': 'zou3519', 'id': 5652049, 'node_id': 'MDQ6VXNlcjU2NTIwNDk=', 'avatar_url': 'https://avatars3.githubusercontent.com/u/5652049?v=4', 'gravatar_id': '', 'url': 'https://api.github.com/users/zou3519', 'html_url': 'https://github.com/zou3519', 'followers_url': 'https://api.github.com/users/zou3519/followers', 'following_url': 'https://api.github.com/users/zou3519/following{/other_user}', 'gists_url': 'https://api.github.com/users/zou3519/gists{/gist_id}', 'starred_url': 'https://api.github.com/users/zou3519/starred{/owner}{/repo}', 'subscriptions_url': 'https://api.github.com/users/zou3519/subscriptions', 'organizations_url': 'https://api.github.com/users/zou3519/orgs', 'repos_url': 'https://api.github.com/users/zou3519/repos', 'events_url': 'https://api.github.com/users/zou3519/events{/privacy}', 'received_events_url': 'https://api.github.com/users/zou3519/received_events', 'type': 'User', 'site_admin': False}",referenced,11c38ad85ad2b6d290f93e6aa6de85013a827b02,https://api.github.com/repos/pytorch/pytorch/commits/11c38ad85ad2b6d290f93e6aa6de85013a827b02,2020-02-14T15:29:20Z,27,25,2
33091,3039139571,"{'login': 'zou3519', 'id': 5652049, 'node_id': 'MDQ6VXNlcjU2NTIwNDk=', 'avatar_url': 'https://avatars3.githubusercontent.com/u/5652049?v=4', 'gravatar_id': '', 'url': 'https://api.github.com/users/zou3519', 'html_url': 'https://github.com/zou3519', 'followers_url': 'https://api.github.com/users/zou3519/followers', 'following_url': 'https://api.github.com/users/zou3519/following{/other_user}', 'gists_url': 'https://api.github.com/users/zou3519/gists{/gist_id}', 'starred_url': 'https://api.github.com/users/zou3519/starred{/owner}{/repo}', 'subscriptions_url': 'https://api.github.com/users/zou3519/subscriptions', 'organizations_url': 'https://api.github.com/users/zou3519/orgs', 'repos_url': 'https://api.github.com/users/zou3519/repos', 'events_url': 'https://api.github.com/users/zou3519/events{/privacy}', 'received_events_url': 'https://api.github.com/users/zou3519/received_events', 'type': 'User', 'site_admin': False}",referenced,4a3a8f670c1961bbcec8fe7bc0db35e84017b329,https://api.github.com/repos/pytorch/pytorch/commits/4a3a8f670c1961bbcec8fe7bc0db35e84017b329,2020-02-14T15:29:25Z,27,25,2
33091,3039142736,"{'login': 'zou3519', 'id': 5652049, 'node_id': 'MDQ6VXNlcjU2NTIwNDk=', 'avatar_url': 'https://avatars3.githubusercontent.com/u/5652049?v=4', 'gravatar_id': '', 'url': 'https://api.github.com/users/zou3519', 'html_url': 'https://github.com/zou3519', 'followers_url': 'https://api.github.com/users/zou3519/followers', 'following_url': 'https://api.github.com/users/zou3519/following{/other_user}', 'gists_url': 'https://api.github.com/users/zou3519/gists{/gist_id}', 'starred_url': 'https://api.github.com/users/zou3519/starred{/owner}{/repo}', 'subscriptions_url': 'https://api.github.com/users/zou3519/subscriptions', 'organizations_url': 'https://api.github.com/users/zou3519/orgs', 'repos_url': 'https://api.github.com/users/zou3519/repos', 'events_url': 'https://api.github.com/users/zou3519/events{/privacy}', 'received_events_url': 'https://api.github.com/users/zou3519/received_events', 'type': 'User', 'site_admin': False}",referenced,5ca90d4312b56e9db468bd76329d2fcb47eb8501,https://api.github.com/repos/pytorch/pytorch/commits/5ca90d4312b56e9db468bd76329d2fcb47eb8501,2020-02-14T15:30:17Z,11,8,3
33091,3039142990,"{'login': 'zou3519', 'id': 5652049, 'node_id': 'MDQ6VXNlcjU2NTIwNDk=', 'avatar_url': 'https://avatars3.githubusercontent.com/u/5652049?v=4', 'gravatar_id': '', 'url': 'https://api.github.com/users/zou3519', 'html_url': 'https://github.com/zou3519', 'followers_url': 'https://api.github.com/users/zou3519/followers', 'following_url': 'https://api.github.com/users/zou3519/following{/other_user}', 'gists_url': 'https://api.github.com/users/zou3519/gists{/gist_id}', 'starred_url': 'https://api.github.com/users/zou3519/starred{/owner}{/repo}', 'subscriptions_url': 'https://api.github.com/users/zou3519/subscriptions', 'organizations_url': 'https://api.github.com/users/zou3519/orgs', 'repos_url': 'https://api.github.com/users/zou3519/repos', 'events_url': 'https://api.github.com/users/zou3519/events{/privacy}', 'received_events_url': 'https://api.github.com/users/zou3519/received_events', 'type': 'User', 'site_admin': False}",referenced,953ebfbc6dc52141d9c4a5073f2a311a7aa2de8e,https://api.github.com/repos/pytorch/pytorch/commits/953ebfbc6dc52141d9c4a5073f2a311a7aa2de8e,2020-02-14T15:30:21Z,32,30,2
33091,3047454338,"{'login': 'facebook-github-bot', 'id': 6422482, 'node_id': 'MDQ6VXNlcjY0MjI0ODI=', 'avatar_url': 'https://avatars3.githubusercontent.com/u/6422482?v=4', 'gravatar_id': '', 'url': 'https://api.github.com/users/facebook-github-bot', 'html_url': 'https://github.com/facebook-github-bot', 'followers_url': 'https://api.github.com/users/facebook-github-bot/followers', 'following_url': 'https://api.github.com/users/facebook-github-bot/following{/other_user}', 'gists_url': 'https://api.github.com/users/facebook-github-bot/gists{/gist_id}', 'starred_url': 'https://api.github.com/users/facebook-github-bot/starred{/owner}{/repo}', 'subscriptions_url': 'https://api.github.com/users/facebook-github-bot/subscriptions', 'organizations_url': 'https://api.github.com/users/facebook-github-bot/orgs', 'repos_url': 'https://api.github.com/users/facebook-github-bot/repos', 'events_url': 'https://api.github.com/users/facebook-github-bot/events{/privacy}', 'received_events_url': 'https://api.github.com/users/facebook-github-bot/received_events', 'type': 'User', 'site_admin': False}",closed,28c5213a97eddc9d742a0ba1087981a8d6010654,https://api.github.com/repos/pytorch/pytorch/commits/28c5213a97eddc9d742a0ba1087981a8d6010654,2020-02-18T14:49:42Z,32,30,2
33001,3052770333,"{'login': 'facebook-github-bot', 'id': 6422482, 'node_id': 'MDQ6VXNlcjY0MjI0ODI=', 'avatar_url': 'https://avatars3.githubusercontent.com/u/6422482?v=4', 'gravatar_id': '', 'url': 'https://api.github.com/users/facebook-github-bot', 'html_url': 'https://github.com/facebook-github-bot', 'followers_url': 'https://api.github.com/users/facebook-github-bot/followers', 'following_url': 'https://api.github.com/users/facebook-github-bot/following{/other_user}', 'gists_url': 'https://api.github.com/users/facebook-github-bot/gists{/gist_id}', 'starred_url': 'https://api.github.com/users/facebook-github-bot/starred{/owner}{/repo}', 'subscriptions_url': 'https://api.github.com/users/facebook-github-bot/subscriptions', 'organizations_url': 'https://api.github.com/users/facebook-github-bot/orgs', 'repos_url': 'https://api.github.com/users/facebook-github-bot/repos', 'events_url': 'https://api.github.com/users/facebook-github-bot/events{/privacy}', 'received_events_url': 'https://api.github.com/users/facebook-github-bot/received_events', 'type': 'User', 'site_admin': False}",closed,60339a38eded68eeef91f84734b4d665ddf4e080,https://api.github.com/repos/pytorch/pytorch/commits/60339a38eded68eeef91f84734b4d665ddf4e080,2020-02-19T18:01:31Z,2,1,1
32973,3033018364,"{'login': 'driazati', 'id': 9407960, 'node_id': 'MDQ6VXNlcjk0MDc5NjA=', 'avatar_url': 'https://avatars3.githubusercontent.com/u/9407960?v=4', 'gravatar_id': '', 'url': 'https://api.github.com/users/driazati', 'html_url': 'https://github.com/driazati', 'followers_url': 'https://api.github.com/users/driazati/followers', 'following_url': 'https://api.github.com/users/driazati/following{/other_user}', 'gists_url': 'https://api.github.com/users/driazati/gists{/gist_id}', 'starred_url': 'https://api.github.com/users/driazati/starred{/owner}{/repo}', 'subscriptions_url': 'https://api.github.com/users/driazati/subscriptions', 'organizations_url': 'https://api.github.com/users/driazati/orgs', 'repos_url': 'https://api.github.com/users/driazati/repos', 'events_url': 'https://api.github.com/users/driazati/events{/privacy}', 'received_events_url': 'https://api.github.com/users/driazati/received_events', 'type': 'User', 'site_admin': False}",referenced,0a2f941318cd9fd7b0350d7de87448ec39e45d2e,https://api.github.com/repos/pytorch/pytorch/commits/0a2f941318cd9fd7b0350d7de87448ec39e45d2e,2020-02-13T00:48:26Z,87,81,6
32973,3061164506,"{'login': 'facebook-github-bot', 'id': 6422482, 'node_id': 'MDQ6VXNlcjY0MjI0ODI=', 'avatar_url': 'https://avatars3.githubusercontent.com/u/6422482?v=4', 'gravatar_id': '', 'url': 'https://api.github.com/users/facebook-github-bot', 'html_url': 'https://github.com/facebook-github-bot', 'followers_url': 'https://api.github.com/users/facebook-github-bot/followers', 'following_url': 'https://api.github.com/users/facebook-github-bot/following{/other_user}', 'gists_url': 'https://api.github.com/users/facebook-github-bot/gists{/gist_id}', 'starred_url': 'https://api.github.com/users/facebook-github-bot/starred{/owner}{/repo}', 'subscriptions_url': 'https://api.github.com/users/facebook-github-bot/subscriptions', 'organizations_url': 'https://api.github.com/users/facebook-github-bot/orgs', 'repos_url': 'https://api.github.com/users/facebook-github-bot/repos', 'events_url': 'https://api.github.com/users/facebook-github-bot/events{/privacy}', 'received_events_url': 'https://api.github.com/users/facebook-github-bot/received_events', 'type': 'User', 'site_admin': False}",closed,ee28831341c0398b0e2a0791ffd77263217f0bff,https://api.github.com/repos/pytorch/pytorch/commits/ee28831341c0398b0e2a0791ffd77263217f0bff,2020-02-21T16:44:27Z,204,175,29
32949,3028083521,"{'login': 'facebook-github-bot', 'id': 6422482, 'node_id': 'MDQ6VXNlcjY0MjI0ODI=', 'avatar_url': 'https://avatars3.githubusercontent.com/u/6422482?v=4', 'gravatar_id': '', 'url': 'https://api.github.com/users/facebook-github-bot', 'html_url': 'https://github.com/facebook-github-bot', 'followers_url': 'https://api.github.com/users/facebook-github-bot/followers', 'following_url': 'https://api.github.com/users/facebook-github-bot/following{/other_user}', 'gists_url': 'https://api.github.com/users/facebook-github-bot/gists{/gist_id}', 'starred_url': 'https://api.github.com/users/facebook-github-bot/starred{/owner}{/repo}', 'subscriptions_url': 'https://api.github.com/users/facebook-github-bot/subscriptions', 'organizations_url': 'https://api.github.com/users/facebook-github-bot/orgs', 'repos_url': 'https://api.github.com/users/facebook-github-bot/repos', 'events_url': 'https://api.github.com/users/facebook-github-bot/events{/privacy}', 'received_events_url': 'https://api.github.com/users/facebook-github-bot/received_events', 'type': 'User', 'site_admin': False}",referenced,ad90c97c0ac455546b2b6353a22caa25dcf0574d,https://api.github.com/repos/pytorch/pytorch/commits/ad90c97c0ac455546b2b6353a22caa25dcf0574d,2020-02-11T20:22:26Z,4,1,3
32946,3007292151,"{'login': 'pbelevich', 'id': 1160355, 'node_id': 'MDQ6VXNlcjExNjAzNTU=', 'avatar_url': 'https://avatars1.githubusercontent.com/u/1160355?v=4', 'gravatar_id': '', 'url': 'https://api.github.com/users/pbelevich', 'html_url': 'https://github.com/pbelevich', 'followers_url': 'https://api.github.com/users/pbelevich/followers', 'following_url': 'https://api.github.com/users/pbelevich/following{/other_user}', 'gists_url': 'https://api.github.com/users/pbelevich/gists{/gist_id}', 'starred_url': 'https://api.github.com/users/pbelevich/starred{/owner}{/repo}', 'subscriptions_url': 'https://api.github.com/users/pbelevich/subscriptions', 'organizations_url': 'https://api.github.com/users/pbelevich/orgs', 'repos_url': 'https://api.github.com/users/pbelevich/repos', 'events_url': 'https://api.github.com/users/pbelevich/events{/privacy}', 'received_events_url': 'https://api.github.com/users/pbelevich/received_events', 'type': 'User', 'site_admin': False}",referenced,1f4ce7a20ed622e91f2a7d0461645ac4110a92f0,https://api.github.com/repos/pytorch/pytorch/commits/1f4ce7a20ed622e91f2a7d0461645ac4110a92f0,2020-02-04T18:52:21Z,111,106,5
32946,3007328422,"{'login': 'pbelevich', 'id': 1160355, 'node_id': 'MDQ6VXNlcjExNjAzNTU=', 'avatar_url': 'https://avatars1.githubusercontent.com/u/1160355?v=4', 'gravatar_id': '', 'url': 'https://api.github.com/users/pbelevich', 'html_url': 'https://github.com/pbelevich', 'followers_url': 'https://api.github.com/users/pbelevich/followers', 'following_url': 'https://api.github.com/users/pbelevich/following{/other_user}', 'gists_url': 'https://api.github.com/users/pbelevich/gists{/gist_id}', 'starred_url': 'https://api.github.com/users/pbelevich/starred{/owner}{/repo}', 'subscriptions_url': 'https://api.github.com/users/pbelevich/subscriptions', 'organizations_url': 'https://api.github.com/users/pbelevich/orgs', 'repos_url': 'https://api.github.com/users/pbelevich/repos', 'events_url': 'https://api.github.com/users/pbelevich/events{/privacy}', 'received_events_url': 'https://api.github.com/users/pbelevich/received_events', 'type': 'User', 'site_admin': False}",referenced,58102751fdd1038324ac29d10cf67fc760922608,https://api.github.com/repos/pytorch/pytorch/commits/58102751fdd1038324ac29d10cf67fc760922608,2020-02-04T19:03:43Z,2,1,1
32946,3007562516,"{'login': 'pbelevich', 'id': 1160355, 'node_id': 'MDQ6VXNlcjExNjAzNTU=', 'avatar_url': 'https://avatars1.githubusercontent.com/u/1160355?v=4', 'gravatar_id': '', 'url': 'https://api.github.com/users/pbelevich', 'html_url': 'https://github.com/pbelevich', 'followers_url': 'https://api.github.com/users/pbelevich/followers', 'following_url': 'https://api.github.com/users/pbelevich/following{/other_user}', 'gists_url': 'https://api.github.com/users/pbelevich/gists{/gist_id}', 'starred_url': 'https://api.github.com/users/pbelevich/starred{/owner}{/repo}', 'subscriptions_url': 'https://api.github.com/users/pbelevich/subscriptions', 'organizations_url': 'https://api.github.com/users/pbelevich/orgs', 'repos_url': 'https://api.github.com/users/pbelevich/repos', 'events_url': 'https://api.github.com/users/pbelevich/events{/privacy}', 'received_events_url': 'https://api.github.com/users/pbelevich/received_events', 'type': 'User', 'site_admin': False}",referenced,1de76e8930201697c1def91ec4923485cd2b1ad8,https://api.github.com/repos/pytorch/pytorch/commits/1de76e8930201697c1def91ec4923485cd2b1ad8,2020-02-04T20:18:01Z,307,278,29
32946,3007606114,"{'login': 'pbelevich', 'id': 1160355, 'node_id': 'MDQ6VXNlcjExNjAzNTU=', 'avatar_url': 'https://avatars1.githubusercontent.com/u/1160355?v=4', 'gravatar_id': '', 'url': 'https://api.github.com/users/pbelevich', 'html_url': 'https://github.com/pbelevich', 'followers_url': 'https://api.github.com/users/pbelevich/followers', 'following_url': 'https://api.github.com/users/pbelevich/following{/other_user}', 'gists_url': 'https://api.github.com/users/pbelevich/gists{/gist_id}', 'starred_url': 'https://api.github.com/users/pbelevich/starred{/owner}{/repo}', 'subscriptions_url': 'https://api.github.com/users/pbelevich/subscriptions', 'organizations_url': 'https://api.github.com/users/pbelevich/orgs', 'repos_url': 'https://api.github.com/users/pbelevich/repos', 'events_url': 'https://api.github.com/users/pbelevich/events{/privacy}', 'received_events_url': 'https://api.github.com/users/pbelevich/received_events', 'type': 'User', 'site_admin': False}",referenced,8f0c89dca9cebdcbfb60823eb896f3c25f4b491e,https://api.github.com/repos/pytorch/pytorch/commits/8f0c89dca9cebdcbfb60823eb896f3c25f4b491e,2020-02-04T20:32:50Z,8,7,1
32946,3008350794,"{'login': 'pbelevich', 'id': 1160355, 'node_id': 'MDQ6VXNlcjExNjAzNTU=', 'avatar_url': 'https://avatars1.githubusercontent.com/u/1160355?v=4', 'gravatar_id': '', 'url': 'https://api.github.com/users/pbelevich', 'html_url': 'https://github.com/pbelevich', 'followers_url': 'https://api.github.com/users/pbelevich/followers', 'following_url': 'https://api.github.com/users/pbelevich/following{/other_user}', 'gists_url': 'https://api.github.com/users/pbelevich/gists{/gist_id}', 'starred_url': 'https://api.github.com/users/pbelevich/starred{/owner}{/repo}', 'subscriptions_url': 'https://api.github.com/users/pbelevich/subscriptions', 'organizations_url': 'https://api.github.com/users/pbelevich/orgs', 'repos_url': 'https://api.github.com/users/pbelevich/repos', 'events_url': 'https://api.github.com/users/pbelevich/events{/privacy}', 'received_events_url': 'https://api.github.com/users/pbelevich/received_events', 'type': 'User', 'site_admin': False}",referenced,fc3b0c51e9f34ca7a1e1256836fbb3bf41821fa5,https://api.github.com/repos/pytorch/pytorch/commits/fc3b0c51e9f34ca7a1e1256836fbb3bf41821fa5,2020-02-05T01:46:46Z,167,96,71
32946,3008475823,"{'login': 'facebook-github-bot', 'id': 6422482, 'node_id': 'MDQ6VXNlcjY0MjI0ODI=', 'avatar_url': 'https://avatars3.githubusercontent.com/u/6422482?v=4', 'gravatar_id': '', 'url': 'https://api.github.com/users/facebook-github-bot', 'html_url': 'https://github.com/facebook-github-bot', 'followers_url': 'https://api.github.com/users/facebook-github-bot/followers', 'following_url': 'https://api.github.com/users/facebook-github-bot/following{/other_user}', 'gists_url': 'https://api.github.com/users/facebook-github-bot/gists{/gist_id}', 'starred_url': 'https://api.github.com/users/facebook-github-bot/starred{/owner}{/repo}', 'subscriptions_url': 'https://api.github.com/users/facebook-github-bot/subscriptions', 'organizations_url': 'https://api.github.com/users/facebook-github-bot/orgs', 'repos_url': 'https://api.github.com/users/facebook-github-bot/repos', 'events_url': 'https://api.github.com/users/facebook-github-bot/events{/privacy}', 'received_events_url': 'https://api.github.com/users/facebook-github-bot/received_events', 'type': 'User', 'site_admin': False}",closed,d141465713c3c8fcb5a4313361daa6dd3f671e29,https://api.github.com/repos/pytorch/pytorch/commits/d141465713c3c8fcb5a4313361daa6dd3f671e29,2020-02-05T03:08:11Z,86,83,3
32914,3007635797,"{'login': 'facebook-github-bot', 'id': 6422482, 'node_id': 'MDQ6VXNlcjY0MjI0ODI=', 'avatar_url': 'https://avatars3.githubusercontent.com/u/6422482?v=4', 'gravatar_id': '', 'url': 'https://api.github.com/users/facebook-github-bot', 'html_url': 'https://github.com/facebook-github-bot', 'followers_url': 'https://api.github.com/users/facebook-github-bot/followers', 'following_url': 'https://api.github.com/users/facebook-github-bot/following{/other_user}', 'gists_url': 'https://api.github.com/users/facebook-github-bot/gists{/gist_id}', 'starred_url': 'https://api.github.com/users/facebook-github-bot/starred{/owner}{/repo}', 'subscriptions_url': 'https://api.github.com/users/facebook-github-bot/subscriptions', 'organizations_url': 'https://api.github.com/users/facebook-github-bot/orgs', 'repos_url': 'https://api.github.com/users/facebook-github-bot/repos', 'events_url': 'https://api.github.com/users/facebook-github-bot/events{/privacy}', 'received_events_url': 'https://api.github.com/users/facebook-github-bot/received_events', 'type': 'User', 'site_admin': False}",closed,d3fa68eeec893bfb809bc18169d79f5d397feb79,https://api.github.com/repos/pytorch/pytorch/commits/d3fa68eeec893bfb809bc18169d79f5d397feb79,2020-02-04T20:43:28Z,25,16,9
32863,3041250348,"{'login': 'facebook-github-bot', 'id': 6422482, 'node_id': 'MDQ6VXNlcjY0MjI0ODI=', 'avatar_url': 'https://avatars3.githubusercontent.com/u/6422482?v=4', 'gravatar_id': '', 'url': 'https://api.github.com/users/facebook-github-bot', 'html_url': 'https://github.com/facebook-github-bot', 'followers_url': 'https://api.github.com/users/facebook-github-bot/followers', 'following_url': 'https://api.github.com/users/facebook-github-bot/following{/other_user}', 'gists_url': 'https://api.github.com/users/facebook-github-bot/gists{/gist_id}', 'starred_url': 'https://api.github.com/users/facebook-github-bot/starred{/owner}{/repo}', 'subscriptions_url': 'https://api.github.com/users/facebook-github-bot/subscriptions', 'organizations_url': 'https://api.github.com/users/facebook-github-bot/orgs', 'repos_url': 'https://api.github.com/users/facebook-github-bot/repos', 'events_url': 'https://api.github.com/users/facebook-github-bot/events{/privacy}', 'received_events_url': 'https://api.github.com/users/facebook-github-bot/received_events', 'type': 'User', 'site_admin': False}",referenced,495bd5818bc094d4b94b309ded614f666c9ca849,https://api.github.com/repos/pytorch/pytorch/commits/495bd5818bc094d4b94b309ded614f666c9ca849,2020-02-16T01:26:34Z,111,96,15
32756,3057804168,"{'login': 'facebook-github-bot', 'id': 6422482, 'node_id': 'MDQ6VXNlcjY0MjI0ODI=', 'avatar_url': 'https://avatars3.githubusercontent.com/u/6422482?v=4', 'gravatar_id': '', 'url': 'https://api.github.com/users/facebook-github-bot', 'html_url': 'https://github.com/facebook-github-bot', 'followers_url': 'https://api.github.com/users/facebook-github-bot/followers', 'following_url': 'https://api.github.com/users/facebook-github-bot/following{/other_user}', 'gists_url': 'https://api.github.com/users/facebook-github-bot/gists{/gist_id}', 'starred_url': 'https://api.github.com/users/facebook-github-bot/starred{/owner}{/repo}', 'subscriptions_url': 'https://api.github.com/users/facebook-github-bot/subscriptions', 'organizations_url': 'https://api.github.com/users/facebook-github-bot/orgs', 'repos_url': 'https://api.github.com/users/facebook-github-bot/repos', 'events_url': 'https://api.github.com/users/facebook-github-bot/events{/privacy}', 'received_events_url': 'https://api.github.com/users/facebook-github-bot/received_events', 'type': 'User', 'site_admin': False}",closed,cdf381c967c7c93aa60941b0d35c33e1f8ec3121,https://api.github.com/repos/pytorch/pytorch/commits/cdf381c967c7c93aa60941b0d35c33e1f8ec3121,2020-02-20T19:12:03Z,6,6,0
32750,2998716460,"{'login': 'facebook-github-bot', 'id': 6422482, 'node_id': 'MDQ6VXNlcjY0MjI0ODI=', 'avatar_url': 'https://avatars3.githubusercontent.com/u/6422482?v=4', 'gravatar_id': '', 'url': 'https://api.github.com/users/facebook-github-bot', 'html_url': 'https://github.com/facebook-github-bot', 'followers_url': 'https://api.github.com/users/facebook-github-bot/followers', 'following_url': 'https://api.github.com/users/facebook-github-bot/following{/other_user}', 'gists_url': 'https://api.github.com/users/facebook-github-bot/gists{/gist_id}', 'starred_url': 'https://api.github.com/users/facebook-github-bot/starred{/owner}{/repo}', 'subscriptions_url': 'https://api.github.com/users/facebook-github-bot/subscriptions', 'organizations_url': 'https://api.github.com/users/facebook-github-bot/orgs', 'repos_url': 'https://api.github.com/users/facebook-github-bot/repos', 'events_url': 'https://api.github.com/users/facebook-github-bot/events{/privacy}', 'received_events_url': 'https://api.github.com/users/facebook-github-bot/received_events', 'type': 'User', 'site_admin': False}",referenced,7b65acdf9e8345d2ffbbc3b85ae6667f7260407e,https://api.github.com/repos/pytorch/pytorch/commits/7b65acdf9e8345d2ffbbc3b85ae6667f7260407e,2020-01-31T22:27:03Z,22,20,2
32732,3003387629,"{'login': 'rohan-varma', 'id': 8039770, 'node_id': 'MDQ6VXNlcjgwMzk3NzA=', 'avatar_url': 'https://avatars2.githubusercontent.com/u/8039770?v=4', 'gravatar_id': '', 'url': 'https://api.github.com/users/rohan-varma', 'html_url': 'https://github.com/rohan-varma', 'followers_url': 'https://api.github.com/users/rohan-varma/followers', 'following_url': 'https://api.github.com/users/rohan-varma/following{/other_user}', 'gists_url': 'https://api.github.com/users/rohan-varma/gists{/gist_id}', 'starred_url': 'https://api.github.com/users/rohan-varma/starred{/owner}{/repo}', 'subscriptions_url': 'https://api.github.com/users/rohan-varma/subscriptions', 'organizations_url': 'https://api.github.com/users/rohan-varma/orgs', 'repos_url': 'https://api.github.com/users/rohan-varma/repos', 'events_url': 'https://api.github.com/users/rohan-varma/events{/privacy}', 'received_events_url': 'https://api.github.com/users/rohan-varma/received_events', 'type': 'User', 'site_admin': False}",referenced,14cb00163a1eb00004b57dbedcc4abea5a8dd198,https://api.github.com/repos/pytorch/pytorch/commits/14cb00163a1eb00004b57dbedcc4abea5a8dd198,2020-02-03T18:55:19Z,23,12,11
32732,3003388724,"{'login': 'rohan-varma', 'id': 8039770, 'node_id': 'MDQ6VXNlcjgwMzk3NzA=', 'avatar_url': 'https://avatars2.githubusercontent.com/u/8039770?v=4', 'gravatar_id': '', 'url': 'https://api.github.com/users/rohan-varma', 'html_url': 'https://github.com/rohan-varma', 'followers_url': 'https://api.github.com/users/rohan-varma/followers', 'following_url': 'https://api.github.com/users/rohan-varma/following{/other_user}', 'gists_url': 'https://api.github.com/users/rohan-varma/gists{/gist_id}', 'starred_url': 'https://api.github.com/users/rohan-varma/starred{/owner}{/repo}', 'subscriptions_url': 'https://api.github.com/users/rohan-varma/subscriptions', 'organizations_url': 'https://api.github.com/users/rohan-varma/orgs', 'repos_url': 'https://api.github.com/users/rohan-varma/repos', 'events_url': 'https://api.github.com/users/rohan-varma/events{/privacy}', 'received_events_url': 'https://api.github.com/users/rohan-varma/received_events', 'type': 'User', 'site_admin': False}",referenced,3f24c0f74f7cef31205a139eb109c978738b7073,https://api.github.com/repos/pytorch/pytorch/commits/3f24c0f74f7cef31205a139eb109c978738b7073,2020-02-03T18:55:39Z,23,12,11
32732,3003422286,"{'login': 'rohan-varma', 'id': 8039770, 'node_id': 'MDQ6VXNlcjgwMzk3NzA=', 'avatar_url': 'https://avatars2.githubusercontent.com/u/8039770?v=4', 'gravatar_id': '', 'url': 'https://api.github.com/users/rohan-varma', 'html_url': 'https://github.com/rohan-varma', 'followers_url': 'https://api.github.com/users/rohan-varma/followers', 'following_url': 'https://api.github.com/users/rohan-varma/following{/other_user}', 'gists_url': 'https://api.github.com/users/rohan-varma/gists{/gist_id}', 'starred_url': 'https://api.github.com/users/rohan-varma/starred{/owner}{/repo}', 'subscriptions_url': 'https://api.github.com/users/rohan-varma/subscriptions', 'organizations_url': 'https://api.github.com/users/rohan-varma/orgs', 'repos_url': 'https://api.github.com/users/rohan-varma/repos', 'events_url': 'https://api.github.com/users/rohan-varma/events{/privacy}', 'received_events_url': 'https://api.github.com/users/rohan-varma/received_events', 'type': 'User', 'site_admin': False}",referenced,9b5176321e6ef91644900229acc131d4180a4e7e,https://api.github.com/repos/pytorch/pytorch/commits/9b5176321e6ef91644900229acc131d4180a4e7e,2020-02-03T19:06:47Z,2,0,2
32732,3003422552,"{'login': 'rohan-varma', 'id': 8039770, 'node_id': 'MDQ6VXNlcjgwMzk3NzA=', 'avatar_url': 'https://avatars2.githubusercontent.com/u/8039770?v=4', 'gravatar_id': '', 'url': 'https://api.github.com/users/rohan-varma', 'html_url': 'https://github.com/rohan-varma', 'followers_url': 'https://api.github.com/users/rohan-varma/followers', 'following_url': 'https://api.github.com/users/rohan-varma/following{/other_user}', 'gists_url': 'https://api.github.com/users/rohan-varma/gists{/gist_id}', 'starred_url': 'https://api.github.com/users/rohan-varma/starred{/owner}{/repo}', 'subscriptions_url': 'https://api.github.com/users/rohan-varma/subscriptions', 'organizations_url': 'https://api.github.com/users/rohan-varma/orgs', 'repos_url': 'https://api.github.com/users/rohan-varma/repos', 'events_url': 'https://api.github.com/users/rohan-varma/events{/privacy}', 'received_events_url': 'https://api.github.com/users/rohan-varma/received_events', 'type': 'User', 'site_admin': False}",referenced,d101d6ee3fffbaf6a5105d88e25261aec012b242,https://api.github.com/repos/pytorch/pytorch/commits/d101d6ee3fffbaf6a5105d88e25261aec012b242,2020-02-03T19:06:53Z,25,12,13
32732,3007089008,"{'login': 'rohan-varma', 'id': 8039770, 'node_id': 'MDQ6VXNlcjgwMzk3NzA=', 'avatar_url': 'https://avatars2.githubusercontent.com/u/8039770?v=4', 'gravatar_id': '', 'url': 'https://api.github.com/users/rohan-varma', 'html_url': 'https://github.com/rohan-varma', 'followers_url': 'https://api.github.com/users/rohan-varma/followers', 'following_url': 'https://api.github.com/users/rohan-varma/following{/other_user}', 'gists_url': 'https://api.github.com/users/rohan-varma/gists{/gist_id}', 'starred_url': 'https://api.github.com/users/rohan-varma/starred{/owner}{/repo}', 'subscriptions_url': 'https://api.github.com/users/rohan-varma/subscriptions', 'organizations_url': 'https://api.github.com/users/rohan-varma/orgs', 'repos_url': 'https://api.github.com/users/rohan-varma/repos', 'events_url': 'https://api.github.com/users/rohan-varma/events{/privacy}', 'received_events_url': 'https://api.github.com/users/rohan-varma/received_events', 'type': 'User', 'site_admin': False}",referenced,71366a670dd5e062561453f7638cd9486041c288,https://api.github.com/repos/pytorch/pytorch/commits/71366a670dd5e062561453f7638cd9486041c288,2020-02-04T17:49:09Z,2626,2002,624
32692,2990195129,"{'login': 'facebook-github-bot', 'id': 6422482, 'node_id': 'MDQ6VXNlcjY0MjI0ODI=', 'avatar_url': 'https://avatars3.githubusercontent.com/u/6422482?v=4', 'gravatar_id': '', 'url': 'https://api.github.com/users/facebook-github-bot', 'html_url': 'https://github.com/facebook-github-bot', 'followers_url': 'https://api.github.com/users/facebook-github-bot/followers', 'following_url': 'https://api.github.com/users/facebook-github-bot/following{/other_user}', 'gists_url': 'https://api.github.com/users/facebook-github-bot/gists{/gist_id}', 'starred_url': 'https://api.github.com/users/facebook-github-bot/starred{/owner}{/repo}', 'subscriptions_url': 'https://api.github.com/users/facebook-github-bot/subscriptions', 'organizations_url': 'https://api.github.com/users/facebook-github-bot/orgs', 'repos_url': 'https://api.github.com/users/facebook-github-bot/repos', 'events_url': 'https://api.github.com/users/facebook-github-bot/events{/privacy}', 'received_events_url': 'https://api.github.com/users/facebook-github-bot/received_events', 'type': 'User', 'site_admin': False}",referenced,c7bf4d22fe7f0de239feeb084682827c3b9a759f,https://api.github.com/repos/pytorch/pytorch/commits/c7bf4d22fe7f0de239feeb084682827c3b9a759f,2020-01-29T16:27:50Z,7,4,3
32645,3048046691,"{'login': 'facebook-github-bot', 'id': 6422482, 'node_id': 'MDQ6VXNlcjY0MjI0ODI=', 'avatar_url': 'https://avatars3.githubusercontent.com/u/6422482?v=4', 'gravatar_id': '', 'url': 'https://api.github.com/users/facebook-github-bot', 'html_url': 'https://github.com/facebook-github-bot', 'followers_url': 'https://api.github.com/users/facebook-github-bot/followers', 'following_url': 'https://api.github.com/users/facebook-github-bot/following{/other_user}', 'gists_url': 'https://api.github.com/users/facebook-github-bot/gists{/gist_id}', 'starred_url': 'https://api.github.com/users/facebook-github-bot/starred{/owner}{/repo}', 'subscriptions_url': 'https://api.github.com/users/facebook-github-bot/subscriptions', 'organizations_url': 'https://api.github.com/users/facebook-github-bot/orgs', 'repos_url': 'https://api.github.com/users/facebook-github-bot/repos', 'events_url': 'https://api.github.com/users/facebook-github-bot/events{/privacy}', 'received_events_url': 'https://api.github.com/users/facebook-github-bot/received_events', 'type': 'User', 'site_admin': False}",closed,879cf0b15a54c7848ae710e3d0ec62c4a9d7d3dd,https://api.github.com/repos/pytorch/pytorch/commits/879cf0b15a54c7848ae710e3d0ec62c4a9d7d3dd,2020-02-18T17:12:31Z,4,2,2
32639,3027507364,"{'login': 'facebook-github-bot', 'id': 6422482, 'node_id': 'MDQ6VXNlcjY0MjI0ODI=', 'avatar_url': 'https://avatars3.githubusercontent.com/u/6422482?v=4', 'gravatar_id': '', 'url': 'https://api.github.com/users/facebook-github-bot', 'html_url': 'https://github.com/facebook-github-bot', 'followers_url': 'https://api.github.com/users/facebook-github-bot/followers', 'following_url': 'https://api.github.com/users/facebook-github-bot/following{/other_user}', 'gists_url': 'https://api.github.com/users/facebook-github-bot/gists{/gist_id}', 'starred_url': 'https://api.github.com/users/facebook-github-bot/starred{/owner}{/repo}', 'subscriptions_url': 'https://api.github.com/users/facebook-github-bot/subscriptions', 'organizations_url': 'https://api.github.com/users/facebook-github-bot/orgs', 'repos_url': 'https://api.github.com/users/facebook-github-bot/repos', 'events_url': 'https://api.github.com/users/facebook-github-bot/events{/privacy}', 'received_events_url': 'https://api.github.com/users/facebook-github-bot/received_events', 'type': 'User', 'site_admin': False}",closed,e7f0b15473d4dea3e202c98ccafe0d054cb0a204,https://api.github.com/repos/pytorch/pytorch/commits/e7f0b15473d4dea3e202c98ccafe0d054cb0a204,2020-02-11T17:29:15Z,19,18,1
32510,2974620839,"{'login': 'pbelevich', 'id': 1160355, 'node_id': 'MDQ6VXNlcjExNjAzNTU=', 'avatar_url': 'https://avatars1.githubusercontent.com/u/1160355?v=4', 'gravatar_id': '', 'url': 'https://api.github.com/users/pbelevich', 'html_url': 'https://github.com/pbelevich', 'followers_url': 'https://api.github.com/users/pbelevich/followers', 'following_url': 'https://api.github.com/users/pbelevich/following{/other_user}', 'gists_url': 'https://api.github.com/users/pbelevich/gists{/gist_id}', 'starred_url': 'https://api.github.com/users/pbelevich/starred{/owner}{/repo}', 'subscriptions_url': 'https://api.github.com/users/pbelevich/subscriptions', 'organizations_url': 'https://api.github.com/users/pbelevich/orgs', 'repos_url': 'https://api.github.com/users/pbelevich/repos', 'events_url': 'https://api.github.com/users/pbelevich/events{/privacy}', 'received_events_url': 'https://api.github.com/users/pbelevich/received_events', 'type': 'User', 'site_admin': False}",referenced,83afe554a84a48daa508ed31f97ef44863c59a59,https://api.github.com/repos/pytorch/pytorch/commits/83afe554a84a48daa508ed31f97ef44863c59a59,2020-01-23T17:32:36Z,19,15,4
32510,2975048022,"{'login': 'pbelevich', 'id': 1160355, 'node_id': 'MDQ6VXNlcjExNjAzNTU=', 'avatar_url': 'https://avatars1.githubusercontent.com/u/1160355?v=4', 'gravatar_id': '', 'url': 'https://api.github.com/users/pbelevich', 'html_url': 'https://github.com/pbelevich', 'followers_url': 'https://api.github.com/users/pbelevich/followers', 'following_url': 'https://api.github.com/users/pbelevich/following{/other_user}', 'gists_url': 'https://api.github.com/users/pbelevich/gists{/gist_id}', 'starred_url': 'https://api.github.com/users/pbelevich/starred{/owner}{/repo}', 'subscriptions_url': 'https://api.github.com/users/pbelevich/subscriptions', 'organizations_url': 'https://api.github.com/users/pbelevich/orgs', 'repos_url': 'https://api.github.com/users/pbelevich/repos', 'events_url': 'https://api.github.com/users/pbelevich/events{/privacy}', 'received_events_url': 'https://api.github.com/users/pbelevich/received_events', 'type': 'User', 'site_admin': False}",referenced,8d470d3b2d040b15dc58ba78f31dc6283a75aa84,https://api.github.com/repos/pytorch/pytorch/commits/8d470d3b2d040b15dc58ba78f31dc6283a75aa84,2020-01-23T19:51:10Z,345,220,125
32510,2975305947,"{'login': 'pbelevich', 'id': 1160355, 'node_id': 'MDQ6VXNlcjExNjAzNTU=', 'avatar_url': 'https://avatars1.githubusercontent.com/u/1160355?v=4', 'gravatar_id': '', 'url': 'https://api.github.com/users/pbelevich', 'html_url': 'https://github.com/pbelevich', 'followers_url': 'https://api.github.com/users/pbelevich/followers', 'following_url': 'https://api.github.com/users/pbelevich/following{/other_user}', 'gists_url': 'https://api.github.com/users/pbelevich/gists{/gist_id}', 'starred_url': 'https://api.github.com/users/pbelevich/starred{/owner}{/repo}', 'subscriptions_url': 'https://api.github.com/users/pbelevich/subscriptions', 'organizations_url': 'https://api.github.com/users/pbelevich/orgs', 'repos_url': 'https://api.github.com/users/pbelevich/repos', 'events_url': 'https://api.github.com/users/pbelevich/events{/privacy}', 'received_events_url': 'https://api.github.com/users/pbelevich/received_events', 'type': 'User', 'site_admin': False}",referenced,2a83c8b2aa2bbaa7ee65f9755acf8ae7277bf992,https://api.github.com/repos/pytorch/pytorch/commits/2a83c8b2aa2bbaa7ee65f9755acf8ae7277bf992,2020-01-23T21:15:26Z,78,74,4
32510,2983608100,"{'login': 'pbelevich', 'id': 1160355, 'node_id': 'MDQ6VXNlcjExNjAzNTU=', 'avatar_url': 'https://avatars1.githubusercontent.com/u/1160355?v=4', 'gravatar_id': '', 'url': 'https://api.github.com/users/pbelevich', 'html_url': 'https://github.com/pbelevich', 'followers_url': 'https://api.github.com/users/pbelevich/followers', 'following_url': 'https://api.github.com/users/pbelevich/following{/other_user}', 'gists_url': 'https://api.github.com/users/pbelevich/gists{/gist_id}', 'starred_url': 'https://api.github.com/users/pbelevich/starred{/owner}{/repo}', 'subscriptions_url': 'https://api.github.com/users/pbelevich/subscriptions', 'organizations_url': 'https://api.github.com/users/pbelevich/orgs', 'repos_url': 'https://api.github.com/users/pbelevich/repos', 'events_url': 'https://api.github.com/users/pbelevich/events{/privacy}', 'received_events_url': 'https://api.github.com/users/pbelevich/received_events', 'type': 'User', 'site_admin': False}",referenced,c14b9786e3de7b2d430609f3ddff63f6ce8b983c,https://api.github.com/repos/pytorch/pytorch/commits/c14b9786e3de7b2d430609f3ddff63f6ce8b983c,2020-01-27T22:16:49Z,4570,3297,1273
32510,2998395572,"{'login': 'pbelevich', 'id': 1160355, 'node_id': 'MDQ6VXNlcjExNjAzNTU=', 'avatar_url': 'https://avatars1.githubusercontent.com/u/1160355?v=4', 'gravatar_id': '', 'url': 'https://api.github.com/users/pbelevich', 'html_url': 'https://github.com/pbelevich', 'followers_url': 'https://api.github.com/users/pbelevich/followers', 'following_url': 'https://api.github.com/users/pbelevich/following{/other_user}', 'gists_url': 'https://api.github.com/users/pbelevich/gists{/gist_id}', 'starred_url': 'https://api.github.com/users/pbelevich/starred{/owner}{/repo}', 'subscriptions_url': 'https://api.github.com/users/pbelevich/subscriptions', 'organizations_url': 'https://api.github.com/users/pbelevich/orgs', 'repos_url': 'https://api.github.com/users/pbelevich/repos', 'events_url': 'https://api.github.com/users/pbelevich/events{/privacy}', 'received_events_url': 'https://api.github.com/users/pbelevich/received_events', 'type': 'User', 'site_admin': False}",referenced,803d2cb9b59c902dc80660565cc002cd4ce202ca,https://api.github.com/repos/pytorch/pytorch/commits/803d2cb9b59c902dc80660565cc002cd4ce202ca,2020-01-31T20:21:28Z,11355,6382,4973
32510,2998982924,"{'login': 'pbelevich', 'id': 1160355, 'node_id': 'MDQ6VXNlcjExNjAzNTU=', 'avatar_url': 'https://avatars1.githubusercontent.com/u/1160355?v=4', 'gravatar_id': '', 'url': 'https://api.github.com/users/pbelevich', 'html_url': 'https://github.com/pbelevich', 'followers_url': 'https://api.github.com/users/pbelevich/followers', 'following_url': 'https://api.github.com/users/pbelevich/following{/other_user}', 'gists_url': 'https://api.github.com/users/pbelevich/gists{/gist_id}', 'starred_url': 'https://api.github.com/users/pbelevich/starred{/owner}{/repo}', 'subscriptions_url': 'https://api.github.com/users/pbelevich/subscriptions', 'organizations_url': 'https://api.github.com/users/pbelevich/orgs', 'repos_url': 'https://api.github.com/users/pbelevich/repos', 'events_url': 'https://api.github.com/users/pbelevich/events{/privacy}', 'received_events_url': 'https://api.github.com/users/pbelevich/received_events', 'type': 'User', 'site_admin': False}",referenced,90ee94ab96a2dc4fcf06a2b77fcc4e996ad79884,https://api.github.com/repos/pytorch/pytorch/commits/90ee94ab96a2dc4fcf06a2b77fcc4e996ad79884,2020-02-01T01:28:39Z,661,502,159
32510,3002661768,"{'login': 'pbelevich', 'id': 1160355, 'node_id': 'MDQ6VXNlcjExNjAzNTU=', 'avatar_url': 'https://avatars1.githubusercontent.com/u/1160355?v=4', 'gravatar_id': '', 'url': 'https://api.github.com/users/pbelevich', 'html_url': 'https://github.com/pbelevich', 'followers_url': 'https://api.github.com/users/pbelevich/followers', 'following_url': 'https://api.github.com/users/pbelevich/following{/other_user}', 'gists_url': 'https://api.github.com/users/pbelevich/gists{/gist_id}', 'starred_url': 'https://api.github.com/users/pbelevich/starred{/owner}{/repo}', 'subscriptions_url': 'https://api.github.com/users/pbelevich/subscriptions', 'organizations_url': 'https://api.github.com/users/pbelevich/orgs', 'repos_url': 'https://api.github.com/users/pbelevich/repos', 'events_url': 'https://api.github.com/users/pbelevich/events{/privacy}', 'received_events_url': 'https://api.github.com/users/pbelevich/received_events', 'type': 'User', 'site_admin': False}",referenced,b65a25b34902eb1f2b55c389eaf0b6e0225090b5,https://api.github.com/repos/pytorch/pytorch/commits/b65a25b34902eb1f2b55c389eaf0b6e0225090b5,2020-02-03T15:30:19Z,386,300,86
32510,3014810782,"{'login': 'pbelevich', 'id': 1160355, 'node_id': 'MDQ6VXNlcjExNjAzNTU=', 'avatar_url': 'https://avatars1.githubusercontent.com/u/1160355?v=4', 'gravatar_id': '', 'url': 'https://api.github.com/users/pbelevich', 'html_url': 'https://github.com/pbelevich', 'followers_url': 'https://api.github.com/users/pbelevich/followers', 'following_url': 'https://api.github.com/users/pbelevich/following{/other_user}', 'gists_url': 'https://api.github.com/users/pbelevich/gists{/gist_id}', 'starred_url': 'https://api.github.com/users/pbelevich/starred{/owner}{/repo}', 'subscriptions_url': 'https://api.github.com/users/pbelevich/subscriptions', 'organizations_url': 'https://api.github.com/users/pbelevich/orgs', 'repos_url': 'https://api.github.com/users/pbelevich/repos', 'events_url': 'https://api.github.com/users/pbelevich/events{/privacy}', 'received_events_url': 'https://api.github.com/users/pbelevich/received_events', 'type': 'User', 'site_admin': False}",referenced,04a0c53c14b9ea63b7a325a4bdc0debd86f161d2,https://api.github.com/repos/pytorch/pytorch/commits/04a0c53c14b9ea63b7a325a4bdc0debd86f161d2,2020-02-06T17:31:34Z,6119,4485,1634
32510,3015410893,"{'login': 'pbelevich', 'id': 1160355, 'node_id': 'MDQ6VXNlcjExNjAzNTU=', 'avatar_url': 'https://avatars1.githubusercontent.com/u/1160355?v=4', 'gravatar_id': '', 'url': 'https://api.github.com/users/pbelevich', 'html_url': 'https://github.com/pbelevich', 'followers_url': 'https://api.github.com/users/pbelevich/followers', 'following_url': 'https://api.github.com/users/pbelevich/following{/other_user}', 'gists_url': 'https://api.github.com/users/pbelevich/gists{/gist_id}', 'starred_url': 'https://api.github.com/users/pbelevich/starred{/owner}{/repo}', 'subscriptions_url': 'https://api.github.com/users/pbelevich/subscriptions', 'organizations_url': 'https://api.github.com/users/pbelevich/orgs', 'repos_url': 'https://api.github.com/users/pbelevich/repos', 'events_url': 'https://api.github.com/users/pbelevich/events{/privacy}', 'received_events_url': 'https://api.github.com/users/pbelevich/received_events', 'type': 'User', 'site_admin': False}",referenced,7d9db5efc8b51519f5d8ebdc9bc5073c86332e8a,https://api.github.com/repos/pytorch/pytorch/commits/7d9db5efc8b51519f5d8ebdc9bc5073c86332e8a,2020-02-06T20:42:13Z,79,75,4
32510,3015614688,"{'login': 'pbelevich', 'id': 1160355, 'node_id': 'MDQ6VXNlcjExNjAzNTU=', 'avatar_url': 'https://avatars1.githubusercontent.com/u/1160355?v=4', 'gravatar_id': '', 'url': 'https://api.github.com/users/pbelevich', 'html_url': 'https://github.com/pbelevich', 'followers_url': 'https://api.github.com/users/pbelevich/followers', 'following_url': 'https://api.github.com/users/pbelevich/following{/other_user}', 'gists_url': 'https://api.github.com/users/pbelevich/gists{/gist_id}', 'starred_url': 'https://api.github.com/users/pbelevich/starred{/owner}{/repo}', 'subscriptions_url': 'https://api.github.com/users/pbelevich/subscriptions', 'organizations_url': 'https://api.github.com/users/pbelevich/orgs', 'repos_url': 'https://api.github.com/users/pbelevich/repos', 'events_url': 'https://api.github.com/users/pbelevich/events{/privacy}', 'received_events_url': 'https://api.github.com/users/pbelevich/received_events', 'type': 'User', 'site_admin': False}",referenced,fbd07dee04f54b6427331df79e0aeb7e32e66c50,https://api.github.com/repos/pytorch/pytorch/commits/fbd07dee04f54b6427331df79e0aeb7e32e66c50,2020-02-06T21:52:23Z,21,5,16
32510,3015765109,"{'login': 'pbelevich', 'id': 1160355, 'node_id': 'MDQ6VXNlcjExNjAzNTU=', 'avatar_url': 'https://avatars1.githubusercontent.com/u/1160355?v=4', 'gravatar_id': '', 'url': 'https://api.github.com/users/pbelevich', 'html_url': 'https://github.com/pbelevich', 'followers_url': 'https://api.github.com/users/pbelevich/followers', 'following_url': 'https://api.github.com/users/pbelevich/following{/other_user}', 'gists_url': 'https://api.github.com/users/pbelevich/gists{/gist_id}', 'starred_url': 'https://api.github.com/users/pbelevich/starred{/owner}{/repo}', 'subscriptions_url': 'https://api.github.com/users/pbelevich/subscriptions', 'organizations_url': 'https://api.github.com/users/pbelevich/orgs', 'repos_url': 'https://api.github.com/users/pbelevich/repos', 'events_url': 'https://api.github.com/users/pbelevich/events{/privacy}', 'received_events_url': 'https://api.github.com/users/pbelevich/received_events', 'type': 'User', 'site_admin': False}",referenced,3d0207305a025f3958e50e2c267460116367d788,https://api.github.com/repos/pytorch/pytorch/commits/3d0207305a025f3958e50e2c267460116367d788,2020-02-06T22:48:35Z,12,6,6
32510,3015827122,"{'login': 'pbelevich', 'id': 1160355, 'node_id': 'MDQ6VXNlcjExNjAzNTU=', 'avatar_url': 'https://avatars1.githubusercontent.com/u/1160355?v=4', 'gravatar_id': '', 'url': 'https://api.github.com/users/pbelevich', 'html_url': 'https://github.com/pbelevich', 'followers_url': 'https://api.github.com/users/pbelevich/followers', 'following_url': 'https://api.github.com/users/pbelevich/following{/other_user}', 'gists_url': 'https://api.github.com/users/pbelevich/gists{/gist_id}', 'starred_url': 'https://api.github.com/users/pbelevich/starred{/owner}{/repo}', 'subscriptions_url': 'https://api.github.com/users/pbelevich/subscriptions', 'organizations_url': 'https://api.github.com/users/pbelevich/orgs', 'repos_url': 'https://api.github.com/users/pbelevich/repos', 'events_url': 'https://api.github.com/users/pbelevich/events{/privacy}', 'received_events_url': 'https://api.github.com/users/pbelevich/received_events', 'type': 'User', 'site_admin': False}",referenced,fa6232882389f7954e981d31c08670cc08b47e99,https://api.github.com/repos/pytorch/pytorch/commits/fa6232882389f7954e981d31c08670cc08b47e99,2020-02-06T23:16:05Z,4,3,1
32510,3015943956,"{'login': 'pbelevich', 'id': 1160355, 'node_id': 'MDQ6VXNlcjExNjAzNTU=', 'avatar_url': 'https://avatars1.githubusercontent.com/u/1160355?v=4', 'gravatar_id': '', 'url': 'https://api.github.com/users/pbelevich', 'html_url': 'https://github.com/pbelevich', 'followers_url': 'https://api.github.com/users/pbelevich/followers', 'following_url': 'https://api.github.com/users/pbelevich/following{/other_user}', 'gists_url': 'https://api.github.com/users/pbelevich/gists{/gist_id}', 'starred_url': 'https://api.github.com/users/pbelevich/starred{/owner}{/repo}', 'subscriptions_url': 'https://api.github.com/users/pbelevich/subscriptions', 'organizations_url': 'https://api.github.com/users/pbelevich/orgs', 'repos_url': 'https://api.github.com/users/pbelevich/repos', 'events_url': 'https://api.github.com/users/pbelevich/events{/privacy}', 'received_events_url': 'https://api.github.com/users/pbelevich/received_events', 'type': 'User', 'site_admin': False}",referenced,aae0dece363fbb6f05b4b82453d30637ecf49e49,https://api.github.com/repos/pytorch/pytorch/commits/aae0dece363fbb6f05b4b82453d30637ecf49e49,2020-02-07T00:15:29Z,25,13,12
32510,3016193999,"{'login': 'pbelevich', 'id': 1160355, 'node_id': 'MDQ6VXNlcjExNjAzNTU=', 'avatar_url': 'https://avatars1.githubusercontent.com/u/1160355?v=4', 'gravatar_id': '', 'url': 'https://api.github.com/users/pbelevich', 'html_url': 'https://github.com/pbelevich', 'followers_url': 'https://api.github.com/users/pbelevich/followers', 'following_url': 'https://api.github.com/users/pbelevich/following{/other_user}', 'gists_url': 'https://api.github.com/users/pbelevich/gists{/gist_id}', 'starred_url': 'https://api.github.com/users/pbelevich/starred{/owner}{/repo}', 'subscriptions_url': 'https://api.github.com/users/pbelevich/subscriptions', 'organizations_url': 'https://api.github.com/users/pbelevich/orgs', 'repos_url': 'https://api.github.com/users/pbelevich/repos', 'events_url': 'https://api.github.com/users/pbelevich/events{/privacy}', 'received_events_url': 'https://api.github.com/users/pbelevich/received_events', 'type': 'User', 'site_admin': False}",referenced,236a3e2be46fc03145780d72948c8bf159fce96d,https://api.github.com/repos/pytorch/pytorch/commits/236a3e2be46fc03145780d72948c8bf159fce96d,2020-02-07T02:47:41Z,149,132,17
32510,3017910619,"{'login': 'pbelevich', 'id': 1160355, 'node_id': 'MDQ6VXNlcjExNjAzNTU=', 'avatar_url': 'https://avatars1.githubusercontent.com/u/1160355?v=4', 'gravatar_id': '', 'url': 'https://api.github.com/users/pbelevich', 'html_url': 'https://github.com/pbelevich', 'followers_url': 'https://api.github.com/users/pbelevich/followers', 'following_url': 'https://api.github.com/users/pbelevich/following{/other_user}', 'gists_url': 'https://api.github.com/users/pbelevich/gists{/gist_id}', 'starred_url': 'https://api.github.com/users/pbelevich/starred{/owner}{/repo}', 'subscriptions_url': 'https://api.github.com/users/pbelevich/subscriptions', 'organizations_url': 'https://api.github.com/users/pbelevich/orgs', 'repos_url': 'https://api.github.com/users/pbelevich/repos', 'events_url': 'https://api.github.com/users/pbelevich/events{/privacy}', 'received_events_url': 'https://api.github.com/users/pbelevich/received_events', 'type': 'User', 'site_admin': False}",referenced,5d4bda9b056975a7cf3875f862db06939979c7bd,https://api.github.com/repos/pytorch/pytorch/commits/5d4bda9b056975a7cf3875f862db06939979c7bd,2020-02-07T14:47:55Z,263,190,73
32510,3021148117,"{'login': 'pbelevich', 'id': 1160355, 'node_id': 'MDQ6VXNlcjExNjAzNTU=', 'avatar_url': 'https://avatars1.githubusercontent.com/u/1160355?v=4', 'gravatar_id': '', 'url': 'https://api.github.com/users/pbelevich', 'html_url': 'https://github.com/pbelevich', 'followers_url': 'https://api.github.com/users/pbelevich/followers', 'following_url': 'https://api.github.com/users/pbelevich/following{/other_user}', 'gists_url': 'https://api.github.com/users/pbelevich/gists{/gist_id}', 'starred_url': 'https://api.github.com/users/pbelevich/starred{/owner}{/repo}', 'subscriptions_url': 'https://api.github.com/users/pbelevich/subscriptions', 'organizations_url': 'https://api.github.com/users/pbelevich/orgs', 'repos_url': 'https://api.github.com/users/pbelevich/repos', 'events_url': 'https://api.github.com/users/pbelevich/events{/privacy}', 'received_events_url': 'https://api.github.com/users/pbelevich/received_events', 'type': 'User', 'site_admin': False}",referenced,a82ca171eee32350b458f5bbc637646bca85c775,https://api.github.com/repos/pytorch/pytorch/commits/a82ca171eee32350b458f5bbc637646bca85c775,2020-02-10T02:38:51Z,1266,833,433
32510,3023272063,"{'login': 'pbelevich', 'id': 1160355, 'node_id': 'MDQ6VXNlcjExNjAzNTU=', 'avatar_url': 'https://avatars1.githubusercontent.com/u/1160355?v=4', 'gravatar_id': '', 'url': 'https://api.github.com/users/pbelevich', 'html_url': 'https://github.com/pbelevich', 'followers_url': 'https://api.github.com/users/pbelevich/followers', 'following_url': 'https://api.github.com/users/pbelevich/following{/other_user}', 'gists_url': 'https://api.github.com/users/pbelevich/gists{/gist_id}', 'starred_url': 'https://api.github.com/users/pbelevich/starred{/owner}{/repo}', 'subscriptions_url': 'https://api.github.com/users/pbelevich/subscriptions', 'organizations_url': 'https://api.github.com/users/pbelevich/orgs', 'repos_url': 'https://api.github.com/users/pbelevich/repos', 'events_url': 'https://api.github.com/users/pbelevich/events{/privacy}', 'received_events_url': 'https://api.github.com/users/pbelevich/received_events', 'type': 'User', 'site_admin': False}",referenced,38e780ba37a0d3776b2d2a92b6b04a83e8fcb133,https://api.github.com/repos/pytorch/pytorch/commits/38e780ba37a0d3776b2d2a92b6b04a83e8fcb133,2020-02-10T15:49:45Z,318,211,107
32510,3032950007,"{'login': 'pbelevich', 'id': 1160355, 'node_id': 'MDQ6VXNlcjExNjAzNTU=', 'avatar_url': 'https://avatars1.githubusercontent.com/u/1160355?v=4', 'gravatar_id': '', 'url': 'https://api.github.com/users/pbelevich', 'html_url': 'https://github.com/pbelevich', 'followers_url': 'https://api.github.com/users/pbelevich/followers', 'following_url': 'https://api.github.com/users/pbelevich/following{/other_user}', 'gists_url': 'https://api.github.com/users/pbelevich/gists{/gist_id}', 'starred_url': 'https://api.github.com/users/pbelevich/starred{/owner}{/repo}', 'subscriptions_url': 'https://api.github.com/users/pbelevich/subscriptions', 'organizations_url': 'https://api.github.com/users/pbelevich/orgs', 'repos_url': 'https://api.github.com/users/pbelevich/repos', 'events_url': 'https://api.github.com/users/pbelevich/events{/privacy}', 'received_events_url': 'https://api.github.com/users/pbelevich/received_events', 'type': 'User', 'site_admin': False}",referenced,af147add7ee4e3067ca4a52a149574c8dab71c24,https://api.github.com/repos/pytorch/pytorch/commits/af147add7ee4e3067ca4a52a149574c8dab71c24,2020-02-13T00:11:10Z,4783,2866,1917
32510,3033038365,"{'login': 'pbelevich', 'id': 1160355, 'node_id': 'MDQ6VXNlcjExNjAzNTU=', 'avatar_url': 'https://avatars1.githubusercontent.com/u/1160355?v=4', 'gravatar_id': '', 'url': 'https://api.github.com/users/pbelevich', 'html_url': 'https://github.com/pbelevich', 'followers_url': 'https://api.github.com/users/pbelevich/followers', 'following_url': 'https://api.github.com/users/pbelevich/following{/other_user}', 'gists_url': 'https://api.github.com/users/pbelevich/gists{/gist_id}', 'starred_url': 'https://api.github.com/users/pbelevich/starred{/owner}{/repo}', 'subscriptions_url': 'https://api.github.com/users/pbelevich/subscriptions', 'organizations_url': 'https://api.github.com/users/pbelevich/orgs', 'repos_url': 'https://api.github.com/users/pbelevich/repos', 'events_url': 'https://api.github.com/users/pbelevich/events{/privacy}', 'received_events_url': 'https://api.github.com/users/pbelevich/received_events', 'type': 'User', 'site_admin': False}",referenced,e1d791f4cab9f3cf614bbe98cc4934de4e2e0240,https://api.github.com/repos/pytorch/pytorch/commits/e1d791f4cab9f3cf614bbe98cc4934de4e2e0240,2020-02-13T00:59:42Z,542,328,214
32510,3033076019,"{'login': 'pbelevich', 'id': 1160355, 'node_id': 'MDQ6VXNlcjExNjAzNTU=', 'avatar_url': 'https://avatars1.githubusercontent.com/u/1160355?v=4', 'gravatar_id': '', 'url': 'https://api.github.com/users/pbelevich', 'html_url': 'https://github.com/pbelevich', 'followers_url': 'https://api.github.com/users/pbelevich/followers', 'following_url': 'https://api.github.com/users/pbelevich/following{/other_user}', 'gists_url': 'https://api.github.com/users/pbelevich/gists{/gist_id}', 'starred_url': 'https://api.github.com/users/pbelevich/starred{/owner}{/repo}', 'subscriptions_url': 'https://api.github.com/users/pbelevich/subscriptions', 'organizations_url': 'https://api.github.com/users/pbelevich/orgs', 'repos_url': 'https://api.github.com/users/pbelevich/repos', 'events_url': 'https://api.github.com/users/pbelevich/events{/privacy}', 'received_events_url': 'https://api.github.com/users/pbelevich/received_events', 'type': 'User', 'site_admin': False}",referenced,ad96f1155dd778cbab94f1462c2d45f2c6c91ff9,https://api.github.com/repos/pytorch/pytorch/commits/ad96f1155dd778cbab94f1462c2d45f2c6c91ff9,2020-02-13T01:20:00Z,6,3,3
32510,3033145546,"{'login': 'pbelevich', 'id': 1160355, 'node_id': 'MDQ6VXNlcjExNjAzNTU=', 'avatar_url': 'https://avatars1.githubusercontent.com/u/1160355?v=4', 'gravatar_id': '', 'url': 'https://api.github.com/users/pbelevich', 'html_url': 'https://github.com/pbelevich', 'followers_url': 'https://api.github.com/users/pbelevich/followers', 'following_url': 'https://api.github.com/users/pbelevich/following{/other_user}', 'gists_url': 'https://api.github.com/users/pbelevich/gists{/gist_id}', 'starred_url': 'https://api.github.com/users/pbelevich/starred{/owner}{/repo}', 'subscriptions_url': 'https://api.github.com/users/pbelevich/subscriptions', 'organizations_url': 'https://api.github.com/users/pbelevich/orgs', 'repos_url': 'https://api.github.com/users/pbelevich/repos', 'events_url': 'https://api.github.com/users/pbelevich/events{/privacy}', 'received_events_url': 'https://api.github.com/users/pbelevich/received_events', 'type': 'User', 'site_admin': False}",referenced,e33fc3a60cf59123db68ff57e608b37dea5eaaf8,https://api.github.com/repos/pytorch/pytorch/commits/e33fc3a60cf59123db68ff57e608b37dea5eaaf8,2020-02-13T02:00:29Z,37,28,9
32510,3034894929,"{'login': 'pbelevich', 'id': 1160355, 'node_id': 'MDQ6VXNlcjExNjAzNTU=', 'avatar_url': 'https://avatars1.githubusercontent.com/u/1160355?v=4', 'gravatar_id': '', 'url': 'https://api.github.com/users/pbelevich', 'html_url': 'https://github.com/pbelevich', 'followers_url': 'https://api.github.com/users/pbelevich/followers', 'following_url': 'https://api.github.com/users/pbelevich/following{/other_user}', 'gists_url': 'https://api.github.com/users/pbelevich/gists{/gist_id}', 'starred_url': 'https://api.github.com/users/pbelevich/starred{/owner}{/repo}', 'subscriptions_url': 'https://api.github.com/users/pbelevich/subscriptions', 'organizations_url': 'https://api.github.com/users/pbelevich/orgs', 'repos_url': 'https://api.github.com/users/pbelevich/repos', 'events_url': 'https://api.github.com/users/pbelevich/events{/privacy}', 'received_events_url': 'https://api.github.com/users/pbelevich/received_events', 'type': 'User', 'site_admin': False}",referenced,92cbd0ec371dc025195f33352c6947b4c037c237,https://api.github.com/repos/pytorch/pytorch/commits/92cbd0ec371dc025195f33352c6947b4c037c237,2020-02-13T13:44:11Z,621,429,192
32510,3034901029,"{'login': 'pbelevich', 'id': 1160355, 'node_id': 'MDQ6VXNlcjExNjAzNTU=', 'avatar_url': 'https://avatars1.githubusercontent.com/u/1160355?v=4', 'gravatar_id': '', 'url': 'https://api.github.com/users/pbelevich', 'html_url': 'https://github.com/pbelevich', 'followers_url': 'https://api.github.com/users/pbelevich/followers', 'following_url': 'https://api.github.com/users/pbelevich/following{/other_user}', 'gists_url': 'https://api.github.com/users/pbelevich/gists{/gist_id}', 'starred_url': 'https://api.github.com/users/pbelevich/starred{/owner}{/repo}', 'subscriptions_url': 'https://api.github.com/users/pbelevich/subscriptions', 'organizations_url': 'https://api.github.com/users/pbelevich/orgs', 'repos_url': 'https://api.github.com/users/pbelevich/repos', 'events_url': 'https://api.github.com/users/pbelevich/events{/privacy}', 'received_events_url': 'https://api.github.com/users/pbelevich/received_events', 'type': 'User', 'site_admin': False}",referenced,91dfd386e156364790b6d5b04022b82808944eca,https://api.github.com/repos/pytorch/pytorch/commits/91dfd386e156364790b6d5b04022b82808944eca,2020-02-13T13:45:50Z,2,0,2
32510,3035412169,"{'login': 'pbelevich', 'id': 1160355, 'node_id': 'MDQ6VXNlcjExNjAzNTU=', 'avatar_url': 'https://avatars1.githubusercontent.com/u/1160355?v=4', 'gravatar_id': '', 'url': 'https://api.github.com/users/pbelevich', 'html_url': 'https://github.com/pbelevich', 'followers_url': 'https://api.github.com/users/pbelevich/followers', 'following_url': 'https://api.github.com/users/pbelevich/following{/other_user}', 'gists_url': 'https://api.github.com/users/pbelevich/gists{/gist_id}', 'starred_url': 'https://api.github.com/users/pbelevich/starred{/owner}{/repo}', 'subscriptions_url': 'https://api.github.com/users/pbelevich/subscriptions', 'organizations_url': 'https://api.github.com/users/pbelevich/orgs', 'repos_url': 'https://api.github.com/users/pbelevich/repos', 'events_url': 'https://api.github.com/users/pbelevich/events{/privacy}', 'received_events_url': 'https://api.github.com/users/pbelevich/received_events', 'type': 'User', 'site_admin': False}",referenced,0bea0881babdbbe70ba6787e3568ff81bdff8264,https://api.github.com/repos/pytorch/pytorch/commits/0bea0881babdbbe70ba6787e3568ff81bdff8264,2020-02-13T15:47:24Z,18,10,8
32502,2983070410,"{'login': 'ezyang', 'id': 13564, 'node_id': 'MDQ6VXNlcjEzNTY0', 'avatar_url': 'https://avatars0.githubusercontent.com/u/13564?v=4', 'gravatar_id': '', 'url': 'https://api.github.com/users/ezyang', 'html_url': 'https://github.com/ezyang', 'followers_url': 'https://api.github.com/users/ezyang/followers', 'following_url': 'https://api.github.com/users/ezyang/following{/other_user}', 'gists_url': 'https://api.github.com/users/ezyang/gists{/gist_id}', 'starred_url': 'https://api.github.com/users/ezyang/starred{/owner}{/repo}', 'subscriptions_url': 'https://api.github.com/users/ezyang/subscriptions', 'organizations_url': 'https://api.github.com/users/ezyang/orgs', 'repos_url': 'https://api.github.com/users/ezyang/repos', 'events_url': 'https://api.github.com/users/ezyang/events{/privacy}', 'received_events_url': 'https://api.github.com/users/ezyang/received_events', 'type': 'User', 'site_admin': False}",referenced,250ff7c4cebc810c0c12e0af994a7234004489d0,https://api.github.com/repos/pytorch/pytorch/commits/250ff7c4cebc810c0c12e0af994a7234004489d0,2020-01-27T19:20:09Z,3,2,1
32502,2983071091,"{'login': 'ezyang', 'id': 13564, 'node_id': 'MDQ6VXNlcjEzNTY0', 'avatar_url': 'https://avatars0.githubusercontent.com/u/13564?v=4', 'gravatar_id': '', 'url': 'https://api.github.com/users/ezyang', 'html_url': 'https://github.com/ezyang', 'followers_url': 'https://api.github.com/users/ezyang/followers', 'following_url': 'https://api.github.com/users/ezyang/following{/other_user}', 'gists_url': 'https://api.github.com/users/ezyang/gists{/gist_id}', 'starred_url': 'https://api.github.com/users/ezyang/starred{/owner}{/repo}', 'subscriptions_url': 'https://api.github.com/users/ezyang/subscriptions', 'organizations_url': 'https://api.github.com/users/ezyang/orgs', 'repos_url': 'https://api.github.com/users/ezyang/repos', 'events_url': 'https://api.github.com/users/ezyang/events{/privacy}', 'received_events_url': 'https://api.github.com/users/ezyang/received_events', 'type': 'User', 'site_admin': False}",referenced,51f5d59de655453ee1658c586b9d89ba7658ee69,https://api.github.com/repos/pytorch/pytorch/commits/51f5d59de655453ee1658c586b9d89ba7658ee69,2020-01-27T19:20:21Z,3,2,1
32494,2990290217,"{'login': 'facebook-github-bot', 'id': 6422482, 'node_id': 'MDQ6VXNlcjY0MjI0ODI=', 'avatar_url': 'https://avatars3.githubusercontent.com/u/6422482?v=4', 'gravatar_id': '', 'url': 'https://api.github.com/users/facebook-github-bot', 'html_url': 'https://github.com/facebook-github-bot', 'followers_url': 'https://api.github.com/users/facebook-github-bot/followers', 'following_url': 'https://api.github.com/users/facebook-github-bot/following{/other_user}', 'gists_url': 'https://api.github.com/users/facebook-github-bot/gists{/gist_id}', 'starred_url': 'https://api.github.com/users/facebook-github-bot/starred{/owner}{/repo}', 'subscriptions_url': 'https://api.github.com/users/facebook-github-bot/subscriptions', 'organizations_url': 'https://api.github.com/users/facebook-github-bot/orgs', 'repos_url': 'https://api.github.com/users/facebook-github-bot/repos', 'events_url': 'https://api.github.com/users/facebook-github-bot/events{/privacy}', 'received_events_url': 'https://api.github.com/users/facebook-github-bot/received_events', 'type': 'User', 'site_admin': False}",referenced,8bc889e502b45627abb4665f746f03e99cc065e0,https://api.github.com/repos/pytorch/pytorch/commits/8bc889e502b45627abb4665f746f03e99cc065e0,2020-01-29T16:50:49Z,13,8,5
32481,2979620287,"{'login': 'facebook-github-bot', 'id': 6422482, 'node_id': 'MDQ6VXNlcjY0MjI0ODI=', 'avatar_url': 'https://avatars3.githubusercontent.com/u/6422482?v=4', 'gravatar_id': '', 'url': 'https://api.github.com/users/facebook-github-bot', 'html_url': 'https://github.com/facebook-github-bot', 'followers_url': 'https://api.github.com/users/facebook-github-bot/followers', 'following_url': 'https://api.github.com/users/facebook-github-bot/following{/other_user}', 'gists_url': 'https://api.github.com/users/facebook-github-bot/gists{/gist_id}', 'starred_url': 'https://api.github.com/users/facebook-github-bot/starred{/owner}{/repo}', 'subscriptions_url': 'https://api.github.com/users/facebook-github-bot/subscriptions', 'organizations_url': 'https://api.github.com/users/facebook-github-bot/orgs', 'repos_url': 'https://api.github.com/users/facebook-github-bot/repos', 'events_url': 'https://api.github.com/users/facebook-github-bot/events{/privacy}', 'received_events_url': 'https://api.github.com/users/facebook-github-bot/received_events', 'type': 'User', 'site_admin': False}",closed,320d1a15735bdba57997343131956ee63d144085,https://api.github.com/repos/pytorch/pytorch/commits/320d1a15735bdba57997343131956ee63d144085,2020-01-26T00:21:15Z,2,1,1
32469,2976233239,"{'login': 'suo', 'id': 1617424, 'node_id': 'MDQ6VXNlcjE2MTc0MjQ=', 'avatar_url': 'https://avatars2.githubusercontent.com/u/1617424?v=4', 'gravatar_id': '', 'url': 'https://api.github.com/users/suo', 'html_url': 'https://github.com/suo', 'followers_url': 'https://api.github.com/users/suo/followers', 'following_url': 'https://api.github.com/users/suo/following{/other_user}', 'gists_url': 'https://api.github.com/users/suo/gists{/gist_id}', 'starred_url': 'https://api.github.com/users/suo/starred{/owner}{/repo}', 'subscriptions_url': 'https://api.github.com/users/suo/subscriptions', 'organizations_url': 'https://api.github.com/users/suo/orgs', 'repos_url': 'https://api.github.com/users/suo/repos', 'events_url': 'https://api.github.com/users/suo/events{/privacy}', 'received_events_url': 'https://api.github.com/users/suo/received_events', 'type': 'User', 'site_admin': False}",referenced,bfdc063a8778f17cfb9935c67a950f8ceb83b40f,https://api.github.com/repos/pytorch/pytorch/commits/bfdc063a8778f17cfb9935c67a950f8ceb83b40f,2020-01-24T06:40:37Z,5,2,3
32469,2978410082,"{'login': 'facebook-github-bot', 'id': 6422482, 'node_id': 'MDQ6VXNlcjY0MjI0ODI=', 'avatar_url': 'https://avatars3.githubusercontent.com/u/6422482?v=4', 'gravatar_id': '', 'url': 'https://api.github.com/users/facebook-github-bot', 'html_url': 'https://github.com/facebook-github-bot', 'followers_url': 'https://api.github.com/users/facebook-github-bot/followers', 'following_url': 'https://api.github.com/users/facebook-github-bot/following{/other_user}', 'gists_url': 'https://api.github.com/users/facebook-github-bot/gists{/gist_id}', 'starred_url': 'https://api.github.com/users/facebook-github-bot/starred{/owner}{/repo}', 'subscriptions_url': 'https://api.github.com/users/facebook-github-bot/subscriptions', 'organizations_url': 'https://api.github.com/users/facebook-github-bot/orgs', 'repos_url': 'https://api.github.com/users/facebook-github-bot/repos', 'events_url': 'https://api.github.com/users/facebook-github-bot/events{/privacy}', 'received_events_url': 'https://api.github.com/users/facebook-github-bot/received_events', 'type': 'User', 'site_admin': False}",closed,ef5637f85e43dff55b03276176ba2949bd83a085,https://api.github.com/repos/pytorch/pytorch/commits/ef5637f85e43dff55b03276176ba2949bd83a085,2020-01-24T19:53:10Z,27,26,1
32435,2974157186,"{'login': 'ezyang', 'id': 13564, 'node_id': 'MDQ6VXNlcjEzNTY0', 'avatar_url': 'https://avatars0.githubusercontent.com/u/13564?v=4', 'gravatar_id': '', 'url': 'https://api.github.com/users/ezyang', 'html_url': 'https://github.com/ezyang', 'followers_url': 'https://api.github.com/users/ezyang/followers', 'following_url': 'https://api.github.com/users/ezyang/following{/other_user}', 'gists_url': 'https://api.github.com/users/ezyang/gists{/gist_id}', 'starred_url': 'https://api.github.com/users/ezyang/starred{/owner}{/repo}', 'subscriptions_url': 'https://api.github.com/users/ezyang/subscriptions', 'organizations_url': 'https://api.github.com/users/ezyang/orgs', 'repos_url': 'https://api.github.com/users/ezyang/repos', 'events_url': 'https://api.github.com/users/ezyang/events{/privacy}', 'received_events_url': 'https://api.github.com/users/ezyang/received_events', 'type': 'User', 'site_admin': False}",referenced,6e1148598596c7d164e43182490f64b16cc0623e,https://api.github.com/repos/pytorch/pytorch/commits/6e1148598596c7d164e43182490f64b16cc0623e,2020-01-23T15:25:36Z,157,80,77
32435,2974157792,"{'login': 'ezyang', 'id': 13564, 'node_id': 'MDQ6VXNlcjEzNTY0', 'avatar_url': 'https://avatars0.githubusercontent.com/u/13564?v=4', 'gravatar_id': '', 'url': 'https://api.github.com/users/ezyang', 'html_url': 'https://github.com/ezyang', 'followers_url': 'https://api.github.com/users/ezyang/followers', 'following_url': 'https://api.github.com/users/ezyang/following{/other_user}', 'gists_url': 'https://api.github.com/users/ezyang/gists{/gist_id}', 'starred_url': 'https://api.github.com/users/ezyang/starred{/owner}{/repo}', 'subscriptions_url': 'https://api.github.com/users/ezyang/subscriptions', 'organizations_url': 'https://api.github.com/users/ezyang/orgs', 'repos_url': 'https://api.github.com/users/ezyang/repos', 'events_url': 'https://api.github.com/users/ezyang/events{/privacy}', 'received_events_url': 'https://api.github.com/users/ezyang/received_events', 'type': 'User', 'site_admin': False}",referenced,dc5504ed4f24db1437d5f865cb6756c926849f82,https://api.github.com/repos/pytorch/pytorch/commits/dc5504ed4f24db1437d5f865cb6756c926849f82,2020-01-23T15:25:44Z,157,80,77
32435,2986050070,"{'login': 'ezyang', 'id': 13564, 'node_id': 'MDQ6VXNlcjEzNTY0', 'avatar_url': 'https://avatars0.githubusercontent.com/u/13564?v=4', 'gravatar_id': '', 'url': 'https://api.github.com/users/ezyang', 'html_url': 'https://github.com/ezyang', 'followers_url': 'https://api.github.com/users/ezyang/followers', 'following_url': 'https://api.github.com/users/ezyang/following{/other_user}', 'gists_url': 'https://api.github.com/users/ezyang/gists{/gist_id}', 'starred_url': 'https://api.github.com/users/ezyang/starred{/owner}{/repo}', 'subscriptions_url': 'https://api.github.com/users/ezyang/subscriptions', 'organizations_url': 'https://api.github.com/users/ezyang/orgs', 'repos_url': 'https://api.github.com/users/ezyang/repos', 'events_url': 'https://api.github.com/users/ezyang/events{/privacy}', 'received_events_url': 'https://api.github.com/users/ezyang/received_events', 'type': 'User', 'site_admin': False}",referenced,8fa9e65b660a3a6f76c9b567befcafbe9223ae7f,https://api.github.com/repos/pytorch/pytorch/commits/8fa9e65b660a3a6f76c9b567befcafbe9223ae7f,2020-01-28T15:18:04Z,6018,4217,1801
32435,2986075127,"{'login': 'ezyang', 'id': 13564, 'node_id': 'MDQ6VXNlcjEzNTY0', 'avatar_url': 'https://avatars0.githubusercontent.com/u/13564?v=4', 'gravatar_id': '', 'url': 'https://api.github.com/users/ezyang', 'html_url': 'https://github.com/ezyang', 'followers_url': 'https://api.github.com/users/ezyang/followers', 'following_url': 'https://api.github.com/users/ezyang/following{/other_user}', 'gists_url': 'https://api.github.com/users/ezyang/gists{/gist_id}', 'starred_url': 'https://api.github.com/users/ezyang/starred{/owner}{/repo}', 'subscriptions_url': 'https://api.github.com/users/ezyang/subscriptions', 'organizations_url': 'https://api.github.com/users/ezyang/orgs', 'repos_url': 'https://api.github.com/users/ezyang/repos', 'events_url': 'https://api.github.com/users/ezyang/events{/privacy}', 'received_events_url': 'https://api.github.com/users/ezyang/received_events', 'type': 'User', 'site_admin': False}",referenced,37835acb1ab4179a131e5e12d9ff6bf08f9eb132,https://api.github.com/repos/pytorch/pytorch/commits/37835acb1ab4179a131e5e12d9ff6bf08f9eb132,2020-01-28T15:24:13Z,16,8,8
32435,2986112978,"{'login': 'ezyang', 'id': 13564, 'node_id': 'MDQ6VXNlcjEzNTY0', 'avatar_url': 'https://avatars0.githubusercontent.com/u/13564?v=4', 'gravatar_id': '', 'url': 'https://api.github.com/users/ezyang', 'html_url': 'https://github.com/ezyang', 'followers_url': 'https://api.github.com/users/ezyang/followers', 'following_url': 'https://api.github.com/users/ezyang/following{/other_user}', 'gists_url': 'https://api.github.com/users/ezyang/gists{/gist_id}', 'starred_url': 'https://api.github.com/users/ezyang/starred{/owner}{/repo}', 'subscriptions_url': 'https://api.github.com/users/ezyang/subscriptions', 'organizations_url': 'https://api.github.com/users/ezyang/orgs', 'repos_url': 'https://api.github.com/users/ezyang/repos', 'events_url': 'https://api.github.com/users/ezyang/events{/privacy}', 'received_events_url': 'https://api.github.com/users/ezyang/received_events', 'type': 'User', 'site_admin': False}",referenced,b719d8f6b0da2fea26aa229b507ffbb8b317a318,https://api.github.com/repos/pytorch/pytorch/commits/b719d8f6b0da2fea26aa229b507ffbb8b317a318,2020-01-28T15:33:25Z,2,1,1
32435,2991127016,"{'login': 'facebook-github-bot', 'id': 6422482, 'node_id': 'MDQ6VXNlcjY0MjI0ODI=', 'avatar_url': 'https://avatars3.githubusercontent.com/u/6422482?v=4', 'gravatar_id': '', 'url': 'https://api.github.com/users/facebook-github-bot', 'html_url': 'https://github.com/facebook-github-bot', 'followers_url': 'https://api.github.com/users/facebook-github-bot/followers', 'following_url': 'https://api.github.com/users/facebook-github-bot/following{/other_user}', 'gists_url': 'https://api.github.com/users/facebook-github-bot/gists{/gist_id}', 'starred_url': 'https://api.github.com/users/facebook-github-bot/starred{/owner}{/repo}', 'subscriptions_url': 'https://api.github.com/users/facebook-github-bot/subscriptions', 'organizations_url': 'https://api.github.com/users/facebook-github-bot/orgs', 'repos_url': 'https://api.github.com/users/facebook-github-bot/repos', 'events_url': 'https://api.github.com/users/facebook-github-bot/events{/privacy}', 'received_events_url': 'https://api.github.com/users/facebook-github-bot/received_events', 'type': 'User', 'site_admin': False}",closed,3b47922855d94c7727a22d924d2a6b447475ee06,https://api.github.com/repos/pytorch/pytorch/commits/3b47922855d94c7727a22d924d2a6b447475ee06,2020-01-29T21:20:28Z,183,95,88
32368,2959500664,"{'login': 'jerryzh168', 'id': 4958441, 'node_id': 'MDQ6VXNlcjQ5NTg0NDE=', 'avatar_url': 'https://avatars0.githubusercontent.com/u/4958441?v=4', 'gravatar_id': '', 'url': 'https://api.github.com/users/jerryzh168', 'html_url': 'https://github.com/jerryzh168', 'followers_url': 'https://api.github.com/users/jerryzh168/followers', 'following_url': 'https://api.github.com/users/jerryzh168/following{/other_user}', 'gists_url': 'https://api.github.com/users/jerryzh168/gists{/gist_id}', 'starred_url': 'https://api.github.com/users/jerryzh168/starred{/owner}{/repo}', 'subscriptions_url': 'https://api.github.com/users/jerryzh168/subscriptions', 'organizations_url': 'https://api.github.com/users/jerryzh168/orgs', 'repos_url': 'https://api.github.com/users/jerryzh168/repos', 'events_url': 'https://api.github.com/users/jerryzh168/events{/privacy}', 'received_events_url': 'https://api.github.com/users/jerryzh168/received_events', 'type': 'User', 'site_admin': False}",referenced,5924747390d6fb302851076911e3d23163888489,https://api.github.com/repos/pytorch/pytorch/commits/5924747390d6fb302851076911e3d23163888489,2020-01-17T21:09:15Z,11,9,2
32368,2959501040,"{'login': 'jerryzh168', 'id': 4958441, 'node_id': 'MDQ6VXNlcjQ5NTg0NDE=', 'avatar_url': 'https://avatars0.githubusercontent.com/u/4958441?v=4', 'gravatar_id': '', 'url': 'https://api.github.com/users/jerryzh168', 'html_url': 'https://github.com/jerryzh168', 'followers_url': 'https://api.github.com/users/jerryzh168/followers', 'following_url': 'https://api.github.com/users/jerryzh168/following{/other_user}', 'gists_url': 'https://api.github.com/users/jerryzh168/gists{/gist_id}', 'starred_url': 'https://api.github.com/users/jerryzh168/starred{/owner}{/repo}', 'subscriptions_url': 'https://api.github.com/users/jerryzh168/subscriptions', 'organizations_url': 'https://api.github.com/users/jerryzh168/orgs', 'repos_url': 'https://api.github.com/users/jerryzh168/repos', 'events_url': 'https://api.github.com/users/jerryzh168/events{/privacy}', 'received_events_url': 'https://api.github.com/users/jerryzh168/received_events', 'type': 'User', 'site_admin': False}",referenced,c3d410f31823978792ba06550a91292537c34bab,https://api.github.com/repos/pytorch/pytorch/commits/c3d410f31823978792ba06550a91292537c34bab,2020-01-17T21:09:25Z,11,9,2
32368,2959504514,"{'login': 'jerryzh168', 'id': 4958441, 'node_id': 'MDQ6VXNlcjQ5NTg0NDE=', 'avatar_url': 'https://avatars0.githubusercontent.com/u/4958441?v=4', 'gravatar_id': '', 'url': 'https://api.github.com/users/jerryzh168', 'html_url': 'https://github.com/jerryzh168', 'followers_url': 'https://api.github.com/users/jerryzh168/followers', 'following_url': 'https://api.github.com/users/jerryzh168/following{/other_user}', 'gists_url': 'https://api.github.com/users/jerryzh168/gists{/gist_id}', 'starred_url': 'https://api.github.com/users/jerryzh168/starred{/owner}{/repo}', 'subscriptions_url': 'https://api.github.com/users/jerryzh168/subscriptions', 'organizations_url': 'https://api.github.com/users/jerryzh168/orgs', 'repos_url': 'https://api.github.com/users/jerryzh168/repos', 'events_url': 'https://api.github.com/users/jerryzh168/events{/privacy}', 'received_events_url': 'https://api.github.com/users/jerryzh168/received_events', 'type': 'User', 'site_admin': False}",referenced,ff18647d7c03ed82f67ac2236a805c80e2a4ad0c,https://api.github.com/repos/pytorch/pytorch/commits/ff18647d7c03ed82f67ac2236a805c80e2a4ad0c,2020-01-17T21:10:58Z,6,3,3
32368,2959504696,"{'login': 'jerryzh168', 'id': 4958441, 'node_id': 'MDQ6VXNlcjQ5NTg0NDE=', 'avatar_url': 'https://avatars0.githubusercontent.com/u/4958441?v=4', 'gravatar_id': '', 'url': 'https://api.github.com/users/jerryzh168', 'html_url': 'https://github.com/jerryzh168', 'followers_url': 'https://api.github.com/users/jerryzh168/followers', 'following_url': 'https://api.github.com/users/jerryzh168/following{/other_user}', 'gists_url': 'https://api.github.com/users/jerryzh168/gists{/gist_id}', 'starred_url': 'https://api.github.com/users/jerryzh168/starred{/owner}{/repo}', 'subscriptions_url': 'https://api.github.com/users/jerryzh168/subscriptions', 'organizations_url': 'https://api.github.com/users/jerryzh168/orgs', 'repos_url': 'https://api.github.com/users/jerryzh168/repos', 'events_url': 'https://api.github.com/users/jerryzh168/events{/privacy}', 'received_events_url': 'https://api.github.com/users/jerryzh168/received_events', 'type': 'User', 'site_admin': False}",referenced,42e07a83de83860c07d9d7103b504e68e37030cc,https://api.github.com/repos/pytorch/pytorch/commits/42e07a83de83860c07d9d7103b504e68e37030cc,2020-01-17T21:11:04Z,11,9,2
32368,2978790163,"{'login': 'jerryzh168', 'id': 4958441, 'node_id': 'MDQ6VXNlcjQ5NTg0NDE=', 'avatar_url': 'https://avatars0.githubusercontent.com/u/4958441?v=4', 'gravatar_id': '', 'url': 'https://api.github.com/users/jerryzh168', 'html_url': 'https://github.com/jerryzh168', 'followers_url': 'https://api.github.com/users/jerryzh168/followers', 'following_url': 'https://api.github.com/users/jerryzh168/following{/other_user}', 'gists_url': 'https://api.github.com/users/jerryzh168/gists{/gist_id}', 'starred_url': 'https://api.github.com/users/jerryzh168/starred{/owner}{/repo}', 'subscriptions_url': 'https://api.github.com/users/jerryzh168/subscriptions', 'organizations_url': 'https://api.github.com/users/jerryzh168/orgs', 'repos_url': 'https://api.github.com/users/jerryzh168/repos', 'events_url': 'https://api.github.com/users/jerryzh168/events{/privacy}', 'received_events_url': 'https://api.github.com/users/jerryzh168/received_events', 'type': 'User', 'site_admin': False}",referenced,82e5e794d346dfaaced53fe4a9070d582fd37c57,https://api.github.com/repos/pytorch/pytorch/commits/82e5e794d346dfaaced53fe4a9070d582fd37c57,2020-01-24T22:29:47Z,12692,9979,2713
32368,2978790287,"{'login': 'jerryzh168', 'id': 4958441, 'node_id': 'MDQ6VXNlcjQ5NTg0NDE=', 'avatar_url': 'https://avatars0.githubusercontent.com/u/4958441?v=4', 'gravatar_id': '', 'url': 'https://api.github.com/users/jerryzh168', 'html_url': 'https://github.com/jerryzh168', 'followers_url': 'https://api.github.com/users/jerryzh168/followers', 'following_url': 'https://api.github.com/users/jerryzh168/following{/other_user}', 'gists_url': 'https://api.github.com/users/jerryzh168/gists{/gist_id}', 'starred_url': 'https://api.github.com/users/jerryzh168/starred{/owner}{/repo}', 'subscriptions_url': 'https://api.github.com/users/jerryzh168/subscriptions', 'organizations_url': 'https://api.github.com/users/jerryzh168/orgs', 'repos_url': 'https://api.github.com/users/jerryzh168/repos', 'events_url': 'https://api.github.com/users/jerryzh168/events{/privacy}', 'received_events_url': 'https://api.github.com/users/jerryzh168/received_events', 'type': 'User', 'site_admin': False}",referenced,bda8cd41f75d51043fdb0577587c1ea7d5f7d1c4,https://api.github.com/repos/pytorch/pytorch/commits/bda8cd41f75d51043fdb0577587c1ea7d5f7d1c4,2020-01-24T22:29:52Z,9,8,1
32368,2978992324,"{'login': 'facebook-github-bot', 'id': 6422482, 'node_id': 'MDQ6VXNlcjY0MjI0ODI=', 'avatar_url': 'https://avatars3.githubusercontent.com/u/6422482?v=4', 'gravatar_id': '', 'url': 'https://api.github.com/users/facebook-github-bot', 'html_url': 'https://github.com/facebook-github-bot', 'followers_url': 'https://api.github.com/users/facebook-github-bot/followers', 'following_url': 'https://api.github.com/users/facebook-github-bot/following{/other_user}', 'gists_url': 'https://api.github.com/users/facebook-github-bot/gists{/gist_id}', 'starred_url': 'https://api.github.com/users/facebook-github-bot/starred{/owner}{/repo}', 'subscriptions_url': 'https://api.github.com/users/facebook-github-bot/subscriptions', 'organizations_url': 'https://api.github.com/users/facebook-github-bot/orgs', 'repos_url': 'https://api.github.com/users/facebook-github-bot/repos', 'events_url': 'https://api.github.com/users/facebook-github-bot/events{/privacy}', 'received_events_url': 'https://api.github.com/users/facebook-github-bot/received_events', 'type': 'User', 'site_admin': False}",closed,e7edc5f20e89257d0cdaafff70447b5885ad8b72,https://api.github.com/repos/pytorch/pytorch/commits/e7edc5f20e89257d0cdaafff70447b5885ad8b72,2020-01-25T00:50:14Z,9,8,1
32234,2999656470,"{'login': 'facebook-github-bot', 'id': 6422482, 'node_id': 'MDQ6VXNlcjY0MjI0ODI=', 'avatar_url': 'https://avatars3.githubusercontent.com/u/6422482?v=4', 'gravatar_id': '', 'url': 'https://api.github.com/users/facebook-github-bot', 'html_url': 'https://github.com/facebook-github-bot', 'followers_url': 'https://api.github.com/users/facebook-github-bot/followers', 'following_url': 'https://api.github.com/users/facebook-github-bot/following{/other_user}', 'gists_url': 'https://api.github.com/users/facebook-github-bot/gists{/gist_id}', 'starred_url': 'https://api.github.com/users/facebook-github-bot/starred{/owner}{/repo}', 'subscriptions_url': 'https://api.github.com/users/facebook-github-bot/subscriptions', 'organizations_url': 'https://api.github.com/users/facebook-github-bot/orgs', 'repos_url': 'https://api.github.com/users/facebook-github-bot/repos', 'events_url': 'https://api.github.com/users/facebook-github-bot/events{/privacy}', 'received_events_url': 'https://api.github.com/users/facebook-github-bot/received_events', 'type': 'User', 'site_admin': False}",closed,b564eaf7a803ae7019ca0523d4ba8c060c30b0cb,https://api.github.com/repos/pytorch/pytorch/commits/b564eaf7a803ae7019ca0523d4ba8c060c30b0cb,2020-02-01T23:01:37Z,165,89,76
32139,2945273893,"{'login': 'driazati', 'id': 9407960, 'node_id': 'MDQ6VXNlcjk0MDc5NjA=', 'avatar_url': 'https://avatars3.githubusercontent.com/u/9407960?v=4', 'gravatar_id': '', 'url': 'https://api.github.com/users/driazati', 'html_url': 'https://github.com/driazati', 'followers_url': 'https://api.github.com/users/driazati/followers', 'following_url': 'https://api.github.com/users/driazati/following{/other_user}', 'gists_url': 'https://api.github.com/users/driazati/gists{/gist_id}', 'starred_url': 'https://api.github.com/users/driazati/starred{/owner}{/repo}', 'subscriptions_url': 'https://api.github.com/users/driazati/subscriptions', 'organizations_url': 'https://api.github.com/users/driazati/orgs', 'repos_url': 'https://api.github.com/users/driazati/repos', 'events_url': 'https://api.github.com/users/driazati/events{/privacy}', 'received_events_url': 'https://api.github.com/users/driazati/received_events', 'type': 'User', 'site_admin': False}",referenced,4f8d7261b3aa660fb3c1a2160868f40150f51145,https://api.github.com/repos/pytorch/pytorch/commits/4f8d7261b3aa660fb3c1a2160868f40150f51145,2020-01-14T00:38:05Z,33,29,4
32139,2948966456,"{'login': 'facebook-github-bot', 'id': 6422482, 'node_id': 'MDQ6VXNlcjY0MjI0ODI=', 'avatar_url': 'https://avatars3.githubusercontent.com/u/6422482?v=4', 'gravatar_id': '', 'url': 'https://api.github.com/users/facebook-github-bot', 'html_url': 'https://github.com/facebook-github-bot', 'followers_url': 'https://api.github.com/users/facebook-github-bot/followers', 'following_url': 'https://api.github.com/users/facebook-github-bot/following{/other_user}', 'gists_url': 'https://api.github.com/users/facebook-github-bot/gists{/gist_id}', 'starred_url': 'https://api.github.com/users/facebook-github-bot/starred{/owner}{/repo}', 'subscriptions_url': 'https://api.github.com/users/facebook-github-bot/subscriptions', 'organizations_url': 'https://api.github.com/users/facebook-github-bot/orgs', 'repos_url': 'https://api.github.com/users/facebook-github-bot/repos', 'events_url': 'https://api.github.com/users/facebook-github-bot/events{/privacy}', 'received_events_url': 'https://api.github.com/users/facebook-github-bot/received_events', 'type': 'User', 'site_admin': False}",closed,f3b67bf75021d1597cd1a55620d3403b4b7e2631,https://api.github.com/repos/pytorch/pytorch/commits/f3b67bf75021d1597cd1a55620d3403b4b7e2631,2020-01-14T23:18:31Z,30,27,3
32136,2991289030,"{'login': 'facebook-github-bot', 'id': 6422482, 'node_id': 'MDQ6VXNlcjY0MjI0ODI=', 'avatar_url': 'https://avatars3.githubusercontent.com/u/6422482?v=4', 'gravatar_id': '', 'url': 'https://api.github.com/users/facebook-github-bot', 'html_url': 'https://github.com/facebook-github-bot', 'followers_url': 'https://api.github.com/users/facebook-github-bot/followers', 'following_url': 'https://api.github.com/users/facebook-github-bot/following{/other_user}', 'gists_url': 'https://api.github.com/users/facebook-github-bot/gists{/gist_id}', 'starred_url': 'https://api.github.com/users/facebook-github-bot/starred{/owner}{/repo}', 'subscriptions_url': 'https://api.github.com/users/facebook-github-bot/subscriptions', 'organizations_url': 'https://api.github.com/users/facebook-github-bot/orgs', 'repos_url': 'https://api.github.com/users/facebook-github-bot/repos', 'events_url': 'https://api.github.com/users/facebook-github-bot/events{/privacy}', 'received_events_url': 'https://api.github.com/users/facebook-github-bot/received_events', 'type': 'User', 'site_admin': False}",closed,9357b911800b891f09e9d8e02b74018514c9b77f,https://api.github.com/repos/pytorch/pytorch/commits/9357b911800b891f09e9d8e02b74018514c9b77f,2020-01-29T22:13:53Z,4,2,2
32058,2948825936,"{'login': 'zou3519', 'id': 5652049, 'node_id': 'MDQ6VXNlcjU2NTIwNDk=', 'avatar_url': 'https://avatars3.githubusercontent.com/u/5652049?v=4', 'gravatar_id': '', 'url': 'https://api.github.com/users/zou3519', 'html_url': 'https://github.com/zou3519', 'followers_url': 'https://api.github.com/users/zou3519/followers', 'following_url': 'https://api.github.com/users/zou3519/following{/other_user}', 'gists_url': 'https://api.github.com/users/zou3519/gists{/gist_id}', 'starred_url': 'https://api.github.com/users/zou3519/starred{/owner}{/repo}', 'subscriptions_url': 'https://api.github.com/users/zou3519/subscriptions', 'organizations_url': 'https://api.github.com/users/zou3519/orgs', 'repos_url': 'https://api.github.com/users/zou3519/repos', 'events_url': 'https://api.github.com/users/zou3519/events{/privacy}', 'received_events_url': 'https://api.github.com/users/zou3519/received_events', 'type': 'User', 'site_admin': False}",referenced,dcc0ab785e17b976de5f6515d51e712418443b66,https://api.github.com/repos/pytorch/pytorch/commits/dcc0ab785e17b976de5f6515d51e712418443b66,2020-01-14T22:18:30Z,10,0,10
32058,2948826212,"{'login': 'zou3519', 'id': 5652049, 'node_id': 'MDQ6VXNlcjU2NTIwNDk=', 'avatar_url': 'https://avatars3.githubusercontent.com/u/5652049?v=4', 'gravatar_id': '', 'url': 'https://api.github.com/users/zou3519', 'html_url': 'https://github.com/zou3519', 'followers_url': 'https://api.github.com/users/zou3519/followers', 'following_url': 'https://api.github.com/users/zou3519/following{/other_user}', 'gists_url': 'https://api.github.com/users/zou3519/gists{/gist_id}', 'starred_url': 'https://api.github.com/users/zou3519/starred{/owner}{/repo}', 'subscriptions_url': 'https://api.github.com/users/zou3519/subscriptions', 'organizations_url': 'https://api.github.com/users/zou3519/orgs', 'repos_url': 'https://api.github.com/users/zou3519/repos', 'events_url': 'https://api.github.com/users/zou3519/events{/privacy}', 'received_events_url': 'https://api.github.com/users/zou3519/received_events', 'type': 'User', 'site_admin': False}",referenced,77ddc0058d33ac22d8351df85f8f1bde55734f9a,https://api.github.com/repos/pytorch/pytorch/commits/77ddc0058d33ac22d8351df85f8f1bde55734f9a,2020-01-14T22:18:36Z,10,0,10
32058,2948842964,"{'login': 'zou3519', 'id': 5652049, 'node_id': 'MDQ6VXNlcjU2NTIwNDk=', 'avatar_url': 'https://avatars3.githubusercontent.com/u/5652049?v=4', 'gravatar_id': '', 'url': 'https://api.github.com/users/zou3519', 'html_url': 'https://github.com/zou3519', 'followers_url': 'https://api.github.com/users/zou3519/followers', 'following_url': 'https://api.github.com/users/zou3519/following{/other_user}', 'gists_url': 'https://api.github.com/users/zou3519/gists{/gist_id}', 'starred_url': 'https://api.github.com/users/zou3519/starred{/owner}{/repo}', 'subscriptions_url': 'https://api.github.com/users/zou3519/subscriptions', 'organizations_url': 'https://api.github.com/users/zou3519/orgs', 'repos_url': 'https://api.github.com/users/zou3519/repos', 'events_url': 'https://api.github.com/users/zou3519/events{/privacy}', 'received_events_url': 'https://api.github.com/users/zou3519/received_events', 'type': 'User', 'site_admin': False}",referenced,88111b95124eb617499bbedbd8ec35e834928ae8,https://api.github.com/repos/pytorch/pytorch/commits/88111b95124eb617499bbedbd8ec35e834928ae8,2020-01-14T22:24:47Z,0,0,0
32058,2948843129,"{'login': 'zou3519', 'id': 5652049, 'node_id': 'MDQ6VXNlcjU2NTIwNDk=', 'avatar_url': 'https://avatars3.githubusercontent.com/u/5652049?v=4', 'gravatar_id': '', 'url': 'https://api.github.com/users/zou3519', 'html_url': 'https://github.com/zou3519', 'followers_url': 'https://api.github.com/users/zou3519/followers', 'following_url': 'https://api.github.com/users/zou3519/following{/other_user}', 'gists_url': 'https://api.github.com/users/zou3519/gists{/gist_id}', 'starred_url': 'https://api.github.com/users/zou3519/starred{/owner}{/repo}', 'subscriptions_url': 'https://api.github.com/users/zou3519/subscriptions', 'organizations_url': 'https://api.github.com/users/zou3519/orgs', 'repos_url': 'https://api.github.com/users/zou3519/repos', 'events_url': 'https://api.github.com/users/zou3519/events{/privacy}', 'received_events_url': 'https://api.github.com/users/zou3519/received_events', 'type': 'User', 'site_admin': False}",referenced,d780d2c865b673409bf2600a49bab7f3f0d7fcb3,https://api.github.com/repos/pytorch/pytorch/commits/d780d2c865b673409bf2600a49bab7f3f0d7fcb3,2020-01-14T22:24:51Z,10,0,10
32058,2948845729,"{'login': 'zou3519', 'id': 5652049, 'node_id': 'MDQ6VXNlcjU2NTIwNDk=', 'avatar_url': 'https://avatars3.githubusercontent.com/u/5652049?v=4', 'gravatar_id': '', 'url': 'https://api.github.com/users/zou3519', 'html_url': 'https://github.com/zou3519', 'followers_url': 'https://api.github.com/users/zou3519/followers', 'following_url': 'https://api.github.com/users/zou3519/following{/other_user}', 'gists_url': 'https://api.github.com/users/zou3519/gists{/gist_id}', 'starred_url': 'https://api.github.com/users/zou3519/starred{/owner}{/repo}', 'subscriptions_url': 'https://api.github.com/users/zou3519/subscriptions', 'organizations_url': 'https://api.github.com/users/zou3519/orgs', 'repos_url': 'https://api.github.com/users/zou3519/repos', 'events_url': 'https://api.github.com/users/zou3519/events{/privacy}', 'received_events_url': 'https://api.github.com/users/zou3519/received_events', 'type': 'User', 'site_admin': False}",referenced,40b0e139eae01b26440eaad73b23516cc6f45904,https://api.github.com/repos/pytorch/pytorch/commits/40b0e139eae01b26440eaad73b23516cc6f45904,2020-01-14T22:25:48Z,0,0,0
32058,2948845986,"{'login': 'zou3519', 'id': 5652049, 'node_id': 'MDQ6VXNlcjU2NTIwNDk=', 'avatar_url': 'https://avatars3.githubusercontent.com/u/5652049?v=4', 'gravatar_id': '', 'url': 'https://api.github.com/users/zou3519', 'html_url': 'https://github.com/zou3519', 'followers_url': 'https://api.github.com/users/zou3519/followers', 'following_url': 'https://api.github.com/users/zou3519/following{/other_user}', 'gists_url': 'https://api.github.com/users/zou3519/gists{/gist_id}', 'starred_url': 'https://api.github.com/users/zou3519/starred{/owner}{/repo}', 'subscriptions_url': 'https://api.github.com/users/zou3519/subscriptions', 'organizations_url': 'https://api.github.com/users/zou3519/orgs', 'repos_url': 'https://api.github.com/users/zou3519/repos', 'events_url': 'https://api.github.com/users/zou3519/events{/privacy}', 'received_events_url': 'https://api.github.com/users/zou3519/received_events', 'type': 'User', 'site_admin': False}",referenced,3e1c716531dbd480181f49d070c64a95df8f668e,https://api.github.com/repos/pytorch/pytorch/commits/3e1c716531dbd480181f49d070c64a95df8f668e,2020-01-14T22:25:53Z,10,0,10
32058,2948998617,"{'login': 'zou3519', 'id': 5652049, 'node_id': 'MDQ6VXNlcjU2NTIwNDk=', 'avatar_url': 'https://avatars3.githubusercontent.com/u/5652049?v=4', 'gravatar_id': '', 'url': 'https://api.github.com/users/zou3519', 'html_url': 'https://github.com/zou3519', 'followers_url': 'https://api.github.com/users/zou3519/followers', 'following_url': 'https://api.github.com/users/zou3519/following{/other_user}', 'gists_url': 'https://api.github.com/users/zou3519/gists{/gist_id}', 'starred_url': 'https://api.github.com/users/zou3519/starred{/owner}{/repo}', 'subscriptions_url': 'https://api.github.com/users/zou3519/subscriptions', 'organizations_url': 'https://api.github.com/users/zou3519/orgs', 'repos_url': 'https://api.github.com/users/zou3519/repos', 'events_url': 'https://api.github.com/users/zou3519/events{/privacy}', 'received_events_url': 'https://api.github.com/users/zou3519/received_events', 'type': 'User', 'site_admin': False}",referenced,6f499ee790bfdaa250df6a37d47b3529243695c1,https://api.github.com/repos/pytorch/pytorch/commits/6f499ee790bfdaa250df6a37d47b3529243695c1,2020-01-14T23:34:42Z,17,14,3
32058,2948998790,"{'login': 'zou3519', 'id': 5652049, 'node_id': 'MDQ6VXNlcjU2NTIwNDk=', 'avatar_url': 'https://avatars3.githubusercontent.com/u/5652049?v=4', 'gravatar_id': '', 'url': 'https://api.github.com/users/zou3519', 'html_url': 'https://github.com/zou3519', 'followers_url': 'https://api.github.com/users/zou3519/followers', 'following_url': 'https://api.github.com/users/zou3519/following{/other_user}', 'gists_url': 'https://api.github.com/users/zou3519/gists{/gist_id}', 'starred_url': 'https://api.github.com/users/zou3519/starred{/owner}{/repo}', 'subscriptions_url': 'https://api.github.com/users/zou3519/subscriptions', 'organizations_url': 'https://api.github.com/users/zou3519/orgs', 'repos_url': 'https://api.github.com/users/zou3519/repos', 'events_url': 'https://api.github.com/users/zou3519/events{/privacy}', 'received_events_url': 'https://api.github.com/users/zou3519/received_events', 'type': 'User', 'site_admin': False}",referenced,2ebced98d36bd9415064806a3d2051ad06874d50,https://api.github.com/repos/pytorch/pytorch/commits/2ebced98d36bd9415064806a3d2051ad06874d50,2020-01-14T23:34:46Z,27,14,13
32058,2949009213,"{'login': 'zou3519', 'id': 5652049, 'node_id': 'MDQ6VXNlcjU2NTIwNDk=', 'avatar_url': 'https://avatars3.githubusercontent.com/u/5652049?v=4', 'gravatar_id': '', 'url': 'https://api.github.com/users/zou3519', 'html_url': 'https://github.com/zou3519', 'followers_url': 'https://api.github.com/users/zou3519/followers', 'following_url': 'https://api.github.com/users/zou3519/following{/other_user}', 'gists_url': 'https://api.github.com/users/zou3519/gists{/gist_id}', 'starred_url': 'https://api.github.com/users/zou3519/starred{/owner}{/repo}', 'subscriptions_url': 'https://api.github.com/users/zou3519/subscriptions', 'organizations_url': 'https://api.github.com/users/zou3519/orgs', 'repos_url': 'https://api.github.com/users/zou3519/repos', 'events_url': 'https://api.github.com/users/zou3519/events{/privacy}', 'received_events_url': 'https://api.github.com/users/zou3519/received_events', 'type': 'User', 'site_admin': False}",referenced,a2d99e2b60684225071292d499df5e21ed1ab5b5,https://api.github.com/repos/pytorch/pytorch/commits/a2d99e2b60684225071292d499df5e21ed1ab5b5,2020-01-14T23:39:54Z,0,0,0
32058,2949009325,"{'login': 'zou3519', 'id': 5652049, 'node_id': 'MDQ6VXNlcjU2NTIwNDk=', 'avatar_url': 'https://avatars3.githubusercontent.com/u/5652049?v=4', 'gravatar_id': '', 'url': 'https://api.github.com/users/zou3519', 'html_url': 'https://github.com/zou3519', 'followers_url': 'https://api.github.com/users/zou3519/followers', 'following_url': 'https://api.github.com/users/zou3519/following{/other_user}', 'gists_url': 'https://api.github.com/users/zou3519/gists{/gist_id}', 'starred_url': 'https://api.github.com/users/zou3519/starred{/owner}{/repo}', 'subscriptions_url': 'https://api.github.com/users/zou3519/subscriptions', 'organizations_url': 'https://api.github.com/users/zou3519/orgs', 'repos_url': 'https://api.github.com/users/zou3519/repos', 'events_url': 'https://api.github.com/users/zou3519/events{/privacy}', 'received_events_url': 'https://api.github.com/users/zou3519/received_events', 'type': 'User', 'site_admin': False}",referenced,33840f128f1082a63e280a98f10935f5afb2751e,https://api.github.com/repos/pytorch/pytorch/commits/33840f128f1082a63e280a98f10935f5afb2751e,2020-01-14T23:39:59Z,27,14,13
32058,2949014469,"{'login': 'zou3519', 'id': 5652049, 'node_id': 'MDQ6VXNlcjU2NTIwNDk=', 'avatar_url': 'https://avatars3.githubusercontent.com/u/5652049?v=4', 'gravatar_id': '', 'url': 'https://api.github.com/users/zou3519', 'html_url': 'https://github.com/zou3519', 'followers_url': 'https://api.github.com/users/zou3519/followers', 'following_url': 'https://api.github.com/users/zou3519/following{/other_user}', 'gists_url': 'https://api.github.com/users/zou3519/gists{/gist_id}', 'starred_url': 'https://api.github.com/users/zou3519/starred{/owner}{/repo}', 'subscriptions_url': 'https://api.github.com/users/zou3519/subscriptions', 'organizations_url': 'https://api.github.com/users/zou3519/orgs', 'repos_url': 'https://api.github.com/users/zou3519/repos', 'events_url': 'https://api.github.com/users/zou3519/events{/privacy}', 'received_events_url': 'https://api.github.com/users/zou3519/received_events', 'type': 'User', 'site_admin': False}",referenced,ffeba56d2cea10f72a206459fe18028e81e92a24,https://api.github.com/repos/pytorch/pytorch/commits/ffeba56d2cea10f72a206459fe18028e81e92a24,2020-01-14T23:42:22Z,5,3,2
32058,2949014622,"{'login': 'zou3519', 'id': 5652049, 'node_id': 'MDQ6VXNlcjU2NTIwNDk=', 'avatar_url': 'https://avatars3.githubusercontent.com/u/5652049?v=4', 'gravatar_id': '', 'url': 'https://api.github.com/users/zou3519', 'html_url': 'https://github.com/zou3519', 'followers_url': 'https://api.github.com/users/zou3519/followers', 'following_url': 'https://api.github.com/users/zou3519/following{/other_user}', 'gists_url': 'https://api.github.com/users/zou3519/gists{/gist_id}', 'starred_url': 'https://api.github.com/users/zou3519/starred{/owner}{/repo}', 'subscriptions_url': 'https://api.github.com/users/zou3519/subscriptions', 'organizations_url': 'https://api.github.com/users/zou3519/orgs', 'repos_url': 'https://api.github.com/users/zou3519/repos', 'events_url': 'https://api.github.com/users/zou3519/events{/privacy}', 'received_events_url': 'https://api.github.com/users/zou3519/received_events', 'type': 'User', 'site_admin': False}",referenced,168e6d095fce6fbd36408a548d58c9bac79af293,https://api.github.com/repos/pytorch/pytorch/commits/168e6d095fce6fbd36408a548d58c9bac79af293,2020-01-14T23:42:26Z,28,15,13
32058,2951317430,"{'login': 'facebook-github-bot', 'id': 6422482, 'node_id': 'MDQ6VXNlcjY0MjI0ODI=', 'avatar_url': 'https://avatars3.githubusercontent.com/u/6422482?v=4', 'gravatar_id': '', 'url': 'https://api.github.com/users/facebook-github-bot', 'html_url': 'https://github.com/facebook-github-bot', 'followers_url': 'https://api.github.com/users/facebook-github-bot/followers', 'following_url': 'https://api.github.com/users/facebook-github-bot/following{/other_user}', 'gists_url': 'https://api.github.com/users/facebook-github-bot/gists{/gist_id}', 'starred_url': 'https://api.github.com/users/facebook-github-bot/starred{/owner}{/repo}', 'subscriptions_url': 'https://api.github.com/users/facebook-github-bot/subscriptions', 'organizations_url': 'https://api.github.com/users/facebook-github-bot/orgs', 'repos_url': 'https://api.github.com/users/facebook-github-bot/repos', 'events_url': 'https://api.github.com/users/facebook-github-bot/events{/privacy}', 'received_events_url': 'https://api.github.com/users/facebook-github-bot/received_events', 'type': 'User', 'site_admin': False}",closed,19bbb4fccb15fdd120ff00697887331f5a2394ef,https://api.github.com/repos/pytorch/pytorch/commits/19bbb4fccb15fdd120ff00697887331f5a2394ef,2020-01-15T15:49:57Z,28,15,13
32045,2955502502,"{'login': 'albanD', 'id': 6359743, 'node_id': 'MDQ6VXNlcjYzNTk3NDM=', 'avatar_url': 'https://avatars3.githubusercontent.com/u/6359743?v=4', 'gravatar_id': '', 'url': 'https://api.github.com/users/albanD', 'html_url': 'https://github.com/albanD', 'followers_url': 'https://api.github.com/users/albanD/followers', 'following_url': 'https://api.github.com/users/albanD/following{/other_user}', 'gists_url': 'https://api.github.com/users/albanD/gists{/gist_id}', 'starred_url': 'https://api.github.com/users/albanD/starred{/owner}{/repo}', 'subscriptions_url': 'https://api.github.com/users/albanD/subscriptions', 'organizations_url': 'https://api.github.com/users/albanD/orgs', 'repos_url': 'https://api.github.com/users/albanD/repos', 'events_url': 'https://api.github.com/users/albanD/events{/privacy}', 'received_events_url': 'https://api.github.com/users/albanD/received_events', 'type': 'User', 'site_admin': False}",referenced,65bc885994e149b4af3192793b2e26e225b6ba0b,https://api.github.com/repos/pytorch/pytorch/commits/65bc885994e149b4af3192793b2e26e225b6ba0b,2020-01-16T17:53:54Z,2,1,1
32045,2973743729,"{'login': 'albanD', 'id': 6359743, 'node_id': 'MDQ6VXNlcjYzNTk3NDM=', 'avatar_url': 'https://avatars3.githubusercontent.com/u/6359743?v=4', 'gravatar_id': '', 'url': 'https://api.github.com/users/albanD', 'html_url': 'https://github.com/albanD', 'followers_url': 'https://api.github.com/users/albanD/followers', 'following_url': 'https://api.github.com/users/albanD/following{/other_user}', 'gists_url': 'https://api.github.com/users/albanD/gists{/gist_id}', 'starred_url': 'https://api.github.com/users/albanD/starred{/owner}{/repo}', 'subscriptions_url': 'https://api.github.com/users/albanD/subscriptions', 'organizations_url': 'https://api.github.com/users/albanD/orgs', 'repos_url': 'https://api.github.com/users/albanD/repos', 'events_url': 'https://api.github.com/users/albanD/events{/privacy}', 'received_events_url': 'https://api.github.com/users/albanD/received_events', 'type': 'User', 'site_admin': False}",referenced,bad22951a47409a2d52fb8e0810614bbf42e9df9,https://api.github.com/repos/pytorch/pytorch/commits/bad22951a47409a2d52fb8e0810614bbf42e9df9,2020-01-23T13:35:33Z,11574,9260,2314
32045,2974500441,"{'login': 'facebook-github-bot', 'id': 6422482, 'node_id': 'MDQ6VXNlcjY0MjI0ODI=', 'avatar_url': 'https://avatars3.githubusercontent.com/u/6422482?v=4', 'gravatar_id': '', 'url': 'https://api.github.com/users/facebook-github-bot', 'html_url': 'https://github.com/facebook-github-bot', 'followers_url': 'https://api.github.com/users/facebook-github-bot/followers', 'following_url': 'https://api.github.com/users/facebook-github-bot/following{/other_user}', 'gists_url': 'https://api.github.com/users/facebook-github-bot/gists{/gist_id}', 'starred_url': 'https://api.github.com/users/facebook-github-bot/starred{/owner}{/repo}', 'subscriptions_url': 'https://api.github.com/users/facebook-github-bot/subscriptions', 'organizations_url': 'https://api.github.com/users/facebook-github-bot/orgs', 'repos_url': 'https://api.github.com/users/facebook-github-bot/repos', 'events_url': 'https://api.github.com/users/facebook-github-bot/events{/privacy}', 'received_events_url': 'https://api.github.com/users/facebook-github-bot/received_events', 'type': 'User', 'site_admin': False}",referenced,02aa3ba3312c273472084f782f06f79109185f33,https://api.github.com/repos/pytorch/pytorch/commits/02aa3ba3312c273472084f782f06f79109185f33,2020-01-23T16:55:25Z,48,48,0
32032,2943604077,"{'login': 'facebook-github-bot', 'id': 6422482, 'node_id': 'MDQ6VXNlcjY0MjI0ODI=', 'avatar_url': 'https://avatars3.githubusercontent.com/u/6422482?v=4', 'gravatar_id': '', 'url': 'https://api.github.com/users/facebook-github-bot', 'html_url': 'https://github.com/facebook-github-bot', 'followers_url': 'https://api.github.com/users/facebook-github-bot/followers', 'following_url': 'https://api.github.com/users/facebook-github-bot/following{/other_user}', 'gists_url': 'https://api.github.com/users/facebook-github-bot/gists{/gist_id}', 'starred_url': 'https://api.github.com/users/facebook-github-bot/starred{/owner}{/repo}', 'subscriptions_url': 'https://api.github.com/users/facebook-github-bot/subscriptions', 'organizations_url': 'https://api.github.com/users/facebook-github-bot/orgs', 'repos_url': 'https://api.github.com/users/facebook-github-bot/repos', 'events_url': 'https://api.github.com/users/facebook-github-bot/events{/privacy}', 'received_events_url': 'https://api.github.com/users/facebook-github-bot/received_events', 'type': 'User', 'site_admin': False}",closed,77c2c78e01d55f111e9d8e6114256e225c853269,https://api.github.com/repos/pytorch/pytorch/commits/77c2c78e01d55f111e9d8e6114256e225c853269,2020-01-13T15:21:49Z,2,1,1
32032,2947406703,"{'login': 'zou3519', 'id': 5652049, 'node_id': 'MDQ6VXNlcjU2NTIwNDk=', 'avatar_url': 'https://avatars3.githubusercontent.com/u/5652049?v=4', 'gravatar_id': '', 'url': 'https://api.github.com/users/zou3519', 'html_url': 'https://github.com/zou3519', 'followers_url': 'https://api.github.com/users/zou3519/followers', 'following_url': 'https://api.github.com/users/zou3519/following{/other_user}', 'gists_url': 'https://api.github.com/users/zou3519/gists{/gist_id}', 'starred_url': 'https://api.github.com/users/zou3519/starred{/owner}{/repo}', 'subscriptions_url': 'https://api.github.com/users/zou3519/subscriptions', 'organizations_url': 'https://api.github.com/users/zou3519/orgs', 'repos_url': 'https://api.github.com/users/zou3519/repos', 'events_url': 'https://api.github.com/users/zou3519/events{/privacy}', 'received_events_url': 'https://api.github.com/users/zou3519/received_events', 'type': 'User', 'site_admin': False}",referenced,49364eb42684416b0dc94e4ce1a3ccd002e8203f,https://api.github.com/repos/pytorch/pytorch/commits/49364eb42684416b0dc94e4ce1a3ccd002e8203f,2020-01-14T15:02:49Z,2,1,1
32002,2939882315,"{'login': 'facebook-github-bot', 'id': 6422482, 'node_id': 'MDQ6VXNlcjY0MjI0ODI=', 'avatar_url': 'https://avatars3.githubusercontent.com/u/6422482?v=4', 'gravatar_id': '', 'url': 'https://api.github.com/users/facebook-github-bot', 'html_url': 'https://github.com/facebook-github-bot', 'followers_url': 'https://api.github.com/users/facebook-github-bot/followers', 'following_url': 'https://api.github.com/users/facebook-github-bot/following{/other_user}', 'gists_url': 'https://api.github.com/users/facebook-github-bot/gists{/gist_id}', 'starred_url': 'https://api.github.com/users/facebook-github-bot/starred{/owner}{/repo}', 'subscriptions_url': 'https://api.github.com/users/facebook-github-bot/subscriptions', 'organizations_url': 'https://api.github.com/users/facebook-github-bot/orgs', 'repos_url': 'https://api.github.com/users/facebook-github-bot/repos', 'events_url': 'https://api.github.com/users/facebook-github-bot/events{/privacy}', 'received_events_url': 'https://api.github.com/users/facebook-github-bot/received_events', 'type': 'User', 'site_admin': False}",referenced,638e4ad8b95793876c0f5e82db58c18618fb6e61,https://api.github.com/repos/pytorch/pytorch/commits/638e4ad8b95793876c0f5e82db58c18618fb6e61,2020-01-10T21:14:12Z,10,4,6
32001,3003268867,"{'login': 'facebook-github-bot', 'id': 6422482, 'node_id': 'MDQ6VXNlcjY0MjI0ODI=', 'avatar_url': 'https://avatars3.githubusercontent.com/u/6422482?v=4', 'gravatar_id': '', 'url': 'https://api.github.com/users/facebook-github-bot', 'html_url': 'https://github.com/facebook-github-bot', 'followers_url': 'https://api.github.com/users/facebook-github-bot/followers', 'following_url': 'https://api.github.com/users/facebook-github-bot/following{/other_user}', 'gists_url': 'https://api.github.com/users/facebook-github-bot/gists{/gist_id}', 'starred_url': 'https://api.github.com/users/facebook-github-bot/starred{/owner}{/repo}', 'subscriptions_url': 'https://api.github.com/users/facebook-github-bot/subscriptions', 'organizations_url': 'https://api.github.com/users/facebook-github-bot/orgs', 'repos_url': 'https://api.github.com/users/facebook-github-bot/repos', 'events_url': 'https://api.github.com/users/facebook-github-bot/events{/privacy}', 'received_events_url': 'https://api.github.com/users/facebook-github-bot/received_events', 'type': 'User', 'site_admin': False}",closed,7cddc302e5742ee458010bbd0a10ff3d39b5ae9c,https://api.github.com/repos/pytorch/pytorch/commits/7cddc302e5742ee458010bbd0a10ff3d39b5ae9c,2020-02-03T18:18:11Z,30,30,0
31944,3011994585,"{'login': 'facebook-github-bot', 'id': 6422482, 'node_id': 'MDQ6VXNlcjY0MjI0ODI=', 'avatar_url': 'https://avatars3.githubusercontent.com/u/6422482?v=4', 'gravatar_id': '', 'url': 'https://api.github.com/users/facebook-github-bot', 'html_url': 'https://github.com/facebook-github-bot', 'followers_url': 'https://api.github.com/users/facebook-github-bot/followers', 'following_url': 'https://api.github.com/users/facebook-github-bot/following{/other_user}', 'gists_url': 'https://api.github.com/users/facebook-github-bot/gists{/gist_id}', 'starred_url': 'https://api.github.com/users/facebook-github-bot/starred{/owner}{/repo}', 'subscriptions_url': 'https://api.github.com/users/facebook-github-bot/subscriptions', 'organizations_url': 'https://api.github.com/users/facebook-github-bot/orgs', 'repos_url': 'https://api.github.com/users/facebook-github-bot/repos', 'events_url': 'https://api.github.com/users/facebook-github-bot/events{/privacy}', 'received_events_url': 'https://api.github.com/users/facebook-github-bot/received_events', 'type': 'User', 'site_admin': False}",closed,1b746b95fb6f3df45bd2883045de9fbd82b72100,https://api.github.com/repos/pytorch/pytorch/commits/1b746b95fb6f3df45bd2883045de9fbd82b72100,2020-02-05T23:37:20Z,16,13,3
31926,2938942434,"{'login': 'facebook-github-bot', 'id': 6422482, 'node_id': 'MDQ6VXNlcjY0MjI0ODI=', 'avatar_url': 'https://avatars3.githubusercontent.com/u/6422482?v=4', 'gravatar_id': '', 'url': 'https://api.github.com/users/facebook-github-bot', 'html_url': 'https://github.com/facebook-github-bot', 'followers_url': 'https://api.github.com/users/facebook-github-bot/followers', 'following_url': 'https://api.github.com/users/facebook-github-bot/following{/other_user}', 'gists_url': 'https://api.github.com/users/facebook-github-bot/gists{/gist_id}', 'starred_url': 'https://api.github.com/users/facebook-github-bot/starred{/owner}{/repo}', 'subscriptions_url': 'https://api.github.com/users/facebook-github-bot/subscriptions', 'organizations_url': 'https://api.github.com/users/facebook-github-bot/orgs', 'repos_url': 'https://api.github.com/users/facebook-github-bot/repos', 'events_url': 'https://api.github.com/users/facebook-github-bot/events{/privacy}', 'received_events_url': 'https://api.github.com/users/facebook-github-bot/received_events', 'type': 'User', 'site_admin': False}",closed,b6f43afacaff516a8e1681afac367bb4cb15aa62,https://api.github.com/repos/pytorch/pytorch/commits/b6f43afacaff516a8e1681afac367bb4cb15aa62,2020-01-10T15:42:20Z,14,10,4
31915,2998938468,"{'login': 'facebook-github-bot', 'id': 6422482, 'node_id': 'MDQ6VXNlcjY0MjI0ODI=', 'avatar_url': 'https://avatars3.githubusercontent.com/u/6422482?v=4', 'gravatar_id': '', 'url': 'https://api.github.com/users/facebook-github-bot', 'html_url': 'https://github.com/facebook-github-bot', 'followers_url': 'https://api.github.com/users/facebook-github-bot/followers', 'following_url': 'https://api.github.com/users/facebook-github-bot/following{/other_user}', 'gists_url': 'https://api.github.com/users/facebook-github-bot/gists{/gist_id}', 'starred_url': 'https://api.github.com/users/facebook-github-bot/starred{/owner}{/repo}', 'subscriptions_url': 'https://api.github.com/users/facebook-github-bot/subscriptions', 'organizations_url': 'https://api.github.com/users/facebook-github-bot/orgs', 'repos_url': 'https://api.github.com/users/facebook-github-bot/repos', 'events_url': 'https://api.github.com/users/facebook-github-bot/events{/privacy}', 'received_events_url': 'https://api.github.com/users/facebook-github-bot/received_events', 'type': 'User', 'site_admin': False}",referenced,d03c9aaa05dc62efa0c0efc77c7483114af5c6cf,https://api.github.com/repos/pytorch/pytorch/commits/d03c9aaa05dc62efa0c0efc77c7483114af5c6cf,2020-02-01T00:42:16Z,14,13,1
31902,2998957607,"{'login': 'facebook-github-bot', 'id': 6422482, 'node_id': 'MDQ6VXNlcjY0MjI0ODI=', 'avatar_url': 'https://avatars3.githubusercontent.com/u/6422482?v=4', 'gravatar_id': '', 'url': 'https://api.github.com/users/facebook-github-bot', 'html_url': 'https://github.com/facebook-github-bot', 'followers_url': 'https://api.github.com/users/facebook-github-bot/followers', 'following_url': 'https://api.github.com/users/facebook-github-bot/following{/other_user}', 'gists_url': 'https://api.github.com/users/facebook-github-bot/gists{/gist_id}', 'starred_url': 'https://api.github.com/users/facebook-github-bot/starred{/owner}{/repo}', 'subscriptions_url': 'https://api.github.com/users/facebook-github-bot/subscriptions', 'organizations_url': 'https://api.github.com/users/facebook-github-bot/orgs', 'repos_url': 'https://api.github.com/users/facebook-github-bot/repos', 'events_url': 'https://api.github.com/users/facebook-github-bot/events{/privacy}', 'received_events_url': 'https://api.github.com/users/facebook-github-bot/received_events', 'type': 'User', 'site_admin': False}",referenced,10bd21d5502ec983ec4e5b9c7810d4e5b3cf0d4b,https://api.github.com/repos/pytorch/pytorch/commits/10bd21d5502ec983ec4e5b9c7810d4e5b3cf0d4b,2020-02-01T01:00:12Z,37,34,3
31875,2979722666,"{'login': 'facebook-github-bot', 'id': 6422482, 'node_id': 'MDQ6VXNlcjY0MjI0ODI=', 'avatar_url': 'https://avatars3.githubusercontent.com/u/6422482?v=4', 'gravatar_id': '', 'url': 'https://api.github.com/users/facebook-github-bot', 'html_url': 'https://github.com/facebook-github-bot', 'followers_url': 'https://api.github.com/users/facebook-github-bot/followers', 'following_url': 'https://api.github.com/users/facebook-github-bot/following{/other_user}', 'gists_url': 'https://api.github.com/users/facebook-github-bot/gists{/gist_id}', 'starred_url': 'https://api.github.com/users/facebook-github-bot/starred{/owner}{/repo}', 'subscriptions_url': 'https://api.github.com/users/facebook-github-bot/subscriptions', 'organizations_url': 'https://api.github.com/users/facebook-github-bot/orgs', 'repos_url': 'https://api.github.com/users/facebook-github-bot/repos', 'events_url': 'https://api.github.com/users/facebook-github-bot/events{/privacy}', 'received_events_url': 'https://api.github.com/users/facebook-github-bot/received_events', 'type': 'User', 'site_admin': False}",closed,90a259e1e22d14c79f788520c836d78b7f6325ba,https://api.github.com/repos/pytorch/pytorch/commits/90a259e1e22d14c79f788520c836d78b7f6325ba,2020-01-26T06:13:53Z,6,6,0
31804,2919144877,"{'login': 'rohan-varma', 'id': 8039770, 'node_id': 'MDQ6VXNlcjgwMzk3NzA=', 'avatar_url': 'https://avatars2.githubusercontent.com/u/8039770?v=4', 'gravatar_id': '', 'url': 'https://api.github.com/users/rohan-varma', 'html_url': 'https://github.com/rohan-varma', 'followers_url': 'https://api.github.com/users/rohan-varma/followers', 'following_url': 'https://api.github.com/users/rohan-varma/following{/other_user}', 'gists_url': 'https://api.github.com/users/rohan-varma/gists{/gist_id}', 'starred_url': 'https://api.github.com/users/rohan-varma/starred{/owner}{/repo}', 'subscriptions_url': 'https://api.github.com/users/rohan-varma/subscriptions', 'organizations_url': 'https://api.github.com/users/rohan-varma/orgs', 'repos_url': 'https://api.github.com/users/rohan-varma/repos', 'events_url': 'https://api.github.com/users/rohan-varma/events{/privacy}', 'received_events_url': 'https://api.github.com/users/rohan-varma/received_events', 'type': 'User', 'site_admin': False}",referenced,d7f558fe762715d9304597e40a86b09b29e3b9cb,https://api.github.com/repos/pytorch/pytorch/commits/d7f558fe762715d9304597e40a86b09b29e3b9cb,2020-01-03T00:20:40Z,19,10,9
31804,2919145402,"{'login': 'rohan-varma', 'id': 8039770, 'node_id': 'MDQ6VXNlcjgwMzk3NzA=', 'avatar_url': 'https://avatars2.githubusercontent.com/u/8039770?v=4', 'gravatar_id': '', 'url': 'https://api.github.com/users/rohan-varma', 'html_url': 'https://github.com/rohan-varma', 'followers_url': 'https://api.github.com/users/rohan-varma/followers', 'following_url': 'https://api.github.com/users/rohan-varma/following{/other_user}', 'gists_url': 'https://api.github.com/users/rohan-varma/gists{/gist_id}', 'starred_url': 'https://api.github.com/users/rohan-varma/starred{/owner}{/repo}', 'subscriptions_url': 'https://api.github.com/users/rohan-varma/subscriptions', 'organizations_url': 'https://api.github.com/users/rohan-varma/orgs', 'repos_url': 'https://api.github.com/users/rohan-varma/repos', 'events_url': 'https://api.github.com/users/rohan-varma/events{/privacy}', 'received_events_url': 'https://api.github.com/users/rohan-varma/received_events', 'type': 'User', 'site_admin': False}",referenced,fbccbd74e861ed9af0f20611ff994982d19d5053,https://api.github.com/repos/pytorch/pytorch/commits/fbccbd74e861ed9af0f20611ff994982d19d5053,2020-01-03T00:21:04Z,19,10,9
31804,2921259621,"{'login': 'facebook-github-bot', 'id': 6422482, 'node_id': 'MDQ6VXNlcjY0MjI0ODI=', 'avatar_url': 'https://avatars3.githubusercontent.com/u/6422482?v=4', 'gravatar_id': '', 'url': 'https://api.github.com/users/facebook-github-bot', 'html_url': 'https://github.com/facebook-github-bot', 'followers_url': 'https://api.github.com/users/facebook-github-bot/followers', 'following_url': 'https://api.github.com/users/facebook-github-bot/following{/other_user}', 'gists_url': 'https://api.github.com/users/facebook-github-bot/gists{/gist_id}', 'starred_url': 'https://api.github.com/users/facebook-github-bot/starred{/owner}{/repo}', 'subscriptions_url': 'https://api.github.com/users/facebook-github-bot/subscriptions', 'organizations_url': 'https://api.github.com/users/facebook-github-bot/orgs', 'repos_url': 'https://api.github.com/users/facebook-github-bot/repos', 'events_url': 'https://api.github.com/users/facebook-github-bot/events{/privacy}', 'received_events_url': 'https://api.github.com/users/facebook-github-bot/received_events', 'type': 'User', 'site_admin': False}",closed,457c57d9f7287c1d7ed97e477499119bc1777749,https://api.github.com/repos/pytorch/pytorch/commits/457c57d9f7287c1d7ed97e477499119bc1777749,2020-01-03T21:21:38Z,19,10,9
31768,2968134252,"{'login': 'facebook-github-bot', 'id': 6422482, 'node_id': 'MDQ6VXNlcjY0MjI0ODI=', 'avatar_url': 'https://avatars3.githubusercontent.com/u/6422482?v=4', 'gravatar_id': '', 'url': 'https://api.github.com/users/facebook-github-bot', 'html_url': 'https://github.com/facebook-github-bot', 'followers_url': 'https://api.github.com/users/facebook-github-bot/followers', 'following_url': 'https://api.github.com/users/facebook-github-bot/following{/other_user}', 'gists_url': 'https://api.github.com/users/facebook-github-bot/gists{/gist_id}', 'starred_url': 'https://api.github.com/users/facebook-github-bot/starred{/owner}{/repo}', 'subscriptions_url': 'https://api.github.com/users/facebook-github-bot/subscriptions', 'organizations_url': 'https://api.github.com/users/facebook-github-bot/orgs', 'repos_url': 'https://api.github.com/users/facebook-github-bot/repos', 'events_url': 'https://api.github.com/users/facebook-github-bot/events{/privacy}', 'received_events_url': 'https://api.github.com/users/facebook-github-bot/received_events', 'type': 'User', 'site_admin': False}",referenced,7fdc6cb74efb0610daaf9c724daa8e4b52cd52fa,https://api.github.com/repos/pytorch/pytorch/commits/7fdc6cb74efb0610daaf9c724daa8e4b52cd52fa,2020-01-21T23:14:29Z,10,9,1
31768,3012464732,"{'login': 'facebook-github-bot', 'id': 6422482, 'node_id': 'MDQ6VXNlcjY0MjI0ODI=', 'avatar_url': 'https://avatars3.githubusercontent.com/u/6422482?v=4', 'gravatar_id': '', 'url': 'https://api.github.com/users/facebook-github-bot', 'html_url': 'https://github.com/facebook-github-bot', 'followers_url': 'https://api.github.com/users/facebook-github-bot/followers', 'following_url': 'https://api.github.com/users/facebook-github-bot/following{/other_user}', 'gists_url': 'https://api.github.com/users/facebook-github-bot/gists{/gist_id}', 'starred_url': 'https://api.github.com/users/facebook-github-bot/starred{/owner}{/repo}', 'subscriptions_url': 'https://api.github.com/users/facebook-github-bot/subscriptions', 'organizations_url': 'https://api.github.com/users/facebook-github-bot/orgs', 'repos_url': 'https://api.github.com/users/facebook-github-bot/repos', 'events_url': 'https://api.github.com/users/facebook-github-bot/events{/privacy}', 'received_events_url': 'https://api.github.com/users/facebook-github-bot/received_events', 'type': 'User', 'site_admin': False}",closed,46c3c18bcc12e7d2d368fdb8606b509f130554f1,https://api.github.com/repos/pytorch/pytorch/commits/46c3c18bcc12e7d2d368fdb8606b509f130554f1,2020-02-06T04:26:57Z,37,37,0
31768,3023089008,"{'login': 'facebook-github-bot', 'id': 6422482, 'node_id': 'MDQ6VXNlcjY0MjI0ODI=', 'avatar_url': 'https://avatars3.githubusercontent.com/u/6422482?v=4', 'gravatar_id': '', 'url': 'https://api.github.com/users/facebook-github-bot', 'html_url': 'https://github.com/facebook-github-bot', 'followers_url': 'https://api.github.com/users/facebook-github-bot/followers', 'following_url': 'https://api.github.com/users/facebook-github-bot/following{/other_user}', 'gists_url': 'https://api.github.com/users/facebook-github-bot/gists{/gist_id}', 'starred_url': 'https://api.github.com/users/facebook-github-bot/starred{/owner}{/repo}', 'subscriptions_url': 'https://api.github.com/users/facebook-github-bot/subscriptions', 'organizations_url': 'https://api.github.com/users/facebook-github-bot/orgs', 'repos_url': 'https://api.github.com/users/facebook-github-bot/repos', 'events_url': 'https://api.github.com/users/facebook-github-bot/events{/privacy}', 'received_events_url': 'https://api.github.com/users/facebook-github-bot/received_events', 'type': 'User', 'site_admin': False}",referenced,efba6302876ef1156c84a0cb1ace24a1df8cecce,https://api.github.com/repos/pytorch/pytorch/commits/efba6302876ef1156c84a0cb1ace24a1df8cecce,2020-02-10T15:05:48Z,37,37,0
31757,3003255241,"{'login': 'facebook-github-bot', 'id': 6422482, 'node_id': 'MDQ6VXNlcjY0MjI0ODI=', 'avatar_url': 'https://avatars3.githubusercontent.com/u/6422482?v=4', 'gravatar_id': '', 'url': 'https://api.github.com/users/facebook-github-bot', 'html_url': 'https://github.com/facebook-github-bot', 'followers_url': 'https://api.github.com/users/facebook-github-bot/followers', 'following_url': 'https://api.github.com/users/facebook-github-bot/following{/other_user}', 'gists_url': 'https://api.github.com/users/facebook-github-bot/gists{/gist_id}', 'starred_url': 'https://api.github.com/users/facebook-github-bot/starred{/owner}{/repo}', 'subscriptions_url': 'https://api.github.com/users/facebook-github-bot/subscriptions', 'organizations_url': 'https://api.github.com/users/facebook-github-bot/orgs', 'repos_url': 'https://api.github.com/users/facebook-github-bot/repos', 'events_url': 'https://api.github.com/users/facebook-github-bot/events{/privacy}', 'received_events_url': 'https://api.github.com/users/facebook-github-bot/received_events', 'type': 'User', 'site_admin': False}",referenced,b34e0dda24291dedf5bbc622a5bbff8ed6e617fe,https://api.github.com/repos/pytorch/pytorch/commits/b34e0dda24291dedf5bbc622a5bbff8ed6e617fe,2020-02-03T18:13:52Z,6,6,0
31734,2970636805,"{'login': 'facebook-github-bot', 'id': 6422482, 'node_id': 'MDQ6VXNlcjY0MjI0ODI=', 'avatar_url': 'https://avatars3.githubusercontent.com/u/6422482?v=4', 'gravatar_id': '', 'url': 'https://api.github.com/users/facebook-github-bot', 'html_url': 'https://github.com/facebook-github-bot', 'followers_url': 'https://api.github.com/users/facebook-github-bot/followers', 'following_url': 'https://api.github.com/users/facebook-github-bot/following{/other_user}', 'gists_url': 'https://api.github.com/users/facebook-github-bot/gists{/gist_id}', 'starred_url': 'https://api.github.com/users/facebook-github-bot/starred{/owner}{/repo}', 'subscriptions_url': 'https://api.github.com/users/facebook-github-bot/subscriptions', 'organizations_url': 'https://api.github.com/users/facebook-github-bot/orgs', 'repos_url': 'https://api.github.com/users/facebook-github-bot/repos', 'events_url': 'https://api.github.com/users/facebook-github-bot/events{/privacy}', 'received_events_url': 'https://api.github.com/users/facebook-github-bot/received_events', 'type': 'User', 'site_admin': False}",closed,e37a24b0446e80d01b52cb04a2e7fde6976a16d4,https://api.github.com/repos/pytorch/pytorch/commits/e37a24b0446e80d01b52cb04a2e7fde6976a16d4,2020-01-22T16:04:58Z,13,12,1
31715,2929029505,"{'login': 'albanD', 'id': 6359743, 'node_id': 'MDQ6VXNlcjYzNTk3NDM=', 'avatar_url': 'https://avatars3.githubusercontent.com/u/6359743?v=4', 'gravatar_id': '', 'url': 'https://api.github.com/users/albanD', 'html_url': 'https://github.com/albanD', 'followers_url': 'https://api.github.com/users/albanD/followers', 'following_url': 'https://api.github.com/users/albanD/following{/other_user}', 'gists_url': 'https://api.github.com/users/albanD/gists{/gist_id}', 'starred_url': 'https://api.github.com/users/albanD/starred{/owner}{/repo}', 'subscriptions_url': 'https://api.github.com/users/albanD/subscriptions', 'organizations_url': 'https://api.github.com/users/albanD/orgs', 'repos_url': 'https://api.github.com/users/albanD/repos', 'events_url': 'https://api.github.com/users/albanD/events{/privacy}', 'received_events_url': 'https://api.github.com/users/albanD/received_events', 'type': 'User', 'site_admin': False}",referenced,35df89bed6a1b3f1f8db0e92b03fe6cc1d2b2e67,https://api.github.com/repos/pytorch/pytorch/commits/35df89bed6a1b3f1f8db0e92b03fe6cc1d2b2e67,2020-01-07T20:56:46Z,2,2,0
31715,2929071020,"{'login': 'albanD', 'id': 6359743, 'node_id': 'MDQ6VXNlcjYzNTk3NDM=', 'avatar_url': 'https://avatars3.githubusercontent.com/u/6359743?v=4', 'gravatar_id': '', 'url': 'https://api.github.com/users/albanD', 'html_url': 'https://github.com/albanD', 'followers_url': 'https://api.github.com/users/albanD/followers', 'following_url': 'https://api.github.com/users/albanD/following{/other_user}', 'gists_url': 'https://api.github.com/users/albanD/gists{/gist_id}', 'starred_url': 'https://api.github.com/users/albanD/starred{/owner}{/repo}', 'subscriptions_url': 'https://api.github.com/users/albanD/subscriptions', 'organizations_url': 'https://api.github.com/users/albanD/orgs', 'repos_url': 'https://api.github.com/users/albanD/repos', 'events_url': 'https://api.github.com/users/albanD/events{/privacy}', 'received_events_url': 'https://api.github.com/users/albanD/received_events', 'type': 'User', 'site_admin': False}",referenced,b04f831aee8821e386e3e604517a0db5cb282319,https://api.github.com/repos/pytorch/pytorch/commits/b04f831aee8821e386e3e604517a0db5cb282319,2020-01-07T21:11:56Z,1711,1090,621
31715,2931662527,"{'login': 'albanD', 'id': 6359743, 'node_id': 'MDQ6VXNlcjYzNTk3NDM=', 'avatar_url': 'https://avatars3.githubusercontent.com/u/6359743?v=4', 'gravatar_id': '', 'url': 'https://api.github.com/users/albanD', 'html_url': 'https://github.com/albanD', 'followers_url': 'https://api.github.com/users/albanD/followers', 'following_url': 'https://api.github.com/users/albanD/following{/other_user}', 'gists_url': 'https://api.github.com/users/albanD/gists{/gist_id}', 'starred_url': 'https://api.github.com/users/albanD/starred{/owner}{/repo}', 'subscriptions_url': 'https://api.github.com/users/albanD/subscriptions', 'organizations_url': 'https://api.github.com/users/albanD/orgs', 'repos_url': 'https://api.github.com/users/albanD/repos', 'events_url': 'https://api.github.com/users/albanD/events{/privacy}', 'received_events_url': 'https://api.github.com/users/albanD/received_events', 'type': 'User', 'site_admin': False}",referenced,e24d1eb9df20786d5822c0c09c11dd0205b9a030,https://api.github.com/repos/pytorch/pytorch/commits/e24d1eb9df20786d5822c0c09c11dd0205b9a030,2020-01-08T15:32:08Z,1019,831,188
31715,2932922416,"{'login': 'facebook-github-bot', 'id': 6422482, 'node_id': 'MDQ6VXNlcjY0MjI0ODI=', 'avatar_url': 'https://avatars3.githubusercontent.com/u/6422482?v=4', 'gravatar_id': '', 'url': 'https://api.github.com/users/facebook-github-bot', 'html_url': 'https://github.com/facebook-github-bot', 'followers_url': 'https://api.github.com/users/facebook-github-bot/followers', 'following_url': 'https://api.github.com/users/facebook-github-bot/following{/other_user}', 'gists_url': 'https://api.github.com/users/facebook-github-bot/gists{/gist_id}', 'starred_url': 'https://api.github.com/users/facebook-github-bot/starred{/owner}{/repo}', 'subscriptions_url': 'https://api.github.com/users/facebook-github-bot/subscriptions', 'organizations_url': 'https://api.github.com/users/facebook-github-bot/orgs', 'repos_url': 'https://api.github.com/users/facebook-github-bot/repos', 'events_url': 'https://api.github.com/users/facebook-github-bot/events{/privacy}', 'received_events_url': 'https://api.github.com/users/facebook-github-bot/received_events', 'type': 'User', 'site_admin': False}",closed,1314f7f4f486e2457b1660e9c89da3cb0c4b5fe4,https://api.github.com/repos/pytorch/pytorch/commits/1314f7f4f486e2457b1660e9c89da3cb0c4b5fe4,2020-01-08T22:17:07Z,31,27,4
31680,2923648589,"{'login': 'facebook-github-bot', 'id': 6422482, 'node_id': 'MDQ6VXNlcjY0MjI0ODI=', 'avatar_url': 'https://avatars3.githubusercontent.com/u/6422482?v=4', 'gravatar_id': '', 'url': 'https://api.github.com/users/facebook-github-bot', 'html_url': 'https://github.com/facebook-github-bot', 'followers_url': 'https://api.github.com/users/facebook-github-bot/followers', 'following_url': 'https://api.github.com/users/facebook-github-bot/following{/other_user}', 'gists_url': 'https://api.github.com/users/facebook-github-bot/gists{/gist_id}', 'starred_url': 'https://api.github.com/users/facebook-github-bot/starred{/owner}{/repo}', 'subscriptions_url': 'https://api.github.com/users/facebook-github-bot/subscriptions', 'organizations_url': 'https://api.github.com/users/facebook-github-bot/orgs', 'repos_url': 'https://api.github.com/users/facebook-github-bot/repos', 'events_url': 'https://api.github.com/users/facebook-github-bot/events{/privacy}', 'received_events_url': 'https://api.github.com/users/facebook-github-bot/received_events', 'type': 'User', 'site_admin': False}",closed,1ba1799a66b20f17657a132eab111d002b3356f3,https://api.github.com/repos/pytorch/pytorch/commits/1ba1799a66b20f17657a132eab111d002b3356f3,2020-01-06T09:46:40Z,4,2,2
31672,2913324693,"{'login': 'facebook-github-bot', 'id': 6422482, 'node_id': 'MDQ6VXNlcjY0MjI0ODI=', 'avatar_url': 'https://avatars3.githubusercontent.com/u/6422482?v=4', 'gravatar_id': '', 'url': 'https://api.github.com/users/facebook-github-bot', 'html_url': 'https://github.com/facebook-github-bot', 'followers_url': 'https://api.github.com/users/facebook-github-bot/followers', 'following_url': 'https://api.github.com/users/facebook-github-bot/following{/other_user}', 'gists_url': 'https://api.github.com/users/facebook-github-bot/gists{/gist_id}', 'starred_url': 'https://api.github.com/users/facebook-github-bot/starred{/owner}{/repo}', 'subscriptions_url': 'https://api.github.com/users/facebook-github-bot/subscriptions', 'organizations_url': 'https://api.github.com/users/facebook-github-bot/orgs', 'repos_url': 'https://api.github.com/users/facebook-github-bot/repos', 'events_url': 'https://api.github.com/users/facebook-github-bot/events{/privacy}', 'received_events_url': 'https://api.github.com/users/facebook-github-bot/received_events', 'type': 'User', 'site_admin': False}",closed,ee87b01f4093208d527fc0bd740723c2fa4f1feb,https://api.github.com/repos/pytorch/pytorch/commits/ee87b01f4093208d527fc0bd740723c2fa4f1feb,2019-12-30T07:04:08Z,38,32,6
31620,2929486232,"{'login': 'facebook-github-bot', 'id': 6422482, 'node_id': 'MDQ6VXNlcjY0MjI0ODI=', 'avatar_url': 'https://avatars3.githubusercontent.com/u/6422482?v=4', 'gravatar_id': '', 'url': 'https://api.github.com/users/facebook-github-bot', 'html_url': 'https://github.com/facebook-github-bot', 'followers_url': 'https://api.github.com/users/facebook-github-bot/followers', 'following_url': 'https://api.github.com/users/facebook-github-bot/following{/other_user}', 'gists_url': 'https://api.github.com/users/facebook-github-bot/gists{/gist_id}', 'starred_url': 'https://api.github.com/users/facebook-github-bot/starred{/owner}{/repo}', 'subscriptions_url': 'https://api.github.com/users/facebook-github-bot/subscriptions', 'organizations_url': 'https://api.github.com/users/facebook-github-bot/orgs', 'repos_url': 'https://api.github.com/users/facebook-github-bot/repos', 'events_url': 'https://api.github.com/users/facebook-github-bot/events{/privacy}', 'received_events_url': 'https://api.github.com/users/facebook-github-bot/received_events', 'type': 'User', 'site_admin': False}",referenced,3c07eb33bb5be9ffaac310031c2b4725c7ddc882,https://api.github.com/repos/pytorch/pytorch/commits/3c07eb33bb5be9ffaac310031c2b4725c7ddc882,2020-01-08T00:20:54Z,56,56,0
31601,2922257023,"{'login': 'facebook-github-bot', 'id': 6422482, 'node_id': 'MDQ6VXNlcjY0MjI0ODI=', 'avatar_url': 'https://avatars3.githubusercontent.com/u/6422482?v=4', 'gravatar_id': '', 'url': 'https://api.github.com/users/facebook-github-bot', 'html_url': 'https://github.com/facebook-github-bot', 'followers_url': 'https://api.github.com/users/facebook-github-bot/followers', 'following_url': 'https://api.github.com/users/facebook-github-bot/following{/other_user}', 'gists_url': 'https://api.github.com/users/facebook-github-bot/gists{/gist_id}', 'starred_url': 'https://api.github.com/users/facebook-github-bot/starred{/owner}{/repo}', 'subscriptions_url': 'https://api.github.com/users/facebook-github-bot/subscriptions', 'organizations_url': 'https://api.github.com/users/facebook-github-bot/orgs', 'repos_url': 'https://api.github.com/users/facebook-github-bot/repos', 'events_url': 'https://api.github.com/users/facebook-github-bot/events{/privacy}', 'received_events_url': 'https://api.github.com/users/facebook-github-bot/received_events', 'type': 'User', 'site_admin': False}",referenced,3f0b330736a2af1331e49e8e12e880dffd1e5974,https://api.github.com/repos/pytorch/pytorch/commits/3f0b330736a2af1331e49e8e12e880dffd1e5974,2020-01-05T05:48:41Z,2,1,1
31549,2939550908,"{'login': 'facebook-github-bot', 'id': 6422482, 'node_id': 'MDQ6VXNlcjY0MjI0ODI=', 'avatar_url': 'https://avatars3.githubusercontent.com/u/6422482?v=4', 'gravatar_id': '', 'url': 'https://api.github.com/users/facebook-github-bot', 'html_url': 'https://github.com/facebook-github-bot', 'followers_url': 'https://api.github.com/users/facebook-github-bot/followers', 'following_url': 'https://api.github.com/users/facebook-github-bot/following{/other_user}', 'gists_url': 'https://api.github.com/users/facebook-github-bot/gists{/gist_id}', 'starred_url': 'https://api.github.com/users/facebook-github-bot/starred{/owner}{/repo}', 'subscriptions_url': 'https://api.github.com/users/facebook-github-bot/subscriptions', 'organizations_url': 'https://api.github.com/users/facebook-github-bot/orgs', 'repos_url': 'https://api.github.com/users/facebook-github-bot/repos', 'events_url': 'https://api.github.com/users/facebook-github-bot/events{/privacy}', 'received_events_url': 'https://api.github.com/users/facebook-github-bot/received_events', 'type': 'User', 'site_admin': False}",closed,f995ec207604ac7b8b22c16acd924a14a9035db9,https://api.github.com/repos/pytorch/pytorch/commits/f995ec207604ac7b8b22c16acd924a14a9035db9,2020-01-10T19:04:50Z,12,4,8
31515,2920870990,"{'login': 'facebook-github-bot', 'id': 6422482, 'node_id': 'MDQ6VXNlcjY0MjI0ODI=', 'avatar_url': 'https://avatars3.githubusercontent.com/u/6422482?v=4', 'gravatar_id': '', 'url': 'https://api.github.com/users/facebook-github-bot', 'html_url': 'https://github.com/facebook-github-bot', 'followers_url': 'https://api.github.com/users/facebook-github-bot/followers', 'following_url': 'https://api.github.com/users/facebook-github-bot/following{/other_user}', 'gists_url': 'https://api.github.com/users/facebook-github-bot/gists{/gist_id}', 'starred_url': 'https://api.github.com/users/facebook-github-bot/starred{/owner}{/repo}', 'subscriptions_url': 'https://api.github.com/users/facebook-github-bot/subscriptions', 'organizations_url': 'https://api.github.com/users/facebook-github-bot/orgs', 'repos_url': 'https://api.github.com/users/facebook-github-bot/repos', 'events_url': 'https://api.github.com/users/facebook-github-bot/events{/privacy}', 'received_events_url': 'https://api.github.com/users/facebook-github-bot/received_events', 'type': 'User', 'site_admin': False}",closed,0b9cd410a96d173e09e0b8661233d3c853907adf,https://api.github.com/repos/pytorch/pytorch/commits/0b9cd410a96d173e09e0b8661233d3c853907adf,2020-01-03T18:17:06Z,25,24,1
31472,2898462808,"{'login': 'pbelevich', 'id': 1160355, 'node_id': 'MDQ6VXNlcjExNjAzNTU=', 'avatar_url': 'https://avatars1.githubusercontent.com/u/1160355?v=4', 'gravatar_id': '', 'url': 'https://api.github.com/users/pbelevich', 'html_url': 'https://github.com/pbelevich', 'followers_url': 'https://api.github.com/users/pbelevich/followers', 'following_url': 'https://api.github.com/users/pbelevich/following{/other_user}', 'gists_url': 'https://api.github.com/users/pbelevich/gists{/gist_id}', 'starred_url': 'https://api.github.com/users/pbelevich/starred{/owner}{/repo}', 'subscriptions_url': 'https://api.github.com/users/pbelevich/subscriptions', 'organizations_url': 'https://api.github.com/users/pbelevich/orgs', 'repos_url': 'https://api.github.com/users/pbelevich/repos', 'events_url': 'https://api.github.com/users/pbelevich/events{/privacy}', 'received_events_url': 'https://api.github.com/users/pbelevich/received_events', 'type': 'User', 'site_admin': False}",referenced,0bca99694411f762800336f27d181565cb660847,https://api.github.com/repos/pytorch/pytorch/commits/0bca99694411f762800336f27d181565cb660847,2019-12-19T19:55:24Z,31,18,13
31472,2898529263,"{'login': 'pbelevich', 'id': 1160355, 'node_id': 'MDQ6VXNlcjExNjAzNTU=', 'avatar_url': 'https://avatars1.githubusercontent.com/u/1160355?v=4', 'gravatar_id': '', 'url': 'https://api.github.com/users/pbelevich', 'html_url': 'https://github.com/pbelevich', 'followers_url': 'https://api.github.com/users/pbelevich/followers', 'following_url': 'https://api.github.com/users/pbelevich/following{/other_user}', 'gists_url': 'https://api.github.com/users/pbelevich/gists{/gist_id}', 'starred_url': 'https://api.github.com/users/pbelevich/starred{/owner}{/repo}', 'subscriptions_url': 'https://api.github.com/users/pbelevich/subscriptions', 'organizations_url': 'https://api.github.com/users/pbelevich/orgs', 'repos_url': 'https://api.github.com/users/pbelevich/repos', 'events_url': 'https://api.github.com/users/pbelevich/events{/privacy}', 'received_events_url': 'https://api.github.com/users/pbelevich/received_events', 'type': 'User', 'site_admin': False}",referenced,7a2c441f949c22d8082e9604d754bafe986d8fa5,https://api.github.com/repos/pytorch/pytorch/commits/7a2c441f949c22d8082e9604d754bafe986d8fa5,2019-12-19T20:19:46Z,2,1,1
31472,2898560940,"{'login': 'pbelevich', 'id': 1160355, 'node_id': 'MDQ6VXNlcjExNjAzNTU=', 'avatar_url': 'https://avatars1.githubusercontent.com/u/1160355?v=4', 'gravatar_id': '', 'url': 'https://api.github.com/users/pbelevich', 'html_url': 'https://github.com/pbelevich', 'followers_url': 'https://api.github.com/users/pbelevich/followers', 'following_url': 'https://api.github.com/users/pbelevich/following{/other_user}', 'gists_url': 'https://api.github.com/users/pbelevich/gists{/gist_id}', 'starred_url': 'https://api.github.com/users/pbelevich/starred{/owner}{/repo}', 'subscriptions_url': 'https://api.github.com/users/pbelevich/subscriptions', 'organizations_url': 'https://api.github.com/users/pbelevich/orgs', 'repos_url': 'https://api.github.com/users/pbelevich/repos', 'events_url': 'https://api.github.com/users/pbelevich/events{/privacy}', 'received_events_url': 'https://api.github.com/users/pbelevich/received_events', 'type': 'User', 'site_admin': False}",referenced,b12b633e9d341def7c1359c16580ccba6238fe1d,https://api.github.com/repos/pytorch/pytorch/commits/b12b633e9d341def7c1359c16580ccba6238fe1d,2019-12-19T20:30:48Z,2,1,1
31472,2909676128,"{'login': 'pbelevich', 'id': 1160355, 'node_id': 'MDQ6VXNlcjExNjAzNTU=', 'avatar_url': 'https://avatars1.githubusercontent.com/u/1160355?v=4', 'gravatar_id': '', 'url': 'https://api.github.com/users/pbelevich', 'html_url': 'https://github.com/pbelevich', 'followers_url': 'https://api.github.com/users/pbelevich/followers', 'following_url': 'https://api.github.com/users/pbelevich/following{/other_user}', 'gists_url': 'https://api.github.com/users/pbelevich/gists{/gist_id}', 'starred_url': 'https://api.github.com/users/pbelevich/starred{/owner}{/repo}', 'subscriptions_url': 'https://api.github.com/users/pbelevich/subscriptions', 'organizations_url': 'https://api.github.com/users/pbelevich/orgs', 'repos_url': 'https://api.github.com/users/pbelevich/repos', 'events_url': 'https://api.github.com/users/pbelevich/events{/privacy}', 'received_events_url': 'https://api.github.com/users/pbelevich/received_events', 'type': 'User', 'site_admin': False}",referenced,e8dae19a52f53b361b2867b4caca198bff977f84,https://api.github.com/repos/pytorch/pytorch/commits/e8dae19a52f53b361b2867b4caca198bff977f84,2019-12-26T21:01:49Z,5719,3766,1953
31472,2909678527,"{'login': 'pbelevich', 'id': 1160355, 'node_id': 'MDQ6VXNlcjExNjAzNTU=', 'avatar_url': 'https://avatars1.githubusercontent.com/u/1160355?v=4', 'gravatar_id': '', 'url': 'https://api.github.com/users/pbelevich', 'html_url': 'https://github.com/pbelevich', 'followers_url': 'https://api.github.com/users/pbelevich/followers', 'following_url': 'https://api.github.com/users/pbelevich/following{/other_user}', 'gists_url': 'https://api.github.com/users/pbelevich/gists{/gist_id}', 'starred_url': 'https://api.github.com/users/pbelevich/starred{/owner}{/repo}', 'subscriptions_url': 'https://api.github.com/users/pbelevich/subscriptions', 'organizations_url': 'https://api.github.com/users/pbelevich/orgs', 'repos_url': 'https://api.github.com/users/pbelevich/repos', 'events_url': 'https://api.github.com/users/pbelevich/events{/privacy}', 'received_events_url': 'https://api.github.com/users/pbelevich/received_events', 'type': 'User', 'site_admin': False}",referenced,7d78e1036896d8229ad14f2e47016a4ab217f0be,https://api.github.com/repos/pytorch/pytorch/commits/7d78e1036896d8229ad14f2e47016a4ab217f0be,2019-12-26T21:04:25Z,4,2,2
31472,2920964340,"{'login': 'pbelevich', 'id': 1160355, 'node_id': 'MDQ6VXNlcjExNjAzNTU=', 'avatar_url': 'https://avatars1.githubusercontent.com/u/1160355?v=4', 'gravatar_id': '', 'url': 'https://api.github.com/users/pbelevich', 'html_url': 'https://github.com/pbelevich', 'followers_url': 'https://api.github.com/users/pbelevich/followers', 'following_url': 'https://api.github.com/users/pbelevich/following{/other_user}', 'gists_url': 'https://api.github.com/users/pbelevich/gists{/gist_id}', 'starred_url': 'https://api.github.com/users/pbelevich/starred{/owner}{/repo}', 'subscriptions_url': 'https://api.github.com/users/pbelevich/subscriptions', 'organizations_url': 'https://api.github.com/users/pbelevich/orgs', 'repos_url': 'https://api.github.com/users/pbelevich/repos', 'events_url': 'https://api.github.com/users/pbelevich/events{/privacy}', 'received_events_url': 'https://api.github.com/users/pbelevich/received_events', 'type': 'User', 'site_admin': False}",referenced,ab5697f42f52597fc3a91960649404d4279e12c5,https://api.github.com/repos/pytorch/pytorch/commits/ab5697f42f52597fc3a91960649404d4279e12c5,2020-01-03T18:59:38Z,3525,2275,1250
31472,2928859001,"{'login': 'pbelevich', 'id': 1160355, 'node_id': 'MDQ6VXNlcjExNjAzNTU=', 'avatar_url': 'https://avatars1.githubusercontent.com/u/1160355?v=4', 'gravatar_id': '', 'url': 'https://api.github.com/users/pbelevich', 'html_url': 'https://github.com/pbelevich', 'followers_url': 'https://api.github.com/users/pbelevich/followers', 'following_url': 'https://api.github.com/users/pbelevich/following{/other_user}', 'gists_url': 'https://api.github.com/users/pbelevich/gists{/gist_id}', 'starred_url': 'https://api.github.com/users/pbelevich/starred{/owner}{/repo}', 'subscriptions_url': 'https://api.github.com/users/pbelevich/subscriptions', 'organizations_url': 'https://api.github.com/users/pbelevich/orgs', 'repos_url': 'https://api.github.com/users/pbelevich/repos', 'events_url': 'https://api.github.com/users/pbelevich/events{/privacy}', 'received_events_url': 'https://api.github.com/users/pbelevich/received_events', 'type': 'User', 'site_admin': False}",referenced,0d45bb8bcbd03599d32abd7b32c422940433d0f1,https://api.github.com/repos/pytorch/pytorch/commits/0d45bb8bcbd03599d32abd7b32c422940433d0f1,2020-01-07T19:54:00Z,2901,1803,1098
31472,2928901514,"{'login': 'pbelevich', 'id': 1160355, 'node_id': 'MDQ6VXNlcjExNjAzNTU=', 'avatar_url': 'https://avatars1.githubusercontent.com/u/1160355?v=4', 'gravatar_id': '', 'url': 'https://api.github.com/users/pbelevich', 'html_url': 'https://github.com/pbelevich', 'followers_url': 'https://api.github.com/users/pbelevich/followers', 'following_url': 'https://api.github.com/users/pbelevich/following{/other_user}', 'gists_url': 'https://api.github.com/users/pbelevich/gists{/gist_id}', 'starred_url': 'https://api.github.com/users/pbelevich/starred{/owner}{/repo}', 'subscriptions_url': 'https://api.github.com/users/pbelevich/subscriptions', 'organizations_url': 'https://api.github.com/users/pbelevich/orgs', 'repos_url': 'https://api.github.com/users/pbelevich/repos', 'events_url': 'https://api.github.com/users/pbelevich/events{/privacy}', 'received_events_url': 'https://api.github.com/users/pbelevich/received_events', 'type': 'User', 'site_admin': False}",referenced,ba89ff96d3f3cc7264293f8f61dd063f465c3322,https://api.github.com/repos/pytorch/pytorch/commits/ba89ff96d3f3cc7264293f8f61dd063f465c3322,2020-01-07T20:09:38Z,71,34,37
31472,2929267106,"{'login': 'pbelevich', 'id': 1160355, 'node_id': 'MDQ6VXNlcjExNjAzNTU=', 'avatar_url': 'https://avatars1.githubusercontent.com/u/1160355?v=4', 'gravatar_id': '', 'url': 'https://api.github.com/users/pbelevich', 'html_url': 'https://github.com/pbelevich', 'followers_url': 'https://api.github.com/users/pbelevich/followers', 'following_url': 'https://api.github.com/users/pbelevich/following{/other_user}', 'gists_url': 'https://api.github.com/users/pbelevich/gists{/gist_id}', 'starred_url': 'https://api.github.com/users/pbelevich/starred{/owner}{/repo}', 'subscriptions_url': 'https://api.github.com/users/pbelevich/subscriptions', 'organizations_url': 'https://api.github.com/users/pbelevich/orgs', 'repos_url': 'https://api.github.com/users/pbelevich/repos', 'events_url': 'https://api.github.com/users/pbelevich/events{/privacy}', 'received_events_url': 'https://api.github.com/users/pbelevich/received_events', 'type': 'User', 'site_admin': False}",referenced,fc39d483d51f6fd75eae77bc538444529d9ab9ee,https://api.github.com/repos/pytorch/pytorch/commits/fc39d483d51f6fd75eae77bc538444529d9ab9ee,2020-01-07T22:27:24Z,232,133,99
31472,2931895627,"{'login': 'pbelevich', 'id': 1160355, 'node_id': 'MDQ6VXNlcjExNjAzNTU=', 'avatar_url': 'https://avatars1.githubusercontent.com/u/1160355?v=4', 'gravatar_id': '', 'url': 'https://api.github.com/users/pbelevich', 'html_url': 'https://github.com/pbelevich', 'followers_url': 'https://api.github.com/users/pbelevich/followers', 'following_url': 'https://api.github.com/users/pbelevich/following{/other_user}', 'gists_url': 'https://api.github.com/users/pbelevich/gists{/gist_id}', 'starred_url': 'https://api.github.com/users/pbelevich/starred{/owner}{/repo}', 'subscriptions_url': 'https://api.github.com/users/pbelevich/subscriptions', 'organizations_url': 'https://api.github.com/users/pbelevich/orgs', 'repos_url': 'https://api.github.com/users/pbelevich/repos', 'events_url': 'https://api.github.com/users/pbelevich/events{/privacy}', 'received_events_url': 'https://api.github.com/users/pbelevich/received_events', 'type': 'User', 'site_admin': False}",referenced,e2b91b040e51ccd2818f8b22d60725f00ba57cd2,https://api.github.com/repos/pytorch/pytorch/commits/e2b91b040e51ccd2818f8b22d60725f00ba57cd2,2020-01-08T16:31:59Z,992,809,183
31472,2932814119,"{'login': 'pbelevich', 'id': 1160355, 'node_id': 'MDQ6VXNlcjExNjAzNTU=', 'avatar_url': 'https://avatars1.githubusercontent.com/u/1160355?v=4', 'gravatar_id': '', 'url': 'https://api.github.com/users/pbelevich', 'html_url': 'https://github.com/pbelevich', 'followers_url': 'https://api.github.com/users/pbelevich/followers', 'following_url': 'https://api.github.com/users/pbelevich/following{/other_user}', 'gists_url': 'https://api.github.com/users/pbelevich/gists{/gist_id}', 'starred_url': 'https://api.github.com/users/pbelevich/starred{/owner}{/repo}', 'subscriptions_url': 'https://api.github.com/users/pbelevich/subscriptions', 'organizations_url': 'https://api.github.com/users/pbelevich/orgs', 'repos_url': 'https://api.github.com/users/pbelevich/repos', 'events_url': 'https://api.github.com/users/pbelevich/events{/privacy}', 'received_events_url': 'https://api.github.com/users/pbelevich/received_events', 'type': 'User', 'site_admin': False}",referenced,3d3b44b04857963484a2ae51b4f5a04821093efa,https://api.github.com/repos/pytorch/pytorch/commits/3d3b44b04857963484a2ae51b4f5a04821093efa,2020-01-08T21:37:48Z,1227,664,563
31472,2932948863,"{'login': 'pbelevich', 'id': 1160355, 'node_id': 'MDQ6VXNlcjExNjAzNTU=', 'avatar_url': 'https://avatars1.githubusercontent.com/u/1160355?v=4', 'gravatar_id': '', 'url': 'https://api.github.com/users/pbelevich', 'html_url': 'https://github.com/pbelevich', 'followers_url': 'https://api.github.com/users/pbelevich/followers', 'following_url': 'https://api.github.com/users/pbelevich/following{/other_user}', 'gists_url': 'https://api.github.com/users/pbelevich/gists{/gist_id}', 'starred_url': 'https://api.github.com/users/pbelevich/starred{/owner}{/repo}', 'subscriptions_url': 'https://api.github.com/users/pbelevich/subscriptions', 'organizations_url': 'https://api.github.com/users/pbelevich/orgs', 'repos_url': 'https://api.github.com/users/pbelevich/repos', 'events_url': 'https://api.github.com/users/pbelevich/events{/privacy}', 'received_events_url': 'https://api.github.com/users/pbelevich/received_events', 'type': 'User', 'site_admin': False}",referenced,8ab69b64371caf50bc088b241972103a8d7e7c9f,https://api.github.com/repos/pytorch/pytorch/commits/8ab69b64371caf50bc088b241972103a8d7e7c9f,2020-01-08T22:27:04Z,35,30,5
31472,2955431100,"{'login': 'pbelevich', 'id': 1160355, 'node_id': 'MDQ6VXNlcjExNjAzNTU=', 'avatar_url': 'https://avatars1.githubusercontent.com/u/1160355?v=4', 'gravatar_id': '', 'url': 'https://api.github.com/users/pbelevich', 'html_url': 'https://github.com/pbelevich', 'followers_url': 'https://api.github.com/users/pbelevich/followers', 'following_url': 'https://api.github.com/users/pbelevich/following{/other_user}', 'gists_url': 'https://api.github.com/users/pbelevich/gists{/gist_id}', 'starred_url': 'https://api.github.com/users/pbelevich/starred{/owner}{/repo}', 'subscriptions_url': 'https://api.github.com/users/pbelevich/subscriptions', 'organizations_url': 'https://api.github.com/users/pbelevich/orgs', 'repos_url': 'https://api.github.com/users/pbelevich/repos', 'events_url': 'https://api.github.com/users/pbelevich/events{/privacy}', 'received_events_url': 'https://api.github.com/users/pbelevich/received_events', 'type': 'User', 'site_admin': False}",referenced,7b022484ddebb24abfd3046b4fd723161ed15144,https://api.github.com/repos/pytorch/pytorch/commits/7b022484ddebb24abfd3046b4fd723161ed15144,2020-01-16T17:30:13Z,15992,8212,7780
31472,2955438393,"{'login': 'pbelevich', 'id': 1160355, 'node_id': 'MDQ6VXNlcjExNjAzNTU=', 'avatar_url': 'https://avatars1.githubusercontent.com/u/1160355?v=4', 'gravatar_id': '', 'url': 'https://api.github.com/users/pbelevich', 'html_url': 'https://github.com/pbelevich', 'followers_url': 'https://api.github.com/users/pbelevich/followers', 'following_url': 'https://api.github.com/users/pbelevich/following{/other_user}', 'gists_url': 'https://api.github.com/users/pbelevich/gists{/gist_id}', 'starred_url': 'https://api.github.com/users/pbelevich/starred{/owner}{/repo}', 'subscriptions_url': 'https://api.github.com/users/pbelevich/subscriptions', 'organizations_url': 'https://api.github.com/users/pbelevich/orgs', 'repos_url': 'https://api.github.com/users/pbelevich/repos', 'events_url': 'https://api.github.com/users/pbelevich/events{/privacy}', 'received_events_url': 'https://api.github.com/users/pbelevich/received_events', 'type': 'User', 'site_admin': False}",referenced,e1b74ee1b5ccaf6c11c0f4fa2b8baca7334d2e23,https://api.github.com/repos/pytorch/pytorch/commits/e1b74ee1b5ccaf6c11c0f4fa2b8baca7334d2e23,2020-01-16T17:32:27Z,4,2,2
31472,2955881607,"{'login': 'pbelevich', 'id': 1160355, 'node_id': 'MDQ6VXNlcjExNjAzNTU=', 'avatar_url': 'https://avatars1.githubusercontent.com/u/1160355?v=4', 'gravatar_id': '', 'url': 'https://api.github.com/users/pbelevich', 'html_url': 'https://github.com/pbelevich', 'followers_url': 'https://api.github.com/users/pbelevich/followers', 'following_url': 'https://api.github.com/users/pbelevich/following{/other_user}', 'gists_url': 'https://api.github.com/users/pbelevich/gists{/gist_id}', 'starred_url': 'https://api.github.com/users/pbelevich/starred{/owner}{/repo}', 'subscriptions_url': 'https://api.github.com/users/pbelevich/subscriptions', 'organizations_url': 'https://api.github.com/users/pbelevich/orgs', 'repos_url': 'https://api.github.com/users/pbelevich/repos', 'events_url': 'https://api.github.com/users/pbelevich/events{/privacy}', 'received_events_url': 'https://api.github.com/users/pbelevich/received_events', 'type': 'User', 'site_admin': False}",referenced,d76d2976cfff2c2a079d65b633c33f76a547f687,https://api.github.com/repos/pytorch/pytorch/commits/d76d2976cfff2c2a079d65b633c33f76a547f687,2020-01-16T20:01:56Z,1,1,0
31472,2955885033,"{'login': 'pbelevich', 'id': 1160355, 'node_id': 'MDQ6VXNlcjExNjAzNTU=', 'avatar_url': 'https://avatars1.githubusercontent.com/u/1160355?v=4', 'gravatar_id': '', 'url': 'https://api.github.com/users/pbelevich', 'html_url': 'https://github.com/pbelevich', 'followers_url': 'https://api.github.com/users/pbelevich/followers', 'following_url': 'https://api.github.com/users/pbelevich/following{/other_user}', 'gists_url': 'https://api.github.com/users/pbelevich/gists{/gist_id}', 'starred_url': 'https://api.github.com/users/pbelevich/starred{/owner}{/repo}', 'subscriptions_url': 'https://api.github.com/users/pbelevich/subscriptions', 'organizations_url': 'https://api.github.com/users/pbelevich/orgs', 'repos_url': 'https://api.github.com/users/pbelevich/repos', 'events_url': 'https://api.github.com/users/pbelevich/events{/privacy}', 'received_events_url': 'https://api.github.com/users/pbelevich/received_events', 'type': 'User', 'site_admin': False}",referenced,88edf110e2615fa7b73708adafa3a9c56dac3708,https://api.github.com/repos/pytorch/pytorch/commits/88edf110e2615fa7b73708adafa3a9c56dac3708,2020-01-16T20:03:04Z,14,4,10
31472,2955915206,"{'login': 'pbelevich', 'id': 1160355, 'node_id': 'MDQ6VXNlcjExNjAzNTU=', 'avatar_url': 'https://avatars1.githubusercontent.com/u/1160355?v=4', 'gravatar_id': '', 'url': 'https://api.github.com/users/pbelevich', 'html_url': 'https://github.com/pbelevich', 'followers_url': 'https://api.github.com/users/pbelevich/followers', 'following_url': 'https://api.github.com/users/pbelevich/following{/other_user}', 'gists_url': 'https://api.github.com/users/pbelevich/gists{/gist_id}', 'starred_url': 'https://api.github.com/users/pbelevich/starred{/owner}{/repo}', 'subscriptions_url': 'https://api.github.com/users/pbelevich/subscriptions', 'organizations_url': 'https://api.github.com/users/pbelevich/orgs', 'repos_url': 'https://api.github.com/users/pbelevich/repos', 'events_url': 'https://api.github.com/users/pbelevich/events{/privacy}', 'received_events_url': 'https://api.github.com/users/pbelevich/received_events', 'type': 'User', 'site_admin': False}",referenced,3d063a5dec47b84c00744fcb24e49d782baabb11,https://api.github.com/repos/pytorch/pytorch/commits/3d063a5dec47b84c00744fcb24e49d782baabb11,2020-01-16T20:13:25Z,2,1,1
31472,2956389498,"{'login': 'pbelevich', 'id': 1160355, 'node_id': 'MDQ6VXNlcjExNjAzNTU=', 'avatar_url': 'https://avatars1.githubusercontent.com/u/1160355?v=4', 'gravatar_id': '', 'url': 'https://api.github.com/users/pbelevich', 'html_url': 'https://github.com/pbelevich', 'followers_url': 'https://api.github.com/users/pbelevich/followers', 'following_url': 'https://api.github.com/users/pbelevich/following{/other_user}', 'gists_url': 'https://api.github.com/users/pbelevich/gists{/gist_id}', 'starred_url': 'https://api.github.com/users/pbelevich/starred{/owner}{/repo}', 'subscriptions_url': 'https://api.github.com/users/pbelevich/subscriptions', 'organizations_url': 'https://api.github.com/users/pbelevich/orgs', 'repos_url': 'https://api.github.com/users/pbelevich/repos', 'events_url': 'https://api.github.com/users/pbelevich/events{/privacy}', 'received_events_url': 'https://api.github.com/users/pbelevich/received_events', 'type': 'User', 'site_admin': False}",referenced,1ecf1385d023acfad63c273a8376c845b37494d6,https://api.github.com/repos/pytorch/pytorch/commits/1ecf1385d023acfad63c273a8376c845b37494d6,2020-01-16T23:11:15Z,169,143,26
31472,2959323746,"{'login': 'pbelevich', 'id': 1160355, 'node_id': 'MDQ6VXNlcjExNjAzNTU=', 'avatar_url': 'https://avatars1.githubusercontent.com/u/1160355?v=4', 'gravatar_id': '', 'url': 'https://api.github.com/users/pbelevich', 'html_url': 'https://github.com/pbelevich', 'followers_url': 'https://api.github.com/users/pbelevich/followers', 'following_url': 'https://api.github.com/users/pbelevich/following{/other_user}', 'gists_url': 'https://api.github.com/users/pbelevich/gists{/gist_id}', 'starred_url': 'https://api.github.com/users/pbelevich/starred{/owner}{/repo}', 'subscriptions_url': 'https://api.github.com/users/pbelevich/subscriptions', 'organizations_url': 'https://api.github.com/users/pbelevich/orgs', 'repos_url': 'https://api.github.com/users/pbelevich/repos', 'events_url': 'https://api.github.com/users/pbelevich/events{/privacy}', 'received_events_url': 'https://api.github.com/users/pbelevich/received_events', 'type': 'User', 'site_admin': False}",referenced,1ba0924554a73c0fc912a5154a860eabde3c229d,https://api.github.com/repos/pytorch/pytorch/commits/1ba0924554a73c0fc912a5154a860eabde3c229d,2020-01-17T19:56:33Z,958,652,306
31472,2966988450,"{'login': 'pbelevich', 'id': 1160355, 'node_id': 'MDQ6VXNlcjExNjAzNTU=', 'avatar_url': 'https://avatars1.githubusercontent.com/u/1160355?v=4', 'gravatar_id': '', 'url': 'https://api.github.com/users/pbelevich', 'html_url': 'https://github.com/pbelevich', 'followers_url': 'https://api.github.com/users/pbelevich/followers', 'following_url': 'https://api.github.com/users/pbelevich/following{/other_user}', 'gists_url': 'https://api.github.com/users/pbelevich/gists{/gist_id}', 'starred_url': 'https://api.github.com/users/pbelevich/starred{/owner}{/repo}', 'subscriptions_url': 'https://api.github.com/users/pbelevich/subscriptions', 'organizations_url': 'https://api.github.com/users/pbelevich/orgs', 'repos_url': 'https://api.github.com/users/pbelevich/repos', 'events_url': 'https://api.github.com/users/pbelevich/events{/privacy}', 'received_events_url': 'https://api.github.com/users/pbelevich/received_events', 'type': 'User', 'site_admin': False}",referenced,0d0517f04c3943a867e6cf0aa824cd35f3d7ffa0,https://api.github.com/repos/pytorch/pytorch/commits/0d0517f04c3943a867e6cf0aa824cd35f3d7ffa0,2020-01-21T16:55:09Z,3156,2228,928
31472,2967145148,"{'login': 'pbelevich', 'id': 1160355, 'node_id': 'MDQ6VXNlcjExNjAzNTU=', 'avatar_url': 'https://avatars1.githubusercontent.com/u/1160355?v=4', 'gravatar_id': '', 'url': 'https://api.github.com/users/pbelevich', 'html_url': 'https://github.com/pbelevich', 'followers_url': 'https://api.github.com/users/pbelevich/followers', 'following_url': 'https://api.github.com/users/pbelevich/following{/other_user}', 'gists_url': 'https://api.github.com/users/pbelevich/gists{/gist_id}', 'starred_url': 'https://api.github.com/users/pbelevich/starred{/owner}{/repo}', 'subscriptions_url': 'https://api.github.com/users/pbelevich/subscriptions', 'organizations_url': 'https://api.github.com/users/pbelevich/orgs', 'repos_url': 'https://api.github.com/users/pbelevich/repos', 'events_url': 'https://api.github.com/users/pbelevich/events{/privacy}', 'received_events_url': 'https://api.github.com/users/pbelevich/received_events', 'type': 'User', 'site_admin': False}",referenced,093372d8f711794b9db5457055594201398e40f6,https://api.github.com/repos/pytorch/pytorch/commits/093372d8f711794b9db5457055594201398e40f6,2020-01-21T17:39:59Z,1,1,0
31459,2925125517,"{'login': 'facebook-github-bot', 'id': 6422482, 'node_id': 'MDQ6VXNlcjY0MjI0ODI=', 'avatar_url': 'https://avatars3.githubusercontent.com/u/6422482?v=4', 'gravatar_id': '', 'url': 'https://api.github.com/users/facebook-github-bot', 'html_url': 'https://github.com/facebook-github-bot', 'followers_url': 'https://api.github.com/users/facebook-github-bot/followers', 'following_url': 'https://api.github.com/users/facebook-github-bot/following{/other_user}', 'gists_url': 'https://api.github.com/users/facebook-github-bot/gists{/gist_id}', 'starred_url': 'https://api.github.com/users/facebook-github-bot/starred{/owner}{/repo}', 'subscriptions_url': 'https://api.github.com/users/facebook-github-bot/subscriptions', 'organizations_url': 'https://api.github.com/users/facebook-github-bot/orgs', 'repos_url': 'https://api.github.com/users/facebook-github-bot/repos', 'events_url': 'https://api.github.com/users/facebook-github-bot/events{/privacy}', 'received_events_url': 'https://api.github.com/users/facebook-github-bot/received_events', 'type': 'User', 'site_admin': False}",referenced,ddff014b79303e5239d5cb876ba97143cad6405a,https://api.github.com/repos/pytorch/pytorch/commits/ddff014b79303e5239d5cb876ba97143cad6405a,2020-01-06T18:27:48Z,12,11,1
31449,2898804999,"{'login': 'nairbv', 'id': 582713, 'node_id': 'MDQ6VXNlcjU4MjcxMw==', 'avatar_url': 'https://avatars1.githubusercontent.com/u/582713?v=4', 'gravatar_id': '', 'url': 'https://api.github.com/users/nairbv', 'html_url': 'https://github.com/nairbv', 'followers_url': 'https://api.github.com/users/nairbv/followers', 'following_url': 'https://api.github.com/users/nairbv/following{/other_user}', 'gists_url': 'https://api.github.com/users/nairbv/gists{/gist_id}', 'starred_url': 'https://api.github.com/users/nairbv/starred{/owner}{/repo}', 'subscriptions_url': 'https://api.github.com/users/nairbv/subscriptions', 'organizations_url': 'https://api.github.com/users/nairbv/orgs', 'repos_url': 'https://api.github.com/users/nairbv/repos', 'events_url': 'https://api.github.com/users/nairbv/events{/privacy}', 'received_events_url': 'https://api.github.com/users/nairbv/received_events', 'type': 'User', 'site_admin': False}",referenced,f202f559eb58240cecc9e91530aee76f724b3fa6,https://api.github.com/repos/pytorch/pytorch/commits/f202f559eb58240cecc9e91530aee76f724b3fa6,2019-12-19T21:43:43Z,450,337,113
31443,2895463739,"{'login': 'gchanan', 'id': 3768583, 'node_id': 'MDQ6VXNlcjM3Njg1ODM=', 'avatar_url': 'https://avatars2.githubusercontent.com/u/3768583?v=4', 'gravatar_id': '', 'url': 'https://api.github.com/users/gchanan', 'html_url': 'https://github.com/gchanan', 'followers_url': 'https://api.github.com/users/gchanan/followers', 'following_url': 'https://api.github.com/users/gchanan/following{/other_user}', 'gists_url': 'https://api.github.com/users/gchanan/gists{/gist_id}', 'starred_url': 'https://api.github.com/users/gchanan/starred{/owner}{/repo}', 'subscriptions_url': 'https://api.github.com/users/gchanan/subscriptions', 'organizations_url': 'https://api.github.com/users/gchanan/orgs', 'repos_url': 'https://api.github.com/users/gchanan/repos', 'events_url': 'https://api.github.com/users/gchanan/events{/privacy}', 'received_events_url': 'https://api.github.com/users/gchanan/received_events', 'type': 'User', 'site_admin': False}",referenced,e398b164d903db36efa24fe8f6478838816c1dd6,https://api.github.com/repos/pytorch/pytorch/commits/e398b164d903db36efa24fe8f6478838816c1dd6,2019-12-19T00:12:02Z,24,24,0
31443,2895463967,"{'login': 'gchanan', 'id': 3768583, 'node_id': 'MDQ6VXNlcjM3Njg1ODM=', 'avatar_url': 'https://avatars2.githubusercontent.com/u/3768583?v=4', 'gravatar_id': '', 'url': 'https://api.github.com/users/gchanan', 'html_url': 'https://github.com/gchanan', 'followers_url': 'https://api.github.com/users/gchanan/followers', 'following_url': 'https://api.github.com/users/gchanan/following{/other_user}', 'gists_url': 'https://api.github.com/users/gchanan/gists{/gist_id}', 'starred_url': 'https://api.github.com/users/gchanan/starred{/owner}{/repo}', 'subscriptions_url': 'https://api.github.com/users/gchanan/subscriptions', 'organizations_url': 'https://api.github.com/users/gchanan/orgs', 'repos_url': 'https://api.github.com/users/gchanan/repos', 'events_url': 'https://api.github.com/users/gchanan/events{/privacy}', 'received_events_url': 'https://api.github.com/users/gchanan/received_events', 'type': 'User', 'site_admin': False}",referenced,e88787f48deffbb741887dbdce51d7e3184f0a7e,https://api.github.com/repos/pytorch/pytorch/commits/e88787f48deffbb741887dbdce51d7e3184f0a7e,2019-12-19T00:12:13Z,24,24,0
31443,2901102054,"{'login': 'gchanan', 'id': 3768583, 'node_id': 'MDQ6VXNlcjM3Njg1ODM=', 'avatar_url': 'https://avatars2.githubusercontent.com/u/3768583?v=4', 'gravatar_id': '', 'url': 'https://api.github.com/users/gchanan', 'html_url': 'https://github.com/gchanan', 'followers_url': 'https://api.github.com/users/gchanan/followers', 'following_url': 'https://api.github.com/users/gchanan/following{/other_user}', 'gists_url': 'https://api.github.com/users/gchanan/gists{/gist_id}', 'starred_url': 'https://api.github.com/users/gchanan/starred{/owner}{/repo}', 'subscriptions_url': 'https://api.github.com/users/gchanan/subscriptions', 'organizations_url': 'https://api.github.com/users/gchanan/orgs', 'repos_url': 'https://api.github.com/users/gchanan/repos', 'events_url': 'https://api.github.com/users/gchanan/events{/privacy}', 'received_events_url': 'https://api.github.com/users/gchanan/received_events', 'type': 'User', 'site_admin': False}",referenced,92b8f5ec6afbf458b9fe86ad939dafb0e8ef25b6,https://api.github.com/repos/pytorch/pytorch/commits/92b8f5ec6afbf458b9fe86ad939dafb0e8ef25b6,2019-12-20T15:32:38Z,2,1,1
31443,2901102438,"{'login': 'gchanan', 'id': 3768583, 'node_id': 'MDQ6VXNlcjM3Njg1ODM=', 'avatar_url': 'https://avatars2.githubusercontent.com/u/3768583?v=4', 'gravatar_id': '', 'url': 'https://api.github.com/users/gchanan', 'html_url': 'https://github.com/gchanan', 'followers_url': 'https://api.github.com/users/gchanan/followers', 'following_url': 'https://api.github.com/users/gchanan/following{/other_user}', 'gists_url': 'https://api.github.com/users/gchanan/gists{/gist_id}', 'starred_url': 'https://api.github.com/users/gchanan/starred{/owner}{/repo}', 'subscriptions_url': 'https://api.github.com/users/gchanan/subscriptions', 'organizations_url': 'https://api.github.com/users/gchanan/orgs', 'repos_url': 'https://api.github.com/users/gchanan/repos', 'events_url': 'https://api.github.com/users/gchanan/events{/privacy}', 'received_events_url': 'https://api.github.com/users/gchanan/received_events', 'type': 'User', 'site_admin': False}",referenced,7170481dedc6ec08ee2b002ec2aed2cc2ee84158,https://api.github.com/repos/pytorch/pytorch/commits/7170481dedc6ec08ee2b002ec2aed2cc2ee84158,2019-12-20T15:32:45Z,24,24,0
31443,2901249451,"{'login': 'facebook-github-bot', 'id': 6422482, 'node_id': 'MDQ6VXNlcjY0MjI0ODI=', 'avatar_url': 'https://avatars3.githubusercontent.com/u/6422482?v=4', 'gravatar_id': '', 'url': 'https://api.github.com/users/facebook-github-bot', 'html_url': 'https://github.com/facebook-github-bot', 'followers_url': 'https://api.github.com/users/facebook-github-bot/followers', 'following_url': 'https://api.github.com/users/facebook-github-bot/following{/other_user}', 'gists_url': 'https://api.github.com/users/facebook-github-bot/gists{/gist_id}', 'starred_url': 'https://api.github.com/users/facebook-github-bot/starred{/owner}{/repo}', 'subscriptions_url': 'https://api.github.com/users/facebook-github-bot/subscriptions', 'organizations_url': 'https://api.github.com/users/facebook-github-bot/orgs', 'repos_url': 'https://api.github.com/users/facebook-github-bot/repos', 'events_url': 'https://api.github.com/users/facebook-github-bot/events{/privacy}', 'received_events_url': 'https://api.github.com/users/facebook-github-bot/received_events', 'type': 'User', 'site_admin': False}",closed,b38901aa15aa8561140098f626dd755f94f4f456,https://api.github.com/repos/pytorch/pytorch/commits/b38901aa15aa8561140098f626dd755f94f4f456,2019-12-20T16:21:53Z,24,24,0
31427,2948007345,"{'login': 'facebook-github-bot', 'id': 6422482, 'node_id': 'MDQ6VXNlcjY0MjI0ODI=', 'avatar_url': 'https://avatars3.githubusercontent.com/u/6422482?v=4', 'gravatar_id': '', 'url': 'https://api.github.com/users/facebook-github-bot', 'html_url': 'https://github.com/facebook-github-bot', 'followers_url': 'https://api.github.com/users/facebook-github-bot/followers', 'following_url': 'https://api.github.com/users/facebook-github-bot/following{/other_user}', 'gists_url': 'https://api.github.com/users/facebook-github-bot/gists{/gist_id}', 'starred_url': 'https://api.github.com/users/facebook-github-bot/starred{/owner}{/repo}', 'subscriptions_url': 'https://api.github.com/users/facebook-github-bot/subscriptions', 'organizations_url': 'https://api.github.com/users/facebook-github-bot/orgs', 'repos_url': 'https://api.github.com/users/facebook-github-bot/repos', 'events_url': 'https://api.github.com/users/facebook-github-bot/events{/privacy}', 'received_events_url': 'https://api.github.com/users/facebook-github-bot/received_events', 'type': 'User', 'site_admin': False}",closed,1487582ba7f046e496554d40301e31b4ebc22422,https://api.github.com/repos/pytorch/pytorch/commits/1487582ba7f046e496554d40301e31b4ebc22422,2020-01-14T17:40:11Z,300,151,149
31419,2901918443,"{'login': 'IvanKobzarev', 'id': 6638825, 'node_id': 'MDQ6VXNlcjY2Mzg4MjU=', 'avatar_url': 'https://avatars3.githubusercontent.com/u/6638825?v=4', 'gravatar_id': '', 'url': 'https://api.github.com/users/IvanKobzarev', 'html_url': 'https://github.com/IvanKobzarev', 'followers_url': 'https://api.github.com/users/IvanKobzarev/followers', 'following_url': 'https://api.github.com/users/IvanKobzarev/following{/other_user}', 'gists_url': 'https://api.github.com/users/IvanKobzarev/gists{/gist_id}', 'starred_url': 'https://api.github.com/users/IvanKobzarev/starred{/owner}{/repo}', 'subscriptions_url': 'https://api.github.com/users/IvanKobzarev/subscriptions', 'organizations_url': 'https://api.github.com/users/IvanKobzarev/orgs', 'repos_url': 'https://api.github.com/users/IvanKobzarev/repos', 'events_url': 'https://api.github.com/users/IvanKobzarev/events{/privacy}', 'received_events_url': 'https://api.github.com/users/IvanKobzarev/received_events', 'type': 'User', 'site_admin': False}",referenced,23248f6b924fc9231bc886e09f67d4542f7a5243,https://api.github.com/repos/pytorch/pytorch/commits/23248f6b924fc9231bc886e09f67d4542f7a5243,2019-12-20T20:10:39Z,68,34,34
31419,2901934917,"{'login': 'IvanKobzarev', 'id': 6638825, 'node_id': 'MDQ6VXNlcjY2Mzg4MjU=', 'avatar_url': 'https://avatars3.githubusercontent.com/u/6638825?v=4', 'gravatar_id': '', 'url': 'https://api.github.com/users/IvanKobzarev', 'html_url': 'https://github.com/IvanKobzarev', 'followers_url': 'https://api.github.com/users/IvanKobzarev/followers', 'following_url': 'https://api.github.com/users/IvanKobzarev/following{/other_user}', 'gists_url': 'https://api.github.com/users/IvanKobzarev/gists{/gist_id}', 'starred_url': 'https://api.github.com/users/IvanKobzarev/starred{/owner}{/repo}', 'subscriptions_url': 'https://api.github.com/users/IvanKobzarev/subscriptions', 'organizations_url': 'https://api.github.com/users/IvanKobzarev/orgs', 'repos_url': 'https://api.github.com/users/IvanKobzarev/repos', 'events_url': 'https://api.github.com/users/IvanKobzarev/events{/privacy}', 'received_events_url': 'https://api.github.com/users/IvanKobzarev/received_events', 'type': 'User', 'site_admin': False}",referenced,468d570b2e048ccf98feb4a2e9a72d48f3cce792,https://api.github.com/repos/pytorch/pytorch/commits/468d570b2e048ccf98feb4a2e9a72d48f3cce792,2019-12-20T20:17:19Z,1,0,1
31419,2901973446,"{'login': 'IvanKobzarev', 'id': 6638825, 'node_id': 'MDQ6VXNlcjY2Mzg4MjU=', 'avatar_url': 'https://avatars3.githubusercontent.com/u/6638825?v=4', 'gravatar_id': '', 'url': 'https://api.github.com/users/IvanKobzarev', 'html_url': 'https://github.com/IvanKobzarev', 'followers_url': 'https://api.github.com/users/IvanKobzarev/followers', 'following_url': 'https://api.github.com/users/IvanKobzarev/following{/other_user}', 'gists_url': 'https://api.github.com/users/IvanKobzarev/gists{/gist_id}', 'starred_url': 'https://api.github.com/users/IvanKobzarev/starred{/owner}{/repo}', 'subscriptions_url': 'https://api.github.com/users/IvanKobzarev/subscriptions', 'organizations_url': 'https://api.github.com/users/IvanKobzarev/orgs', 'repos_url': 'https://api.github.com/users/IvanKobzarev/repos', 'events_url': 'https://api.github.com/users/IvanKobzarev/events{/privacy}', 'received_events_url': 'https://api.github.com/users/IvanKobzarev/received_events', 'type': 'User', 'site_admin': False}",referenced,7c660e204eeac2ff556a2d9aff9b7d49cdc4b337,https://api.github.com/repos/pytorch/pytorch/commits/7c660e204eeac2ff556a2d9aff9b7d49cdc4b337,2019-12-20T20:34:41Z,2,0,2
31385,2898554457,"{'login': 'facebook-github-bot', 'id': 6422482, 'node_id': 'MDQ6VXNlcjY0MjI0ODI=', 'avatar_url': 'https://avatars3.githubusercontent.com/u/6422482?v=4', 'gravatar_id': '', 'url': 'https://api.github.com/users/facebook-github-bot', 'html_url': 'https://github.com/facebook-github-bot', 'followers_url': 'https://api.github.com/users/facebook-github-bot/followers', 'following_url': 'https://api.github.com/users/facebook-github-bot/following{/other_user}', 'gists_url': 'https://api.github.com/users/facebook-github-bot/gists{/gist_id}', 'starred_url': 'https://api.github.com/users/facebook-github-bot/starred{/owner}{/repo}', 'subscriptions_url': 'https://api.github.com/users/facebook-github-bot/subscriptions', 'organizations_url': 'https://api.github.com/users/facebook-github-bot/orgs', 'repos_url': 'https://api.github.com/users/facebook-github-bot/repos', 'events_url': 'https://api.github.com/users/facebook-github-bot/events{/privacy}', 'received_events_url': 'https://api.github.com/users/facebook-github-bot/received_events', 'type': 'User', 'site_admin': False}",referenced,49fe7a74014cd2aa803df14d547d0899c5582051,https://api.github.com/repos/pytorch/pytorch/commits/49fe7a74014cd2aa803df14d547d0899c5582051,2019-12-19T20:28:34Z,3,2,1
31295,2898554462,"{'login': 'facebook-github-bot', 'id': 6422482, 'node_id': 'MDQ6VXNlcjY0MjI0ODI=', 'avatar_url': 'https://avatars3.githubusercontent.com/u/6422482?v=4', 'gravatar_id': '', 'url': 'https://api.github.com/users/facebook-github-bot', 'html_url': 'https://github.com/facebook-github-bot', 'followers_url': 'https://api.github.com/users/facebook-github-bot/followers', 'following_url': 'https://api.github.com/users/facebook-github-bot/following{/other_user}', 'gists_url': 'https://api.github.com/users/facebook-github-bot/gists{/gist_id}', 'starred_url': 'https://api.github.com/users/facebook-github-bot/starred{/owner}{/repo}', 'subscriptions_url': 'https://api.github.com/users/facebook-github-bot/subscriptions', 'organizations_url': 'https://api.github.com/users/facebook-github-bot/orgs', 'repos_url': 'https://api.github.com/users/facebook-github-bot/repos', 'events_url': 'https://api.github.com/users/facebook-github-bot/events{/privacy}', 'received_events_url': 'https://api.github.com/users/facebook-github-bot/received_events', 'type': 'User', 'site_admin': False}",referenced,49fe7a74014cd2aa803df14d547d0899c5582051,https://api.github.com/repos/pytorch/pytorch/commits/49fe7a74014cd2aa803df14d547d0899c5582051,2019-12-19T20:28:34Z,3,2,1
31287,2952099647,"{'login': 'facebook-github-bot', 'id': 6422482, 'node_id': 'MDQ6VXNlcjY0MjI0ODI=', 'avatar_url': 'https://avatars3.githubusercontent.com/u/6422482?v=4', 'gravatar_id': '', 'url': 'https://api.github.com/users/facebook-github-bot', 'html_url': 'https://github.com/facebook-github-bot', 'followers_url': 'https://api.github.com/users/facebook-github-bot/followers', 'following_url': 'https://api.github.com/users/facebook-github-bot/following{/other_user}', 'gists_url': 'https://api.github.com/users/facebook-github-bot/gists{/gist_id}', 'starred_url': 'https://api.github.com/users/facebook-github-bot/starred{/owner}{/repo}', 'subscriptions_url': 'https://api.github.com/users/facebook-github-bot/subscriptions', 'organizations_url': 'https://api.github.com/users/facebook-github-bot/orgs', 'repos_url': 'https://api.github.com/users/facebook-github-bot/repos', 'events_url': 'https://api.github.com/users/facebook-github-bot/events{/privacy}', 'received_events_url': 'https://api.github.com/users/facebook-github-bot/received_events', 'type': 'User', 'site_admin': False}",closed,0392e8384bfbaaa2ad9f594fa7d95b8a06b5c146,https://api.github.com/repos/pytorch/pytorch/commits/0392e8384bfbaaa2ad9f594fa7d95b8a06b5c146,2020-01-15T19:48:40Z,4,2,2
31271,2884250115,"{'login': 'facebook-github-bot', 'id': 6422482, 'node_id': 'MDQ6VXNlcjY0MjI0ODI=', 'avatar_url': 'https://avatars3.githubusercontent.com/u/6422482?v=4', 'gravatar_id': '', 'url': 'https://api.github.com/users/facebook-github-bot', 'html_url': 'https://github.com/facebook-github-bot', 'followers_url': 'https://api.github.com/users/facebook-github-bot/followers', 'following_url': 'https://api.github.com/users/facebook-github-bot/following{/other_user}', 'gists_url': 'https://api.github.com/users/facebook-github-bot/gists{/gist_id}', 'starred_url': 'https://api.github.com/users/facebook-github-bot/starred{/owner}{/repo}', 'subscriptions_url': 'https://api.github.com/users/facebook-github-bot/subscriptions', 'organizations_url': 'https://api.github.com/users/facebook-github-bot/orgs', 'repos_url': 'https://api.github.com/users/facebook-github-bot/repos', 'events_url': 'https://api.github.com/users/facebook-github-bot/events{/privacy}', 'received_events_url': 'https://api.github.com/users/facebook-github-bot/received_events', 'type': 'User', 'site_admin': False}",closed,60ec53c7fda003fb6874dca7373c6c414e27f88c,https://api.github.com/repos/pytorch/pytorch/commits/60ec53c7fda003fb6874dca7373c6c414e27f88c,2019-12-15T22:01:46Z,17,16,1
31271,2899137475,"{'login': 'mingbowan', 'id': 2181364, 'node_id': 'MDQ6VXNlcjIxODEzNjQ=', 'avatar_url': 'https://avatars2.githubusercontent.com/u/2181364?v=4', 'gravatar_id': '', 'url': 'https://api.github.com/users/mingbowan', 'html_url': 'https://github.com/mingbowan', 'followers_url': 'https://api.github.com/users/mingbowan/followers', 'following_url': 'https://api.github.com/users/mingbowan/following{/other_user}', 'gists_url': 'https://api.github.com/users/mingbowan/gists{/gist_id}', 'starred_url': 'https://api.github.com/users/mingbowan/starred{/owner}{/repo}', 'subscriptions_url': 'https://api.github.com/users/mingbowan/subscriptions', 'organizations_url': 'https://api.github.com/users/mingbowan/orgs', 'repos_url': 'https://api.github.com/users/mingbowan/repos', 'events_url': 'https://api.github.com/users/mingbowan/events{/privacy}', 'received_events_url': 'https://api.github.com/users/mingbowan/received_events', 'type': 'User', 'site_admin': False}",referenced,369ab73efd023987b13a81b56928e9c4d4c99a43,https://api.github.com/repos/pytorch/pytorch/commits/369ab73efd023987b13a81b56928e9c4d4c99a43,2019-12-20T00:09:14Z,17,16,1
31268,2933490301,"{'login': 'jerryzh168', 'id': 4958441, 'node_id': 'MDQ6VXNlcjQ5NTg0NDE=', 'avatar_url': 'https://avatars0.githubusercontent.com/u/4958441?v=4', 'gravatar_id': '', 'url': 'https://api.github.com/users/jerryzh168', 'html_url': 'https://github.com/jerryzh168', 'followers_url': 'https://api.github.com/users/jerryzh168/followers', 'following_url': 'https://api.github.com/users/jerryzh168/following{/other_user}', 'gists_url': 'https://api.github.com/users/jerryzh168/gists{/gist_id}', 'starred_url': 'https://api.github.com/users/jerryzh168/starred{/owner}{/repo}', 'subscriptions_url': 'https://api.github.com/users/jerryzh168/subscriptions', 'organizations_url': 'https://api.github.com/users/jerryzh168/orgs', 'repos_url': 'https://api.github.com/users/jerryzh168/repos', 'events_url': 'https://api.github.com/users/jerryzh168/events{/privacy}', 'received_events_url': 'https://api.github.com/users/jerryzh168/received_events', 'type': 'User', 'site_admin': False}",referenced,56e8144d8e3badb1b9b390b6fddceb1bb20efa6b,https://api.github.com/repos/pytorch/pytorch/commits/56e8144d8e3badb1b9b390b6fddceb1bb20efa6b,2020-01-09T03:44:37Z,19,13,6
31268,2933490458,"{'login': 'jerryzh168', 'id': 4958441, 'node_id': 'MDQ6VXNlcjQ5NTg0NDE=', 'avatar_url': 'https://avatars0.githubusercontent.com/u/4958441?v=4', 'gravatar_id': '', 'url': 'https://api.github.com/users/jerryzh168', 'html_url': 'https://github.com/jerryzh168', 'followers_url': 'https://api.github.com/users/jerryzh168/followers', 'following_url': 'https://api.github.com/users/jerryzh168/following{/other_user}', 'gists_url': 'https://api.github.com/users/jerryzh168/gists{/gist_id}', 'starred_url': 'https://api.github.com/users/jerryzh168/starred{/owner}{/repo}', 'subscriptions_url': 'https://api.github.com/users/jerryzh168/subscriptions', 'organizations_url': 'https://api.github.com/users/jerryzh168/orgs', 'repos_url': 'https://api.github.com/users/jerryzh168/repos', 'events_url': 'https://api.github.com/users/jerryzh168/events{/privacy}', 'received_events_url': 'https://api.github.com/users/jerryzh168/received_events', 'type': 'User', 'site_admin': False}",referenced,4c905a27abe83dd74ffd587bcda6e11732a2871e,https://api.github.com/repos/pytorch/pytorch/commits/4c905a27abe83dd74ffd587bcda6e11732a2871e,2020-01-09T03:44:45Z,19,13,6
31268,2936679740,"{'login': 'jerryzh168', 'id': 4958441, 'node_id': 'MDQ6VXNlcjQ5NTg0NDE=', 'avatar_url': 'https://avatars0.githubusercontent.com/u/4958441?v=4', 'gravatar_id': '', 'url': 'https://api.github.com/users/jerryzh168', 'html_url': 'https://github.com/jerryzh168', 'followers_url': 'https://api.github.com/users/jerryzh168/followers', 'following_url': 'https://api.github.com/users/jerryzh168/following{/other_user}', 'gists_url': 'https://api.github.com/users/jerryzh168/gists{/gist_id}', 'starred_url': 'https://api.github.com/users/jerryzh168/starred{/owner}{/repo}', 'subscriptions_url': 'https://api.github.com/users/jerryzh168/subscriptions', 'organizations_url': 'https://api.github.com/users/jerryzh168/orgs', 'repos_url': 'https://api.github.com/users/jerryzh168/repos', 'events_url': 'https://api.github.com/users/jerryzh168/events{/privacy}', 'received_events_url': 'https://api.github.com/users/jerryzh168/received_events', 'type': 'User', 'site_admin': False}",referenced,3feb7ac0c5ab22fd62b07200f888234118651b1c,https://api.github.com/repos/pytorch/pytorch/commits/3feb7ac0c5ab22fd62b07200f888234118651b1c,2020-01-09T22:28:00Z,3451,1211,2240
31268,2936679888,"{'login': 'jerryzh168', 'id': 4958441, 'node_id': 'MDQ6VXNlcjQ5NTg0NDE=', 'avatar_url': 'https://avatars0.githubusercontent.com/u/4958441?v=4', 'gravatar_id': '', 'url': 'https://api.github.com/users/jerryzh168', 'html_url': 'https://github.com/jerryzh168', 'followers_url': 'https://api.github.com/users/jerryzh168/followers', 'following_url': 'https://api.github.com/users/jerryzh168/following{/other_user}', 'gists_url': 'https://api.github.com/users/jerryzh168/gists{/gist_id}', 'starred_url': 'https://api.github.com/users/jerryzh168/starred{/owner}{/repo}', 'subscriptions_url': 'https://api.github.com/users/jerryzh168/subscriptions', 'organizations_url': 'https://api.github.com/users/jerryzh168/orgs', 'repos_url': 'https://api.github.com/users/jerryzh168/repos', 'events_url': 'https://api.github.com/users/jerryzh168/events{/privacy}', 'received_events_url': 'https://api.github.com/users/jerryzh168/received_events', 'type': 'User', 'site_admin': False}",referenced,2aedd7461057a8956c4ccbc61311f66a7cbe62e4,https://api.github.com/repos/pytorch/pytorch/commits/2aedd7461057a8956c4ccbc61311f66a7cbe62e4,2020-01-09T22:28:04Z,36,30,6
31268,2936876525,"{'login': 'jerryzh168', 'id': 4958441, 'node_id': 'MDQ6VXNlcjQ5NTg0NDE=', 'avatar_url': 'https://avatars0.githubusercontent.com/u/4958441?v=4', 'gravatar_id': '', 'url': 'https://api.github.com/users/jerryzh168', 'html_url': 'https://github.com/jerryzh168', 'followers_url': 'https://api.github.com/users/jerryzh168/followers', 'following_url': 'https://api.github.com/users/jerryzh168/following{/other_user}', 'gists_url': 'https://api.github.com/users/jerryzh168/gists{/gist_id}', 'starred_url': 'https://api.github.com/users/jerryzh168/starred{/owner}{/repo}', 'subscriptions_url': 'https://api.github.com/users/jerryzh168/subscriptions', 'organizations_url': 'https://api.github.com/users/jerryzh168/orgs', 'repos_url': 'https://api.github.com/users/jerryzh168/repos', 'events_url': 'https://api.github.com/users/jerryzh168/events{/privacy}', 'received_events_url': 'https://api.github.com/users/jerryzh168/received_events', 'type': 'User', 'site_admin': False}",referenced,daa826e1ebea229d445c3f3407a0d8ecb21bd774,https://api.github.com/repos/pytorch/pytorch/commits/daa826e1ebea229d445c3f3407a0d8ecb21bd774,2020-01-10T00:05:48Z,1,1,0
31268,2936876683,"{'login': 'jerryzh168', 'id': 4958441, 'node_id': 'MDQ6VXNlcjQ5NTg0NDE=', 'avatar_url': 'https://avatars0.githubusercontent.com/u/4958441?v=4', 'gravatar_id': '', 'url': 'https://api.github.com/users/jerryzh168', 'html_url': 'https://github.com/jerryzh168', 'followers_url': 'https://api.github.com/users/jerryzh168/followers', 'following_url': 'https://api.github.com/users/jerryzh168/following{/other_user}', 'gists_url': 'https://api.github.com/users/jerryzh168/gists{/gist_id}', 'starred_url': 'https://api.github.com/users/jerryzh168/starred{/owner}{/repo}', 'subscriptions_url': 'https://api.github.com/users/jerryzh168/subscriptions', 'organizations_url': 'https://api.github.com/users/jerryzh168/orgs', 'repos_url': 'https://api.github.com/users/jerryzh168/repos', 'events_url': 'https://api.github.com/users/jerryzh168/events{/privacy}', 'received_events_url': 'https://api.github.com/users/jerryzh168/received_events', 'type': 'User', 'site_admin': False}",referenced,17eaa6bc02f2327205a00ed04bb6c2add1d95939,https://api.github.com/repos/pytorch/pytorch/commits/17eaa6bc02f2327205a00ed04bb6c2add1d95939,2020-01-10T00:05:53Z,37,31,6
31268,2940128610,"{'login': 'jerryzh168', 'id': 4958441, 'node_id': 'MDQ6VXNlcjQ5NTg0NDE=', 'avatar_url': 'https://avatars0.githubusercontent.com/u/4958441?v=4', 'gravatar_id': '', 'url': 'https://api.github.com/users/jerryzh168', 'html_url': 'https://github.com/jerryzh168', 'followers_url': 'https://api.github.com/users/jerryzh168/followers', 'following_url': 'https://api.github.com/users/jerryzh168/following{/other_user}', 'gists_url': 'https://api.github.com/users/jerryzh168/gists{/gist_id}', 'starred_url': 'https://api.github.com/users/jerryzh168/starred{/owner}{/repo}', 'subscriptions_url': 'https://api.github.com/users/jerryzh168/subscriptions', 'organizations_url': 'https://api.github.com/users/jerryzh168/orgs', 'repos_url': 'https://api.github.com/users/jerryzh168/repos', 'events_url': 'https://api.github.com/users/jerryzh168/events{/privacy}', 'received_events_url': 'https://api.github.com/users/jerryzh168/received_events', 'type': 'User', 'site_admin': False}",referenced,13a4d149abc267ae23e77868645900182c555497,https://api.github.com/repos/pytorch/pytorch/commits/13a4d149abc267ae23e77868645900182c555497,2020-01-10T23:07:50Z,1449,1432,17
31268,2940128783,"{'login': 'jerryzh168', 'id': 4958441, 'node_id': 'MDQ6VXNlcjQ5NTg0NDE=', 'avatar_url': 'https://avatars0.githubusercontent.com/u/4958441?v=4', 'gravatar_id': '', 'url': 'https://api.github.com/users/jerryzh168', 'html_url': 'https://github.com/jerryzh168', 'followers_url': 'https://api.github.com/users/jerryzh168/followers', 'following_url': 'https://api.github.com/users/jerryzh168/following{/other_user}', 'gists_url': 'https://api.github.com/users/jerryzh168/gists{/gist_id}', 'starred_url': 'https://api.github.com/users/jerryzh168/starred{/owner}{/repo}', 'subscriptions_url': 'https://api.github.com/users/jerryzh168/subscriptions', 'organizations_url': 'https://api.github.com/users/jerryzh168/orgs', 'repos_url': 'https://api.github.com/users/jerryzh168/repos', 'events_url': 'https://api.github.com/users/jerryzh168/events{/privacy}', 'received_events_url': 'https://api.github.com/users/jerryzh168/received_events', 'type': 'User', 'site_admin': False}",referenced,db223f399047ae1371498b863a0603f6f800471d,https://api.github.com/repos/pytorch/pytorch/commits/db223f399047ae1371498b863a0603f6f800471d,2020-01-10T23:07:55Z,37,31,6
31268,2944417808,"{'login': 'facebook-github-bot', 'id': 6422482, 'node_id': 'MDQ6VXNlcjY0MjI0ODI=', 'avatar_url': 'https://avatars3.githubusercontent.com/u/6422482?v=4', 'gravatar_id': '', 'url': 'https://api.github.com/users/facebook-github-bot', 'html_url': 'https://github.com/facebook-github-bot', 'followers_url': 'https://api.github.com/users/facebook-github-bot/followers', 'following_url': 'https://api.github.com/users/facebook-github-bot/following{/other_user}', 'gists_url': 'https://api.github.com/users/facebook-github-bot/gists{/gist_id}', 'starred_url': 'https://api.github.com/users/facebook-github-bot/starred{/owner}{/repo}', 'subscriptions_url': 'https://api.github.com/users/facebook-github-bot/subscriptions', 'organizations_url': 'https://api.github.com/users/facebook-github-bot/orgs', 'repos_url': 'https://api.github.com/users/facebook-github-bot/repos', 'events_url': 'https://api.github.com/users/facebook-github-bot/events{/privacy}', 'received_events_url': 'https://api.github.com/users/facebook-github-bot/received_events', 'type': 'User', 'site_admin': False}",closed,1f34801460661201782cebc61deff2b38c5ab32e,https://api.github.com/repos/pytorch/pytorch/commits/1f34801460661201782cebc61deff2b38c5ab32e,2020-01-13T19:12:04Z,37,31,6
31213,2894318713,"{'login': 'facebook-github-bot', 'id': 6422482, 'node_id': 'MDQ6VXNlcjY0MjI0ODI=', 'avatar_url': 'https://avatars3.githubusercontent.com/u/6422482?v=4', 'gravatar_id': '', 'url': 'https://api.github.com/users/facebook-github-bot', 'html_url': 'https://github.com/facebook-github-bot', 'followers_url': 'https://api.github.com/users/facebook-github-bot/followers', 'following_url': 'https://api.github.com/users/facebook-github-bot/following{/other_user}', 'gists_url': 'https://api.github.com/users/facebook-github-bot/gists{/gist_id}', 'starred_url': 'https://api.github.com/users/facebook-github-bot/starred{/owner}{/repo}', 'subscriptions_url': 'https://api.github.com/users/facebook-github-bot/subscriptions', 'organizations_url': 'https://api.github.com/users/facebook-github-bot/orgs', 'repos_url': 'https://api.github.com/users/facebook-github-bot/repos', 'events_url': 'https://api.github.com/users/facebook-github-bot/events{/privacy}', 'received_events_url': 'https://api.github.com/users/facebook-github-bot/received_events', 'type': 'User', 'site_admin': False}",referenced,58d2dd5b734e5d4dbf7ea423c7858d9d13f7a32f,https://api.github.com/repos/pytorch/pytorch/commits/58d2dd5b734e5d4dbf7ea423c7858d9d13f7a32f,2019-12-18T17:01:46Z,8,6,2
31198,2883805214,"{'login': 'facebook-github-bot', 'id': 6422482, 'node_id': 'MDQ6VXNlcjY0MjI0ODI=', 'avatar_url': 'https://avatars3.githubusercontent.com/u/6422482?v=4', 'gravatar_id': '', 'url': 'https://api.github.com/users/facebook-github-bot', 'html_url': 'https://github.com/facebook-github-bot', 'followers_url': 'https://api.github.com/users/facebook-github-bot/followers', 'following_url': 'https://api.github.com/users/facebook-github-bot/following{/other_user}', 'gists_url': 'https://api.github.com/users/facebook-github-bot/gists{/gist_id}', 'starred_url': 'https://api.github.com/users/facebook-github-bot/starred{/owner}{/repo}', 'subscriptions_url': 'https://api.github.com/users/facebook-github-bot/subscriptions', 'organizations_url': 'https://api.github.com/users/facebook-github-bot/orgs', 'repos_url': 'https://api.github.com/users/facebook-github-bot/repos', 'events_url': 'https://api.github.com/users/facebook-github-bot/events{/privacy}', 'received_events_url': 'https://api.github.com/users/facebook-github-bot/received_events', 'type': 'User', 'site_admin': False}",closed,ec92711aac5537bb509535c74bf59ccbf4d72db2,https://api.github.com/repos/pytorch/pytorch/commits/ec92711aac5537bb509535c74bf59ccbf4d72db2,2019-12-15T06:51:15Z,12,11,1
31181,2970754800,"{'login': 'facebook-github-bot', 'id': 6422482, 'node_id': 'MDQ6VXNlcjY0MjI0ODI=', 'avatar_url': 'https://avatars3.githubusercontent.com/u/6422482?v=4', 'gravatar_id': '', 'url': 'https://api.github.com/users/facebook-github-bot', 'html_url': 'https://github.com/facebook-github-bot', 'followers_url': 'https://api.github.com/users/facebook-github-bot/followers', 'following_url': 'https://api.github.com/users/facebook-github-bot/following{/other_user}', 'gists_url': 'https://api.github.com/users/facebook-github-bot/gists{/gist_id}', 'starred_url': 'https://api.github.com/users/facebook-github-bot/starred{/owner}{/repo}', 'subscriptions_url': 'https://api.github.com/users/facebook-github-bot/subscriptions', 'organizations_url': 'https://api.github.com/users/facebook-github-bot/orgs', 'repos_url': 'https://api.github.com/users/facebook-github-bot/repos', 'events_url': 'https://api.github.com/users/facebook-github-bot/events{/privacy}', 'received_events_url': 'https://api.github.com/users/facebook-github-bot/received_events', 'type': 'User', 'site_admin': False}",closed,b77c25dec056bf08b857f66b42ec6d2b21e547ff,https://api.github.com/repos/pytorch/pytorch/commits/b77c25dec056bf08b857f66b42ec6d2b21e547ff,2020-01-22T16:35:48Z,92,65,27
31132,2953081024,"{'login': 'facebook-github-bot', 'id': 6422482, 'node_id': 'MDQ6VXNlcjY0MjI0ODI=', 'avatar_url': 'https://avatars3.githubusercontent.com/u/6422482?v=4', 'gravatar_id': '', 'url': 'https://api.github.com/users/facebook-github-bot', 'html_url': 'https://github.com/facebook-github-bot', 'followers_url': 'https://api.github.com/users/facebook-github-bot/followers', 'following_url': 'https://api.github.com/users/facebook-github-bot/following{/other_user}', 'gists_url': 'https://api.github.com/users/facebook-github-bot/gists{/gist_id}', 'starred_url': 'https://api.github.com/users/facebook-github-bot/starred{/owner}{/repo}', 'subscriptions_url': 'https://api.github.com/users/facebook-github-bot/subscriptions', 'organizations_url': 'https://api.github.com/users/facebook-github-bot/orgs', 'repos_url': 'https://api.github.com/users/facebook-github-bot/repos', 'events_url': 'https://api.github.com/users/facebook-github-bot/events{/privacy}', 'received_events_url': 'https://api.github.com/users/facebook-github-bot/received_events', 'type': 'User', 'site_admin': False}",closed,851a7e861be120c74787ef533ebf7a20e1e0b2c2,https://api.github.com/repos/pytorch/pytorch/commits/851a7e861be120c74787ef533ebf7a20e1e0b2c2,2020-01-16T03:40:15Z,4,2,2
31103,2921184353,"{'login': 'facebook-github-bot', 'id': 6422482, 'node_id': 'MDQ6VXNlcjY0MjI0ODI=', 'avatar_url': 'https://avatars3.githubusercontent.com/u/6422482?v=4', 'gravatar_id': '', 'url': 'https://api.github.com/users/facebook-github-bot', 'html_url': 'https://github.com/facebook-github-bot', 'followers_url': 'https://api.github.com/users/facebook-github-bot/followers', 'following_url': 'https://api.github.com/users/facebook-github-bot/following{/other_user}', 'gists_url': 'https://api.github.com/users/facebook-github-bot/gists{/gist_id}', 'starred_url': 'https://api.github.com/users/facebook-github-bot/starred{/owner}{/repo}', 'subscriptions_url': 'https://api.github.com/users/facebook-github-bot/subscriptions', 'organizations_url': 'https://api.github.com/users/facebook-github-bot/orgs', 'repos_url': 'https://api.github.com/users/facebook-github-bot/repos', 'events_url': 'https://api.github.com/users/facebook-github-bot/events{/privacy}', 'received_events_url': 'https://api.github.com/users/facebook-github-bot/received_events', 'type': 'User', 'site_admin': False}",referenced,b44c0f328e6145e8961a1dc1f072bbcf12fb4634,https://api.github.com/repos/pytorch/pytorch/commits/b44c0f328e6145e8961a1dc1f072bbcf12fb4634,2020-01-03T20:42:54Z,14,8,6
31079,2879496311,"{'login': 'facebook-github-bot', 'id': 6422482, 'node_id': 'MDQ6VXNlcjY0MjI0ODI=', 'avatar_url': 'https://avatars3.githubusercontent.com/u/6422482?v=4', 'gravatar_id': '', 'url': 'https://api.github.com/users/facebook-github-bot', 'html_url': 'https://github.com/facebook-github-bot', 'followers_url': 'https://api.github.com/users/facebook-github-bot/followers', 'following_url': 'https://api.github.com/users/facebook-github-bot/following{/other_user}', 'gists_url': 'https://api.github.com/users/facebook-github-bot/gists{/gist_id}', 'starred_url': 'https://api.github.com/users/facebook-github-bot/starred{/owner}{/repo}', 'subscriptions_url': 'https://api.github.com/users/facebook-github-bot/subscriptions', 'organizations_url': 'https://api.github.com/users/facebook-github-bot/orgs', 'repos_url': 'https://api.github.com/users/facebook-github-bot/repos', 'events_url': 'https://api.github.com/users/facebook-github-bot/events{/privacy}', 'received_events_url': 'https://api.github.com/users/facebook-github-bot/received_events', 'type': 'User', 'site_admin': False}",referenced,f6c31f61c5c2309701a14597913e32a88193225d,https://api.github.com/repos/pytorch/pytorch/commits/f6c31f61c5c2309701a14597913e32a88193225d,2019-12-12T21:48:28Z,8,7,1
31027,2879124599,"{'login': 'facebook-github-bot', 'id': 6422482, 'node_id': 'MDQ6VXNlcjY0MjI0ODI=', 'avatar_url': 'https://avatars3.githubusercontent.com/u/6422482?v=4', 'gravatar_id': '', 'url': 'https://api.github.com/users/facebook-github-bot', 'html_url': 'https://github.com/facebook-github-bot', 'followers_url': 'https://api.github.com/users/facebook-github-bot/followers', 'following_url': 'https://api.github.com/users/facebook-github-bot/following{/other_user}', 'gists_url': 'https://api.github.com/users/facebook-github-bot/gists{/gist_id}', 'starred_url': 'https://api.github.com/users/facebook-github-bot/starred{/owner}{/repo}', 'subscriptions_url': 'https://api.github.com/users/facebook-github-bot/subscriptions', 'organizations_url': 'https://api.github.com/users/facebook-github-bot/orgs', 'repos_url': 'https://api.github.com/users/facebook-github-bot/repos', 'events_url': 'https://api.github.com/users/facebook-github-bot/events{/privacy}', 'received_events_url': 'https://api.github.com/users/facebook-github-bot/received_events', 'type': 'User', 'site_admin': False}",referenced,4ead2e8996c7dd8a0d3a07541449da48c2b9f3c6,https://api.github.com/repos/pytorch/pytorch/commits/4ead2e8996c7dd8a0d3a07541449da48c2b9f3c6,2019-12-12T19:33:32Z,2,1,1
31021,2936489189,"{'login': 'facebook-github-bot', 'id': 6422482, 'node_id': 'MDQ6VXNlcjY0MjI0ODI=', 'avatar_url': 'https://avatars3.githubusercontent.com/u/6422482?v=4', 'gravatar_id': '', 'url': 'https://api.github.com/users/facebook-github-bot', 'html_url': 'https://github.com/facebook-github-bot', 'followers_url': 'https://api.github.com/users/facebook-github-bot/followers', 'following_url': 'https://api.github.com/users/facebook-github-bot/following{/other_user}', 'gists_url': 'https://api.github.com/users/facebook-github-bot/gists{/gist_id}', 'starred_url': 'https://api.github.com/users/facebook-github-bot/starred{/owner}{/repo}', 'subscriptions_url': 'https://api.github.com/users/facebook-github-bot/subscriptions', 'organizations_url': 'https://api.github.com/users/facebook-github-bot/orgs', 'repos_url': 'https://api.github.com/users/facebook-github-bot/repos', 'events_url': 'https://api.github.com/users/facebook-github-bot/events{/privacy}', 'received_events_url': 'https://api.github.com/users/facebook-github-bot/received_events', 'type': 'User', 'site_admin': False}",closed,1296e2d55ef66d711e993f1c799d0a1a72a7171f,https://api.github.com/repos/pytorch/pytorch/commits/1296e2d55ef66d711e993f1c799d0a1a72a7171f,2020-01-09T21:16:29Z,130,102,28
30988,2998952197,"{'login': 'facebook-github-bot', 'id': 6422482, 'node_id': 'MDQ6VXNlcjY0MjI0ODI=', 'avatar_url': 'https://avatars3.githubusercontent.com/u/6422482?v=4', 'gravatar_id': '', 'url': 'https://api.github.com/users/facebook-github-bot', 'html_url': 'https://github.com/facebook-github-bot', 'followers_url': 'https://api.github.com/users/facebook-github-bot/followers', 'following_url': 'https://api.github.com/users/facebook-github-bot/following{/other_user}', 'gists_url': 'https://api.github.com/users/facebook-github-bot/gists{/gist_id}', 'starred_url': 'https://api.github.com/users/facebook-github-bot/starred{/owner}{/repo}', 'subscriptions_url': 'https://api.github.com/users/facebook-github-bot/subscriptions', 'organizations_url': 'https://api.github.com/users/facebook-github-bot/orgs', 'repos_url': 'https://api.github.com/users/facebook-github-bot/repos', 'events_url': 'https://api.github.com/users/facebook-github-bot/events{/privacy}', 'received_events_url': 'https://api.github.com/users/facebook-github-bot/received_events', 'type': 'User', 'site_admin': False}",referenced,ad78c0f4fc880c0da5064ccb85290c38dbe252ab,https://api.github.com/repos/pytorch/pytorch/commits/ad78c0f4fc880c0da5064ccb85290c38dbe252ab,2020-02-01T00:55:04Z,30,22,8
30932,2898504704,"{'login': 'facebook-github-bot', 'id': 6422482, 'node_id': 'MDQ6VXNlcjY0MjI0ODI=', 'avatar_url': 'https://avatars3.githubusercontent.com/u/6422482?v=4', 'gravatar_id': '', 'url': 'https://api.github.com/users/facebook-github-bot', 'html_url': 'https://github.com/facebook-github-bot', 'followers_url': 'https://api.github.com/users/facebook-github-bot/followers', 'following_url': 'https://api.github.com/users/facebook-github-bot/following{/other_user}', 'gists_url': 'https://api.github.com/users/facebook-github-bot/gists{/gist_id}', 'starred_url': 'https://api.github.com/users/facebook-github-bot/starred{/owner}{/repo}', 'subscriptions_url': 'https://api.github.com/users/facebook-github-bot/subscriptions', 'organizations_url': 'https://api.github.com/users/facebook-github-bot/orgs', 'repos_url': 'https://api.github.com/users/facebook-github-bot/repos', 'events_url': 'https://api.github.com/users/facebook-github-bot/events{/privacy}', 'received_events_url': 'https://api.github.com/users/facebook-github-bot/received_events', 'type': 'User', 'site_admin': False}",closed,c4121ed8dbe5a1b8e0ad3d28be2c9b7b54db6389,https://api.github.com/repos/pytorch/pytorch/commits/c4121ed8dbe5a1b8e0ad3d28be2c9b7b54db6389,2019-12-19T20:10:37Z,38,26,12
30931,2876587366,"{'login': 'facebook-github-bot', 'id': 6422482, 'node_id': 'MDQ6VXNlcjY0MjI0ODI=', 'avatar_url': 'https://avatars3.githubusercontent.com/u/6422482?v=4', 'gravatar_id': '', 'url': 'https://api.github.com/users/facebook-github-bot', 'html_url': 'https://github.com/facebook-github-bot', 'followers_url': 'https://api.github.com/users/facebook-github-bot/followers', 'following_url': 'https://api.github.com/users/facebook-github-bot/following{/other_user}', 'gists_url': 'https://api.github.com/users/facebook-github-bot/gists{/gist_id}', 'starred_url': 'https://api.github.com/users/facebook-github-bot/starred{/owner}{/repo}', 'subscriptions_url': 'https://api.github.com/users/facebook-github-bot/subscriptions', 'organizations_url': 'https://api.github.com/users/facebook-github-bot/orgs', 'repos_url': 'https://api.github.com/users/facebook-github-bot/repos', 'events_url': 'https://api.github.com/users/facebook-github-bot/events{/privacy}', 'received_events_url': 'https://api.github.com/users/facebook-github-bot/received_events', 'type': 'User', 'site_admin': False}",referenced,49a5841a9f2e444eb2ac8c7ca2efca084457c490,https://api.github.com/repos/pytorch/pytorch/commits/49a5841a9f2e444eb2ac8c7ca2efca084457c490,2019-12-12T04:32:04Z,287,241,46
30931,2876598991,"{'login': 'yf225', 'id': 4063635, 'node_id': 'MDQ6VXNlcjQwNjM2MzU=', 'avatar_url': 'https://avatars0.githubusercontent.com/u/4063635?v=4', 'gravatar_id': '', 'url': 'https://api.github.com/users/yf225', 'html_url': 'https://github.com/yf225', 'followers_url': 'https://api.github.com/users/yf225/followers', 'following_url': 'https://api.github.com/users/yf225/following{/other_user}', 'gists_url': 'https://api.github.com/users/yf225/gists{/gist_id}', 'starred_url': 'https://api.github.com/users/yf225/starred{/owner}{/repo}', 'subscriptions_url': 'https://api.github.com/users/yf225/subscriptions', 'organizations_url': 'https://api.github.com/users/yf225/orgs', 'repos_url': 'https://api.github.com/users/yf225/repos', 'events_url': 'https://api.github.com/users/yf225/events{/privacy}', 'received_events_url': 'https://api.github.com/users/yf225/received_events', 'type': 'User', 'site_admin': False}",referenced,6205a70b53e25f7972988951f5187f8c716f2b43,https://api.github.com/repos/pytorch/pytorch/commits/6205a70b53e25f7972988951f5187f8c716f2b43,2019-12-12T04:41:03Z,287,241,46
30931,2878629507,"{'login': 'yf225', 'id': 4063635, 'node_id': 'MDQ6VXNlcjQwNjM2MzU=', 'avatar_url': 'https://avatars0.githubusercontent.com/u/4063635?v=4', 'gravatar_id': '', 'url': 'https://api.github.com/users/yf225', 'html_url': 'https://github.com/yf225', 'followers_url': 'https://api.github.com/users/yf225/followers', 'following_url': 'https://api.github.com/users/yf225/following{/other_user}', 'gists_url': 'https://api.github.com/users/yf225/gists{/gist_id}', 'starred_url': 'https://api.github.com/users/yf225/starred{/owner}{/repo}', 'subscriptions_url': 'https://api.github.com/users/yf225/subscriptions', 'organizations_url': 'https://api.github.com/users/yf225/orgs', 'repos_url': 'https://api.github.com/users/yf225/repos', 'events_url': 'https://api.github.com/users/yf225/events{/privacy}', 'received_events_url': 'https://api.github.com/users/yf225/received_events', 'type': 'User', 'site_admin': False}",referenced,a06f26560cc6503f45974b1bbfc1f682d76b7a4b,https://api.github.com/repos/pytorch/pytorch/commits/a06f26560cc6503f45974b1bbfc1f682d76b7a4b,2019-12-12T16:46:36Z,287,241,46
30931,3045661154,"{'login': 'facebook-github-bot', 'id': 6422482, 'node_id': 'MDQ6VXNlcjY0MjI0ODI=', 'avatar_url': 'https://avatars3.githubusercontent.com/u/6422482?v=4', 'gravatar_id': '', 'url': 'https://api.github.com/users/facebook-github-bot', 'html_url': 'https://github.com/facebook-github-bot', 'followers_url': 'https://api.github.com/users/facebook-github-bot/followers', 'following_url': 'https://api.github.com/users/facebook-github-bot/following{/other_user}', 'gists_url': 'https://api.github.com/users/facebook-github-bot/gists{/gist_id}', 'starred_url': 'https://api.github.com/users/facebook-github-bot/starred{/owner}{/repo}', 'subscriptions_url': 'https://api.github.com/users/facebook-github-bot/subscriptions', 'organizations_url': 'https://api.github.com/users/facebook-github-bot/orgs', 'repos_url': 'https://api.github.com/users/facebook-github-bot/repos', 'events_url': 'https://api.github.com/users/facebook-github-bot/events{/privacy}', 'received_events_url': 'https://api.github.com/users/facebook-github-bot/received_events', 'type': 'User', 'site_admin': False}",referenced,a203dc2e6d74c8abb63145873b757769d1383273,https://api.github.com/repos/pytorch/pytorch/commits/a203dc2e6d74c8abb63145873b757769d1383273,2020-02-18T04:38:19Z,488,470,18
30910,2873074924,"{'login': 'facebook-github-bot', 'id': 6422482, 'node_id': 'MDQ6VXNlcjY0MjI0ODI=', 'avatar_url': 'https://avatars3.githubusercontent.com/u/6422482?v=4', 'gravatar_id': '', 'url': 'https://api.github.com/users/facebook-github-bot', 'html_url': 'https://github.com/facebook-github-bot', 'followers_url': 'https://api.github.com/users/facebook-github-bot/followers', 'following_url': 'https://api.github.com/users/facebook-github-bot/following{/other_user}', 'gists_url': 'https://api.github.com/users/facebook-github-bot/gists{/gist_id}', 'starred_url': 'https://api.github.com/users/facebook-github-bot/starred{/owner}{/repo}', 'subscriptions_url': 'https://api.github.com/users/facebook-github-bot/subscriptions', 'organizations_url': 'https://api.github.com/users/facebook-github-bot/orgs', 'repos_url': 'https://api.github.com/users/facebook-github-bot/repos', 'events_url': 'https://api.github.com/users/facebook-github-bot/events{/privacy}', 'received_events_url': 'https://api.github.com/users/facebook-github-bot/received_events', 'type': 'User', 'site_admin': False}",closed,9a5fd2eb07e6f7ff7516e1a59831464594191d65,https://api.github.com/repos/pytorch/pytorch/commits/9a5fd2eb07e6f7ff7516e1a59831464594191d65,2019-12-11T06:22:41Z,2,2,0
30820,2884181664,"{'login': 'facebook-github-bot', 'id': 6422482, 'node_id': 'MDQ6VXNlcjY0MjI0ODI=', 'avatar_url': 'https://avatars3.githubusercontent.com/u/6422482?v=4', 'gravatar_id': '', 'url': 'https://api.github.com/users/facebook-github-bot', 'html_url': 'https://github.com/facebook-github-bot', 'followers_url': 'https://api.github.com/users/facebook-github-bot/followers', 'following_url': 'https://api.github.com/users/facebook-github-bot/following{/other_user}', 'gists_url': 'https://api.github.com/users/facebook-github-bot/gists{/gist_id}', 'starred_url': 'https://api.github.com/users/facebook-github-bot/starred{/owner}{/repo}', 'subscriptions_url': 'https://api.github.com/users/facebook-github-bot/subscriptions', 'organizations_url': 'https://api.github.com/users/facebook-github-bot/orgs', 'repos_url': 'https://api.github.com/users/facebook-github-bot/repos', 'events_url': 'https://api.github.com/users/facebook-github-bot/events{/privacy}', 'received_events_url': 'https://api.github.com/users/facebook-github-bot/received_events', 'type': 'User', 'site_admin': False}",closed,9dc3d8738cafe84f89e36c5358f13ae3355825cc,https://api.github.com/repos/pytorch/pytorch/commits/9dc3d8738cafe84f89e36c5358f13ae3355825cc,2019-12-15T19:52:06Z,10,6,4
30731,2871662921,"{'login': 'facebook-github-bot', 'id': 6422482, 'node_id': 'MDQ6VXNlcjY0MjI0ODI=', 'avatar_url': 'https://avatars3.githubusercontent.com/u/6422482?v=4', 'gravatar_id': '', 'url': 'https://api.github.com/users/facebook-github-bot', 'html_url': 'https://github.com/facebook-github-bot', 'followers_url': 'https://api.github.com/users/facebook-github-bot/followers', 'following_url': 'https://api.github.com/users/facebook-github-bot/following{/other_user}', 'gists_url': 'https://api.github.com/users/facebook-github-bot/gists{/gist_id}', 'starred_url': 'https://api.github.com/users/facebook-github-bot/starred{/owner}{/repo}', 'subscriptions_url': 'https://api.github.com/users/facebook-github-bot/subscriptions', 'organizations_url': 'https://api.github.com/users/facebook-github-bot/orgs', 'repos_url': 'https://api.github.com/users/facebook-github-bot/repos', 'events_url': 'https://api.github.com/users/facebook-github-bot/events{/privacy}', 'received_events_url': 'https://api.github.com/users/facebook-github-bot/received_events', 'type': 'User', 'site_admin': False}",closed,394d2f703780ba21c4d91cd524af929b501182da,https://api.github.com/repos/pytorch/pytorch/commits/394d2f703780ba21c4d91cd524af929b501182da,2019-12-10T18:48:32Z,20,10,10
30717,2990909136,"{'login': 'facebook-github-bot', 'id': 6422482, 'node_id': 'MDQ6VXNlcjY0MjI0ODI=', 'avatar_url': 'https://avatars3.githubusercontent.com/u/6422482?v=4', 'gravatar_id': '', 'url': 'https://api.github.com/users/facebook-github-bot', 'html_url': 'https://github.com/facebook-github-bot', 'followers_url': 'https://api.github.com/users/facebook-github-bot/followers', 'following_url': 'https://api.github.com/users/facebook-github-bot/following{/other_user}', 'gists_url': 'https://api.github.com/users/facebook-github-bot/gists{/gist_id}', 'starred_url': 'https://api.github.com/users/facebook-github-bot/starred{/owner}{/repo}', 'subscriptions_url': 'https://api.github.com/users/facebook-github-bot/subscriptions', 'organizations_url': 'https://api.github.com/users/facebook-github-bot/orgs', 'repos_url': 'https://api.github.com/users/facebook-github-bot/repos', 'events_url': 'https://api.github.com/users/facebook-github-bot/events{/privacy}', 'received_events_url': 'https://api.github.com/users/facebook-github-bot/received_events', 'type': 'User', 'site_admin': False}",closed,8693164acbc797c75a08381c7735337a8a58621f,https://api.github.com/repos/pytorch/pytorch/commits/8693164acbc797c75a08381c7735337a8a58621f,2020-01-29T20:05:56Z,4,3,1
30708,2876189263,"{'login': 'facebook-github-bot', 'id': 6422482, 'node_id': 'MDQ6VXNlcjY0MjI0ODI=', 'avatar_url': 'https://avatars3.githubusercontent.com/u/6422482?v=4', 'gravatar_id': '', 'url': 'https://api.github.com/users/facebook-github-bot', 'html_url': 'https://github.com/facebook-github-bot', 'followers_url': 'https://api.github.com/users/facebook-github-bot/followers', 'following_url': 'https://api.github.com/users/facebook-github-bot/following{/other_user}', 'gists_url': 'https://api.github.com/users/facebook-github-bot/gists{/gist_id}', 'starred_url': 'https://api.github.com/users/facebook-github-bot/starred{/owner}{/repo}', 'subscriptions_url': 'https://api.github.com/users/facebook-github-bot/subscriptions', 'organizations_url': 'https://api.github.com/users/facebook-github-bot/orgs', 'repos_url': 'https://api.github.com/users/facebook-github-bot/repos', 'events_url': 'https://api.github.com/users/facebook-github-bot/events{/privacy}', 'received_events_url': 'https://api.github.com/users/facebook-github-bot/received_events', 'type': 'User', 'site_admin': False}",referenced,0414463007cecbc987ec376e95639073d26d7d2d,https://api.github.com/repos/pytorch/pytorch/commits/0414463007cecbc987ec376e95639073d26d7d2d,2019-12-12T00:02:51Z,12,12,0
30682,2851961677,"{'login': 'facebook-github-bot', 'id': 6422482, 'node_id': 'MDQ6VXNlcjY0MjI0ODI=', 'avatar_url': 'https://avatars3.githubusercontent.com/u/6422482?v=4', 'gravatar_id': '', 'url': 'https://api.github.com/users/facebook-github-bot', 'html_url': 'https://github.com/facebook-github-bot', 'followers_url': 'https://api.github.com/users/facebook-github-bot/followers', 'following_url': 'https://api.github.com/users/facebook-github-bot/following{/other_user}', 'gists_url': 'https://api.github.com/users/facebook-github-bot/gists{/gist_id}', 'starred_url': 'https://api.github.com/users/facebook-github-bot/starred{/owner}{/repo}', 'subscriptions_url': 'https://api.github.com/users/facebook-github-bot/subscriptions', 'organizations_url': 'https://api.github.com/users/facebook-github-bot/orgs', 'repos_url': 'https://api.github.com/users/facebook-github-bot/repos', 'events_url': 'https://api.github.com/users/facebook-github-bot/events{/privacy}', 'received_events_url': 'https://api.github.com/users/facebook-github-bot/received_events', 'type': 'User', 'site_admin': False}",closed,03a73cb9ac75400fe5ee88de4d1271d45c785e10,https://api.github.com/repos/pytorch/pytorch/commits/03a73cb9ac75400fe5ee88de4d1271d45c785e10,2019-12-03T22:52:42Z,6,2,4
30682,2851964391,"{'login': 'yf225', 'id': 4063635, 'node_id': 'MDQ6VXNlcjQwNjM2MzU=', 'avatar_url': 'https://avatars0.githubusercontent.com/u/4063635?v=4', 'gravatar_id': '', 'url': 'https://api.github.com/users/yf225', 'html_url': 'https://github.com/yf225', 'followers_url': 'https://api.github.com/users/yf225/followers', 'following_url': 'https://api.github.com/users/yf225/following{/other_user}', 'gists_url': 'https://api.github.com/users/yf225/gists{/gist_id}', 'starred_url': 'https://api.github.com/users/yf225/starred{/owner}{/repo}', 'subscriptions_url': 'https://api.github.com/users/yf225/subscriptions', 'organizations_url': 'https://api.github.com/users/yf225/orgs', 'repos_url': 'https://api.github.com/users/yf225/repos', 'events_url': 'https://api.github.com/users/yf225/events{/privacy}', 'received_events_url': 'https://api.github.com/users/yf225/received_events', 'type': 'User', 'site_admin': False}",referenced,aa9dd63133ddd8175d1bce0a7010fb00aee015bc,https://api.github.com/repos/pytorch/pytorch/commits/aa9dd63133ddd8175d1bce0a7010fb00aee015bc,2019-12-03T22:53:53Z,6,2,4
30682,2854688894,"{'login': 'yf225', 'id': 4063635, 'node_id': 'MDQ6VXNlcjQwNjM2MzU=', 'avatar_url': 'https://avatars0.githubusercontent.com/u/4063635?v=4', 'gravatar_id': '', 'url': 'https://api.github.com/users/yf225', 'html_url': 'https://github.com/yf225', 'followers_url': 'https://api.github.com/users/yf225/followers', 'following_url': 'https://api.github.com/users/yf225/following{/other_user}', 'gists_url': 'https://api.github.com/users/yf225/gists{/gist_id}', 'starred_url': 'https://api.github.com/users/yf225/starred{/owner}{/repo}', 'subscriptions_url': 'https://api.github.com/users/yf225/subscriptions', 'organizations_url': 'https://api.github.com/users/yf225/orgs', 'repos_url': 'https://api.github.com/users/yf225/repos', 'events_url': 'https://api.github.com/users/yf225/events{/privacy}', 'received_events_url': 'https://api.github.com/users/yf225/received_events', 'type': 'User', 'site_admin': False}",referenced,fb8aa0e98c1199bb05bccab4f318615542ad9999,https://api.github.com/repos/pytorch/pytorch/commits/fb8aa0e98c1199bb05bccab4f318615542ad9999,2019-12-04T16:35:22Z,6,2,4
30678,2975315065,"{'login': 'facebook-github-bot', 'id': 6422482, 'node_id': 'MDQ6VXNlcjY0MjI0ODI=', 'avatar_url': 'https://avatars3.githubusercontent.com/u/6422482?v=4', 'gravatar_id': '', 'url': 'https://api.github.com/users/facebook-github-bot', 'html_url': 'https://github.com/facebook-github-bot', 'followers_url': 'https://api.github.com/users/facebook-github-bot/followers', 'following_url': 'https://api.github.com/users/facebook-github-bot/following{/other_user}', 'gists_url': 'https://api.github.com/users/facebook-github-bot/gists{/gist_id}', 'starred_url': 'https://api.github.com/users/facebook-github-bot/starred{/owner}{/repo}', 'subscriptions_url': 'https://api.github.com/users/facebook-github-bot/subscriptions', 'organizations_url': 'https://api.github.com/users/facebook-github-bot/orgs', 'repos_url': 'https://api.github.com/users/facebook-github-bot/repos', 'events_url': 'https://api.github.com/users/facebook-github-bot/events{/privacy}', 'received_events_url': 'https://api.github.com/users/facebook-github-bot/received_events', 'type': 'User', 'site_admin': False}",closed,db02a4e4ceced885508991441ea68896d48fc369,https://api.github.com/repos/pytorch/pytorch/commits/db02a4e4ceced885508991441ea68896d48fc369,2020-01-23T21:18:36Z,79,57,22
30627,2856087963,"{'login': 'facebook-github-bot', 'id': 6422482, 'node_id': 'MDQ6VXNlcjY0MjI0ODI=', 'avatar_url': 'https://avatars3.githubusercontent.com/u/6422482?v=4', 'gravatar_id': '', 'url': 'https://api.github.com/users/facebook-github-bot', 'html_url': 'https://github.com/facebook-github-bot', 'followers_url': 'https://api.github.com/users/facebook-github-bot/followers', 'following_url': 'https://api.github.com/users/facebook-github-bot/following{/other_user}', 'gists_url': 'https://api.github.com/users/facebook-github-bot/gists{/gist_id}', 'starred_url': 'https://api.github.com/users/facebook-github-bot/starred{/owner}{/repo}', 'subscriptions_url': 'https://api.github.com/users/facebook-github-bot/subscriptions', 'organizations_url': 'https://api.github.com/users/facebook-github-bot/orgs', 'repos_url': 'https://api.github.com/users/facebook-github-bot/repos', 'events_url': 'https://api.github.com/users/facebook-github-bot/events{/privacy}', 'received_events_url': 'https://api.github.com/users/facebook-github-bot/received_events', 'type': 'User', 'site_admin': False}",closed,1f1ce53e8e93c80b3f88b9e6c84013a037e9c074,https://api.github.com/repos/pytorch/pytorch/commits/1f1ce53e8e93c80b3f88b9e6c84013a037e9c074,2019-12-05T00:43:37Z,6,3,3
30583,3028020173,"{'login': 'facebook-github-bot', 'id': 6422482, 'node_id': 'MDQ6VXNlcjY0MjI0ODI=', 'avatar_url': 'https://avatars3.githubusercontent.com/u/6422482?v=4', 'gravatar_id': '', 'url': 'https://api.github.com/users/facebook-github-bot', 'html_url': 'https://github.com/facebook-github-bot', 'followers_url': 'https://api.github.com/users/facebook-github-bot/followers', 'following_url': 'https://api.github.com/users/facebook-github-bot/following{/other_user}', 'gists_url': 'https://api.github.com/users/facebook-github-bot/gists{/gist_id}', 'starred_url': 'https://api.github.com/users/facebook-github-bot/starred{/owner}{/repo}', 'subscriptions_url': 'https://api.github.com/users/facebook-github-bot/subscriptions', 'organizations_url': 'https://api.github.com/users/facebook-github-bot/orgs', 'repos_url': 'https://api.github.com/users/facebook-github-bot/repos', 'events_url': 'https://api.github.com/users/facebook-github-bot/events{/privacy}', 'received_events_url': 'https://api.github.com/users/facebook-github-bot/received_events', 'type': 'User', 'site_admin': False}",referenced,a64d0ffe81b250889a3e6670daa9c7d07d946e32,https://api.github.com/repos/pytorch/pytorch/commits/a64d0ffe81b250889a3e6670daa9c7d07d946e32,2020-02-11T20:01:58Z,78,53,25
30562,2928792979,"{'login': 'facebook-github-bot', 'id': 6422482, 'node_id': 'MDQ6VXNlcjY0MjI0ODI=', 'avatar_url': 'https://avatars3.githubusercontent.com/u/6422482?v=4', 'gravatar_id': '', 'url': 'https://api.github.com/users/facebook-github-bot', 'html_url': 'https://github.com/facebook-github-bot', 'followers_url': 'https://api.github.com/users/facebook-github-bot/followers', 'following_url': 'https://api.github.com/users/facebook-github-bot/following{/other_user}', 'gists_url': 'https://api.github.com/users/facebook-github-bot/gists{/gist_id}', 'starred_url': 'https://api.github.com/users/facebook-github-bot/starred{/owner}{/repo}', 'subscriptions_url': 'https://api.github.com/users/facebook-github-bot/subscriptions', 'organizations_url': 'https://api.github.com/users/facebook-github-bot/orgs', 'repos_url': 'https://api.github.com/users/facebook-github-bot/repos', 'events_url': 'https://api.github.com/users/facebook-github-bot/events{/privacy}', 'received_events_url': 'https://api.github.com/users/facebook-github-bot/received_events', 'type': 'User', 'site_admin': False}",closed,74d69e296e71896bbe29b92fd6dae41cbbee21e3,https://api.github.com/repos/pytorch/pytorch/commits/74d69e296e71896bbe29b92fd6dae41cbbee21e3,2020-01-07T19:30:50Z,51,49,2
30526,2976567146,"{'login': 'bhosmer', 'id': 355313, 'node_id': 'MDQ6VXNlcjM1NTMxMw==', 'avatar_url': 'https://avatars3.githubusercontent.com/u/355313?v=4', 'gravatar_id': '', 'url': 'https://api.github.com/users/bhosmer', 'html_url': 'https://github.com/bhosmer', 'followers_url': 'https://api.github.com/users/bhosmer/followers', 'following_url': 'https://api.github.com/users/bhosmer/following{/other_user}', 'gists_url': 'https://api.github.com/users/bhosmer/gists{/gist_id}', 'starred_url': 'https://api.github.com/users/bhosmer/starred{/owner}{/repo}', 'subscriptions_url': 'https://api.github.com/users/bhosmer/subscriptions', 'organizations_url': 'https://api.github.com/users/bhosmer/orgs', 'repos_url': 'https://api.github.com/users/bhosmer/repos', 'events_url': 'https://api.github.com/users/bhosmer/events{/privacy}', 'received_events_url': 'https://api.github.com/users/bhosmer/received_events', 'type': 'User', 'site_admin': False}",referenced,bd39bf168887a36d464845f7a70554bd0d5f8350,https://api.github.com/repos/pytorch/pytorch/commits/bd39bf168887a36d464845f7a70554bd0d5f8350,2020-01-24T09:23:21Z,98,23,75
30526,2976567447,"{'login': 'bhosmer', 'id': 355313, 'node_id': 'MDQ6VXNlcjM1NTMxMw==', 'avatar_url': 'https://avatars3.githubusercontent.com/u/355313?v=4', 'gravatar_id': '', 'url': 'https://api.github.com/users/bhosmer', 'html_url': 'https://github.com/bhosmer', 'followers_url': 'https://api.github.com/users/bhosmer/followers', 'following_url': 'https://api.github.com/users/bhosmer/following{/other_user}', 'gists_url': 'https://api.github.com/users/bhosmer/gists{/gist_id}', 'starred_url': 'https://api.github.com/users/bhosmer/starred{/owner}{/repo}', 'subscriptions_url': 'https://api.github.com/users/bhosmer/subscriptions', 'organizations_url': 'https://api.github.com/users/bhosmer/orgs', 'repos_url': 'https://api.github.com/users/bhosmer/repos', 'events_url': 'https://api.github.com/users/bhosmer/events{/privacy}', 'received_events_url': 'https://api.github.com/users/bhosmer/received_events', 'type': 'User', 'site_admin': False}",referenced,397d6a2baec29590134bba8180ad480bbcc384f6,https://api.github.com/repos/pytorch/pytorch/commits/397d6a2baec29590134bba8180ad480bbcc384f6,2020-01-24T09:23:27Z,98,23,75
30526,2978839827,"{'login': 'bhosmer', 'id': 355313, 'node_id': 'MDQ6VXNlcjM1NTMxMw==', 'avatar_url': 'https://avatars3.githubusercontent.com/u/355313?v=4', 'gravatar_id': '', 'url': 'https://api.github.com/users/bhosmer', 'html_url': 'https://github.com/bhosmer', 'followers_url': 'https://api.github.com/users/bhosmer/followers', 'following_url': 'https://api.github.com/users/bhosmer/following{/other_user}', 'gists_url': 'https://api.github.com/users/bhosmer/gists{/gist_id}', 'starred_url': 'https://api.github.com/users/bhosmer/starred{/owner}{/repo}', 'subscriptions_url': 'https://api.github.com/users/bhosmer/subscriptions', 'organizations_url': 'https://api.github.com/users/bhosmer/orgs', 'repos_url': 'https://api.github.com/users/bhosmer/repos', 'events_url': 'https://api.github.com/users/bhosmer/events{/privacy}', 'received_events_url': 'https://api.github.com/users/bhosmer/received_events', 'type': 'User', 'site_admin': False}",referenced,eeb6a5f79d5b6bd2417e4f13df8cc2c756008b7d,https://api.github.com/repos/pytorch/pytorch/commits/eeb6a5f79d5b6bd2417e4f13df8cc2c756008b7d,2020-01-24T22:56:38Z,90,89,1
30526,2978840003,"{'login': 'bhosmer', 'id': 355313, 'node_id': 'MDQ6VXNlcjM1NTMxMw==', 'avatar_url': 'https://avatars3.githubusercontent.com/u/355313?v=4', 'gravatar_id': '', 'url': 'https://api.github.com/users/bhosmer', 'html_url': 'https://github.com/bhosmer', 'followers_url': 'https://api.github.com/users/bhosmer/followers', 'following_url': 'https://api.github.com/users/bhosmer/following{/other_user}', 'gists_url': 'https://api.github.com/users/bhosmer/gists{/gist_id}', 'starred_url': 'https://api.github.com/users/bhosmer/starred{/owner}{/repo}', 'subscriptions_url': 'https://api.github.com/users/bhosmer/subscriptions', 'organizations_url': 'https://api.github.com/users/bhosmer/orgs', 'repos_url': 'https://api.github.com/users/bhosmer/repos', 'events_url': 'https://api.github.com/users/bhosmer/events{/privacy}', 'received_events_url': 'https://api.github.com/users/bhosmer/received_events', 'type': 'User', 'site_admin': False}",referenced,6a88b0516b0dbb732a16f216eee1f95d3b29d354,https://api.github.com/repos/pytorch/pytorch/commits/6a88b0516b0dbb732a16f216eee1f95d3b29d354,2020-01-24T22:56:45Z,42,39,3
30526,2978847871,"{'login': 'bhosmer', 'id': 355313, 'node_id': 'MDQ6VXNlcjM1NTMxMw==', 'avatar_url': 'https://avatars3.githubusercontent.com/u/355313?v=4', 'gravatar_id': '', 'url': 'https://api.github.com/users/bhosmer', 'html_url': 'https://github.com/bhosmer', 'followers_url': 'https://api.github.com/users/bhosmer/followers', 'following_url': 'https://api.github.com/users/bhosmer/following{/other_user}', 'gists_url': 'https://api.github.com/users/bhosmer/gists{/gist_id}', 'starred_url': 'https://api.github.com/users/bhosmer/starred{/owner}{/repo}', 'subscriptions_url': 'https://api.github.com/users/bhosmer/subscriptions', 'organizations_url': 'https://api.github.com/users/bhosmer/orgs', 'repos_url': 'https://api.github.com/users/bhosmer/repos', 'events_url': 'https://api.github.com/users/bhosmer/events{/privacy}', 'received_events_url': 'https://api.github.com/users/bhosmer/received_events', 'type': 'User', 'site_admin': False}",referenced,a740e2b33a9808aff288762b12fee60551536cad,https://api.github.com/repos/pytorch/pytorch/commits/a740e2b33a9808aff288762b12fee60551536cad,2020-01-24T23:01:11Z,20,11,9
30526,2978848349,"{'login': 'bhosmer', 'id': 355313, 'node_id': 'MDQ6VXNlcjM1NTMxMw==', 'avatar_url': 'https://avatars3.githubusercontent.com/u/355313?v=4', 'gravatar_id': '', 'url': 'https://api.github.com/users/bhosmer', 'html_url': 'https://github.com/bhosmer', 'followers_url': 'https://api.github.com/users/bhosmer/followers', 'following_url': 'https://api.github.com/users/bhosmer/following{/other_user}', 'gists_url': 'https://api.github.com/users/bhosmer/gists{/gist_id}', 'starred_url': 'https://api.github.com/users/bhosmer/starred{/owner}{/repo}', 'subscriptions_url': 'https://api.github.com/users/bhosmer/subscriptions', 'organizations_url': 'https://api.github.com/users/bhosmer/orgs', 'repos_url': 'https://api.github.com/users/bhosmer/repos', 'events_url': 'https://api.github.com/users/bhosmer/events{/privacy}', 'received_events_url': 'https://api.github.com/users/bhosmer/received_events', 'type': 'User', 'site_admin': False}",referenced,a69aaec35c61c7f9b498203b353592f626a53224,https://api.github.com/repos/pytorch/pytorch/commits/a69aaec35c61c7f9b498203b353592f626a53224,2020-01-24T23:01:31Z,44,41,3
30526,2978870214,"{'login': 'bhosmer', 'id': 355313, 'node_id': 'MDQ6VXNlcjM1NTMxMw==', 'avatar_url': 'https://avatars3.githubusercontent.com/u/355313?v=4', 'gravatar_id': '', 'url': 'https://api.github.com/users/bhosmer', 'html_url': 'https://github.com/bhosmer', 'followers_url': 'https://api.github.com/users/bhosmer/followers', 'following_url': 'https://api.github.com/users/bhosmer/following{/other_user}', 'gists_url': 'https://api.github.com/users/bhosmer/gists{/gist_id}', 'starred_url': 'https://api.github.com/users/bhosmer/starred{/owner}{/repo}', 'subscriptions_url': 'https://api.github.com/users/bhosmer/subscriptions', 'organizations_url': 'https://api.github.com/users/bhosmer/orgs', 'repos_url': 'https://api.github.com/users/bhosmer/repos', 'events_url': 'https://api.github.com/users/bhosmer/events{/privacy}', 'received_events_url': 'https://api.github.com/users/bhosmer/received_events', 'type': 'User', 'site_admin': False}",referenced,452f60c3f69f5b68dac3f8d22f4140999d5fa10d,https://api.github.com/repos/pytorch/pytorch/commits/452f60c3f69f5b68dac3f8d22f4140999d5fa10d,2020-01-24T23:13:02Z,1,1,0
30526,2978870432,"{'login': 'bhosmer', 'id': 355313, 'node_id': 'MDQ6VXNlcjM1NTMxMw==', 'avatar_url': 'https://avatars3.githubusercontent.com/u/355313?v=4', 'gravatar_id': '', 'url': 'https://api.github.com/users/bhosmer', 'html_url': 'https://github.com/bhosmer', 'followers_url': 'https://api.github.com/users/bhosmer/followers', 'following_url': 'https://api.github.com/users/bhosmer/following{/other_user}', 'gists_url': 'https://api.github.com/users/bhosmer/gists{/gist_id}', 'starred_url': 'https://api.github.com/users/bhosmer/starred{/owner}{/repo}', 'subscriptions_url': 'https://api.github.com/users/bhosmer/subscriptions', 'organizations_url': 'https://api.github.com/users/bhosmer/orgs', 'repos_url': 'https://api.github.com/users/bhosmer/repos', 'events_url': 'https://api.github.com/users/bhosmer/events{/privacy}', 'received_events_url': 'https://api.github.com/users/bhosmer/received_events', 'type': 'User', 'site_admin': False}",referenced,bb2cce82dfb74f46566d11b2b41065c7a3ab2f32,https://api.github.com/repos/pytorch/pytorch/commits/bb2cce82dfb74f46566d11b2b41065c7a3ab2f32,2020-01-24T23:13:09Z,45,42,3
30526,2978875820,"{'login': 'bhosmer', 'id': 355313, 'node_id': 'MDQ6VXNlcjM1NTMxMw==', 'avatar_url': 'https://avatars3.githubusercontent.com/u/355313?v=4', 'gravatar_id': '', 'url': 'https://api.github.com/users/bhosmer', 'html_url': 'https://github.com/bhosmer', 'followers_url': 'https://api.github.com/users/bhosmer/followers', 'following_url': 'https://api.github.com/users/bhosmer/following{/other_user}', 'gists_url': 'https://api.github.com/users/bhosmer/gists{/gist_id}', 'starred_url': 'https://api.github.com/users/bhosmer/starred{/owner}{/repo}', 'subscriptions_url': 'https://api.github.com/users/bhosmer/subscriptions', 'organizations_url': 'https://api.github.com/users/bhosmer/orgs', 'repos_url': 'https://api.github.com/users/bhosmer/repos', 'events_url': 'https://api.github.com/users/bhosmer/events{/privacy}', 'received_events_url': 'https://api.github.com/users/bhosmer/received_events', 'type': 'User', 'site_admin': False}",referenced,cbadbd30773d78734b5fad2393f57841348f936a,https://api.github.com/repos/pytorch/pytorch/commits/cbadbd30773d78734b5fad2393f57841348f936a,2020-01-24T23:16:39Z,1,1,0
30524,2872425191,"{'login': 'facebook-github-bot', 'id': 6422482, 'node_id': 'MDQ6VXNlcjY0MjI0ODI=', 'avatar_url': 'https://avatars3.githubusercontent.com/u/6422482?v=4', 'gravatar_id': '', 'url': 'https://api.github.com/users/facebook-github-bot', 'html_url': 'https://github.com/facebook-github-bot', 'followers_url': 'https://api.github.com/users/facebook-github-bot/followers', 'following_url': 'https://api.github.com/users/facebook-github-bot/following{/other_user}', 'gists_url': 'https://api.github.com/users/facebook-github-bot/gists{/gist_id}', 'starred_url': 'https://api.github.com/users/facebook-github-bot/starred{/owner}{/repo}', 'subscriptions_url': 'https://api.github.com/users/facebook-github-bot/subscriptions', 'organizations_url': 'https://api.github.com/users/facebook-github-bot/orgs', 'repos_url': 'https://api.github.com/users/facebook-github-bot/repos', 'events_url': 'https://api.github.com/users/facebook-github-bot/events{/privacy}', 'received_events_url': 'https://api.github.com/users/facebook-github-bot/received_events', 'type': 'User', 'site_admin': False}",closed,5edfe9cb8095a1f9ee141f4d024e67a0aea5aba9,https://api.github.com/repos/pytorch/pytorch/commits/5edfe9cb8095a1f9ee141f4d024e67a0aea5aba9,2019-12-10T23:23:02Z,52,52,0
30508,2837712245,"{'login': 'facebook-github-bot', 'id': 6422482, 'node_id': 'MDQ6VXNlcjY0MjI0ODI=', 'avatar_url': 'https://avatars3.githubusercontent.com/u/6422482?v=4', 'gravatar_id': '', 'url': 'https://api.github.com/users/facebook-github-bot', 'html_url': 'https://github.com/facebook-github-bot', 'followers_url': 'https://api.github.com/users/facebook-github-bot/followers', 'following_url': 'https://api.github.com/users/facebook-github-bot/following{/other_user}', 'gists_url': 'https://api.github.com/users/facebook-github-bot/gists{/gist_id}', 'starred_url': 'https://api.github.com/users/facebook-github-bot/starred{/owner}{/repo}', 'subscriptions_url': 'https://api.github.com/users/facebook-github-bot/subscriptions', 'organizations_url': 'https://api.github.com/users/facebook-github-bot/orgs', 'repos_url': 'https://api.github.com/users/facebook-github-bot/repos', 'events_url': 'https://api.github.com/users/facebook-github-bot/events{/privacy}', 'received_events_url': 'https://api.github.com/users/facebook-github-bot/received_events', 'type': 'User', 'site_admin': False}",referenced,7ac8efa689de7f62993dc3241127f911166585b1,https://api.github.com/repos/pytorch/pytorch/commits/7ac8efa689de7f62993dc3241127f911166585b1,2019-11-28T05:21:17Z,52,50,2
30480,2952358013,"{'login': 'glaringlee', 'id': 32228059, 'node_id': 'MDQ6VXNlcjMyMjI4MDU5', 'avatar_url': 'https://avatars1.githubusercontent.com/u/32228059?v=4', 'gravatar_id': '', 'url': 'https://api.github.com/users/glaringlee', 'html_url': 'https://github.com/glaringlee', 'followers_url': 'https://api.github.com/users/glaringlee/followers', 'following_url': 'https://api.github.com/users/glaringlee/following{/other_user}', 'gists_url': 'https://api.github.com/users/glaringlee/gists{/gist_id}', 'starred_url': 'https://api.github.com/users/glaringlee/starred{/owner}{/repo}', 'subscriptions_url': 'https://api.github.com/users/glaringlee/subscriptions', 'organizations_url': 'https://api.github.com/users/glaringlee/orgs', 'repos_url': 'https://api.github.com/users/glaringlee/repos', 'events_url': 'https://api.github.com/users/glaringlee/events{/privacy}', 'received_events_url': 'https://api.github.com/users/glaringlee/received_events', 'type': 'User', 'site_admin': False}",referenced,289b5ad40f7e228ff8b8e09d7897154deb6632e9,https://api.github.com/repos/pytorch/pytorch/commits/289b5ad40f7e228ff8b8e09d7897154deb6632e9,2020-01-15T21:20:44Z,9,8,1
30480,2952358526,"{'login': 'glaringlee', 'id': 32228059, 'node_id': 'MDQ6VXNlcjMyMjI4MDU5', 'avatar_url': 'https://avatars1.githubusercontent.com/u/32228059?v=4', 'gravatar_id': '', 'url': 'https://api.github.com/users/glaringlee', 'html_url': 'https://github.com/glaringlee', 'followers_url': 'https://api.github.com/users/glaringlee/followers', 'following_url': 'https://api.github.com/users/glaringlee/following{/other_user}', 'gists_url': 'https://api.github.com/users/glaringlee/gists{/gist_id}', 'starred_url': 'https://api.github.com/users/glaringlee/starred{/owner}{/repo}', 'subscriptions_url': 'https://api.github.com/users/glaringlee/subscriptions', 'organizations_url': 'https://api.github.com/users/glaringlee/orgs', 'repos_url': 'https://api.github.com/users/glaringlee/repos', 'events_url': 'https://api.github.com/users/glaringlee/events{/privacy}', 'received_events_url': 'https://api.github.com/users/glaringlee/received_events', 'type': 'User', 'site_admin': False}",referenced,62d605e9d6a18adbe38e500017835e8f3dfa1c1a,https://api.github.com/repos/pytorch/pytorch/commits/62d605e9d6a18adbe38e500017835e8f3dfa1c1a,2020-01-15T21:20:57Z,9,8,1
30480,2955844470,"{'login': 'glaringlee', 'id': 32228059, 'node_id': 'MDQ6VXNlcjMyMjI4MDU5', 'avatar_url': 'https://avatars1.githubusercontent.com/u/32228059?v=4', 'gravatar_id': '', 'url': 'https://api.github.com/users/glaringlee', 'html_url': 'https://github.com/glaringlee', 'followers_url': 'https://api.github.com/users/glaringlee/followers', 'following_url': 'https://api.github.com/users/glaringlee/following{/other_user}', 'gists_url': 'https://api.github.com/users/glaringlee/gists{/gist_id}', 'starred_url': 'https://api.github.com/users/glaringlee/starred{/owner}{/repo}', 'subscriptions_url': 'https://api.github.com/users/glaringlee/subscriptions', 'organizations_url': 'https://api.github.com/users/glaringlee/orgs', 'repos_url': 'https://api.github.com/users/glaringlee/repos', 'events_url': 'https://api.github.com/users/glaringlee/events{/privacy}', 'received_events_url': 'https://api.github.com/users/glaringlee/received_events', 'type': 'User', 'site_admin': False}",referenced,d088e84b076da111e48c90a4a2e3350c3af0b073,https://api.github.com/repos/pytorch/pytorch/commits/d088e84b076da111e48c90a4a2e3350c3af0b073,2020-01-16T19:50:01Z,23,23,0
30480,2955844995,"{'login': 'glaringlee', 'id': 32228059, 'node_id': 'MDQ6VXNlcjMyMjI4MDU5', 'avatar_url': 'https://avatars1.githubusercontent.com/u/32228059?v=4', 'gravatar_id': '', 'url': 'https://api.github.com/users/glaringlee', 'html_url': 'https://github.com/glaringlee', 'followers_url': 'https://api.github.com/users/glaringlee/followers', 'following_url': 'https://api.github.com/users/glaringlee/following{/other_user}', 'gists_url': 'https://api.github.com/users/glaringlee/gists{/gist_id}', 'starred_url': 'https://api.github.com/users/glaringlee/starred{/owner}{/repo}', 'subscriptions_url': 'https://api.github.com/users/glaringlee/subscriptions', 'organizations_url': 'https://api.github.com/users/glaringlee/orgs', 'repos_url': 'https://api.github.com/users/glaringlee/repos', 'events_url': 'https://api.github.com/users/glaringlee/events{/privacy}', 'received_events_url': 'https://api.github.com/users/glaringlee/received_events', 'type': 'User', 'site_admin': False}",referenced,3ab54c08b31bb145306e39a675cb201c60382b9c,https://api.github.com/repos/pytorch/pytorch/commits/3ab54c08b31bb145306e39a675cb201c60382b9c,2020-01-16T19:50:11Z,32,31,1
30480,2956070061,"{'login': 'glaringlee', 'id': 32228059, 'node_id': 'MDQ6VXNlcjMyMjI4MDU5', 'avatar_url': 'https://avatars1.githubusercontent.com/u/32228059?v=4', 'gravatar_id': '', 'url': 'https://api.github.com/users/glaringlee', 'html_url': 'https://github.com/glaringlee', 'followers_url': 'https://api.github.com/users/glaringlee/followers', 'following_url': 'https://api.github.com/users/glaringlee/following{/other_user}', 'gists_url': 'https://api.github.com/users/glaringlee/gists{/gist_id}', 'starred_url': 'https://api.github.com/users/glaringlee/starred{/owner}{/repo}', 'subscriptions_url': 'https://api.github.com/users/glaringlee/subscriptions', 'organizations_url': 'https://api.github.com/users/glaringlee/orgs', 'repos_url': 'https://api.github.com/users/glaringlee/repos', 'events_url': 'https://api.github.com/users/glaringlee/events{/privacy}', 'received_events_url': 'https://api.github.com/users/glaringlee/received_events', 'type': 'User', 'site_admin': False}",referenced,4121bb92f20ae9bd1e6d2c97d68f03d13f889422,https://api.github.com/repos/pytorch/pytorch/commits/4121bb92f20ae9bd1e6d2c97d68f03d13f889422,2020-01-16T21:08:43Z,34,17,17
30480,2956070528,"{'login': 'glaringlee', 'id': 32228059, 'node_id': 'MDQ6VXNlcjMyMjI4MDU5', 'avatar_url': 'https://avatars1.githubusercontent.com/u/32228059?v=4', 'gravatar_id': '', 'url': 'https://api.github.com/users/glaringlee', 'html_url': 'https://github.com/glaringlee', 'followers_url': 'https://api.github.com/users/glaringlee/followers', 'following_url': 'https://api.github.com/users/glaringlee/following{/other_user}', 'gists_url': 'https://api.github.com/users/glaringlee/gists{/gist_id}', 'starred_url': 'https://api.github.com/users/glaringlee/starred{/owner}{/repo}', 'subscriptions_url': 'https://api.github.com/users/glaringlee/subscriptions', 'organizations_url': 'https://api.github.com/users/glaringlee/orgs', 'repos_url': 'https://api.github.com/users/glaringlee/repos', 'events_url': 'https://api.github.com/users/glaringlee/events{/privacy}', 'received_events_url': 'https://api.github.com/users/glaringlee/received_events', 'type': 'User', 'site_admin': False}",referenced,db5da94bedf3c7c2c7c24bea777b99bd073d01b8,https://api.github.com/repos/pytorch/pytorch/commits/db5da94bedf3c7c2c7c24bea777b99bd073d01b8,2020-01-16T21:08:53Z,32,31,1
30480,2956206759,"{'login': 'glaringlee', 'id': 32228059, 'node_id': 'MDQ6VXNlcjMyMjI4MDU5', 'avatar_url': 'https://avatars1.githubusercontent.com/u/32228059?v=4', 'gravatar_id': '', 'url': 'https://api.github.com/users/glaringlee', 'html_url': 'https://github.com/glaringlee', 'followers_url': 'https://api.github.com/users/glaringlee/followers', 'following_url': 'https://api.github.com/users/glaringlee/following{/other_user}', 'gists_url': 'https://api.github.com/users/glaringlee/gists{/gist_id}', 'starred_url': 'https://api.github.com/users/glaringlee/starred{/owner}{/repo}', 'subscriptions_url': 'https://api.github.com/users/glaringlee/subscriptions', 'organizations_url': 'https://api.github.com/users/glaringlee/orgs', 'repos_url': 'https://api.github.com/users/glaringlee/repos', 'events_url': 'https://api.github.com/users/glaringlee/events{/privacy}', 'received_events_url': 'https://api.github.com/users/glaringlee/received_events', 'type': 'User', 'site_admin': False}",referenced,cc1ed729a5d411184c0daa3306e8c6215adaabb1,https://api.github.com/repos/pytorch/pytorch/commits/cc1ed729a5d411184c0daa3306e8c6215adaabb1,2020-01-16T21:55:25Z,23,22,1
30480,2956208365,"{'login': 'glaringlee', 'id': 32228059, 'node_id': 'MDQ6VXNlcjMyMjI4MDU5', 'avatar_url': 'https://avatars1.githubusercontent.com/u/32228059?v=4', 'gravatar_id': '', 'url': 'https://api.github.com/users/glaringlee', 'html_url': 'https://github.com/glaringlee', 'followers_url': 'https://api.github.com/users/glaringlee/followers', 'following_url': 'https://api.github.com/users/glaringlee/following{/other_user}', 'gists_url': 'https://api.github.com/users/glaringlee/gists{/gist_id}', 'starred_url': 'https://api.github.com/users/glaringlee/starred{/owner}{/repo}', 'subscriptions_url': 'https://api.github.com/users/glaringlee/subscriptions', 'organizations_url': 'https://api.github.com/users/glaringlee/orgs', 'repos_url': 'https://api.github.com/users/glaringlee/repos', 'events_url': 'https://api.github.com/users/glaringlee/events{/privacy}', 'received_events_url': 'https://api.github.com/users/glaringlee/received_events', 'type': 'User', 'site_admin': False}",referenced,49473bbc4bfce6e19629cfafc4c11d1b919736ce,https://api.github.com/repos/pytorch/pytorch/commits/49473bbc4bfce6e19629cfafc4c11d1b919736ce,2020-01-16T21:56:03Z,0,0,0
30480,2956208863,"{'login': 'glaringlee', 'id': 32228059, 'node_id': 'MDQ6VXNlcjMyMjI4MDU5', 'avatar_url': 'https://avatars1.githubusercontent.com/u/32228059?v=4', 'gravatar_id': '', 'url': 'https://api.github.com/users/glaringlee', 'html_url': 'https://github.com/glaringlee', 'followers_url': 'https://api.github.com/users/glaringlee/followers', 'following_url': 'https://api.github.com/users/glaringlee/following{/other_user}', 'gists_url': 'https://api.github.com/users/glaringlee/gists{/gist_id}', 'starred_url': 'https://api.github.com/users/glaringlee/starred{/owner}{/repo}', 'subscriptions_url': 'https://api.github.com/users/glaringlee/subscriptions', 'organizations_url': 'https://api.github.com/users/glaringlee/orgs', 'repos_url': 'https://api.github.com/users/glaringlee/repos', 'events_url': 'https://api.github.com/users/glaringlee/events{/privacy}', 'received_events_url': 'https://api.github.com/users/glaringlee/received_events', 'type': 'User', 'site_admin': False}",referenced,9f96d581418465beb978ffe1087277675bf41c94,https://api.github.com/repos/pytorch/pytorch/commits/9f96d581418465beb978ffe1087277675bf41c94,2020-01-16T21:56:15Z,53,52,1
30480,2971716694,"{'login': 'glaringlee', 'id': 32228059, 'node_id': 'MDQ6VXNlcjMyMjI4MDU5', 'avatar_url': 'https://avatars1.githubusercontent.com/u/32228059?v=4', 'gravatar_id': '', 'url': 'https://api.github.com/users/glaringlee', 'html_url': 'https://github.com/glaringlee', 'followers_url': 'https://api.github.com/users/glaringlee/followers', 'following_url': 'https://api.github.com/users/glaringlee/following{/other_user}', 'gists_url': 'https://api.github.com/users/glaringlee/gists{/gist_id}', 'starred_url': 'https://api.github.com/users/glaringlee/starred{/owner}{/repo}', 'subscriptions_url': 'https://api.github.com/users/glaringlee/subscriptions', 'organizations_url': 'https://api.github.com/users/glaringlee/orgs', 'repos_url': 'https://api.github.com/users/glaringlee/repos', 'events_url': 'https://api.github.com/users/glaringlee/events{/privacy}', 'received_events_url': 'https://api.github.com/users/glaringlee/received_events', 'type': 'User', 'site_admin': False}",referenced,8526e218263dc0fe53e62d30225ee644d531b378,https://api.github.com/repos/pytorch/pytorch/commits/8526e218263dc0fe53e62d30225ee644d531b378,2020-01-22T21:43:18Z,47,42,5
30480,2971717270,"{'login': 'glaringlee', 'id': 32228059, 'node_id': 'MDQ6VXNlcjMyMjI4MDU5', 'avatar_url': 'https://avatars1.githubusercontent.com/u/32228059?v=4', 'gravatar_id': '', 'url': 'https://api.github.com/users/glaringlee', 'html_url': 'https://github.com/glaringlee', 'followers_url': 'https://api.github.com/users/glaringlee/followers', 'following_url': 'https://api.github.com/users/glaringlee/following{/other_user}', 'gists_url': 'https://api.github.com/users/glaringlee/gists{/gist_id}', 'starred_url': 'https://api.github.com/users/glaringlee/starred{/owner}{/repo}', 'subscriptions_url': 'https://api.github.com/users/glaringlee/subscriptions', 'organizations_url': 'https://api.github.com/users/glaringlee/orgs', 'repos_url': 'https://api.github.com/users/glaringlee/repos', 'events_url': 'https://api.github.com/users/glaringlee/events{/privacy}', 'received_events_url': 'https://api.github.com/users/glaringlee/received_events', 'type': 'User', 'site_admin': False}",referenced,1d0613c4e7caf4c16f39978e00cec05d1b2d5f4e,https://api.github.com/repos/pytorch/pytorch/commits/1d0613c4e7caf4c16f39978e00cec05d1b2d5f4e,2020-01-22T21:43:29Z,92,90,2
30480,3003409944,"{'login': 'glaringlee', 'id': 32228059, 'node_id': 'MDQ6VXNlcjMyMjI4MDU5', 'avatar_url': 'https://avatars1.githubusercontent.com/u/32228059?v=4', 'gravatar_id': '', 'url': 'https://api.github.com/users/glaringlee', 'html_url': 'https://github.com/glaringlee', 'followers_url': 'https://api.github.com/users/glaringlee/followers', 'following_url': 'https://api.github.com/users/glaringlee/following{/other_user}', 'gists_url': 'https://api.github.com/users/glaringlee/gists{/gist_id}', 'starred_url': 'https://api.github.com/users/glaringlee/starred{/owner}{/repo}', 'subscriptions_url': 'https://api.github.com/users/glaringlee/subscriptions', 'organizations_url': 'https://api.github.com/users/glaringlee/orgs', 'repos_url': 'https://api.github.com/users/glaringlee/repos', 'events_url': 'https://api.github.com/users/glaringlee/events{/privacy}', 'received_events_url': 'https://api.github.com/users/glaringlee/received_events', 'type': 'User', 'site_admin': False}",referenced,c45fa14fbc368b216f8122e6144cdf1b1b681070,https://api.github.com/repos/pytorch/pytorch/commits/c45fa14fbc368b216f8122e6144cdf1b1b681070,2020-02-03T19:02:41Z,134,62,72
30480,3003410453,"{'login': 'glaringlee', 'id': 32228059, 'node_id': 'MDQ6VXNlcjMyMjI4MDU5', 'avatar_url': 'https://avatars1.githubusercontent.com/u/32228059?v=4', 'gravatar_id': '', 'url': 'https://api.github.com/users/glaringlee', 'html_url': 'https://github.com/glaringlee', 'followers_url': 'https://api.github.com/users/glaringlee/followers', 'following_url': 'https://api.github.com/users/glaringlee/following{/other_user}', 'gists_url': 'https://api.github.com/users/glaringlee/gists{/gist_id}', 'starred_url': 'https://api.github.com/users/glaringlee/starred{/owner}{/repo}', 'subscriptions_url': 'https://api.github.com/users/glaringlee/subscriptions', 'organizations_url': 'https://api.github.com/users/glaringlee/orgs', 'repos_url': 'https://api.github.com/users/glaringlee/repos', 'events_url': 'https://api.github.com/users/glaringlee/events{/privacy}', 'received_events_url': 'https://api.github.com/users/glaringlee/received_events', 'type': 'User', 'site_admin': False}",referenced,d427dd170cd8818558066315913960ffe12c8c24,https://api.github.com/repos/pytorch/pytorch/commits/d427dd170cd8818558066315913960ffe12c8c24,2020-02-03T19:02:51Z,82,80,2
30480,3003624635,"{'login': 'glaringlee', 'id': 32228059, 'node_id': 'MDQ6VXNlcjMyMjI4MDU5', 'avatar_url': 'https://avatars1.githubusercontent.com/u/32228059?v=4', 'gravatar_id': '', 'url': 'https://api.github.com/users/glaringlee', 'html_url': 'https://github.com/glaringlee', 'followers_url': 'https://api.github.com/users/glaringlee/followers', 'following_url': 'https://api.github.com/users/glaringlee/following{/other_user}', 'gists_url': 'https://api.github.com/users/glaringlee/gists{/gist_id}', 'starred_url': 'https://api.github.com/users/glaringlee/starred{/owner}{/repo}', 'subscriptions_url': 'https://api.github.com/users/glaringlee/subscriptions', 'organizations_url': 'https://api.github.com/users/glaringlee/orgs', 'repos_url': 'https://api.github.com/users/glaringlee/repos', 'events_url': 'https://api.github.com/users/glaringlee/events{/privacy}', 'received_events_url': 'https://api.github.com/users/glaringlee/received_events', 'type': 'User', 'site_admin': False}",referenced,18daff526c6e4520b6396b50db15eed8c713de96,https://api.github.com/repos/pytorch/pytorch/commits/18daff526c6e4520b6396b50db15eed8c713de96,2020-02-03T20:09:50Z,4,2,2
30480,3003625192,"{'login': 'glaringlee', 'id': 32228059, 'node_id': 'MDQ6VXNlcjMyMjI4MDU5', 'avatar_url': 'https://avatars1.githubusercontent.com/u/32228059?v=4', 'gravatar_id': '', 'url': 'https://api.github.com/users/glaringlee', 'html_url': 'https://github.com/glaringlee', 'followers_url': 'https://api.github.com/users/glaringlee/followers', 'following_url': 'https://api.github.com/users/glaringlee/following{/other_user}', 'gists_url': 'https://api.github.com/users/glaringlee/gists{/gist_id}', 'starred_url': 'https://api.github.com/users/glaringlee/starred{/owner}{/repo}', 'subscriptions_url': 'https://api.github.com/users/glaringlee/subscriptions', 'organizations_url': 'https://api.github.com/users/glaringlee/orgs', 'repos_url': 'https://api.github.com/users/glaringlee/repos', 'events_url': 'https://api.github.com/users/glaringlee/events{/privacy}', 'received_events_url': 'https://api.github.com/users/glaringlee/received_events', 'type': 'User', 'site_admin': False}",referenced,503477924f5ca0af1e7faebb9bc560aca5f4ae2d,https://api.github.com/repos/pytorch/pytorch/commits/503477924f5ca0af1e7faebb9bc560aca5f4ae2d,2020-02-03T20:10:00Z,82,80,2
30480,3004197034,"{'login': 'glaringlee', 'id': 32228059, 'node_id': 'MDQ6VXNlcjMyMjI4MDU5', 'avatar_url': 'https://avatars1.githubusercontent.com/u/32228059?v=4', 'gravatar_id': '', 'url': 'https://api.github.com/users/glaringlee', 'html_url': 'https://github.com/glaringlee', 'followers_url': 'https://api.github.com/users/glaringlee/followers', 'following_url': 'https://api.github.com/users/glaringlee/following{/other_user}', 'gists_url': 'https://api.github.com/users/glaringlee/gists{/gist_id}', 'starred_url': 'https://api.github.com/users/glaringlee/starred{/owner}{/repo}', 'subscriptions_url': 'https://api.github.com/users/glaringlee/subscriptions', 'organizations_url': 'https://api.github.com/users/glaringlee/orgs', 'repos_url': 'https://api.github.com/users/glaringlee/repos', 'events_url': 'https://api.github.com/users/glaringlee/events{/privacy}', 'received_events_url': 'https://api.github.com/users/glaringlee/received_events', 'type': 'User', 'site_admin': False}",referenced,8817897940aad1a2cc68e3187f5fb45543f1fda5,https://api.github.com/repos/pytorch/pytorch/commits/8817897940aad1a2cc68e3187f5fb45543f1fda5,2020-02-03T23:39:08Z,18,9,9
30480,3004197318,"{'login': 'glaringlee', 'id': 32228059, 'node_id': 'MDQ6VXNlcjMyMjI4MDU5', 'avatar_url': 'https://avatars1.githubusercontent.com/u/32228059?v=4', 'gravatar_id': '', 'url': 'https://api.github.com/users/glaringlee', 'html_url': 'https://github.com/glaringlee', 'followers_url': 'https://api.github.com/users/glaringlee/followers', 'following_url': 'https://api.github.com/users/glaringlee/following{/other_user}', 'gists_url': 'https://api.github.com/users/glaringlee/gists{/gist_id}', 'starred_url': 'https://api.github.com/users/glaringlee/starred{/owner}{/repo}', 'subscriptions_url': 'https://api.github.com/users/glaringlee/subscriptions', 'organizations_url': 'https://api.github.com/users/glaringlee/orgs', 'repos_url': 'https://api.github.com/users/glaringlee/repos', 'events_url': 'https://api.github.com/users/glaringlee/events{/privacy}', 'received_events_url': 'https://api.github.com/users/glaringlee/received_events', 'type': 'User', 'site_admin': False}",referenced,93d5651ae7ab4a07eddcf89b2158fa24c384571d,https://api.github.com/repos/pytorch/pytorch/commits/93d5651ae7ab4a07eddcf89b2158fa24c384571d,2020-02-03T23:39:16Z,82,80,2
30480,3008176676,"{'login': 'glaringlee', 'id': 32228059, 'node_id': 'MDQ6VXNlcjMyMjI4MDU5', 'avatar_url': 'https://avatars1.githubusercontent.com/u/32228059?v=4', 'gravatar_id': '', 'url': 'https://api.github.com/users/glaringlee', 'html_url': 'https://github.com/glaringlee', 'followers_url': 'https://api.github.com/users/glaringlee/followers', 'following_url': 'https://api.github.com/users/glaringlee/following{/other_user}', 'gists_url': 'https://api.github.com/users/glaringlee/gists{/gist_id}', 'starred_url': 'https://api.github.com/users/glaringlee/starred{/owner}{/repo}', 'subscriptions_url': 'https://api.github.com/users/glaringlee/subscriptions', 'organizations_url': 'https://api.github.com/users/glaringlee/orgs', 'repos_url': 'https://api.github.com/users/glaringlee/repos', 'events_url': 'https://api.github.com/users/glaringlee/events{/privacy}', 'received_events_url': 'https://api.github.com/users/glaringlee/received_events', 'type': 'User', 'site_admin': False}",referenced,a0c652e7279f2f70943956d3eb0c3313f7d719d3,https://api.github.com/repos/pytorch/pytorch/commits/a0c652e7279f2f70943956d3eb0c3313f7d719d3,2020-02-05T00:11:13Z,93,56,37
30480,3008176971,"{'login': 'glaringlee', 'id': 32228059, 'node_id': 'MDQ6VXNlcjMyMjI4MDU5', 'avatar_url': 'https://avatars1.githubusercontent.com/u/32228059?v=4', 'gravatar_id': '', 'url': 'https://api.github.com/users/glaringlee', 'html_url': 'https://github.com/glaringlee', 'followers_url': 'https://api.github.com/users/glaringlee/followers', 'following_url': 'https://api.github.com/users/glaringlee/following{/other_user}', 'gists_url': 'https://api.github.com/users/glaringlee/gists{/gist_id}', 'starred_url': 'https://api.github.com/users/glaringlee/starred{/owner}{/repo}', 'subscriptions_url': 'https://api.github.com/users/glaringlee/subscriptions', 'organizations_url': 'https://api.github.com/users/glaringlee/orgs', 'repos_url': 'https://api.github.com/users/glaringlee/repos', 'events_url': 'https://api.github.com/users/glaringlee/events{/privacy}', 'received_events_url': 'https://api.github.com/users/glaringlee/received_events', 'type': 'User', 'site_admin': False}",referenced,efac342b4b4f389cf83b5484dc1596bfe5f62a4c,https://api.github.com/repos/pytorch/pytorch/commits/efac342b4b4f389cf83b5484dc1596bfe5f62a4c,2020-02-05T00:11:22Z,103,100,3
30480,3011144225,"{'login': 'glaringlee', 'id': 32228059, 'node_id': 'MDQ6VXNlcjMyMjI4MDU5', 'avatar_url': 'https://avatars1.githubusercontent.com/u/32228059?v=4', 'gravatar_id': '', 'url': 'https://api.github.com/users/glaringlee', 'html_url': 'https://github.com/glaringlee', 'followers_url': 'https://api.github.com/users/glaringlee/followers', 'following_url': 'https://api.github.com/users/glaringlee/following{/other_user}', 'gists_url': 'https://api.github.com/users/glaringlee/gists{/gist_id}', 'starred_url': 'https://api.github.com/users/glaringlee/starred{/owner}{/repo}', 'subscriptions_url': 'https://api.github.com/users/glaringlee/subscriptions', 'organizations_url': 'https://api.github.com/users/glaringlee/orgs', 'repos_url': 'https://api.github.com/users/glaringlee/repos', 'events_url': 'https://api.github.com/users/glaringlee/events{/privacy}', 'received_events_url': 'https://api.github.com/users/glaringlee/received_events', 'type': 'User', 'site_admin': False}",referenced,9ec5330e3c2fd0207a87486ef2371b66918db2b4,https://api.github.com/repos/pytorch/pytorch/commits/9ec5330e3c2fd0207a87486ef2371b66918db2b4,2020-02-05T18:38:07Z,11,9,2
30480,3011144702,"{'login': 'glaringlee', 'id': 32228059, 'node_id': 'MDQ6VXNlcjMyMjI4MDU5', 'avatar_url': 'https://avatars1.githubusercontent.com/u/32228059?v=4', 'gravatar_id': '', 'url': 'https://api.github.com/users/glaringlee', 'html_url': 'https://github.com/glaringlee', 'followers_url': 'https://api.github.com/users/glaringlee/followers', 'following_url': 'https://api.github.com/users/glaringlee/following{/other_user}', 'gists_url': 'https://api.github.com/users/glaringlee/gists{/gist_id}', 'starred_url': 'https://api.github.com/users/glaringlee/starred{/owner}{/repo}', 'subscriptions_url': 'https://api.github.com/users/glaringlee/subscriptions', 'organizations_url': 'https://api.github.com/users/glaringlee/orgs', 'repos_url': 'https://api.github.com/users/glaringlee/repos', 'events_url': 'https://api.github.com/users/glaringlee/events{/privacy}', 'received_events_url': 'https://api.github.com/users/glaringlee/received_events', 'type': 'User', 'site_admin': False}",referenced,8ebe6f065f5c20357935f76375df0e4eb31113c5,https://api.github.com/repos/pytorch/pytorch/commits/8ebe6f065f5c20357935f76375df0e4eb31113c5,2020-02-05T18:38:16Z,110,107,3
30477,2879987034,"{'login': 'facebook-github-bot', 'id': 6422482, 'node_id': 'MDQ6VXNlcjY0MjI0ODI=', 'avatar_url': 'https://avatars3.githubusercontent.com/u/6422482?v=4', 'gravatar_id': '', 'url': 'https://api.github.com/users/facebook-github-bot', 'html_url': 'https://github.com/facebook-github-bot', 'followers_url': 'https://api.github.com/users/facebook-github-bot/followers', 'following_url': 'https://api.github.com/users/facebook-github-bot/following{/other_user}', 'gists_url': 'https://api.github.com/users/facebook-github-bot/gists{/gist_id}', 'starred_url': 'https://api.github.com/users/facebook-github-bot/starred{/owner}{/repo}', 'subscriptions_url': 'https://api.github.com/users/facebook-github-bot/subscriptions', 'organizations_url': 'https://api.github.com/users/facebook-github-bot/orgs', 'repos_url': 'https://api.github.com/users/facebook-github-bot/repos', 'events_url': 'https://api.github.com/users/facebook-github-bot/events{/privacy}', 'received_events_url': 'https://api.github.com/users/facebook-github-bot/received_events', 'type': 'User', 'site_admin': False}",closed,f30b14dead12776981bb0a9449deb52b2fd9f17d,https://api.github.com/repos/pytorch/pytorch/commits/f30b14dead12776981bb0a9449deb52b2fd9f17d,2019-12-13T02:19:43Z,33,27,6
30321,2823576322,"{'login': 'ezyang', 'id': 13564, 'node_id': 'MDQ6VXNlcjEzNTY0', 'avatar_url': 'https://avatars0.githubusercontent.com/u/13564?v=4', 'gravatar_id': '', 'url': 'https://api.github.com/users/ezyang', 'html_url': 'https://github.com/ezyang', 'followers_url': 'https://api.github.com/users/ezyang/followers', 'following_url': 'https://api.github.com/users/ezyang/following{/other_user}', 'gists_url': 'https://api.github.com/users/ezyang/gists{/gist_id}', 'starred_url': 'https://api.github.com/users/ezyang/starred{/owner}{/repo}', 'subscriptions_url': 'https://api.github.com/users/ezyang/subscriptions', 'organizations_url': 'https://api.github.com/users/ezyang/orgs', 'repos_url': 'https://api.github.com/users/ezyang/repos', 'events_url': 'https://api.github.com/users/ezyang/events{/privacy}', 'received_events_url': 'https://api.github.com/users/ezyang/received_events', 'type': 'User', 'site_admin': False}",referenced,8cf2dbe26b411f9781c057c21354c2bc1d74037c,https://api.github.com/repos/pytorch/pytorch/commits/8cf2dbe26b411f9781c057c21354c2bc1d74037c,2019-11-22T15:14:55Z,28,16,12
30321,2823578024,"{'login': 'ezyang', 'id': 13564, 'node_id': 'MDQ6VXNlcjEzNTY0', 'avatar_url': 'https://avatars0.githubusercontent.com/u/13564?v=4', 'gravatar_id': '', 'url': 'https://api.github.com/users/ezyang', 'html_url': 'https://github.com/ezyang', 'followers_url': 'https://api.github.com/users/ezyang/followers', 'following_url': 'https://api.github.com/users/ezyang/following{/other_user}', 'gists_url': 'https://api.github.com/users/ezyang/gists{/gist_id}', 'starred_url': 'https://api.github.com/users/ezyang/starred{/owner}{/repo}', 'subscriptions_url': 'https://api.github.com/users/ezyang/subscriptions', 'organizations_url': 'https://api.github.com/users/ezyang/orgs', 'repos_url': 'https://api.github.com/users/ezyang/repos', 'events_url': 'https://api.github.com/users/ezyang/events{/privacy}', 'received_events_url': 'https://api.github.com/users/ezyang/received_events', 'type': 'User', 'site_admin': False}",referenced,f20397fe69a0294574155640b7b9889cabbbc1ed,https://api.github.com/repos/pytorch/pytorch/commits/f20397fe69a0294574155640b7b9889cabbbc1ed,2019-11-22T15:15:25Z,4,4,0
30321,2823790687,"{'login': 'ezyang', 'id': 13564, 'node_id': 'MDQ6VXNlcjEzNTY0', 'avatar_url': 'https://avatars0.githubusercontent.com/u/13564?v=4', 'gravatar_id': '', 'url': 'https://api.github.com/users/ezyang', 'html_url': 'https://github.com/ezyang', 'followers_url': 'https://api.github.com/users/ezyang/followers', 'following_url': 'https://api.github.com/users/ezyang/following{/other_user}', 'gists_url': 'https://api.github.com/users/ezyang/gists{/gist_id}', 'starred_url': 'https://api.github.com/users/ezyang/starred{/owner}{/repo}', 'subscriptions_url': 'https://api.github.com/users/ezyang/subscriptions', 'organizations_url': 'https://api.github.com/users/ezyang/orgs', 'repos_url': 'https://api.github.com/users/ezyang/repos', 'events_url': 'https://api.github.com/users/ezyang/events{/privacy}', 'received_events_url': 'https://api.github.com/users/ezyang/received_events', 'type': 'User', 'site_admin': False}",referenced,44fae88b153d878dd5fe9e7e5a0764289cd2dff3,https://api.github.com/repos/pytorch/pytorch/commits/44fae88b153d878dd5fe9e7e5a0764289cd2dff3,2019-11-22T16:17:13Z,32,16,16
30301,2832993356,"{'login': 'facebook-github-bot', 'id': 6422482, 'node_id': 'MDQ6VXNlcjY0MjI0ODI=', 'avatar_url': 'https://avatars3.githubusercontent.com/u/6422482?v=4', 'gravatar_id': '', 'url': 'https://api.github.com/users/facebook-github-bot', 'html_url': 'https://github.com/facebook-github-bot', 'followers_url': 'https://api.github.com/users/facebook-github-bot/followers', 'following_url': 'https://api.github.com/users/facebook-github-bot/following{/other_user}', 'gists_url': 'https://api.github.com/users/facebook-github-bot/gists{/gist_id}', 'starred_url': 'https://api.github.com/users/facebook-github-bot/starred{/owner}{/repo}', 'subscriptions_url': 'https://api.github.com/users/facebook-github-bot/subscriptions', 'organizations_url': 'https://api.github.com/users/facebook-github-bot/orgs', 'repos_url': 'https://api.github.com/users/facebook-github-bot/repos', 'events_url': 'https://api.github.com/users/facebook-github-bot/events{/privacy}', 'received_events_url': 'https://api.github.com/users/facebook-github-bot/received_events', 'type': 'User', 'site_admin': False}",closed,dcd9f49809ad76baed2f6ebc3ae6797720a04b61,https://api.github.com/repos/pytorch/pytorch/commits/dcd9f49809ad76baed2f6ebc3ae6797720a04b61,2019-11-26T18:24:02Z,6,6,0
30301,2899139130,"{'login': 'mingbowan', 'id': 2181364, 'node_id': 'MDQ6VXNlcjIxODEzNjQ=', 'avatar_url': 'https://avatars2.githubusercontent.com/u/2181364?v=4', 'gravatar_id': '', 'url': 'https://api.github.com/users/mingbowan', 'html_url': 'https://github.com/mingbowan', 'followers_url': 'https://api.github.com/users/mingbowan/followers', 'following_url': 'https://api.github.com/users/mingbowan/following{/other_user}', 'gists_url': 'https://api.github.com/users/mingbowan/gists{/gist_id}', 'starred_url': 'https://api.github.com/users/mingbowan/starred{/owner}{/repo}', 'subscriptions_url': 'https://api.github.com/users/mingbowan/subscriptions', 'organizations_url': 'https://api.github.com/users/mingbowan/orgs', 'repos_url': 'https://api.github.com/users/mingbowan/repos', 'events_url': 'https://api.github.com/users/mingbowan/events{/privacy}', 'received_events_url': 'https://api.github.com/users/mingbowan/received_events', 'type': 'User', 'site_admin': False}",referenced,19d4fd4910d0832eb2291a82e54465b67ea6f535,https://api.github.com/repos/pytorch/pytorch/commits/19d4fd4910d0832eb2291a82e54465b67ea6f535,2019-12-20T00:10:09Z,6,6,0
30296,2823519353,"{'login': 'ezyang', 'id': 13564, 'node_id': 'MDQ6VXNlcjEzNTY0', 'avatar_url': 'https://avatars0.githubusercontent.com/u/13564?v=4', 'gravatar_id': '', 'url': 'https://api.github.com/users/ezyang', 'html_url': 'https://github.com/ezyang', 'followers_url': 'https://api.github.com/users/ezyang/followers', 'following_url': 'https://api.github.com/users/ezyang/following{/other_user}', 'gists_url': 'https://api.github.com/users/ezyang/gists{/gist_id}', 'starred_url': 'https://api.github.com/users/ezyang/starred{/owner}{/repo}', 'subscriptions_url': 'https://api.github.com/users/ezyang/subscriptions', 'organizations_url': 'https://api.github.com/users/ezyang/orgs', 'repos_url': 'https://api.github.com/users/ezyang/repos', 'events_url': 'https://api.github.com/users/ezyang/events{/privacy}', 'received_events_url': 'https://api.github.com/users/ezyang/received_events', 'type': 'User', 'site_admin': False}",referenced,7bcae60ff925c504d52c2baea74a1d9f9dd073f1,https://api.github.com/repos/pytorch/pytorch/commits/7bcae60ff925c504d52c2baea74a1d9f9dd073f1,2019-11-22T14:58:03Z,6,3,3
30296,2823519928,"{'login': 'ezyang', 'id': 13564, 'node_id': 'MDQ6VXNlcjEzNTY0', 'avatar_url': 'https://avatars0.githubusercontent.com/u/13564?v=4', 'gravatar_id': '', 'url': 'https://api.github.com/users/ezyang', 'html_url': 'https://github.com/ezyang', 'followers_url': 'https://api.github.com/users/ezyang/followers', 'following_url': 'https://api.github.com/users/ezyang/following{/other_user}', 'gists_url': 'https://api.github.com/users/ezyang/gists{/gist_id}', 'starred_url': 'https://api.github.com/users/ezyang/starred{/owner}{/repo}', 'subscriptions_url': 'https://api.github.com/users/ezyang/subscriptions', 'organizations_url': 'https://api.github.com/users/ezyang/orgs', 'repos_url': 'https://api.github.com/users/ezyang/repos', 'events_url': 'https://api.github.com/users/ezyang/events{/privacy}', 'received_events_url': 'https://api.github.com/users/ezyang/received_events', 'type': 'User', 'site_admin': False}",referenced,44b1fb48c91bbc9a266276d1bd789e361410dc88,https://api.github.com/repos/pytorch/pytorch/commits/44b1fb48c91bbc9a266276d1bd789e361410dc88,2019-11-22T14:58:12Z,6,3,3
30296,2829911215,"{'login': 'facebook-github-bot', 'id': 6422482, 'node_id': 'MDQ6VXNlcjY0MjI0ODI=', 'avatar_url': 'https://avatars3.githubusercontent.com/u/6422482?v=4', 'gravatar_id': '', 'url': 'https://api.github.com/users/facebook-github-bot', 'html_url': 'https://github.com/facebook-github-bot', 'followers_url': 'https://api.github.com/users/facebook-github-bot/followers', 'following_url': 'https://api.github.com/users/facebook-github-bot/following{/other_user}', 'gists_url': 'https://api.github.com/users/facebook-github-bot/gists{/gist_id}', 'starred_url': 'https://api.github.com/users/facebook-github-bot/starred{/owner}{/repo}', 'subscriptions_url': 'https://api.github.com/users/facebook-github-bot/subscriptions', 'organizations_url': 'https://api.github.com/users/facebook-github-bot/orgs', 'repos_url': 'https://api.github.com/users/facebook-github-bot/repos', 'events_url': 'https://api.github.com/users/facebook-github-bot/events{/privacy}', 'received_events_url': 'https://api.github.com/users/facebook-github-bot/received_events', 'type': 'User', 'site_admin': False}",closed,99a46b44eaeb36689ca99f97e41fccaa51d3c127,https://api.github.com/repos/pytorch/pytorch/commits/99a46b44eaeb36689ca99f97e41fccaa51d3c127,2019-11-25T22:53:11Z,6,3,3
30283,2825470373,"{'login': 'facebook-github-bot', 'id': 6422482, 'node_id': 'MDQ6VXNlcjY0MjI0ODI=', 'avatar_url': 'https://avatars3.githubusercontent.com/u/6422482?v=4', 'gravatar_id': '', 'url': 'https://api.github.com/users/facebook-github-bot', 'html_url': 'https://github.com/facebook-github-bot', 'followers_url': 'https://api.github.com/users/facebook-github-bot/followers', 'following_url': 'https://api.github.com/users/facebook-github-bot/following{/other_user}', 'gists_url': 'https://api.github.com/users/facebook-github-bot/gists{/gist_id}', 'starred_url': 'https://api.github.com/users/facebook-github-bot/starred{/owner}{/repo}', 'subscriptions_url': 'https://api.github.com/users/facebook-github-bot/subscriptions', 'organizations_url': 'https://api.github.com/users/facebook-github-bot/orgs', 'repos_url': 'https://api.github.com/users/facebook-github-bot/repos', 'events_url': 'https://api.github.com/users/facebook-github-bot/events{/privacy}', 'received_events_url': 'https://api.github.com/users/facebook-github-bot/received_events', 'type': 'User', 'site_admin': False}",referenced,7c4b9042ababa32dcd49e8d35114c81c53027431,https://api.github.com/repos/pytorch/pytorch/commits/7c4b9042ababa32dcd49e8d35114c81c53027431,2019-11-23T17:29:43Z,79,67,12
30283,2899122642,"{'login': 'mingbowan', 'id': 2181364, 'node_id': 'MDQ6VXNlcjIxODEzNjQ=', 'avatar_url': 'https://avatars2.githubusercontent.com/u/2181364?v=4', 'gravatar_id': '', 'url': 'https://api.github.com/users/mingbowan', 'html_url': 'https://github.com/mingbowan', 'followers_url': 'https://api.github.com/users/mingbowan/followers', 'following_url': 'https://api.github.com/users/mingbowan/following{/other_user}', 'gists_url': 'https://api.github.com/users/mingbowan/gists{/gist_id}', 'starred_url': 'https://api.github.com/users/mingbowan/starred{/owner}{/repo}', 'subscriptions_url': 'https://api.github.com/users/mingbowan/subscriptions', 'organizations_url': 'https://api.github.com/users/mingbowan/orgs', 'repos_url': 'https://api.github.com/users/mingbowan/repos', 'events_url': 'https://api.github.com/users/mingbowan/events{/privacy}', 'received_events_url': 'https://api.github.com/users/mingbowan/received_events', 'type': 'User', 'site_admin': False}",referenced,9e7dc37f902af78b26739410766e79e63f53e27f,https://api.github.com/repos/pytorch/pytorch/commits/9e7dc37f902af78b26739410766e79e63f53e27f,2019-12-20T00:01:12Z,79,67,12
30184,2863062609,"{'login': 'facebook-github-bot', 'id': 6422482, 'node_id': 'MDQ6VXNlcjY0MjI0ODI=', 'avatar_url': 'https://avatars3.githubusercontent.com/u/6422482?v=4', 'gravatar_id': '', 'url': 'https://api.github.com/users/facebook-github-bot', 'html_url': 'https://github.com/facebook-github-bot', 'followers_url': 'https://api.github.com/users/facebook-github-bot/followers', 'following_url': 'https://api.github.com/users/facebook-github-bot/following{/other_user}', 'gists_url': 'https://api.github.com/users/facebook-github-bot/gists{/gist_id}', 'starred_url': 'https://api.github.com/users/facebook-github-bot/starred{/owner}{/repo}', 'subscriptions_url': 'https://api.github.com/users/facebook-github-bot/subscriptions', 'organizations_url': 'https://api.github.com/users/facebook-github-bot/orgs', 'repos_url': 'https://api.github.com/users/facebook-github-bot/repos', 'events_url': 'https://api.github.com/users/facebook-github-bot/events{/privacy}', 'received_events_url': 'https://api.github.com/users/facebook-github-bot/received_events', 'type': 'User', 'site_admin': False}",closed,c37de32b2386efaf7166e2e54ab406a47c8b3b34,https://api.github.com/repos/pytorch/pytorch/commits/c37de32b2386efaf7166e2e54ab406a47c8b3b34,2019-12-06T23:38:20Z,123,94,29
30102,2848672142,"{'login': 'smessmer', 'id': 2373925, 'node_id': 'MDQ6VXNlcjIzNzM5MjU=', 'avatar_url': 'https://avatars3.githubusercontent.com/u/2373925?v=4', 'gravatar_id': '', 'url': 'https://api.github.com/users/smessmer', 'html_url': 'https://github.com/smessmer', 'followers_url': 'https://api.github.com/users/smessmer/followers', 'following_url': 'https://api.github.com/users/smessmer/following{/other_user}', 'gists_url': 'https://api.github.com/users/smessmer/gists{/gist_id}', 'starred_url': 'https://api.github.com/users/smessmer/starred{/owner}{/repo}', 'subscriptions_url': 'https://api.github.com/users/smessmer/subscriptions', 'organizations_url': 'https://api.github.com/users/smessmer/orgs', 'repos_url': 'https://api.github.com/users/smessmer/repos', 'events_url': 'https://api.github.com/users/smessmer/events{/privacy}', 'received_events_url': 'https://api.github.com/users/smessmer/received_events', 'type': 'User', 'site_admin': False}",referenced,aee632482f7cd55b8f63a5209a2c8336f555abbf,https://api.github.com/repos/pytorch/pytorch/commits/aee632482f7cd55b8f63a5209a2c8336f555abbf,2019-12-03T06:13:57Z,320,202,118
30102,2848942112,"{'login': 'smessmer', 'id': 2373925, 'node_id': 'MDQ6VXNlcjIzNzM5MjU=', 'avatar_url': 'https://avatars3.githubusercontent.com/u/2373925?v=4', 'gravatar_id': '', 'url': 'https://api.github.com/users/smessmer', 'html_url': 'https://github.com/smessmer', 'followers_url': 'https://api.github.com/users/smessmer/followers', 'following_url': 'https://api.github.com/users/smessmer/following{/other_user}', 'gists_url': 'https://api.github.com/users/smessmer/gists{/gist_id}', 'starred_url': 'https://api.github.com/users/smessmer/starred{/owner}{/repo}', 'subscriptions_url': 'https://api.github.com/users/smessmer/subscriptions', 'organizations_url': 'https://api.github.com/users/smessmer/orgs', 'repos_url': 'https://api.github.com/users/smessmer/repos', 'events_url': 'https://api.github.com/users/smessmer/events{/privacy}', 'received_events_url': 'https://api.github.com/users/smessmer/received_events', 'type': 'User', 'site_admin': False}",referenced,5df21017cb86468e5f7f0ae6896c1a3c7dc38662,https://api.github.com/repos/pytorch/pytorch/commits/5df21017cb86468e5f7f0ae6896c1a3c7dc38662,2019-12-03T08:09:12Z,576,394,182
30102,2852171291,"{'login': 'smessmer', 'id': 2373925, 'node_id': 'MDQ6VXNlcjIzNzM5MjU=', 'avatar_url': 'https://avatars3.githubusercontent.com/u/2373925?v=4', 'gravatar_id': '', 'url': 'https://api.github.com/users/smessmer', 'html_url': 'https://github.com/smessmer', 'followers_url': 'https://api.github.com/users/smessmer/followers', 'following_url': 'https://api.github.com/users/smessmer/following{/other_user}', 'gists_url': 'https://api.github.com/users/smessmer/gists{/gist_id}', 'starred_url': 'https://api.github.com/users/smessmer/starred{/owner}{/repo}', 'subscriptions_url': 'https://api.github.com/users/smessmer/subscriptions', 'organizations_url': 'https://api.github.com/users/smessmer/orgs', 'repos_url': 'https://api.github.com/users/smessmer/repos', 'events_url': 'https://api.github.com/users/smessmer/events{/privacy}', 'received_events_url': 'https://api.github.com/users/smessmer/received_events', 'type': 'User', 'site_admin': False}",referenced,6aa31ef2f8bd2a22d943ba03ae5ea604807d5cac,https://api.github.com/repos/pytorch/pytorch/commits/6aa31ef2f8bd2a22d943ba03ae5ea604807d5cac,2019-12-04T00:29:27Z,935,502,433
30102,2855902070,"{'login': 'smessmer', 'id': 2373925, 'node_id': 'MDQ6VXNlcjIzNzM5MjU=', 'avatar_url': 'https://avatars3.githubusercontent.com/u/2373925?v=4', 'gravatar_id': '', 'url': 'https://api.github.com/users/smessmer', 'html_url': 'https://github.com/smessmer', 'followers_url': 'https://api.github.com/users/smessmer/followers', 'following_url': 'https://api.github.com/users/smessmer/following{/other_user}', 'gists_url': 'https://api.github.com/users/smessmer/gists{/gist_id}', 'starred_url': 'https://api.github.com/users/smessmer/starred{/owner}{/repo}', 'subscriptions_url': 'https://api.github.com/users/smessmer/subscriptions', 'organizations_url': 'https://api.github.com/users/smessmer/orgs', 'repos_url': 'https://api.github.com/users/smessmer/repos', 'events_url': 'https://api.github.com/users/smessmer/events{/privacy}', 'received_events_url': 'https://api.github.com/users/smessmer/received_events', 'type': 'User', 'site_admin': False}",referenced,ae04009430623771ad90db4777c4971cac061d12,https://api.github.com/repos/pytorch/pytorch/commits/ae04009430623771ad90db4777c4971cac061d12,2019-12-04T23:20:18Z,2,1,1
30102,2860594328,"{'login': 'smessmer', 'id': 2373925, 'node_id': 'MDQ6VXNlcjIzNzM5MjU=', 'avatar_url': 'https://avatars3.githubusercontent.com/u/2373925?v=4', 'gravatar_id': '', 'url': 'https://api.github.com/users/smessmer', 'html_url': 'https://github.com/smessmer', 'followers_url': 'https://api.github.com/users/smessmer/followers', 'following_url': 'https://api.github.com/users/smessmer/following{/other_user}', 'gists_url': 'https://api.github.com/users/smessmer/gists{/gist_id}', 'starred_url': 'https://api.github.com/users/smessmer/starred{/owner}{/repo}', 'subscriptions_url': 'https://api.github.com/users/smessmer/subscriptions', 'organizations_url': 'https://api.github.com/users/smessmer/orgs', 'repos_url': 'https://api.github.com/users/smessmer/repos', 'events_url': 'https://api.github.com/users/smessmer/events{/privacy}', 'received_events_url': 'https://api.github.com/users/smessmer/received_events', 'type': 'User', 'site_admin': False}",referenced,216b8f598b31b2ac10605bdbcbf509be608bc83f,https://api.github.com/repos/pytorch/pytorch/commits/216b8f598b31b2ac10605bdbcbf509be608bc83f,2019-12-06T08:51:29Z,9830,7505,2325
30102,2862556104,"{'login': 'facebook-github-bot', 'id': 6422482, 'node_id': 'MDQ6VXNlcjY0MjI0ODI=', 'avatar_url': 'https://avatars3.githubusercontent.com/u/6422482?v=4', 'gravatar_id': '', 'url': 'https://api.github.com/users/facebook-github-bot', 'html_url': 'https://github.com/facebook-github-bot', 'followers_url': 'https://api.github.com/users/facebook-github-bot/followers', 'following_url': 'https://api.github.com/users/facebook-github-bot/following{/other_user}', 'gists_url': 'https://api.github.com/users/facebook-github-bot/gists{/gist_id}', 'starred_url': 'https://api.github.com/users/facebook-github-bot/starred{/owner}{/repo}', 'subscriptions_url': 'https://api.github.com/users/facebook-github-bot/subscriptions', 'organizations_url': 'https://api.github.com/users/facebook-github-bot/orgs', 'repos_url': 'https://api.github.com/users/facebook-github-bot/repos', 'events_url': 'https://api.github.com/users/facebook-github-bot/events{/privacy}', 'received_events_url': 'https://api.github.com/users/facebook-github-bot/received_events', 'type': 'User', 'site_admin': False}",referenced,37435d36eddca3778014503aeaeef1f0dccb8bb2,https://api.github.com/repos/pytorch/pytorch/commits/37435d36eddca3778014503aeaeef1f0dccb8bb2,2019-12-06T19:45:22Z,297,212,85
30044,2821194244,"{'login': 'nairbv', 'id': 582713, 'node_id': 'MDQ6VXNlcjU4MjcxMw==', 'avatar_url': 'https://avatars1.githubusercontent.com/u/582713?v=4', 'gravatar_id': '', 'url': 'https://api.github.com/users/nairbv', 'html_url': 'https://github.com/nairbv', 'followers_url': 'https://api.github.com/users/nairbv/followers', 'following_url': 'https://api.github.com/users/nairbv/following{/other_user}', 'gists_url': 'https://api.github.com/users/nairbv/gists{/gist_id}', 'starred_url': 'https://api.github.com/users/nairbv/starred{/owner}{/repo}', 'subscriptions_url': 'https://api.github.com/users/nairbv/subscriptions', 'organizations_url': 'https://api.github.com/users/nairbv/orgs', 'repos_url': 'https://api.github.com/users/nairbv/repos', 'events_url': 'https://api.github.com/users/nairbv/events{/privacy}', 'received_events_url': 'https://api.github.com/users/nairbv/received_events', 'type': 'User', 'site_admin': False}",referenced,52a8df3756bc2adda2c7ad8fc48c170cbca26a5b,https://api.github.com/repos/pytorch/pytorch/commits/52a8df3756bc2adda2c7ad8fc48c170cbca26a5b,2019-11-21T21:16:25Z,1,1,0
30044,2821194516,"{'login': 'nairbv', 'id': 582713, 'node_id': 'MDQ6VXNlcjU4MjcxMw==', 'avatar_url': 'https://avatars1.githubusercontent.com/u/582713?v=4', 'gravatar_id': '', 'url': 'https://api.github.com/users/nairbv', 'html_url': 'https://github.com/nairbv', 'followers_url': 'https://api.github.com/users/nairbv/followers', 'following_url': 'https://api.github.com/users/nairbv/following{/other_user}', 'gists_url': 'https://api.github.com/users/nairbv/gists{/gist_id}', 'starred_url': 'https://api.github.com/users/nairbv/starred{/owner}{/repo}', 'subscriptions_url': 'https://api.github.com/users/nairbv/subscriptions', 'organizations_url': 'https://api.github.com/users/nairbv/orgs', 'repos_url': 'https://api.github.com/users/nairbv/repos', 'events_url': 'https://api.github.com/users/nairbv/events{/privacy}', 'received_events_url': 'https://api.github.com/users/nairbv/received_events', 'type': 'User', 'site_admin': False}",referenced,5a5e196f10f53d8de34166e9eff03b5c01163674,https://api.github.com/repos/pytorch/pytorch/commits/5a5e196f10f53d8de34166e9eff03b5c01163674,2019-11-21T21:16:32Z,1,1,0
30044,2821294342,"{'login': 'nairbv', 'id': 582713, 'node_id': 'MDQ6VXNlcjU4MjcxMw==', 'avatar_url': 'https://avatars1.githubusercontent.com/u/582713?v=4', 'gravatar_id': '', 'url': 'https://api.github.com/users/nairbv', 'html_url': 'https://github.com/nairbv', 'followers_url': 'https://api.github.com/users/nairbv/followers', 'following_url': 'https://api.github.com/users/nairbv/following{/other_user}', 'gists_url': 'https://api.github.com/users/nairbv/gists{/gist_id}', 'starred_url': 'https://api.github.com/users/nairbv/starred{/owner}{/repo}', 'subscriptions_url': 'https://api.github.com/users/nairbv/subscriptions', 'organizations_url': 'https://api.github.com/users/nairbv/orgs', 'repos_url': 'https://api.github.com/users/nairbv/repos', 'events_url': 'https://api.github.com/users/nairbv/events{/privacy}', 'received_events_url': 'https://api.github.com/users/nairbv/received_events', 'type': 'User', 'site_admin': False}",referenced,5e901327a802f677db7e87eb17ee32d0724e40c2,https://api.github.com/repos/pytorch/pytorch/commits/5e901327a802f677db7e87eb17ee32d0724e40c2,2019-11-21T21:51:18Z,6,5,1
30044,2821294705,"{'login': 'nairbv', 'id': 582713, 'node_id': 'MDQ6VXNlcjU4MjcxMw==', 'avatar_url': 'https://avatars1.githubusercontent.com/u/582713?v=4', 'gravatar_id': '', 'url': 'https://api.github.com/users/nairbv', 'html_url': 'https://github.com/nairbv', 'followers_url': 'https://api.github.com/users/nairbv/followers', 'following_url': 'https://api.github.com/users/nairbv/following{/other_user}', 'gists_url': 'https://api.github.com/users/nairbv/gists{/gist_id}', 'starred_url': 'https://api.github.com/users/nairbv/starred{/owner}{/repo}', 'subscriptions_url': 'https://api.github.com/users/nairbv/subscriptions', 'organizations_url': 'https://api.github.com/users/nairbv/orgs', 'repos_url': 'https://api.github.com/users/nairbv/repos', 'events_url': 'https://api.github.com/users/nairbv/events{/privacy}', 'received_events_url': 'https://api.github.com/users/nairbv/received_events', 'type': 'User', 'site_admin': False}",referenced,2416b9d9c684d759aaa62ccb7fe421ce891323cf,https://api.github.com/repos/pytorch/pytorch/commits/2416b9d9c684d759aaa62ccb7fe421ce891323cf,2019-11-21T21:51:25Z,5,5,0
30044,2821354486,"{'login': 'nairbv', 'id': 582713, 'node_id': 'MDQ6VXNlcjU4MjcxMw==', 'avatar_url': 'https://avatars1.githubusercontent.com/u/582713?v=4', 'gravatar_id': '', 'url': 'https://api.github.com/users/nairbv', 'html_url': 'https://github.com/nairbv', 'followers_url': 'https://api.github.com/users/nairbv/followers', 'following_url': 'https://api.github.com/users/nairbv/following{/other_user}', 'gists_url': 'https://api.github.com/users/nairbv/gists{/gist_id}', 'starred_url': 'https://api.github.com/users/nairbv/starred{/owner}{/repo}', 'subscriptions_url': 'https://api.github.com/users/nairbv/subscriptions', 'organizations_url': 'https://api.github.com/users/nairbv/orgs', 'repos_url': 'https://api.github.com/users/nairbv/repos', 'events_url': 'https://api.github.com/users/nairbv/events{/privacy}', 'received_events_url': 'https://api.github.com/users/nairbv/received_events', 'type': 'User', 'site_admin': False}",referenced,2ba815b3fb0c60c75a5049f8863df2af882329c5,https://api.github.com/repos/pytorch/pytorch/commits/2ba815b3fb0c60c75a5049f8863df2af882329c5,2019-11-21T22:13:00Z,7,3,4
30044,2821354763,"{'login': 'nairbv', 'id': 582713, 'node_id': 'MDQ6VXNlcjU4MjcxMw==', 'avatar_url': 'https://avatars1.githubusercontent.com/u/582713?v=4', 'gravatar_id': '', 'url': 'https://api.github.com/users/nairbv', 'html_url': 'https://github.com/nairbv', 'followers_url': 'https://api.github.com/users/nairbv/followers', 'following_url': 'https://api.github.com/users/nairbv/following{/other_user}', 'gists_url': 'https://api.github.com/users/nairbv/gists{/gist_id}', 'starred_url': 'https://api.github.com/users/nairbv/starred{/owner}{/repo}', 'subscriptions_url': 'https://api.github.com/users/nairbv/subscriptions', 'organizations_url': 'https://api.github.com/users/nairbv/orgs', 'repos_url': 'https://api.github.com/users/nairbv/repos', 'events_url': 'https://api.github.com/users/nairbv/events{/privacy}', 'received_events_url': 'https://api.github.com/users/nairbv/received_events', 'type': 'User', 'site_admin': False}",referenced,9f7a9f50fec122aee4e80165ecb2e81ed6eea3b3,https://api.github.com/repos/pytorch/pytorch/commits/9f7a9f50fec122aee4e80165ecb2e81ed6eea3b3,2019-11-21T22:13:06Z,4,4,0
30044,2824346593,"{'login': 'facebook-github-bot', 'id': 6422482, 'node_id': 'MDQ6VXNlcjY0MjI0ODI=', 'avatar_url': 'https://avatars3.githubusercontent.com/u/6422482?v=4', 'gravatar_id': '', 'url': 'https://api.github.com/users/facebook-github-bot', 'html_url': 'https://github.com/facebook-github-bot', 'followers_url': 'https://api.github.com/users/facebook-github-bot/followers', 'following_url': 'https://api.github.com/users/facebook-github-bot/following{/other_user}', 'gists_url': 'https://api.github.com/users/facebook-github-bot/gists{/gist_id}', 'starred_url': 'https://api.github.com/users/facebook-github-bot/starred{/owner}{/repo}', 'subscriptions_url': 'https://api.github.com/users/facebook-github-bot/subscriptions', 'organizations_url': 'https://api.github.com/users/facebook-github-bot/orgs', 'repos_url': 'https://api.github.com/users/facebook-github-bot/repos', 'events_url': 'https://api.github.com/users/facebook-github-bot/events{/privacy}', 'received_events_url': 'https://api.github.com/users/facebook-github-bot/received_events', 'type': 'User', 'site_admin': False}",closed,a5272cb6433efe0bdaf76bff428ce961538daa25,https://api.github.com/repos/pytorch/pytorch/commits/a5272cb6433efe0bdaf76bff428ce961538daa25,2019-11-22T19:31:40Z,4,4,0
30022,2926536385,"{'login': 'facebook-github-bot', 'id': 6422482, 'node_id': 'MDQ6VXNlcjY0MjI0ODI=', 'avatar_url': 'https://avatars3.githubusercontent.com/u/6422482?v=4', 'gravatar_id': '', 'url': 'https://api.github.com/users/facebook-github-bot', 'html_url': 'https://github.com/facebook-github-bot', 'followers_url': 'https://api.github.com/users/facebook-github-bot/followers', 'following_url': 'https://api.github.com/users/facebook-github-bot/following{/other_user}', 'gists_url': 'https://api.github.com/users/facebook-github-bot/gists{/gist_id}', 'starred_url': 'https://api.github.com/users/facebook-github-bot/starred{/owner}{/repo}', 'subscriptions_url': 'https://api.github.com/users/facebook-github-bot/subscriptions', 'organizations_url': 'https://api.github.com/users/facebook-github-bot/orgs', 'repos_url': 'https://api.github.com/users/facebook-github-bot/repos', 'events_url': 'https://api.github.com/users/facebook-github-bot/events{/privacy}', 'received_events_url': 'https://api.github.com/users/facebook-github-bot/received_events', 'type': 'User', 'site_admin': False}",referenced,a561a8448b6b7bb8f6068178fe7bc9e2bf348304,https://api.github.com/repos/pytorch/pytorch/commits/a561a8448b6b7bb8f6068178fe7bc9e2bf348304,2020-01-07T06:19:16Z,21,7,14
30015,2876561288,"{'login': 'facebook-github-bot', 'id': 6422482, 'node_id': 'MDQ6VXNlcjY0MjI0ODI=', 'avatar_url': 'https://avatars3.githubusercontent.com/u/6422482?v=4', 'gravatar_id': '', 'url': 'https://api.github.com/users/facebook-github-bot', 'html_url': 'https://github.com/facebook-github-bot', 'followers_url': 'https://api.github.com/users/facebook-github-bot/followers', 'following_url': 'https://api.github.com/users/facebook-github-bot/following{/other_user}', 'gists_url': 'https://api.github.com/users/facebook-github-bot/gists{/gist_id}', 'starred_url': 'https://api.github.com/users/facebook-github-bot/starred{/owner}{/repo}', 'subscriptions_url': 'https://api.github.com/users/facebook-github-bot/subscriptions', 'organizations_url': 'https://api.github.com/users/facebook-github-bot/orgs', 'repos_url': 'https://api.github.com/users/facebook-github-bot/repos', 'events_url': 'https://api.github.com/users/facebook-github-bot/events{/privacy}', 'received_events_url': 'https://api.github.com/users/facebook-github-bot/received_events', 'type': 'User', 'site_admin': False}",referenced,85107e72b4abb1007de94287707985dd06e977db,https://api.github.com/repos/pytorch/pytorch/commits/85107e72b4abb1007de94287707985dd06e977db,2019-12-12T04:11:47Z,120,85,35
29995,2833718121,"{'login': 'zou3519', 'id': 5652049, 'node_id': 'MDQ6VXNlcjU2NTIwNDk=', 'avatar_url': 'https://avatars3.githubusercontent.com/u/5652049?v=4', 'gravatar_id': '', 'url': 'https://api.github.com/users/zou3519', 'html_url': 'https://github.com/zou3519', 'followers_url': 'https://api.github.com/users/zou3519/followers', 'following_url': 'https://api.github.com/users/zou3519/following{/other_user}', 'gists_url': 'https://api.github.com/users/zou3519/gists{/gist_id}', 'starred_url': 'https://api.github.com/users/zou3519/starred{/owner}{/repo}', 'subscriptions_url': 'https://api.github.com/users/zou3519/subscriptions', 'organizations_url': 'https://api.github.com/users/zou3519/orgs', 'repos_url': 'https://api.github.com/users/zou3519/repos', 'events_url': 'https://api.github.com/users/zou3519/events{/privacy}', 'received_events_url': 'https://api.github.com/users/zou3519/received_events', 'type': 'User', 'site_admin': False}",referenced,0d3db1f77a3a03add4470e6fe758c0343ad5cbc2,https://api.github.com/repos/pytorch/pytorch/commits/0d3db1f77a3a03add4470e6fe758c0343ad5cbc2,2019-11-26T22:49:49Z,4,2,2
29995,2833718245,"{'login': 'zou3519', 'id': 5652049, 'node_id': 'MDQ6VXNlcjU2NTIwNDk=', 'avatar_url': 'https://avatars3.githubusercontent.com/u/5652049?v=4', 'gravatar_id': '', 'url': 'https://api.github.com/users/zou3519', 'html_url': 'https://github.com/zou3519', 'followers_url': 'https://api.github.com/users/zou3519/followers', 'following_url': 'https://api.github.com/users/zou3519/following{/other_user}', 'gists_url': 'https://api.github.com/users/zou3519/gists{/gist_id}', 'starred_url': 'https://api.github.com/users/zou3519/starred{/owner}{/repo}', 'subscriptions_url': 'https://api.github.com/users/zou3519/subscriptions', 'organizations_url': 'https://api.github.com/users/zou3519/orgs', 'repos_url': 'https://api.github.com/users/zou3519/repos', 'events_url': 'https://api.github.com/users/zou3519/events{/privacy}', 'received_events_url': 'https://api.github.com/users/zou3519/received_events', 'type': 'User', 'site_admin': False}",referenced,cb48d676cfdeb58bbd3df7ec3297bf53a777eada,https://api.github.com/repos/pytorch/pytorch/commits/cb48d676cfdeb58bbd3df7ec3297bf53a777eada,2019-11-26T22:49:53Z,33,20,13
29995,2833743600,"{'login': 'zou3519', 'id': 5652049, 'node_id': 'MDQ6VXNlcjU2NTIwNDk=', 'avatar_url': 'https://avatars3.githubusercontent.com/u/5652049?v=4', 'gravatar_id': '', 'url': 'https://api.github.com/users/zou3519', 'html_url': 'https://github.com/zou3519', 'followers_url': 'https://api.github.com/users/zou3519/followers', 'following_url': 'https://api.github.com/users/zou3519/following{/other_user}', 'gists_url': 'https://api.github.com/users/zou3519/gists{/gist_id}', 'starred_url': 'https://api.github.com/users/zou3519/starred{/owner}{/repo}', 'subscriptions_url': 'https://api.github.com/users/zou3519/subscriptions', 'organizations_url': 'https://api.github.com/users/zou3519/orgs', 'repos_url': 'https://api.github.com/users/zou3519/repos', 'events_url': 'https://api.github.com/users/zou3519/events{/privacy}', 'received_events_url': 'https://api.github.com/users/zou3519/received_events', 'type': 'User', 'site_admin': False}",referenced,b6ed6b6d5e0e4c8db4106372e2dec499de083839,https://api.github.com/repos/pytorch/pytorch/commits/b6ed6b6d5e0e4c8db4106372e2dec499de083839,2019-11-26T23:01:51Z,32,19,13
29995,2833743750,"{'login': 'zou3519', 'id': 5652049, 'node_id': 'MDQ6VXNlcjU2NTIwNDk=', 'avatar_url': 'https://avatars3.githubusercontent.com/u/5652049?v=4', 'gravatar_id': '', 'url': 'https://api.github.com/users/zou3519', 'html_url': 'https://github.com/zou3519', 'followers_url': 'https://api.github.com/users/zou3519/followers', 'following_url': 'https://api.github.com/users/zou3519/following{/other_user}', 'gists_url': 'https://api.github.com/users/zou3519/gists{/gist_id}', 'starred_url': 'https://api.github.com/users/zou3519/starred{/owner}{/repo}', 'subscriptions_url': 'https://api.github.com/users/zou3519/subscriptions', 'organizations_url': 'https://api.github.com/users/zou3519/orgs', 'repos_url': 'https://api.github.com/users/zou3519/repos', 'events_url': 'https://api.github.com/users/zou3519/events{/privacy}', 'received_events_url': 'https://api.github.com/users/zou3519/received_events', 'type': 'User', 'site_admin': False}",referenced,ae0804b63eabee610022697581805c34103a8d71,https://api.github.com/repos/pytorch/pytorch/commits/ae0804b63eabee610022697581805c34103a8d71,2019-11-26T23:01:56Z,35,24,11
29995,2833808479,"{'login': 'zou3519', 'id': 5652049, 'node_id': 'MDQ6VXNlcjU2NTIwNDk=', 'avatar_url': 'https://avatars3.githubusercontent.com/u/5652049?v=4', 'gravatar_id': '', 'url': 'https://api.github.com/users/zou3519', 'html_url': 'https://github.com/zou3519', 'followers_url': 'https://api.github.com/users/zou3519/followers', 'following_url': 'https://api.github.com/users/zou3519/following{/other_user}', 'gists_url': 'https://api.github.com/users/zou3519/gists{/gist_id}', 'starred_url': 'https://api.github.com/users/zou3519/starred{/owner}{/repo}', 'subscriptions_url': 'https://api.github.com/users/zou3519/subscriptions', 'organizations_url': 'https://api.github.com/users/zou3519/orgs', 'repos_url': 'https://api.github.com/users/zou3519/repos', 'events_url': 'https://api.github.com/users/zou3519/events{/privacy}', 'received_events_url': 'https://api.github.com/users/zou3519/received_events', 'type': 'User', 'site_admin': False}",referenced,7281e5fc60a48f199423fe342643f89dd4da99af,https://api.github.com/repos/pytorch/pytorch/commits/7281e5fc60a48f199423fe342643f89dd4da99af,2019-11-26T23:33:55Z,2,1,1
29995,2833808606,"{'login': 'zou3519', 'id': 5652049, 'node_id': 'MDQ6VXNlcjU2NTIwNDk=', 'avatar_url': 'https://avatars3.githubusercontent.com/u/5652049?v=4', 'gravatar_id': '', 'url': 'https://api.github.com/users/zou3519', 'html_url': 'https://github.com/zou3519', 'followers_url': 'https://api.github.com/users/zou3519/followers', 'following_url': 'https://api.github.com/users/zou3519/following{/other_user}', 'gists_url': 'https://api.github.com/users/zou3519/gists{/gist_id}', 'starred_url': 'https://api.github.com/users/zou3519/starred{/owner}{/repo}', 'subscriptions_url': 'https://api.github.com/users/zou3519/subscriptions', 'organizations_url': 'https://api.github.com/users/zou3519/orgs', 'repos_url': 'https://api.github.com/users/zou3519/repos', 'events_url': 'https://api.github.com/users/zou3519/events{/privacy}', 'received_events_url': 'https://api.github.com/users/zou3519/received_events', 'type': 'User', 'site_admin': False}",referenced,967f03b697760941c69d89fc0c141cda9de11175,https://api.github.com/repos/pytorch/pytorch/commits/967f03b697760941c69d89fc0c141cda9de11175,2019-11-26T23:33:59Z,37,25,12
29995,2836592498,"{'login': 'zou3519', 'id': 5652049, 'node_id': 'MDQ6VXNlcjU2NTIwNDk=', 'avatar_url': 'https://avatars3.githubusercontent.com/u/5652049?v=4', 'gravatar_id': '', 'url': 'https://api.github.com/users/zou3519', 'html_url': 'https://github.com/zou3519', 'followers_url': 'https://api.github.com/users/zou3519/followers', 'following_url': 'https://api.github.com/users/zou3519/following{/other_user}', 'gists_url': 'https://api.github.com/users/zou3519/gists{/gist_id}', 'starred_url': 'https://api.github.com/users/zou3519/starred{/owner}{/repo}', 'subscriptions_url': 'https://api.github.com/users/zou3519/subscriptions', 'organizations_url': 'https://api.github.com/users/zou3519/orgs', 'repos_url': 'https://api.github.com/users/zou3519/repos', 'events_url': 'https://api.github.com/users/zou3519/events{/privacy}', 'received_events_url': 'https://api.github.com/users/zou3519/received_events', 'type': 'User', 'site_admin': False}",referenced,2837d84ad38ccfa3e6d71c247305b5f82dc35c50,https://api.github.com/repos/pytorch/pytorch/commits/2837d84ad38ccfa3e6d71c247305b5f82dc35c50,2019-11-27T18:12:08Z,1,1,0
29995,2836592733,"{'login': 'zou3519', 'id': 5652049, 'node_id': 'MDQ6VXNlcjU2NTIwNDk=', 'avatar_url': 'https://avatars3.githubusercontent.com/u/5652049?v=4', 'gravatar_id': '', 'url': 'https://api.github.com/users/zou3519', 'html_url': 'https://github.com/zou3519', 'followers_url': 'https://api.github.com/users/zou3519/followers', 'following_url': 'https://api.github.com/users/zou3519/following{/other_user}', 'gists_url': 'https://api.github.com/users/zou3519/gists{/gist_id}', 'starred_url': 'https://api.github.com/users/zou3519/starred{/owner}{/repo}', 'subscriptions_url': 'https://api.github.com/users/zou3519/subscriptions', 'organizations_url': 'https://api.github.com/users/zou3519/orgs', 'repos_url': 'https://api.github.com/users/zou3519/repos', 'events_url': 'https://api.github.com/users/zou3519/events{/privacy}', 'received_events_url': 'https://api.github.com/users/zou3519/received_events', 'type': 'User', 'site_admin': False}",referenced,13b574561d63295f97322f875cc3f2f00d827486,https://api.github.com/repos/pytorch/pytorch/commits/13b574561d63295f97322f875cc3f2f00d827486,2019-11-27T18:12:13Z,35,24,11
29995,2846558568,"{'login': 'zou3519', 'id': 5652049, 'node_id': 'MDQ6VXNlcjU2NTIwNDk=', 'avatar_url': 'https://avatars3.githubusercontent.com/u/5652049?v=4', 'gravatar_id': '', 'url': 'https://api.github.com/users/zou3519', 'html_url': 'https://github.com/zou3519', 'followers_url': 'https://api.github.com/users/zou3519/followers', 'following_url': 'https://api.github.com/users/zou3519/following{/other_user}', 'gists_url': 'https://api.github.com/users/zou3519/gists{/gist_id}', 'starred_url': 'https://api.github.com/users/zou3519/starred{/owner}{/repo}', 'subscriptions_url': 'https://api.github.com/users/zou3519/subscriptions', 'organizations_url': 'https://api.github.com/users/zou3519/orgs', 'repos_url': 'https://api.github.com/users/zou3519/repos', 'events_url': 'https://api.github.com/users/zou3519/events{/privacy}', 'received_events_url': 'https://api.github.com/users/zou3519/received_events', 'type': 'User', 'site_admin': False}",referenced,6369f235c3c403007b7097bcd35ae2ec027e3f40,https://api.github.com/repos/pytorch/pytorch/commits/6369f235c3c403007b7097bcd35ae2ec027e3f40,2019-12-02T17:23:31Z,128,64,64
29995,2846558937,"{'login': 'zou3519', 'id': 5652049, 'node_id': 'MDQ6VXNlcjU2NTIwNDk=', 'avatar_url': 'https://avatars3.githubusercontent.com/u/5652049?v=4', 'gravatar_id': '', 'url': 'https://api.github.com/users/zou3519', 'html_url': 'https://github.com/zou3519', 'followers_url': 'https://api.github.com/users/zou3519/followers', 'following_url': 'https://api.github.com/users/zou3519/following{/other_user}', 'gists_url': 'https://api.github.com/users/zou3519/gists{/gist_id}', 'starred_url': 'https://api.github.com/users/zou3519/starred{/owner}{/repo}', 'subscriptions_url': 'https://api.github.com/users/zou3519/subscriptions', 'organizations_url': 'https://api.github.com/users/zou3519/orgs', 'repos_url': 'https://api.github.com/users/zou3519/repos', 'events_url': 'https://api.github.com/users/zou3519/events{/privacy}', 'received_events_url': 'https://api.github.com/users/zou3519/received_events', 'type': 'User', 'site_admin': False}",referenced,49646acbec39eab3efc4662bcbe95034fcf2ce75,https://api.github.com/repos/pytorch/pytorch/commits/49646acbec39eab3efc4662bcbe95034fcf2ce75,2019-12-02T17:23:38Z,35,24,11
29995,2846567729,"{'login': 'zou3519', 'id': 5652049, 'node_id': 'MDQ6VXNlcjU2NTIwNDk=', 'avatar_url': 'https://avatars3.githubusercontent.com/u/5652049?v=4', 'gravatar_id': '', 'url': 'https://api.github.com/users/zou3519', 'html_url': 'https://github.com/zou3519', 'followers_url': 'https://api.github.com/users/zou3519/followers', 'following_url': 'https://api.github.com/users/zou3519/following{/other_user}', 'gists_url': 'https://api.github.com/users/zou3519/gists{/gist_id}', 'starred_url': 'https://api.github.com/users/zou3519/starred{/owner}{/repo}', 'subscriptions_url': 'https://api.github.com/users/zou3519/subscriptions', 'organizations_url': 'https://api.github.com/users/zou3519/orgs', 'repos_url': 'https://api.github.com/users/zou3519/repos', 'events_url': 'https://api.github.com/users/zou3519/events{/privacy}', 'received_events_url': 'https://api.github.com/users/zou3519/received_events', 'type': 'User', 'site_admin': False}",referenced,51a89132dbaef6be320937fb3f95921e7197608a,https://api.github.com/repos/pytorch/pytorch/commits/51a89132dbaef6be320937fb3f95921e7197608a,2019-12-02T17:26:12Z,2371,1691,680
29995,2846567790,"{'login': 'zou3519', 'id': 5652049, 'node_id': 'MDQ6VXNlcjU2NTIwNDk=', 'avatar_url': 'https://avatars3.githubusercontent.com/u/5652049?v=4', 'gravatar_id': '', 'url': 'https://api.github.com/users/zou3519', 'html_url': 'https://github.com/zou3519', 'followers_url': 'https://api.github.com/users/zou3519/followers', 'following_url': 'https://api.github.com/users/zou3519/following{/other_user}', 'gists_url': 'https://api.github.com/users/zou3519/gists{/gist_id}', 'starred_url': 'https://api.github.com/users/zou3519/starred{/owner}{/repo}', 'subscriptions_url': 'https://api.github.com/users/zou3519/subscriptions', 'organizations_url': 'https://api.github.com/users/zou3519/orgs', 'repos_url': 'https://api.github.com/users/zou3519/repos', 'events_url': 'https://api.github.com/users/zou3519/events{/privacy}', 'received_events_url': 'https://api.github.com/users/zou3519/received_events', 'type': 'User', 'site_admin': False}",referenced,7e70b8eb8ddaa6544725dbcbe0da196f38e5f0c0,https://api.github.com/repos/pytorch/pytorch/commits/7e70b8eb8ddaa6544725dbcbe0da196f38e5f0c0,2019-12-02T17:26:13Z,35,24,11
29995,2851781593,"{'login': 'zou3519', 'id': 5652049, 'node_id': 'MDQ6VXNlcjU2NTIwNDk=', 'avatar_url': 'https://avatars3.githubusercontent.com/u/5652049?v=4', 'gravatar_id': '', 'url': 'https://api.github.com/users/zou3519', 'html_url': 'https://github.com/zou3519', 'followers_url': 'https://api.github.com/users/zou3519/followers', 'following_url': 'https://api.github.com/users/zou3519/following{/other_user}', 'gists_url': 'https://api.github.com/users/zou3519/gists{/gist_id}', 'starred_url': 'https://api.github.com/users/zou3519/starred{/owner}{/repo}', 'subscriptions_url': 'https://api.github.com/users/zou3519/subscriptions', 'organizations_url': 'https://api.github.com/users/zou3519/orgs', 'repos_url': 'https://api.github.com/users/zou3519/repos', 'events_url': 'https://api.github.com/users/zou3519/events{/privacy}', 'received_events_url': 'https://api.github.com/users/zou3519/received_events', 'type': 'User', 'site_admin': False}",referenced,e57d236b426e85f2c5d9df2d74ab23ff9cf189db,https://api.github.com/repos/pytorch/pytorch/commits/e57d236b426e85f2c5d9df2d74ab23ff9cf189db,2019-12-03T21:48:55Z,128,64,64
29995,2851781793,"{'login': 'zou3519', 'id': 5652049, 'node_id': 'MDQ6VXNlcjU2NTIwNDk=', 'avatar_url': 'https://avatars3.githubusercontent.com/u/5652049?v=4', 'gravatar_id': '', 'url': 'https://api.github.com/users/zou3519', 'html_url': 'https://github.com/zou3519', 'followers_url': 'https://api.github.com/users/zou3519/followers', 'following_url': 'https://api.github.com/users/zou3519/following{/other_user}', 'gists_url': 'https://api.github.com/users/zou3519/gists{/gist_id}', 'starred_url': 'https://api.github.com/users/zou3519/starred{/owner}{/repo}', 'subscriptions_url': 'https://api.github.com/users/zou3519/subscriptions', 'organizations_url': 'https://api.github.com/users/zou3519/orgs', 'repos_url': 'https://api.github.com/users/zou3519/repos', 'events_url': 'https://api.github.com/users/zou3519/events{/privacy}', 'received_events_url': 'https://api.github.com/users/zou3519/received_events', 'type': 'User', 'site_admin': False}",referenced,44daf310ce21c89f13ece6e04a85076878813314,https://api.github.com/repos/pytorch/pytorch/commits/44daf310ce21c89f13ece6e04a85076878813314,2019-12-03T21:49:00Z,35,24,11
29995,2851783754,"{'login': 'zou3519', 'id': 5652049, 'node_id': 'MDQ6VXNlcjU2NTIwNDk=', 'avatar_url': 'https://avatars3.githubusercontent.com/u/5652049?v=4', 'gravatar_id': '', 'url': 'https://api.github.com/users/zou3519', 'html_url': 'https://github.com/zou3519', 'followers_url': 'https://api.github.com/users/zou3519/followers', 'following_url': 'https://api.github.com/users/zou3519/following{/other_user}', 'gists_url': 'https://api.github.com/users/zou3519/gists{/gist_id}', 'starred_url': 'https://api.github.com/users/zou3519/starred{/owner}{/repo}', 'subscriptions_url': 'https://api.github.com/users/zou3519/subscriptions', 'organizations_url': 'https://api.github.com/users/zou3519/orgs', 'repos_url': 'https://api.github.com/users/zou3519/repos', 'events_url': 'https://api.github.com/users/zou3519/events{/privacy}', 'received_events_url': 'https://api.github.com/users/zou3519/received_events', 'type': 'User', 'site_admin': False}",referenced,7b2d24a4fdccccdddd2ab8c4a3762b80267392d4,https://api.github.com/repos/pytorch/pytorch/commits/7b2d24a4fdccccdddd2ab8c4a3762b80267392d4,2019-12-03T21:49:37Z,2806,1745,1061
29995,2851783764,"{'login': 'zou3519', 'id': 5652049, 'node_id': 'MDQ6VXNlcjU2NTIwNDk=', 'avatar_url': 'https://avatars3.githubusercontent.com/u/5652049?v=4', 'gravatar_id': '', 'url': 'https://api.github.com/users/zou3519', 'html_url': 'https://github.com/zou3519', 'followers_url': 'https://api.github.com/users/zou3519/followers', 'following_url': 'https://api.github.com/users/zou3519/following{/other_user}', 'gists_url': 'https://api.github.com/users/zou3519/gists{/gist_id}', 'starred_url': 'https://api.github.com/users/zou3519/starred{/owner}{/repo}', 'subscriptions_url': 'https://api.github.com/users/zou3519/subscriptions', 'organizations_url': 'https://api.github.com/users/zou3519/orgs', 'repos_url': 'https://api.github.com/users/zou3519/repos', 'events_url': 'https://api.github.com/users/zou3519/events{/privacy}', 'received_events_url': 'https://api.github.com/users/zou3519/received_events', 'type': 'User', 'site_admin': False}",referenced,b571d2bbf3a1922dbdc617225e8bf6b68a79e283,https://api.github.com/repos/pytorch/pytorch/commits/b571d2bbf3a1922dbdc617225e8bf6b68a79e283,2019-12-03T21:49:37Z,35,24,11
29995,2902064261,"{'login': 'zou3519', 'id': 5652049, 'node_id': 'MDQ6VXNlcjU2NTIwNDk=', 'avatar_url': 'https://avatars3.githubusercontent.com/u/5652049?v=4', 'gravatar_id': '', 'url': 'https://api.github.com/users/zou3519', 'html_url': 'https://github.com/zou3519', 'followers_url': 'https://api.github.com/users/zou3519/followers', 'following_url': 'https://api.github.com/users/zou3519/following{/other_user}', 'gists_url': 'https://api.github.com/users/zou3519/gists{/gist_id}', 'starred_url': 'https://api.github.com/users/zou3519/starred{/owner}{/repo}', 'subscriptions_url': 'https://api.github.com/users/zou3519/subscriptions', 'organizations_url': 'https://api.github.com/users/zou3519/orgs', 'repos_url': 'https://api.github.com/users/zou3519/repos', 'events_url': 'https://api.github.com/users/zou3519/events{/privacy}', 'received_events_url': 'https://api.github.com/users/zou3519/received_events', 'type': 'User', 'site_admin': False}",referenced,c7baafe59e992d5257f53e30aaeb5bbd507c3247,https://api.github.com/repos/pytorch/pytorch/commits/c7baafe59e992d5257f53e30aaeb5bbd507c3247,2019-12-20T21:14:12Z,37,25,12
29995,2902065349,"{'login': 'zou3519', 'id': 5652049, 'node_id': 'MDQ6VXNlcjU2NTIwNDk=', 'avatar_url': 'https://avatars3.githubusercontent.com/u/5652049?v=4', 'gravatar_id': '', 'url': 'https://api.github.com/users/zou3519', 'html_url': 'https://github.com/zou3519', 'followers_url': 'https://api.github.com/users/zou3519/followers', 'following_url': 'https://api.github.com/users/zou3519/following{/other_user}', 'gists_url': 'https://api.github.com/users/zou3519/gists{/gist_id}', 'starred_url': 'https://api.github.com/users/zou3519/starred{/owner}{/repo}', 'subscriptions_url': 'https://api.github.com/users/zou3519/subscriptions', 'organizations_url': 'https://api.github.com/users/zou3519/orgs', 'repos_url': 'https://api.github.com/users/zou3519/repos', 'events_url': 'https://api.github.com/users/zou3519/events{/privacy}', 'received_events_url': 'https://api.github.com/users/zou3519/received_events', 'type': 'User', 'site_admin': False}",referenced,15e11728591b2cc2c35394b99ce79347fa66f225,https://api.github.com/repos/pytorch/pytorch/commits/15e11728591b2cc2c35394b99ce79347fa66f225,2019-12-20T21:14:37Z,35065,24438,10627
29995,2943554182,"{'login': 'zou3519', 'id': 5652049, 'node_id': 'MDQ6VXNlcjU2NTIwNDk=', 'avatar_url': 'https://avatars3.githubusercontent.com/u/5652049?v=4', 'gravatar_id': '', 'url': 'https://api.github.com/users/zou3519', 'html_url': 'https://github.com/zou3519', 'followers_url': 'https://api.github.com/users/zou3519/followers', 'following_url': 'https://api.github.com/users/zou3519/following{/other_user}', 'gists_url': 'https://api.github.com/users/zou3519/gists{/gist_id}', 'starred_url': 'https://api.github.com/users/zou3519/starred{/owner}{/repo}', 'subscriptions_url': 'https://api.github.com/users/zou3519/subscriptions', 'organizations_url': 'https://api.github.com/users/zou3519/orgs', 'repos_url': 'https://api.github.com/users/zou3519/repos', 'events_url': 'https://api.github.com/users/zou3519/events{/privacy}', 'received_events_url': 'https://api.github.com/users/zou3519/received_events', 'type': 'User', 'site_admin': False}",referenced,f5bd0d4e02ab9e4de7b1157bd3e170ca9be0cf28,https://api.github.com/repos/pytorch/pytorch/commits/f5bd0d4e02ab9e4de7b1157bd3e170ca9be0cf28,2020-01-13T15:09:28Z,34,24,10
29968,2823552759,"{'login': 'facebook-github-bot', 'id': 6422482, 'node_id': 'MDQ6VXNlcjY0MjI0ODI=', 'avatar_url': 'https://avatars3.githubusercontent.com/u/6422482?v=4', 'gravatar_id': '', 'url': 'https://api.github.com/users/facebook-github-bot', 'html_url': 'https://github.com/facebook-github-bot', 'followers_url': 'https://api.github.com/users/facebook-github-bot/followers', 'following_url': 'https://api.github.com/users/facebook-github-bot/following{/other_user}', 'gists_url': 'https://api.github.com/users/facebook-github-bot/gists{/gist_id}', 'starred_url': 'https://api.github.com/users/facebook-github-bot/starred{/owner}{/repo}', 'subscriptions_url': 'https://api.github.com/users/facebook-github-bot/subscriptions', 'organizations_url': 'https://api.github.com/users/facebook-github-bot/orgs', 'repos_url': 'https://api.github.com/users/facebook-github-bot/repos', 'events_url': 'https://api.github.com/users/facebook-github-bot/events{/privacy}', 'received_events_url': 'https://api.github.com/users/facebook-github-bot/received_events', 'type': 'User', 'site_admin': False}",referenced,3455231e9cd67e03fe86262d8fe19432ca4789a7,https://api.github.com/repos/pytorch/pytorch/commits/3455231e9cd67e03fe86262d8fe19432ca4789a7,2019-11-22T15:07:55Z,2,2,0
29968,2920680119,"{'login': 'facebook-github-bot', 'id': 6422482, 'node_id': 'MDQ6VXNlcjY0MjI0ODI=', 'avatar_url': 'https://avatars3.githubusercontent.com/u/6422482?v=4', 'gravatar_id': '', 'url': 'https://api.github.com/users/facebook-github-bot', 'html_url': 'https://github.com/facebook-github-bot', 'followers_url': 'https://api.github.com/users/facebook-github-bot/followers', 'following_url': 'https://api.github.com/users/facebook-github-bot/following{/other_user}', 'gists_url': 'https://api.github.com/users/facebook-github-bot/gists{/gist_id}', 'starred_url': 'https://api.github.com/users/facebook-github-bot/starred{/owner}{/repo}', 'subscriptions_url': 'https://api.github.com/users/facebook-github-bot/subscriptions', 'organizations_url': 'https://api.github.com/users/facebook-github-bot/orgs', 'repos_url': 'https://api.github.com/users/facebook-github-bot/repos', 'events_url': 'https://api.github.com/users/facebook-github-bot/events{/privacy}', 'received_events_url': 'https://api.github.com/users/facebook-github-bot/received_events', 'type': 'User', 'site_admin': False}",referenced,daf00beabaf82da5fac19098de045c872bd0bd34,https://api.github.com/repos/pytorch/pytorch/commits/daf00beabaf82da5fac19098de045c872bd0bd34,2020-01-03T16:48:59Z,42,7,35
29924,2804225857,"{'login': 'zhaojuanmao', 'id': 48731194, 'node_id': 'MDQ6VXNlcjQ4NzMxMTk0', 'avatar_url': 'https://avatars0.githubusercontent.com/u/48731194?v=4', 'gravatar_id': '', 'url': 'https://api.github.com/users/zhaojuanmao', 'html_url': 'https://github.com/zhaojuanmao', 'followers_url': 'https://api.github.com/users/zhaojuanmao/followers', 'following_url': 'https://api.github.com/users/zhaojuanmao/following{/other_user}', 'gists_url': 'https://api.github.com/users/zhaojuanmao/gists{/gist_id}', 'starred_url': 'https://api.github.com/users/zhaojuanmao/starred{/owner}{/repo}', 'subscriptions_url': 'https://api.github.com/users/zhaojuanmao/subscriptions', 'organizations_url': 'https://api.github.com/users/zhaojuanmao/orgs', 'repos_url': 'https://api.github.com/users/zhaojuanmao/repos', 'events_url': 'https://api.github.com/users/zhaojuanmao/events{/privacy}', 'received_events_url': 'https://api.github.com/users/zhaojuanmao/received_events', 'type': 'User', 'site_admin': False}",referenced,d43e98e0813ba2a682d645a030757fda8c9e2fed,https://api.github.com/repos/pytorch/pytorch/commits/d43e98e0813ba2a682d645a030757fda8c9e2fed,2019-11-15T22:56:17Z,37,33,4
29924,2804226622,"{'login': 'zhaojuanmao', 'id': 48731194, 'node_id': 'MDQ6VXNlcjQ4NzMxMTk0', 'avatar_url': 'https://avatars0.githubusercontent.com/u/48731194?v=4', 'gravatar_id': '', 'url': 'https://api.github.com/users/zhaojuanmao', 'html_url': 'https://github.com/zhaojuanmao', 'followers_url': 'https://api.github.com/users/zhaojuanmao/followers', 'following_url': 'https://api.github.com/users/zhaojuanmao/following{/other_user}', 'gists_url': 'https://api.github.com/users/zhaojuanmao/gists{/gist_id}', 'starred_url': 'https://api.github.com/users/zhaojuanmao/starred{/owner}{/repo}', 'subscriptions_url': 'https://api.github.com/users/zhaojuanmao/subscriptions', 'organizations_url': 'https://api.github.com/users/zhaojuanmao/orgs', 'repos_url': 'https://api.github.com/users/zhaojuanmao/repos', 'events_url': 'https://api.github.com/users/zhaojuanmao/events{/privacy}', 'received_events_url': 'https://api.github.com/users/zhaojuanmao/received_events', 'type': 'User', 'site_admin': False}",referenced,ec56504435338723f9e87025fb3971feb10e60f9,https://api.github.com/repos/pytorch/pytorch/commits/ec56504435338723f9e87025fb3971feb10e60f9,2019-11-15T22:56:42Z,37,33,4
29924,2808816036,"{'login': 'zhaojuanmao', 'id': 48731194, 'node_id': 'MDQ6VXNlcjQ4NzMxMTk0', 'avatar_url': 'https://avatars0.githubusercontent.com/u/48731194?v=4', 'gravatar_id': '', 'url': 'https://api.github.com/users/zhaojuanmao', 'html_url': 'https://github.com/zhaojuanmao', 'followers_url': 'https://api.github.com/users/zhaojuanmao/followers', 'following_url': 'https://api.github.com/users/zhaojuanmao/following{/other_user}', 'gists_url': 'https://api.github.com/users/zhaojuanmao/gists{/gist_id}', 'starred_url': 'https://api.github.com/users/zhaojuanmao/starred{/owner}{/repo}', 'subscriptions_url': 'https://api.github.com/users/zhaojuanmao/subscriptions', 'organizations_url': 'https://api.github.com/users/zhaojuanmao/orgs', 'repos_url': 'https://api.github.com/users/zhaojuanmao/repos', 'events_url': 'https://api.github.com/users/zhaojuanmao/events{/privacy}', 'received_events_url': 'https://api.github.com/users/zhaojuanmao/received_events', 'type': 'User', 'site_admin': False}",referenced,8fae7c8b0ccbdab7d044a1a5673f67fe052c148c,https://api.github.com/repos/pytorch/pytorch/commits/8fae7c8b0ccbdab7d044a1a5673f67fe052c148c,2019-11-18T19:32:37Z,14,3,11
29924,2808816336,"{'login': 'zhaojuanmao', 'id': 48731194, 'node_id': 'MDQ6VXNlcjQ4NzMxMTk0', 'avatar_url': 'https://avatars0.githubusercontent.com/u/48731194?v=4', 'gravatar_id': '', 'url': 'https://api.github.com/users/zhaojuanmao', 'html_url': 'https://github.com/zhaojuanmao', 'followers_url': 'https://api.github.com/users/zhaojuanmao/followers', 'following_url': 'https://api.github.com/users/zhaojuanmao/following{/other_user}', 'gists_url': 'https://api.github.com/users/zhaojuanmao/gists{/gist_id}', 'starred_url': 'https://api.github.com/users/zhaojuanmao/starred{/owner}{/repo}', 'subscriptions_url': 'https://api.github.com/users/zhaojuanmao/subscriptions', 'organizations_url': 'https://api.github.com/users/zhaojuanmao/orgs', 'repos_url': 'https://api.github.com/users/zhaojuanmao/repos', 'events_url': 'https://api.github.com/users/zhaojuanmao/events{/privacy}', 'received_events_url': 'https://api.github.com/users/zhaojuanmao/received_events', 'type': 'User', 'site_admin': False}",referenced,25a7ed00c430eab17aaec9fe54745708c3b52337,https://api.github.com/repos/pytorch/pytorch/commits/25a7ed00c430eab17aaec9fe54745708c3b52337,2019-11-18T19:32:43Z,25,23,2
29924,2809336903,"{'login': 'zhaojuanmao', 'id': 48731194, 'node_id': 'MDQ6VXNlcjQ4NzMxMTk0', 'avatar_url': 'https://avatars0.githubusercontent.com/u/48731194?v=4', 'gravatar_id': '', 'url': 'https://api.github.com/users/zhaojuanmao', 'html_url': 'https://github.com/zhaojuanmao', 'followers_url': 'https://api.github.com/users/zhaojuanmao/followers', 'following_url': 'https://api.github.com/users/zhaojuanmao/following{/other_user}', 'gists_url': 'https://api.github.com/users/zhaojuanmao/gists{/gist_id}', 'starred_url': 'https://api.github.com/users/zhaojuanmao/starred{/owner}{/repo}', 'subscriptions_url': 'https://api.github.com/users/zhaojuanmao/subscriptions', 'organizations_url': 'https://api.github.com/users/zhaojuanmao/orgs', 'repos_url': 'https://api.github.com/users/zhaojuanmao/repos', 'events_url': 'https://api.github.com/users/zhaojuanmao/events{/privacy}', 'received_events_url': 'https://api.github.com/users/zhaojuanmao/received_events', 'type': 'User', 'site_admin': False}",referenced,cdee55402d55b3b02e56cfb24914a74a6962b26e,https://api.github.com/repos/pytorch/pytorch/commits/cdee55402d55b3b02e56cfb24914a74a6962b26e,2019-11-18T22:32:15Z,5950,3826,2124
29924,2809337025,"{'login': 'zhaojuanmao', 'id': 48731194, 'node_id': 'MDQ6VXNlcjQ4NzMxMTk0', 'avatar_url': 'https://avatars0.githubusercontent.com/u/48731194?v=4', 'gravatar_id': '', 'url': 'https://api.github.com/users/zhaojuanmao', 'html_url': 'https://github.com/zhaojuanmao', 'followers_url': 'https://api.github.com/users/zhaojuanmao/followers', 'following_url': 'https://api.github.com/users/zhaojuanmao/following{/other_user}', 'gists_url': 'https://api.github.com/users/zhaojuanmao/gists{/gist_id}', 'starred_url': 'https://api.github.com/users/zhaojuanmao/starred{/owner}{/repo}', 'subscriptions_url': 'https://api.github.com/users/zhaojuanmao/subscriptions', 'organizations_url': 'https://api.github.com/users/zhaojuanmao/orgs', 'repos_url': 'https://api.github.com/users/zhaojuanmao/repos', 'events_url': 'https://api.github.com/users/zhaojuanmao/events{/privacy}', 'received_events_url': 'https://api.github.com/users/zhaojuanmao/received_events', 'type': 'User', 'site_admin': False}",referenced,a5c8974492e274a1bc69132d18c89ea7928bad93,https://api.github.com/repos/pytorch/pytorch/commits/a5c8974492e274a1bc69132d18c89ea7928bad93,2019-11-18T22:32:17Z,25,23,2
29924,2811741782,"{'login': 'zhaojuanmao', 'id': 48731194, 'node_id': 'MDQ6VXNlcjQ4NzMxMTk0', 'avatar_url': 'https://avatars0.githubusercontent.com/u/48731194?v=4', 'gravatar_id': '', 'url': 'https://api.github.com/users/zhaojuanmao', 'html_url': 'https://github.com/zhaojuanmao', 'followers_url': 'https://api.github.com/users/zhaojuanmao/followers', 'following_url': 'https://api.github.com/users/zhaojuanmao/following{/other_user}', 'gists_url': 'https://api.github.com/users/zhaojuanmao/gists{/gist_id}', 'starred_url': 'https://api.github.com/users/zhaojuanmao/starred{/owner}{/repo}', 'subscriptions_url': 'https://api.github.com/users/zhaojuanmao/subscriptions', 'organizations_url': 'https://api.github.com/users/zhaojuanmao/orgs', 'repos_url': 'https://api.github.com/users/zhaojuanmao/repos', 'events_url': 'https://api.github.com/users/zhaojuanmao/events{/privacy}', 'received_events_url': 'https://api.github.com/users/zhaojuanmao/received_events', 'type': 'User', 'site_admin': False}",referenced,a800ca68c6ffdce1dc17a8abb1aaff6a59515e1a,https://api.github.com/repos/pytorch/pytorch/commits/a800ca68c6ffdce1dc17a8abb1aaff6a59515e1a,2019-11-19T14:58:02Z,2416,1848,568
29924,2811742003,"{'login': 'zhaojuanmao', 'id': 48731194, 'node_id': 'MDQ6VXNlcjQ4NzMxMTk0', 'avatar_url': 'https://avatars0.githubusercontent.com/u/48731194?v=4', 'gravatar_id': '', 'url': 'https://api.github.com/users/zhaojuanmao', 'html_url': 'https://github.com/zhaojuanmao', 'followers_url': 'https://api.github.com/users/zhaojuanmao/followers', 'following_url': 'https://api.github.com/users/zhaojuanmao/following{/other_user}', 'gists_url': 'https://api.github.com/users/zhaojuanmao/gists{/gist_id}', 'starred_url': 'https://api.github.com/users/zhaojuanmao/starred{/owner}{/repo}', 'subscriptions_url': 'https://api.github.com/users/zhaojuanmao/subscriptions', 'organizations_url': 'https://api.github.com/users/zhaojuanmao/orgs', 'repos_url': 'https://api.github.com/users/zhaojuanmao/repos', 'events_url': 'https://api.github.com/users/zhaojuanmao/events{/privacy}', 'received_events_url': 'https://api.github.com/users/zhaojuanmao/received_events', 'type': 'User', 'site_admin': False}",referenced,ca949057dcf8af9b7e8f7c365b70f42c5d917434,https://api.github.com/repos/pytorch/pytorch/commits/ca949057dcf8af9b7e8f7c365b70f42c5d917434,2019-11-19T14:58:05Z,25,23,2
29924,2812754286,"{'login': 'zhaojuanmao', 'id': 48731194, 'node_id': 'MDQ6VXNlcjQ4NzMxMTk0', 'avatar_url': 'https://avatars0.githubusercontent.com/u/48731194?v=4', 'gravatar_id': '', 'url': 'https://api.github.com/users/zhaojuanmao', 'html_url': 'https://github.com/zhaojuanmao', 'followers_url': 'https://api.github.com/users/zhaojuanmao/followers', 'following_url': 'https://api.github.com/users/zhaojuanmao/following{/other_user}', 'gists_url': 'https://api.github.com/users/zhaojuanmao/gists{/gist_id}', 'starred_url': 'https://api.github.com/users/zhaojuanmao/starred{/owner}{/repo}', 'subscriptions_url': 'https://api.github.com/users/zhaojuanmao/subscriptions', 'organizations_url': 'https://api.github.com/users/zhaojuanmao/orgs', 'repos_url': 'https://api.github.com/users/zhaojuanmao/repos', 'events_url': 'https://api.github.com/users/zhaojuanmao/events{/privacy}', 'received_events_url': 'https://api.github.com/users/zhaojuanmao/received_events', 'type': 'User', 'site_admin': False}",referenced,a926ed9fd3eee6d29db48fa6432a92517c42494d,https://api.github.com/repos/pytorch/pytorch/commits/a926ed9fd3eee6d29db48fa6432a92517c42494d,2019-11-19T19:43:17Z,1364,872,492
29909,2851978244,"{'login': 'facebook-github-bot', 'id': 6422482, 'node_id': 'MDQ6VXNlcjY0MjI0ODI=', 'avatar_url': 'https://avatars3.githubusercontent.com/u/6422482?v=4', 'gravatar_id': '', 'url': 'https://api.github.com/users/facebook-github-bot', 'html_url': 'https://github.com/facebook-github-bot', 'followers_url': 'https://api.github.com/users/facebook-github-bot/followers', 'following_url': 'https://api.github.com/users/facebook-github-bot/following{/other_user}', 'gists_url': 'https://api.github.com/users/facebook-github-bot/gists{/gist_id}', 'starred_url': 'https://api.github.com/users/facebook-github-bot/starred{/owner}{/repo}', 'subscriptions_url': 'https://api.github.com/users/facebook-github-bot/subscriptions', 'organizations_url': 'https://api.github.com/users/facebook-github-bot/orgs', 'repos_url': 'https://api.github.com/users/facebook-github-bot/repos', 'events_url': 'https://api.github.com/users/facebook-github-bot/events{/privacy}', 'received_events_url': 'https://api.github.com/users/facebook-github-bot/received_events', 'type': 'User', 'site_admin': False}",referenced,d4c25add458f65fb9de1f1310cd536d4c073d3aa,https://api.github.com/repos/pytorch/pytorch/commits/d4c25add458f65fb9de1f1310cd536d4c073d3aa,2019-12-03T22:59:29Z,63,52,11
29823,2856087950,"{'login': 'facebook-github-bot', 'id': 6422482, 'node_id': 'MDQ6VXNlcjY0MjI0ODI=', 'avatar_url': 'https://avatars3.githubusercontent.com/u/6422482?v=4', 'gravatar_id': '', 'url': 'https://api.github.com/users/facebook-github-bot', 'html_url': 'https://github.com/facebook-github-bot', 'followers_url': 'https://api.github.com/users/facebook-github-bot/followers', 'following_url': 'https://api.github.com/users/facebook-github-bot/following{/other_user}', 'gists_url': 'https://api.github.com/users/facebook-github-bot/gists{/gist_id}', 'starred_url': 'https://api.github.com/users/facebook-github-bot/starred{/owner}{/repo}', 'subscriptions_url': 'https://api.github.com/users/facebook-github-bot/subscriptions', 'organizations_url': 'https://api.github.com/users/facebook-github-bot/orgs', 'repos_url': 'https://api.github.com/users/facebook-github-bot/repos', 'events_url': 'https://api.github.com/users/facebook-github-bot/events{/privacy}', 'received_events_url': 'https://api.github.com/users/facebook-github-bot/received_events', 'type': 'User', 'site_admin': False}",closed,1f1ce53e8e93c80b3f88b9e6c84013a037e9c074,https://api.github.com/repos/pytorch/pytorch/commits/1f1ce53e8e93c80b3f88b9e6c84013a037e9c074,2019-12-05T00:43:37Z,6,3,3
29764,2801283846,"{'login': 'zdevito', 'id': 370202, 'node_id': 'MDQ6VXNlcjM3MDIwMg==', 'avatar_url': 'https://avatars0.githubusercontent.com/u/370202?v=4', 'gravatar_id': '', 'url': 'https://api.github.com/users/zdevito', 'html_url': 'https://github.com/zdevito', 'followers_url': 'https://api.github.com/users/zdevito/followers', 'following_url': 'https://api.github.com/users/zdevito/following{/other_user}', 'gists_url': 'https://api.github.com/users/zdevito/gists{/gist_id}', 'starred_url': 'https://api.github.com/users/zdevito/starred{/owner}{/repo}', 'subscriptions_url': 'https://api.github.com/users/zdevito/subscriptions', 'organizations_url': 'https://api.github.com/users/zdevito/orgs', 'repos_url': 'https://api.github.com/users/zdevito/repos', 'events_url': 'https://api.github.com/users/zdevito/events{/privacy}', 'received_events_url': 'https://api.github.com/users/zdevito/received_events', 'type': 'User', 'site_admin': False}",referenced,407267294f4b4118db12f0033cb72660c461ecf2,https://api.github.com/repos/pytorch/pytorch/commits/407267294f4b4118db12f0033cb72660c461ecf2,2019-11-15T02:58:48Z,6,3,3
29764,2801283975,"{'login': 'zdevito', 'id': 370202, 'node_id': 'MDQ6VXNlcjM3MDIwMg==', 'avatar_url': 'https://avatars0.githubusercontent.com/u/370202?v=4', 'gravatar_id': '', 'url': 'https://api.github.com/users/zdevito', 'html_url': 'https://github.com/zdevito', 'followers_url': 'https://api.github.com/users/zdevito/followers', 'following_url': 'https://api.github.com/users/zdevito/following{/other_user}', 'gists_url': 'https://api.github.com/users/zdevito/gists{/gist_id}', 'starred_url': 'https://api.github.com/users/zdevito/starred{/owner}{/repo}', 'subscriptions_url': 'https://api.github.com/users/zdevito/subscriptions', 'organizations_url': 'https://api.github.com/users/zdevito/orgs', 'repos_url': 'https://api.github.com/users/zdevito/repos', 'events_url': 'https://api.github.com/users/zdevito/events{/privacy}', 'received_events_url': 'https://api.github.com/users/zdevito/received_events', 'type': 'User', 'site_admin': False}",referenced,acc176c6df768151fba97c8ff2edb8e37c16f408,https://api.github.com/repos/pytorch/pytorch/commits/acc176c6df768151fba97c8ff2edb8e37c16f408,2019-11-15T02:58:54Z,6,3,3
29764,2803614287,"{'login': 'zdevito', 'id': 370202, 'node_id': 'MDQ6VXNlcjM3MDIwMg==', 'avatar_url': 'https://avatars0.githubusercontent.com/u/370202?v=4', 'gravatar_id': '', 'url': 'https://api.github.com/users/zdevito', 'html_url': 'https://github.com/zdevito', 'followers_url': 'https://api.github.com/users/zdevito/followers', 'following_url': 'https://api.github.com/users/zdevito/following{/other_user}', 'gists_url': 'https://api.github.com/users/zdevito/gists{/gist_id}', 'starred_url': 'https://api.github.com/users/zdevito/starred{/owner}{/repo}', 'subscriptions_url': 'https://api.github.com/users/zdevito/subscriptions', 'organizations_url': 'https://api.github.com/users/zdevito/orgs', 'repos_url': 'https://api.github.com/users/zdevito/repos', 'events_url': 'https://api.github.com/users/zdevito/events{/privacy}', 'received_events_url': 'https://api.github.com/users/zdevito/received_events', 'type': 'User', 'site_admin': False}",referenced,068de5894dd4572fea7f55f149262241cf864dd0,https://api.github.com/repos/pytorch/pytorch/commits/068de5894dd4572fea7f55f149262241cf864dd0,2019-11-15T18:42:39Z,13722,8658,5064
29764,2803614290,"{'login': 'zdevito', 'id': 370202, 'node_id': 'MDQ6VXNlcjM3MDIwMg==', 'avatar_url': 'https://avatars0.githubusercontent.com/u/370202?v=4', 'gravatar_id': '', 'url': 'https://api.github.com/users/zdevito', 'html_url': 'https://github.com/zdevito', 'followers_url': 'https://api.github.com/users/zdevito/followers', 'following_url': 'https://api.github.com/users/zdevito/following{/other_user}', 'gists_url': 'https://api.github.com/users/zdevito/gists{/gist_id}', 'starred_url': 'https://api.github.com/users/zdevito/starred{/owner}{/repo}', 'subscriptions_url': 'https://api.github.com/users/zdevito/subscriptions', 'organizations_url': 'https://api.github.com/users/zdevito/orgs', 'repos_url': 'https://api.github.com/users/zdevito/repos', 'events_url': 'https://api.github.com/users/zdevito/events{/privacy}', 'received_events_url': 'https://api.github.com/users/zdevito/received_events', 'type': 'User', 'site_admin': False}",referenced,11c18966f3145ea701e9a56593be69a04d099cd0,https://api.github.com/repos/pytorch/pytorch/commits/11c18966f3145ea701e9a56593be69a04d099cd0,2019-11-15T18:42:39Z,6,3,3
29764,2804298772,"{'login': 'zdevito', 'id': 370202, 'node_id': 'MDQ6VXNlcjM3MDIwMg==', 'avatar_url': 'https://avatars0.githubusercontent.com/u/370202?v=4', 'gravatar_id': '', 'url': 'https://api.github.com/users/zdevito', 'html_url': 'https://github.com/zdevito', 'followers_url': 'https://api.github.com/users/zdevito/followers', 'following_url': 'https://api.github.com/users/zdevito/following{/other_user}', 'gists_url': 'https://api.github.com/users/zdevito/gists{/gist_id}', 'starred_url': 'https://api.github.com/users/zdevito/starred{/owner}{/repo}', 'subscriptions_url': 'https://api.github.com/users/zdevito/subscriptions', 'organizations_url': 'https://api.github.com/users/zdevito/orgs', 'repos_url': 'https://api.github.com/users/zdevito/repos', 'events_url': 'https://api.github.com/users/zdevito/events{/privacy}', 'received_events_url': 'https://api.github.com/users/zdevito/received_events', 'type': 'User', 'site_admin': False}",referenced,f3d2ba659171c3ad17b9eb044f48c2b425b625fa,https://api.github.com/repos/pytorch/pytorch/commits/f3d2ba659171c3ad17b9eb044f48c2b425b625fa,2019-11-15T23:38:43Z,0,0,0
29764,2804298868,"{'login': 'zdevito', 'id': 370202, 'node_id': 'MDQ6VXNlcjM3MDIwMg==', 'avatar_url': 'https://avatars0.githubusercontent.com/u/370202?v=4', 'gravatar_id': '', 'url': 'https://api.github.com/users/zdevito', 'html_url': 'https://github.com/zdevito', 'followers_url': 'https://api.github.com/users/zdevito/followers', 'following_url': 'https://api.github.com/users/zdevito/following{/other_user}', 'gists_url': 'https://api.github.com/users/zdevito/gists{/gist_id}', 'starred_url': 'https://api.github.com/users/zdevito/starred{/owner}{/repo}', 'subscriptions_url': 'https://api.github.com/users/zdevito/subscriptions', 'organizations_url': 'https://api.github.com/users/zdevito/orgs', 'repos_url': 'https://api.github.com/users/zdevito/repos', 'events_url': 'https://api.github.com/users/zdevito/events{/privacy}', 'received_events_url': 'https://api.github.com/users/zdevito/received_events', 'type': 'User', 'site_admin': False}",referenced,570ca0dd0489681be51ff9637779d04fc595847c,https://api.github.com/repos/pytorch/pytorch/commits/570ca0dd0489681be51ff9637779d04fc595847c,2019-11-15T23:38:47Z,6,3,3
29764,2804440970,"{'login': 'facebook-github-bot', 'id': 6422482, 'node_id': 'MDQ6VXNlcjY0MjI0ODI=', 'avatar_url': 'https://avatars3.githubusercontent.com/u/6422482?v=4', 'gravatar_id': '', 'url': 'https://api.github.com/users/facebook-github-bot', 'html_url': 'https://github.com/facebook-github-bot', 'followers_url': 'https://api.github.com/users/facebook-github-bot/followers', 'following_url': 'https://api.github.com/users/facebook-github-bot/following{/other_user}', 'gists_url': 'https://api.github.com/users/facebook-github-bot/gists{/gist_id}', 'starred_url': 'https://api.github.com/users/facebook-github-bot/starred{/owner}{/repo}', 'subscriptions_url': 'https://api.github.com/users/facebook-github-bot/subscriptions', 'organizations_url': 'https://api.github.com/users/facebook-github-bot/orgs', 'repos_url': 'https://api.github.com/users/facebook-github-bot/repos', 'events_url': 'https://api.github.com/users/facebook-github-bot/events{/privacy}', 'received_events_url': 'https://api.github.com/users/facebook-github-bot/received_events', 'type': 'User', 'site_admin': False}",closed,f1860aea83dbf880cff242c18cb286cc502544e6,https://api.github.com/repos/pytorch/pytorch/commits/f1860aea83dbf880cff242c18cb286cc502544e6,2019-11-16T01:51:58Z,6,3,3
29744,2995459548,"{'login': 'facebook-github-bot', 'id': 6422482, 'node_id': 'MDQ6VXNlcjY0MjI0ODI=', 'avatar_url': 'https://avatars3.githubusercontent.com/u/6422482?v=4', 'gravatar_id': '', 'url': 'https://api.github.com/users/facebook-github-bot', 'html_url': 'https://github.com/facebook-github-bot', 'followers_url': 'https://api.github.com/users/facebook-github-bot/followers', 'following_url': 'https://api.github.com/users/facebook-github-bot/following{/other_user}', 'gists_url': 'https://api.github.com/users/facebook-github-bot/gists{/gist_id}', 'starred_url': 'https://api.github.com/users/facebook-github-bot/starred{/owner}{/repo}', 'subscriptions_url': 'https://api.github.com/users/facebook-github-bot/subscriptions', 'organizations_url': 'https://api.github.com/users/facebook-github-bot/orgs', 'repos_url': 'https://api.github.com/users/facebook-github-bot/repos', 'events_url': 'https://api.github.com/users/facebook-github-bot/events{/privacy}', 'received_events_url': 'https://api.github.com/users/facebook-github-bot/received_events', 'type': 'User', 'site_admin': False}",closed,0f0972051a7eaf3da645b2f18cc77be188d59b8d,https://api.github.com/repos/pytorch/pytorch/commits/0f0972051a7eaf3da645b2f18cc77be188d59b8d,2020-01-31T00:58:37Z,9,6,3
29735,2825470377,"{'login': 'facebook-github-bot', 'id': 6422482, 'node_id': 'MDQ6VXNlcjY0MjI0ODI=', 'avatar_url': 'https://avatars3.githubusercontent.com/u/6422482?v=4', 'gravatar_id': '', 'url': 'https://api.github.com/users/facebook-github-bot', 'html_url': 'https://github.com/facebook-github-bot', 'followers_url': 'https://api.github.com/users/facebook-github-bot/followers', 'following_url': 'https://api.github.com/users/facebook-github-bot/following{/other_user}', 'gists_url': 'https://api.github.com/users/facebook-github-bot/gists{/gist_id}', 'starred_url': 'https://api.github.com/users/facebook-github-bot/starred{/owner}{/repo}', 'subscriptions_url': 'https://api.github.com/users/facebook-github-bot/subscriptions', 'organizations_url': 'https://api.github.com/users/facebook-github-bot/orgs', 'repos_url': 'https://api.github.com/users/facebook-github-bot/repos', 'events_url': 'https://api.github.com/users/facebook-github-bot/events{/privacy}', 'received_events_url': 'https://api.github.com/users/facebook-github-bot/received_events', 'type': 'User', 'site_admin': False}",referenced,7c4b9042ababa32dcd49e8d35114c81c53027431,https://api.github.com/repos/pytorch/pytorch/commits/7c4b9042ababa32dcd49e8d35114c81c53027431,2019-11-23T17:29:43Z,79,67,12
29735,2899122622,"{'login': 'mingbowan', 'id': 2181364, 'node_id': 'MDQ6VXNlcjIxODEzNjQ=', 'avatar_url': 'https://avatars2.githubusercontent.com/u/2181364?v=4', 'gravatar_id': '', 'url': 'https://api.github.com/users/mingbowan', 'html_url': 'https://github.com/mingbowan', 'followers_url': 'https://api.github.com/users/mingbowan/followers', 'following_url': 'https://api.github.com/users/mingbowan/following{/other_user}', 'gists_url': 'https://api.github.com/users/mingbowan/gists{/gist_id}', 'starred_url': 'https://api.github.com/users/mingbowan/starred{/owner}{/repo}', 'subscriptions_url': 'https://api.github.com/users/mingbowan/subscriptions', 'organizations_url': 'https://api.github.com/users/mingbowan/orgs', 'repos_url': 'https://api.github.com/users/mingbowan/repos', 'events_url': 'https://api.github.com/users/mingbowan/events{/privacy}', 'received_events_url': 'https://api.github.com/users/mingbowan/received_events', 'type': 'User', 'site_admin': False}",referenced,9e7dc37f902af78b26739410766e79e63f53e27f,https://api.github.com/repos/pytorch/pytorch/commits/9e7dc37f902af78b26739410766e79e63f53e27f,2019-12-20T00:01:12Z,79,67,12
29712,2939050730,"{'login': 'facebook-github-bot', 'id': 6422482, 'node_id': 'MDQ6VXNlcjY0MjI0ODI=', 'avatar_url': 'https://avatars3.githubusercontent.com/u/6422482?v=4', 'gravatar_id': '', 'url': 'https://api.github.com/users/facebook-github-bot', 'html_url': 'https://github.com/facebook-github-bot', 'followers_url': 'https://api.github.com/users/facebook-github-bot/followers', 'following_url': 'https://api.github.com/users/facebook-github-bot/following{/other_user}', 'gists_url': 'https://api.github.com/users/facebook-github-bot/gists{/gist_id}', 'starred_url': 'https://api.github.com/users/facebook-github-bot/starred{/owner}{/repo}', 'subscriptions_url': 'https://api.github.com/users/facebook-github-bot/subscriptions', 'organizations_url': 'https://api.github.com/users/facebook-github-bot/orgs', 'repos_url': 'https://api.github.com/users/facebook-github-bot/repos', 'events_url': 'https://api.github.com/users/facebook-github-bot/events{/privacy}', 'received_events_url': 'https://api.github.com/users/facebook-github-bot/received_events', 'type': 'User', 'site_admin': False}",closed,c6f41ae01b2014e4001996b30fd0f429002ecb87,https://api.github.com/repos/pytorch/pytorch/commits/c6f41ae01b2014e4001996b30fd0f429002ecb87,2020-01-10T16:15:11Z,147,96,51
29703,3004328054,"{'login': 'rohan-varma', 'id': 8039770, 'node_id': 'MDQ6VXNlcjgwMzk3NzA=', 'avatar_url': 'https://avatars2.githubusercontent.com/u/8039770?v=4', 'gravatar_id': '', 'url': 'https://api.github.com/users/rohan-varma', 'html_url': 'https://github.com/rohan-varma', 'followers_url': 'https://api.github.com/users/rohan-varma/followers', 'following_url': 'https://api.github.com/users/rohan-varma/following{/other_user}', 'gists_url': 'https://api.github.com/users/rohan-varma/gists{/gist_id}', 'starred_url': 'https://api.github.com/users/rohan-varma/starred{/owner}{/repo}', 'subscriptions_url': 'https://api.github.com/users/rohan-varma/subscriptions', 'organizations_url': 'https://api.github.com/users/rohan-varma/orgs', 'repos_url': 'https://api.github.com/users/rohan-varma/repos', 'events_url': 'https://api.github.com/users/rohan-varma/events{/privacy}', 'received_events_url': 'https://api.github.com/users/rohan-varma/received_events', 'type': 'User', 'site_admin': False}",referenced,25576b095d6eddaf605199a65599f9f1a963e28a,https://api.github.com/repos/pytorch/pytorch/commits/25576b095d6eddaf605199a65599f9f1a963e28a,2020-02-04T00:50:41Z,112,102,10
29703,3004328800,"{'login': 'rohan-varma', 'id': 8039770, 'node_id': 'MDQ6VXNlcjgwMzk3NzA=', 'avatar_url': 'https://avatars2.githubusercontent.com/u/8039770?v=4', 'gravatar_id': '', 'url': 'https://api.github.com/users/rohan-varma', 'html_url': 'https://github.com/rohan-varma', 'followers_url': 'https://api.github.com/users/rohan-varma/followers', 'following_url': 'https://api.github.com/users/rohan-varma/following{/other_user}', 'gists_url': 'https://api.github.com/users/rohan-varma/gists{/gist_id}', 'starred_url': 'https://api.github.com/users/rohan-varma/starred{/owner}{/repo}', 'subscriptions_url': 'https://api.github.com/users/rohan-varma/subscriptions', 'organizations_url': 'https://api.github.com/users/rohan-varma/orgs', 'repos_url': 'https://api.github.com/users/rohan-varma/repos', 'events_url': 'https://api.github.com/users/rohan-varma/events{/privacy}', 'received_events_url': 'https://api.github.com/users/rohan-varma/received_events', 'type': 'User', 'site_admin': False}",referenced,af9644b57c68647b2c18c85dc39f3b8c8c9269fd,https://api.github.com/repos/pytorch/pytorch/commits/af9644b57c68647b2c18c85dc39f3b8c8c9269fd,2020-02-04T00:51:07Z,112,102,10
29703,3004340192,"{'login': 'rohan-varma', 'id': 8039770, 'node_id': 'MDQ6VXNlcjgwMzk3NzA=', 'avatar_url': 'https://avatars2.githubusercontent.com/u/8039770?v=4', 'gravatar_id': '', 'url': 'https://api.github.com/users/rohan-varma', 'html_url': 'https://github.com/rohan-varma', 'followers_url': 'https://api.github.com/users/rohan-varma/followers', 'following_url': 'https://api.github.com/users/rohan-varma/following{/other_user}', 'gists_url': 'https://api.github.com/users/rohan-varma/gists{/gist_id}', 'starred_url': 'https://api.github.com/users/rohan-varma/starred{/owner}{/repo}', 'subscriptions_url': 'https://api.github.com/users/rohan-varma/subscriptions', 'organizations_url': 'https://api.github.com/users/rohan-varma/orgs', 'repos_url': 'https://api.github.com/users/rohan-varma/repos', 'events_url': 'https://api.github.com/users/rohan-varma/events{/privacy}', 'received_events_url': 'https://api.github.com/users/rohan-varma/received_events', 'type': 'User', 'site_admin': False}",referenced,1560df474f911b1f9ad7cca1dec094b71575e6d2,https://api.github.com/repos/pytorch/pytorch/commits/1560df474f911b1f9ad7cca1dec094b71575e6d2,2020-02-04T00:57:53Z,10,3,7
29683,2808114882,"{'login': 'facebook-github-bot', 'id': 6422482, 'node_id': 'MDQ6VXNlcjY0MjI0ODI=', 'avatar_url': 'https://avatars3.githubusercontent.com/u/6422482?v=4', 'gravatar_id': '', 'url': 'https://api.github.com/users/facebook-github-bot', 'html_url': 'https://github.com/facebook-github-bot', 'followers_url': 'https://api.github.com/users/facebook-github-bot/followers', 'following_url': 'https://api.github.com/users/facebook-github-bot/following{/other_user}', 'gists_url': 'https://api.github.com/users/facebook-github-bot/gists{/gist_id}', 'starred_url': 'https://api.github.com/users/facebook-github-bot/starred{/owner}{/repo}', 'subscriptions_url': 'https://api.github.com/users/facebook-github-bot/subscriptions', 'organizations_url': 'https://api.github.com/users/facebook-github-bot/orgs', 'repos_url': 'https://api.github.com/users/facebook-github-bot/repos', 'events_url': 'https://api.github.com/users/facebook-github-bot/events{/privacy}', 'received_events_url': 'https://api.github.com/users/facebook-github-bot/received_events', 'type': 'User', 'site_admin': False}",closed,38340f59fddb90b1c94eb6feff3f38981b71daef,https://api.github.com/repos/pytorch/pytorch/commits/38340f59fddb90b1c94eb6feff3f38981b71daef,2019-11-18T16:07:44Z,104,36,68
29668,2939050696,"{'login': 'facebook-github-bot', 'id': 6422482, 'node_id': 'MDQ6VXNlcjY0MjI0ODI=', 'avatar_url': 'https://avatars3.githubusercontent.com/u/6422482?v=4', 'gravatar_id': '', 'url': 'https://api.github.com/users/facebook-github-bot', 'html_url': 'https://github.com/facebook-github-bot', 'followers_url': 'https://api.github.com/users/facebook-github-bot/followers', 'following_url': 'https://api.github.com/users/facebook-github-bot/following{/other_user}', 'gists_url': 'https://api.github.com/users/facebook-github-bot/gists{/gist_id}', 'starred_url': 'https://api.github.com/users/facebook-github-bot/starred{/owner}{/repo}', 'subscriptions_url': 'https://api.github.com/users/facebook-github-bot/subscriptions', 'organizations_url': 'https://api.github.com/users/facebook-github-bot/orgs', 'repos_url': 'https://api.github.com/users/facebook-github-bot/repos', 'events_url': 'https://api.github.com/users/facebook-github-bot/events{/privacy}', 'received_events_url': 'https://api.github.com/users/facebook-github-bot/received_events', 'type': 'User', 'site_admin': False}",referenced,c6f41ae01b2014e4001996b30fd0f429002ecb87,https://api.github.com/repos/pytorch/pytorch/commits/c6f41ae01b2014e4001996b30fd0f429002ecb87,2020-01-10T16:15:11Z,147,96,51
29649,2813327091,"{'login': 'dskhudia', 'id': 37562707, 'node_id': 'MDQ6VXNlcjM3NTYyNzA3', 'avatar_url': 'https://avatars2.githubusercontent.com/u/37562707?v=4', 'gravatar_id': '', 'url': 'https://api.github.com/users/dskhudia', 'html_url': 'https://github.com/dskhudia', 'followers_url': 'https://api.github.com/users/dskhudia/followers', 'following_url': 'https://api.github.com/users/dskhudia/following{/other_user}', 'gists_url': 'https://api.github.com/users/dskhudia/gists{/gist_id}', 'starred_url': 'https://api.github.com/users/dskhudia/starred{/owner}{/repo}', 'subscriptions_url': 'https://api.github.com/users/dskhudia/subscriptions', 'organizations_url': 'https://api.github.com/users/dskhudia/orgs', 'repos_url': 'https://api.github.com/users/dskhudia/repos', 'events_url': 'https://api.github.com/users/dskhudia/events{/privacy}', 'received_events_url': 'https://api.github.com/users/dskhudia/received_events', 'type': 'User', 'site_admin': False}",referenced,97230b52e547513d334a08ae8f63688d31e3e265,https://api.github.com/repos/pytorch/pytorch/commits/97230b52e547513d334a08ae8f63688d31e3e265,2019-11-19T23:00:59Z,11,6,5
29649,2813328065,"{'login': 'dskhudia', 'id': 37562707, 'node_id': 'MDQ6VXNlcjM3NTYyNzA3', 'avatar_url': 'https://avatars2.githubusercontent.com/u/37562707?v=4', 'gravatar_id': '', 'url': 'https://api.github.com/users/dskhudia', 'html_url': 'https://github.com/dskhudia', 'followers_url': 'https://api.github.com/users/dskhudia/followers', 'following_url': 'https://api.github.com/users/dskhudia/following{/other_user}', 'gists_url': 'https://api.github.com/users/dskhudia/gists{/gist_id}', 'starred_url': 'https://api.github.com/users/dskhudia/starred{/owner}{/repo}', 'subscriptions_url': 'https://api.github.com/users/dskhudia/subscriptions', 'organizations_url': 'https://api.github.com/users/dskhudia/orgs', 'repos_url': 'https://api.github.com/users/dskhudia/repos', 'events_url': 'https://api.github.com/users/dskhudia/events{/privacy}', 'received_events_url': 'https://api.github.com/users/dskhudia/received_events', 'type': 'User', 'site_admin': False}",referenced,a26476dd010ddfaf23c91f81690461e055756ada,https://api.github.com/repos/pytorch/pytorch/commits/a26476dd010ddfaf23c91f81690461e055756ada,2019-11-19T23:01:22Z,11,6,5
29649,2816125255,"{'login': 'dskhudia', 'id': 37562707, 'node_id': 'MDQ6VXNlcjM3NTYyNzA3', 'avatar_url': 'https://avatars2.githubusercontent.com/u/37562707?v=4', 'gravatar_id': '', 'url': 'https://api.github.com/users/dskhudia', 'html_url': 'https://github.com/dskhudia', 'followers_url': 'https://api.github.com/users/dskhudia/followers', 'following_url': 'https://api.github.com/users/dskhudia/following{/other_user}', 'gists_url': 'https://api.github.com/users/dskhudia/gists{/gist_id}', 'starred_url': 'https://api.github.com/users/dskhudia/starred{/owner}{/repo}', 'subscriptions_url': 'https://api.github.com/users/dskhudia/subscriptions', 'organizations_url': 'https://api.github.com/users/dskhudia/orgs', 'repos_url': 'https://api.github.com/users/dskhudia/repos', 'events_url': 'https://api.github.com/users/dskhudia/events{/privacy}', 'received_events_url': 'https://api.github.com/users/dskhudia/received_events', 'type': 'User', 'site_admin': False}",referenced,d63795b8f1f586bfb4a50d1b22d25d30053e04a4,https://api.github.com/repos/pytorch/pytorch/commits/d63795b8f1f586bfb4a50d1b22d25d30053e04a4,2019-11-20T17:20:52Z,6351,4891,1460
29649,2816125388,"{'login': 'dskhudia', 'id': 37562707, 'node_id': 'MDQ6VXNlcjM3NTYyNzA3', 'avatar_url': 'https://avatars2.githubusercontent.com/u/37562707?v=4', 'gravatar_id': '', 'url': 'https://api.github.com/users/dskhudia', 'html_url': 'https://github.com/dskhudia', 'followers_url': 'https://api.github.com/users/dskhudia/followers', 'following_url': 'https://api.github.com/users/dskhudia/following{/other_user}', 'gists_url': 'https://api.github.com/users/dskhudia/gists{/gist_id}', 'starred_url': 'https://api.github.com/users/dskhudia/starred{/owner}{/repo}', 'subscriptions_url': 'https://api.github.com/users/dskhudia/subscriptions', 'organizations_url': 'https://api.github.com/users/dskhudia/orgs', 'repos_url': 'https://api.github.com/users/dskhudia/repos', 'events_url': 'https://api.github.com/users/dskhudia/events{/privacy}', 'received_events_url': 'https://api.github.com/users/dskhudia/received_events', 'type': 'User', 'site_admin': False}",referenced,15f5dd41754c874c15c8089e0b6d7540f4ec5197,https://api.github.com/repos/pytorch/pytorch/commits/15f5dd41754c874c15c8089e0b6d7540f4ec5197,2019-11-20T17:20:55Z,11,6,5
29649,2817491350,"{'login': 'dskhudia', 'id': 37562707, 'node_id': 'MDQ6VXNlcjM3NTYyNzA3', 'avatar_url': 'https://avatars2.githubusercontent.com/u/37562707?v=4', 'gravatar_id': '', 'url': 'https://api.github.com/users/dskhudia', 'html_url': 'https://github.com/dskhudia', 'followers_url': 'https://api.github.com/users/dskhudia/followers', 'following_url': 'https://api.github.com/users/dskhudia/following{/other_user}', 'gists_url': 'https://api.github.com/users/dskhudia/gists{/gist_id}', 'starred_url': 'https://api.github.com/users/dskhudia/starred{/owner}{/repo}', 'subscriptions_url': 'https://api.github.com/users/dskhudia/subscriptions', 'organizations_url': 'https://api.github.com/users/dskhudia/orgs', 'repos_url': 'https://api.github.com/users/dskhudia/repos', 'events_url': 'https://api.github.com/users/dskhudia/events{/privacy}', 'received_events_url': 'https://api.github.com/users/dskhudia/received_events', 'type': 'User', 'site_admin': False}",referenced,7b2686530a9f794ee091b73f5814c7660408581d,https://api.github.com/repos/pytorch/pytorch/commits/7b2686530a9f794ee091b73f5814c7660408581d,2019-11-21T00:54:29Z,3096,2018,1078
29649,2817491668,"{'login': 'dskhudia', 'id': 37562707, 'node_id': 'MDQ6VXNlcjM3NTYyNzA3', 'avatar_url': 'https://avatars2.githubusercontent.com/u/37562707?v=4', 'gravatar_id': '', 'url': 'https://api.github.com/users/dskhudia', 'html_url': 'https://github.com/dskhudia', 'followers_url': 'https://api.github.com/users/dskhudia/followers', 'following_url': 'https://api.github.com/users/dskhudia/following{/other_user}', 'gists_url': 'https://api.github.com/users/dskhudia/gists{/gist_id}', 'starred_url': 'https://api.github.com/users/dskhudia/starred{/owner}{/repo}', 'subscriptions_url': 'https://api.github.com/users/dskhudia/subscriptions', 'organizations_url': 'https://api.github.com/users/dskhudia/orgs', 'repos_url': 'https://api.github.com/users/dskhudia/repos', 'events_url': 'https://api.github.com/users/dskhudia/events{/privacy}', 'received_events_url': 'https://api.github.com/users/dskhudia/received_events', 'type': 'User', 'site_admin': False}",referenced,714cebeb2dc65e1293c0559f9c2c15178fda3fdb,https://api.github.com/repos/pytorch/pytorch/commits/714cebeb2dc65e1293c0559f9c2c15178fda3fdb,2019-11-21T00:54:34Z,11,6,5
29649,2820742241,"{'login': 'dskhudia', 'id': 37562707, 'node_id': 'MDQ6VXNlcjM3NTYyNzA3', 'avatar_url': 'https://avatars2.githubusercontent.com/u/37562707?v=4', 'gravatar_id': '', 'url': 'https://api.github.com/users/dskhudia', 'html_url': 'https://github.com/dskhudia', 'followers_url': 'https://api.github.com/users/dskhudia/followers', 'following_url': 'https://api.github.com/users/dskhudia/following{/other_user}', 'gists_url': 'https://api.github.com/users/dskhudia/gists{/gist_id}', 'starred_url': 'https://api.github.com/users/dskhudia/starred{/owner}{/repo}', 'subscriptions_url': 'https://api.github.com/users/dskhudia/subscriptions', 'organizations_url': 'https://api.github.com/users/dskhudia/orgs', 'repos_url': 'https://api.github.com/users/dskhudia/repos', 'events_url': 'https://api.github.com/users/dskhudia/events{/privacy}', 'received_events_url': 'https://api.github.com/users/dskhudia/received_events', 'type': 'User', 'site_admin': False}",referenced,f41ff8969fc8a9c10e1ef94046db18b95abc5a79,https://api.github.com/repos/pytorch/pytorch/commits/f41ff8969fc8a9c10e1ef94046db18b95abc5a79,2019-11-21T18:40:23Z,1194,1033,161
29646,2851365236,"{'login': 'facebook-github-bot', 'id': 6422482, 'node_id': 'MDQ6VXNlcjY0MjI0ODI=', 'avatar_url': 'https://avatars3.githubusercontent.com/u/6422482?v=4', 'gravatar_id': '', 'url': 'https://api.github.com/users/facebook-github-bot', 'html_url': 'https://github.com/facebook-github-bot', 'followers_url': 'https://api.github.com/users/facebook-github-bot/followers', 'following_url': 'https://api.github.com/users/facebook-github-bot/following{/other_user}', 'gists_url': 'https://api.github.com/users/facebook-github-bot/gists{/gist_id}', 'starred_url': 'https://api.github.com/users/facebook-github-bot/starred{/owner}{/repo}', 'subscriptions_url': 'https://api.github.com/users/facebook-github-bot/subscriptions', 'organizations_url': 'https://api.github.com/users/facebook-github-bot/orgs', 'repos_url': 'https://api.github.com/users/facebook-github-bot/repos', 'events_url': 'https://api.github.com/users/facebook-github-bot/events{/privacy}', 'received_events_url': 'https://api.github.com/users/facebook-github-bot/received_events', 'type': 'User', 'site_admin': False}",referenced,7023e13fbba56fade9db82ac32052e7ef635597c,https://api.github.com/repos/pytorch/pytorch/commits/7023e13fbba56fade9db82ac32052e7ef635597c,2019-12-03T19:34:41Z,8,4,4
29578,2810244994,"{'login': 'facebook-github-bot', 'id': 6422482, 'node_id': 'MDQ6VXNlcjY0MjI0ODI=', 'avatar_url': 'https://avatars3.githubusercontent.com/u/6422482?v=4', 'gravatar_id': '', 'url': 'https://api.github.com/users/facebook-github-bot', 'html_url': 'https://github.com/facebook-github-bot', 'followers_url': 'https://api.github.com/users/facebook-github-bot/followers', 'following_url': 'https://api.github.com/users/facebook-github-bot/following{/other_user}', 'gists_url': 'https://api.github.com/users/facebook-github-bot/gists{/gist_id}', 'starred_url': 'https://api.github.com/users/facebook-github-bot/starred{/owner}{/repo}', 'subscriptions_url': 'https://api.github.com/users/facebook-github-bot/subscriptions', 'organizations_url': 'https://api.github.com/users/facebook-github-bot/orgs', 'repos_url': 'https://api.github.com/users/facebook-github-bot/repos', 'events_url': 'https://api.github.com/users/facebook-github-bot/events{/privacy}', 'received_events_url': 'https://api.github.com/users/facebook-github-bot/received_events', 'type': 'User', 'site_admin': False}",referenced,a9ad2e2f00e9b7d9b30af5c0c6db348432ad7964,https://api.github.com/repos/pytorch/pytorch/commits/a9ad2e2f00e9b7d9b30af5c0c6db348432ad7964,2019-11-19T07:08:29Z,35,28,7
29520,2975315092,"{'login': 'facebook-github-bot', 'id': 6422482, 'node_id': 'MDQ6VXNlcjY0MjI0ODI=', 'avatar_url': 'https://avatars3.githubusercontent.com/u/6422482?v=4', 'gravatar_id': '', 'url': 'https://api.github.com/users/facebook-github-bot', 'html_url': 'https://github.com/facebook-github-bot', 'followers_url': 'https://api.github.com/users/facebook-github-bot/followers', 'following_url': 'https://api.github.com/users/facebook-github-bot/following{/other_user}', 'gists_url': 'https://api.github.com/users/facebook-github-bot/gists{/gist_id}', 'starred_url': 'https://api.github.com/users/facebook-github-bot/starred{/owner}{/repo}', 'subscriptions_url': 'https://api.github.com/users/facebook-github-bot/subscriptions', 'organizations_url': 'https://api.github.com/users/facebook-github-bot/orgs', 'repos_url': 'https://api.github.com/users/facebook-github-bot/repos', 'events_url': 'https://api.github.com/users/facebook-github-bot/events{/privacy}', 'received_events_url': 'https://api.github.com/users/facebook-github-bot/received_events', 'type': 'User', 'site_admin': False}",referenced,db02a4e4ceced885508991441ea68896d48fc369,https://api.github.com/repos/pytorch/pytorch/commits/db02a4e4ceced885508991441ea68896d48fc369,2020-01-23T21:18:36Z,79,57,22
29475,2803704074,"{'login': 'facebook-github-bot', 'id': 6422482, 'node_id': 'MDQ6VXNlcjY0MjI0ODI=', 'avatar_url': 'https://avatars3.githubusercontent.com/u/6422482?v=4', 'gravatar_id': '', 'url': 'https://api.github.com/users/facebook-github-bot', 'html_url': 'https://github.com/facebook-github-bot', 'followers_url': 'https://api.github.com/users/facebook-github-bot/followers', 'following_url': 'https://api.github.com/users/facebook-github-bot/following{/other_user}', 'gists_url': 'https://api.github.com/users/facebook-github-bot/gists{/gist_id}', 'starred_url': 'https://api.github.com/users/facebook-github-bot/starred{/owner}{/repo}', 'subscriptions_url': 'https://api.github.com/users/facebook-github-bot/subscriptions', 'organizations_url': 'https://api.github.com/users/facebook-github-bot/orgs', 'repos_url': 'https://api.github.com/users/facebook-github-bot/repos', 'events_url': 'https://api.github.com/users/facebook-github-bot/events{/privacy}', 'received_events_url': 'https://api.github.com/users/facebook-github-bot/received_events', 'type': 'User', 'site_admin': False}",closed,69e343f2cc26f7a090fa0a4c4f8cf5064d4df1c9,https://api.github.com/repos/pytorch/pytorch/commits/69e343f2cc26f7a090fa0a4c4f8cf5064d4df1c9,2019-11-15T19:16:58Z,28,23,5
29435,2792518358,"{'login': 'jerryzh168', 'id': 4958441, 'node_id': 'MDQ6VXNlcjQ5NTg0NDE=', 'avatar_url': 'https://avatars0.githubusercontent.com/u/4958441?v=4', 'gravatar_id': '', 'url': 'https://api.github.com/users/jerryzh168', 'html_url': 'https://github.com/jerryzh168', 'followers_url': 'https://api.github.com/users/jerryzh168/followers', 'following_url': 'https://api.github.com/users/jerryzh168/following{/other_user}', 'gists_url': 'https://api.github.com/users/jerryzh168/gists{/gist_id}', 'starred_url': 'https://api.github.com/users/jerryzh168/starred{/owner}{/repo}', 'subscriptions_url': 'https://api.github.com/users/jerryzh168/subscriptions', 'organizations_url': 'https://api.github.com/users/jerryzh168/orgs', 'repos_url': 'https://api.github.com/users/jerryzh168/repos', 'events_url': 'https://api.github.com/users/jerryzh168/events{/privacy}', 'received_events_url': 'https://api.github.com/users/jerryzh168/received_events', 'type': 'User', 'site_admin': False}",referenced,2bb241104c5af62e2500618e630713787643e6e1,https://api.github.com/repos/pytorch/pytorch/commits/2bb241104c5af62e2500618e630713787643e6e1,2019-11-12T18:22:43Z,3,2,1
29435,2793041773,"{'login': 'facebook-github-bot', 'id': 6422482, 'node_id': 'MDQ6VXNlcjY0MjI0ODI=', 'avatar_url': 'https://avatars3.githubusercontent.com/u/6422482?v=4', 'gravatar_id': '', 'url': 'https://api.github.com/users/facebook-github-bot', 'html_url': 'https://github.com/facebook-github-bot', 'followers_url': 'https://api.github.com/users/facebook-github-bot/followers', 'following_url': 'https://api.github.com/users/facebook-github-bot/following{/other_user}', 'gists_url': 'https://api.github.com/users/facebook-github-bot/gists{/gist_id}', 'starred_url': 'https://api.github.com/users/facebook-github-bot/starred{/owner}{/repo}', 'subscriptions_url': 'https://api.github.com/users/facebook-github-bot/subscriptions', 'organizations_url': 'https://api.github.com/users/facebook-github-bot/orgs', 'repos_url': 'https://api.github.com/users/facebook-github-bot/repos', 'events_url': 'https://api.github.com/users/facebook-github-bot/events{/privacy}', 'received_events_url': 'https://api.github.com/users/facebook-github-bot/received_events', 'type': 'User', 'site_admin': False}",closed,82913a266d76279d282a10edbb59e405d7cec648,https://api.github.com/repos/pytorch/pytorch/commits/82913a266d76279d282a10edbb59e405d7cec648,2019-11-12T21:16:54Z,11,8,3
29367,2781312489,"{'login': 'facebook-github-bot', 'id': 6422482, 'node_id': 'MDQ6VXNlcjY0MjI0ODI=', 'avatar_url': 'https://avatars3.githubusercontent.com/u/6422482?v=4', 'gravatar_id': '', 'url': 'https://api.github.com/users/facebook-github-bot', 'html_url': 'https://github.com/facebook-github-bot', 'followers_url': 'https://api.github.com/users/facebook-github-bot/followers', 'following_url': 'https://api.github.com/users/facebook-github-bot/following{/other_user}', 'gists_url': 'https://api.github.com/users/facebook-github-bot/gists{/gist_id}', 'starred_url': 'https://api.github.com/users/facebook-github-bot/starred{/owner}{/repo}', 'subscriptions_url': 'https://api.github.com/users/facebook-github-bot/subscriptions', 'organizations_url': 'https://api.github.com/users/facebook-github-bot/orgs', 'repos_url': 'https://api.github.com/users/facebook-github-bot/repos', 'events_url': 'https://api.github.com/users/facebook-github-bot/events{/privacy}', 'received_events_url': 'https://api.github.com/users/facebook-github-bot/received_events', 'type': 'User', 'site_admin': False}",closed,782e80e6e71ab05b53bd5f0ca2db079f8e86b243,https://api.github.com/repos/pytorch/pytorch/commits/782e80e6e71ab05b53bd5f0ca2db079f8e86b243,2019-11-08T00:29:20Z,63,32,31
29352,2785827831,"{'login': 'facebook-github-bot', 'id': 6422482, 'node_id': 'MDQ6VXNlcjY0MjI0ODI=', 'avatar_url': 'https://avatars3.githubusercontent.com/u/6422482?v=4', 'gravatar_id': '', 'url': 'https://api.github.com/users/facebook-github-bot', 'html_url': 'https://github.com/facebook-github-bot', 'followers_url': 'https://api.github.com/users/facebook-github-bot/followers', 'following_url': 'https://api.github.com/users/facebook-github-bot/following{/other_user}', 'gists_url': 'https://api.github.com/users/facebook-github-bot/gists{/gist_id}', 'starred_url': 'https://api.github.com/users/facebook-github-bot/starred{/owner}{/repo}', 'subscriptions_url': 'https://api.github.com/users/facebook-github-bot/subscriptions', 'organizations_url': 'https://api.github.com/users/facebook-github-bot/orgs', 'repos_url': 'https://api.github.com/users/facebook-github-bot/repos', 'events_url': 'https://api.github.com/users/facebook-github-bot/events{/privacy}', 'received_events_url': 'https://api.github.com/users/facebook-github-bot/received_events', 'type': 'User', 'site_admin': False}",closed,2032482eb97f0b650f11fd117791c9bc62125dee,https://api.github.com/repos/pytorch/pytorch/commits/2032482eb97f0b650f11fd117791c9bc62125dee,2019-11-10T07:12:46Z,197,127,70
29271,2810097071,"{'login': 'facebook-github-bot', 'id': 6422482, 'node_id': 'MDQ6VXNlcjY0MjI0ODI=', 'avatar_url': 'https://avatars3.githubusercontent.com/u/6422482?v=4', 'gravatar_id': '', 'url': 'https://api.github.com/users/facebook-github-bot', 'html_url': 'https://github.com/facebook-github-bot', 'followers_url': 'https://api.github.com/users/facebook-github-bot/followers', 'following_url': 'https://api.github.com/users/facebook-github-bot/following{/other_user}', 'gists_url': 'https://api.github.com/users/facebook-github-bot/gists{/gist_id}', 'starred_url': 'https://api.github.com/users/facebook-github-bot/starred{/owner}{/repo}', 'subscriptions_url': 'https://api.github.com/users/facebook-github-bot/subscriptions', 'organizations_url': 'https://api.github.com/users/facebook-github-bot/orgs', 'repos_url': 'https://api.github.com/users/facebook-github-bot/repos', 'events_url': 'https://api.github.com/users/facebook-github-bot/events{/privacy}', 'received_events_url': 'https://api.github.com/users/facebook-github-bot/received_events', 'type': 'User', 'site_admin': False}",referenced,267fd4a06cec5cea4749c8f6375acd62ce453656,https://api.github.com/repos/pytorch/pytorch/commits/267fd4a06cec5cea4749c8f6375acd62ce453656,2019-11-19T05:52:24Z,85,55,30
29252,2833628886,"{'login': 'nairbv', 'id': 582713, 'node_id': 'MDQ6VXNlcjU4MjcxMw==', 'avatar_url': 'https://avatars1.githubusercontent.com/u/582713?v=4', 'gravatar_id': '', 'url': 'https://api.github.com/users/nairbv', 'html_url': 'https://github.com/nairbv', 'followers_url': 'https://api.github.com/users/nairbv/followers', 'following_url': 'https://api.github.com/users/nairbv/following{/other_user}', 'gists_url': 'https://api.github.com/users/nairbv/gists{/gist_id}', 'starred_url': 'https://api.github.com/users/nairbv/starred{/owner}{/repo}', 'subscriptions_url': 'https://api.github.com/users/nairbv/subscriptions', 'organizations_url': 'https://api.github.com/users/nairbv/orgs', 'repos_url': 'https://api.github.com/users/nairbv/repos', 'events_url': 'https://api.github.com/users/nairbv/events{/privacy}', 'received_events_url': 'https://api.github.com/users/nairbv/received_events', 'type': 'User', 'site_admin': False}",referenced,ad4f5be9b58155584fd9301da98520e36af718fe,https://api.github.com/repos/pytorch/pytorch/commits/ad4f5be9b58155584fd9301da98520e36af718fe,2019-11-26T22:10:25Z,56,42,14
29252,2833629015,"{'login': 'nairbv', 'id': 582713, 'node_id': 'MDQ6VXNlcjU4MjcxMw==', 'avatar_url': 'https://avatars1.githubusercontent.com/u/582713?v=4', 'gravatar_id': '', 'url': 'https://api.github.com/users/nairbv', 'html_url': 'https://github.com/nairbv', 'followers_url': 'https://api.github.com/users/nairbv/followers', 'following_url': 'https://api.github.com/users/nairbv/following{/other_user}', 'gists_url': 'https://api.github.com/users/nairbv/gists{/gist_id}', 'starred_url': 'https://api.github.com/users/nairbv/starred{/owner}{/repo}', 'subscriptions_url': 'https://api.github.com/users/nairbv/subscriptions', 'organizations_url': 'https://api.github.com/users/nairbv/orgs', 'repos_url': 'https://api.github.com/users/nairbv/repos', 'events_url': 'https://api.github.com/users/nairbv/events{/privacy}', 'received_events_url': 'https://api.github.com/users/nairbv/received_events', 'type': 'User', 'site_admin': False}",referenced,7cb89b22176a95c63577af788449a08a4b567e86,https://api.github.com/repos/pytorch/pytorch/commits/7cb89b22176a95c63577af788449a08a4b567e86,2019-11-26T22:10:28Z,56,42,14
29252,2833643973,"{'login': 'nairbv', 'id': 582713, 'node_id': 'MDQ6VXNlcjU4MjcxMw==', 'avatar_url': 'https://avatars1.githubusercontent.com/u/582713?v=4', 'gravatar_id': '', 'url': 'https://api.github.com/users/nairbv', 'html_url': 'https://github.com/nairbv', 'followers_url': 'https://api.github.com/users/nairbv/followers', 'following_url': 'https://api.github.com/users/nairbv/following{/other_user}', 'gists_url': 'https://api.github.com/users/nairbv/gists{/gist_id}', 'starred_url': 'https://api.github.com/users/nairbv/starred{/owner}{/repo}', 'subscriptions_url': 'https://api.github.com/users/nairbv/subscriptions', 'organizations_url': 'https://api.github.com/users/nairbv/orgs', 'repos_url': 'https://api.github.com/users/nairbv/repos', 'events_url': 'https://api.github.com/users/nairbv/events{/privacy}', 'received_events_url': 'https://api.github.com/users/nairbv/received_events', 'type': 'User', 'site_admin': False}",referenced,768b8568919ce86217aec6c4ef521949e499ee83,https://api.github.com/repos/pytorch/pytorch/commits/768b8568919ce86217aec6c4ef521949e499ee83,2019-11-26T22:16:23Z,4,0,4
29252,2833644122,"{'login': 'nairbv', 'id': 582713, 'node_id': 'MDQ6VXNlcjU4MjcxMw==', 'avatar_url': 'https://avatars1.githubusercontent.com/u/582713?v=4', 'gravatar_id': '', 'url': 'https://api.github.com/users/nairbv', 'html_url': 'https://github.com/nairbv', 'followers_url': 'https://api.github.com/users/nairbv/followers', 'following_url': 'https://api.github.com/users/nairbv/following{/other_user}', 'gists_url': 'https://api.github.com/users/nairbv/gists{/gist_id}', 'starred_url': 'https://api.github.com/users/nairbv/starred{/owner}{/repo}', 'subscriptions_url': 'https://api.github.com/users/nairbv/subscriptions', 'organizations_url': 'https://api.github.com/users/nairbv/orgs', 'repos_url': 'https://api.github.com/users/nairbv/repos', 'events_url': 'https://api.github.com/users/nairbv/events{/privacy}', 'received_events_url': 'https://api.github.com/users/nairbv/received_events', 'type': 'User', 'site_admin': False}",referenced,5b62067f28e51fb2c0e8db7aac49fed8292c3f94,https://api.github.com/repos/pytorch/pytorch/commits/5b62067f28e51fb2c0e8db7aac49fed8292c3f94,2019-11-26T22:16:27Z,58,41,17
29252,2836564378,"{'login': 'nairbv', 'id': 582713, 'node_id': 'MDQ6VXNlcjU4MjcxMw==', 'avatar_url': 'https://avatars1.githubusercontent.com/u/582713?v=4', 'gravatar_id': '', 'url': 'https://api.github.com/users/nairbv', 'html_url': 'https://github.com/nairbv', 'followers_url': 'https://api.github.com/users/nairbv/followers', 'following_url': 'https://api.github.com/users/nairbv/following{/other_user}', 'gists_url': 'https://api.github.com/users/nairbv/gists{/gist_id}', 'starred_url': 'https://api.github.com/users/nairbv/starred{/owner}{/repo}', 'subscriptions_url': 'https://api.github.com/users/nairbv/subscriptions', 'organizations_url': 'https://api.github.com/users/nairbv/orgs', 'repos_url': 'https://api.github.com/users/nairbv/repos', 'events_url': 'https://api.github.com/users/nairbv/events{/privacy}', 'received_events_url': 'https://api.github.com/users/nairbv/received_events', 'type': 'User', 'site_admin': False}",referenced,f49a42579feea47dfb342f77ad6440a7a3c822ac,https://api.github.com/repos/pytorch/pytorch/commits/f49a42579feea47dfb342f77ad6440a7a3c822ac,2019-11-27T18:01:39Z,20,9,11
29252,2836564537,"{'login': 'nairbv', 'id': 582713, 'node_id': 'MDQ6VXNlcjU4MjcxMw==', 'avatar_url': 'https://avatars1.githubusercontent.com/u/582713?v=4', 'gravatar_id': '', 'url': 'https://api.github.com/users/nairbv', 'html_url': 'https://github.com/nairbv', 'followers_url': 'https://api.github.com/users/nairbv/followers', 'following_url': 'https://api.github.com/users/nairbv/following{/other_user}', 'gists_url': 'https://api.github.com/users/nairbv/gists{/gist_id}', 'starred_url': 'https://api.github.com/users/nairbv/starred{/owner}{/repo}', 'subscriptions_url': 'https://api.github.com/users/nairbv/subscriptions', 'organizations_url': 'https://api.github.com/users/nairbv/orgs', 'repos_url': 'https://api.github.com/users/nairbv/repos', 'events_url': 'https://api.github.com/users/nairbv/events{/privacy}', 'received_events_url': 'https://api.github.com/users/nairbv/received_events', 'type': 'User', 'site_admin': False}",referenced,c62a911759068a67c804eedd8e3e97bbe36e1418,https://api.github.com/repos/pytorch/pytorch/commits/c62a911759068a67c804eedd8e3e97bbe36e1418,2019-11-27T18:01:43Z,74,48,26
29252,2836594767,"{'login': 'nairbv', 'id': 582713, 'node_id': 'MDQ6VXNlcjU4MjcxMw==', 'avatar_url': 'https://avatars1.githubusercontent.com/u/582713?v=4', 'gravatar_id': '', 'url': 'https://api.github.com/users/nairbv', 'html_url': 'https://github.com/nairbv', 'followers_url': 'https://api.github.com/users/nairbv/followers', 'following_url': 'https://api.github.com/users/nairbv/following{/other_user}', 'gists_url': 'https://api.github.com/users/nairbv/gists{/gist_id}', 'starred_url': 'https://api.github.com/users/nairbv/starred{/owner}{/repo}', 'subscriptions_url': 'https://api.github.com/users/nairbv/subscriptions', 'organizations_url': 'https://api.github.com/users/nairbv/orgs', 'repos_url': 'https://api.github.com/users/nairbv/repos', 'events_url': 'https://api.github.com/users/nairbv/events{/privacy}', 'received_events_url': 'https://api.github.com/users/nairbv/received_events', 'type': 'User', 'site_admin': False}",referenced,9c92ba7e513558ae92f25c96f44f824712bed4bb,https://api.github.com/repos/pytorch/pytorch/commits/9c92ba7e513558ae92f25c96f44f824712bed4bb,2019-11-27T18:13:00Z,3,1,2
29252,2836594926,"{'login': 'nairbv', 'id': 582713, 'node_id': 'MDQ6VXNlcjU4MjcxMw==', 'avatar_url': 'https://avatars1.githubusercontent.com/u/582713?v=4', 'gravatar_id': '', 'url': 'https://api.github.com/users/nairbv', 'html_url': 'https://github.com/nairbv', 'followers_url': 'https://api.github.com/users/nairbv/followers', 'following_url': 'https://api.github.com/users/nairbv/following{/other_user}', 'gists_url': 'https://api.github.com/users/nairbv/gists{/gist_id}', 'starred_url': 'https://api.github.com/users/nairbv/starred{/owner}{/repo}', 'subscriptions_url': 'https://api.github.com/users/nairbv/subscriptions', 'organizations_url': 'https://api.github.com/users/nairbv/orgs', 'repos_url': 'https://api.github.com/users/nairbv/repos', 'events_url': 'https://api.github.com/users/nairbv/events{/privacy}', 'received_events_url': 'https://api.github.com/users/nairbv/received_events', 'type': 'User', 'site_admin': False}",referenced,ebc1a398ce7bb3a3ebaee6db4f110ddfc46cba54,https://api.github.com/repos/pytorch/pytorch/commits/ebc1a398ce7bb3a3ebaee6db4f110ddfc46cba54,2019-11-27T18:13:04Z,77,49,28
29252,2847106125,"{'login': 'nairbv', 'id': 582713, 'node_id': 'MDQ6VXNlcjU4MjcxMw==', 'avatar_url': 'https://avatars1.githubusercontent.com/u/582713?v=4', 'gravatar_id': '', 'url': 'https://api.github.com/users/nairbv', 'html_url': 'https://github.com/nairbv', 'followers_url': 'https://api.github.com/users/nairbv/followers', 'following_url': 'https://api.github.com/users/nairbv/following{/other_user}', 'gists_url': 'https://api.github.com/users/nairbv/gists{/gist_id}', 'starred_url': 'https://api.github.com/users/nairbv/starred{/owner}{/repo}', 'subscriptions_url': 'https://api.github.com/users/nairbv/subscriptions', 'organizations_url': 'https://api.github.com/users/nairbv/orgs', 'repos_url': 'https://api.github.com/users/nairbv/repos', 'events_url': 'https://api.github.com/users/nairbv/events{/privacy}', 'received_events_url': 'https://api.github.com/users/nairbv/received_events', 'type': 'User', 'site_admin': False}",referenced,d27a85cc549149e7a55454d76d9596e07af83e1f,https://api.github.com/repos/pytorch/pytorch/commits/d27a85cc549149e7a55454d76d9596e07af83e1f,2019-12-02T20:13:13Z,31,19,12
29252,2847106276,"{'login': 'nairbv', 'id': 582713, 'node_id': 'MDQ6VXNlcjU4MjcxMw==', 'avatar_url': 'https://avatars1.githubusercontent.com/u/582713?v=4', 'gravatar_id': '', 'url': 'https://api.github.com/users/nairbv', 'html_url': 'https://github.com/nairbv', 'followers_url': 'https://api.github.com/users/nairbv/followers', 'following_url': 'https://api.github.com/users/nairbv/following{/other_user}', 'gists_url': 'https://api.github.com/users/nairbv/gists{/gist_id}', 'starred_url': 'https://api.github.com/users/nairbv/starred{/owner}{/repo}', 'subscriptions_url': 'https://api.github.com/users/nairbv/subscriptions', 'organizations_url': 'https://api.github.com/users/nairbv/orgs', 'repos_url': 'https://api.github.com/users/nairbv/repos', 'events_url': 'https://api.github.com/users/nairbv/events{/privacy}', 'received_events_url': 'https://api.github.com/users/nairbv/received_events', 'type': 'User', 'site_admin': False}",referenced,9393830da5334ffaa6014e7dfa6206a56626090c,https://api.github.com/repos/pytorch/pytorch/commits/9393830da5334ffaa6014e7dfa6206a56626090c,2019-12-02T20:13:17Z,78,53,25
29252,2847108256,"{'login': 'nairbv', 'id': 582713, 'node_id': 'MDQ6VXNlcjU4MjcxMw==', 'avatar_url': 'https://avatars1.githubusercontent.com/u/582713?v=4', 'gravatar_id': '', 'url': 'https://api.github.com/users/nairbv', 'html_url': 'https://github.com/nairbv', 'followers_url': 'https://api.github.com/users/nairbv/followers', 'following_url': 'https://api.github.com/users/nairbv/following{/other_user}', 'gists_url': 'https://api.github.com/users/nairbv/gists{/gist_id}', 'starred_url': 'https://api.github.com/users/nairbv/starred{/owner}{/repo}', 'subscriptions_url': 'https://api.github.com/users/nairbv/subscriptions', 'organizations_url': 'https://api.github.com/users/nairbv/orgs', 'repos_url': 'https://api.github.com/users/nairbv/repos', 'events_url': 'https://api.github.com/users/nairbv/events{/privacy}', 'received_events_url': 'https://api.github.com/users/nairbv/received_events', 'type': 'User', 'site_admin': False}",referenced,12d6de600476b9b1d9bcae6351680b37995e6d9c,https://api.github.com/repos/pytorch/pytorch/commits/12d6de600476b9b1d9bcae6351680b37995e6d9c,2019-12-02T20:14:00Z,3617,2797,820
29252,2847108426,"{'login': 'nairbv', 'id': 582713, 'node_id': 'MDQ6VXNlcjU4MjcxMw==', 'avatar_url': 'https://avatars1.githubusercontent.com/u/582713?v=4', 'gravatar_id': '', 'url': 'https://api.github.com/users/nairbv', 'html_url': 'https://github.com/nairbv', 'followers_url': 'https://api.github.com/users/nairbv/followers', 'following_url': 'https://api.github.com/users/nairbv/following{/other_user}', 'gists_url': 'https://api.github.com/users/nairbv/gists{/gist_id}', 'starred_url': 'https://api.github.com/users/nairbv/starred{/owner}{/repo}', 'subscriptions_url': 'https://api.github.com/users/nairbv/subscriptions', 'organizations_url': 'https://api.github.com/users/nairbv/orgs', 'repos_url': 'https://api.github.com/users/nairbv/repos', 'events_url': 'https://api.github.com/users/nairbv/events{/privacy}', 'received_events_url': 'https://api.github.com/users/nairbv/received_events', 'type': 'User', 'site_admin': False}",referenced,57ea151abc958a0259a0a2f4da9edd81b24ea255,https://api.github.com/repos/pytorch/pytorch/commits/57ea151abc958a0259a0a2f4da9edd81b24ea255,2019-12-02T20:14:02Z,78,53,25
29252,2858260263,"{'login': 'nairbv', 'id': 582713, 'node_id': 'MDQ6VXNlcjU4MjcxMw==', 'avatar_url': 'https://avatars1.githubusercontent.com/u/582713?v=4', 'gravatar_id': '', 'url': 'https://api.github.com/users/nairbv', 'html_url': 'https://github.com/nairbv', 'followers_url': 'https://api.github.com/users/nairbv/followers', 'following_url': 'https://api.github.com/users/nairbv/following{/other_user}', 'gists_url': 'https://api.github.com/users/nairbv/gists{/gist_id}', 'starred_url': 'https://api.github.com/users/nairbv/starred{/owner}{/repo}', 'subscriptions_url': 'https://api.github.com/users/nairbv/subscriptions', 'organizations_url': 'https://api.github.com/users/nairbv/orgs', 'repos_url': 'https://api.github.com/users/nairbv/repos', 'events_url': 'https://api.github.com/users/nairbv/events{/privacy}', 'received_events_url': 'https://api.github.com/users/nairbv/received_events', 'type': 'User', 'site_admin': False}",referenced,a1f9f71306ef15a996fcf2c22995abb6b4ae75d8,https://api.github.com/repos/pytorch/pytorch/commits/a1f9f71306ef15a996fcf2c22995abb6b4ae75d8,2019-12-05T15:30:59Z,8,4,4
29252,2858260616,"{'login': 'nairbv', 'id': 582713, 'node_id': 'MDQ6VXNlcjU4MjcxMw==', 'avatar_url': 'https://avatars1.githubusercontent.com/u/582713?v=4', 'gravatar_id': '', 'url': 'https://api.github.com/users/nairbv', 'html_url': 'https://github.com/nairbv', 'followers_url': 'https://api.github.com/users/nairbv/followers', 'following_url': 'https://api.github.com/users/nairbv/following{/other_user}', 'gists_url': 'https://api.github.com/users/nairbv/gists{/gist_id}', 'starred_url': 'https://api.github.com/users/nairbv/starred{/owner}{/repo}', 'subscriptions_url': 'https://api.github.com/users/nairbv/subscriptions', 'organizations_url': 'https://api.github.com/users/nairbv/orgs', 'repos_url': 'https://api.github.com/users/nairbv/repos', 'events_url': 'https://api.github.com/users/nairbv/events{/privacy}', 'received_events_url': 'https://api.github.com/users/nairbv/received_events', 'type': 'User', 'site_admin': False}",referenced,dd9c57e2246449815b68f8c29950d955497e02e6,https://api.github.com/repos/pytorch/pytorch/commits/dd9c57e2246449815b68f8c29950d955497e02e6,2019-12-05T15:31:05Z,82,55,27
29252,2858516940,"{'login': 'nairbv', 'id': 582713, 'node_id': 'MDQ6VXNlcjU4MjcxMw==', 'avatar_url': 'https://avatars1.githubusercontent.com/u/582713?v=4', 'gravatar_id': '', 'url': 'https://api.github.com/users/nairbv', 'html_url': 'https://github.com/nairbv', 'followers_url': 'https://api.github.com/users/nairbv/followers', 'following_url': 'https://api.github.com/users/nairbv/following{/other_user}', 'gists_url': 'https://api.github.com/users/nairbv/gists{/gist_id}', 'starred_url': 'https://api.github.com/users/nairbv/starred{/owner}{/repo}', 'subscriptions_url': 'https://api.github.com/users/nairbv/subscriptions', 'organizations_url': 'https://api.github.com/users/nairbv/orgs', 'repos_url': 'https://api.github.com/users/nairbv/repos', 'events_url': 'https://api.github.com/users/nairbv/events{/privacy}', 'received_events_url': 'https://api.github.com/users/nairbv/received_events', 'type': 'User', 'site_admin': False}",referenced,bee619c5e17cd4929fc6c31a12a9f7fd01977677,https://api.github.com/repos/pytorch/pytorch/commits/bee619c5e17cd4929fc6c31a12a9f7fd01977677,2019-12-05T16:39:59Z,10278,7945,2333
29252,2858517017,"{'login': 'nairbv', 'id': 582713, 'node_id': 'MDQ6VXNlcjU4MjcxMw==', 'avatar_url': 'https://avatars1.githubusercontent.com/u/582713?v=4', 'gravatar_id': '', 'url': 'https://api.github.com/users/nairbv', 'html_url': 'https://github.com/nairbv', 'followers_url': 'https://api.github.com/users/nairbv/followers', 'following_url': 'https://api.github.com/users/nairbv/following{/other_user}', 'gists_url': 'https://api.github.com/users/nairbv/gists{/gist_id}', 'starred_url': 'https://api.github.com/users/nairbv/starred{/owner}{/repo}', 'subscriptions_url': 'https://api.github.com/users/nairbv/subscriptions', 'organizations_url': 'https://api.github.com/users/nairbv/orgs', 'repos_url': 'https://api.github.com/users/nairbv/repos', 'events_url': 'https://api.github.com/users/nairbv/events{/privacy}', 'received_events_url': 'https://api.github.com/users/nairbv/received_events', 'type': 'User', 'site_admin': False}",referenced,3828df7b3fda07ccf0ea13b5b0b2cd3e932440ff,https://api.github.com/repos/pytorch/pytorch/commits/3828df7b3fda07ccf0ea13b5b0b2cd3e932440ff,2019-12-05T16:40:00Z,88,61,27
29252,2858957942,"{'login': 'nairbv', 'id': 582713, 'node_id': 'MDQ6VXNlcjU4MjcxMw==', 'avatar_url': 'https://avatars1.githubusercontent.com/u/582713?v=4', 'gravatar_id': '', 'url': 'https://api.github.com/users/nairbv', 'html_url': 'https://github.com/nairbv', 'followers_url': 'https://api.github.com/users/nairbv/followers', 'following_url': 'https://api.github.com/users/nairbv/following{/other_user}', 'gists_url': 'https://api.github.com/users/nairbv/gists{/gist_id}', 'starred_url': 'https://api.github.com/users/nairbv/starred{/owner}{/repo}', 'subscriptions_url': 'https://api.github.com/users/nairbv/subscriptions', 'organizations_url': 'https://api.github.com/users/nairbv/orgs', 'repos_url': 'https://api.github.com/users/nairbv/repos', 'events_url': 'https://api.github.com/users/nairbv/events{/privacy}', 'received_events_url': 'https://api.github.com/users/nairbv/received_events', 'type': 'User', 'site_admin': False}",referenced,db7db61aa8e760282536facfbdf85162b64d915b,https://api.github.com/repos/pytorch/pytorch/commits/db7db61aa8e760282536facfbdf85162b64d915b,2019-12-05T19:02:52Z,23,12,11
29252,2858958237,"{'login': 'nairbv', 'id': 582713, 'node_id': 'MDQ6VXNlcjU4MjcxMw==', 'avatar_url': 'https://avatars1.githubusercontent.com/u/582713?v=4', 'gravatar_id': '', 'url': 'https://api.github.com/users/nairbv', 'html_url': 'https://github.com/nairbv', 'followers_url': 'https://api.github.com/users/nairbv/followers', 'following_url': 'https://api.github.com/users/nairbv/following{/other_user}', 'gists_url': 'https://api.github.com/users/nairbv/gists{/gist_id}', 'starred_url': 'https://api.github.com/users/nairbv/starred{/owner}{/repo}', 'subscriptions_url': 'https://api.github.com/users/nairbv/subscriptions', 'organizations_url': 'https://api.github.com/users/nairbv/orgs', 'repos_url': 'https://api.github.com/users/nairbv/repos', 'events_url': 'https://api.github.com/users/nairbv/events{/privacy}', 'received_events_url': 'https://api.github.com/users/nairbv/received_events', 'type': 'User', 'site_admin': False}",referenced,7ee67d1fabe9cde42e43872a8bae92dd6d0df947,https://api.github.com/repos/pytorch/pytorch/commits/7ee67d1fabe9cde42e43872a8bae92dd6d0df947,2019-12-05T19:02:58Z,89,62,27
29252,2859281538,"{'login': 'nairbv', 'id': 582713, 'node_id': 'MDQ6VXNlcjU4MjcxMw==', 'avatar_url': 'https://avatars1.githubusercontent.com/u/582713?v=4', 'gravatar_id': '', 'url': 'https://api.github.com/users/nairbv', 'html_url': 'https://github.com/nairbv', 'followers_url': 'https://api.github.com/users/nairbv/followers', 'following_url': 'https://api.github.com/users/nairbv/following{/other_user}', 'gists_url': 'https://api.github.com/users/nairbv/gists{/gist_id}', 'starred_url': 'https://api.github.com/users/nairbv/starred{/owner}{/repo}', 'subscriptions_url': 'https://api.github.com/users/nairbv/subscriptions', 'organizations_url': 'https://api.github.com/users/nairbv/orgs', 'repos_url': 'https://api.github.com/users/nairbv/repos', 'events_url': 'https://api.github.com/users/nairbv/events{/privacy}', 'received_events_url': 'https://api.github.com/users/nairbv/received_events', 'type': 'User', 'site_admin': False}",referenced,814227899fe8fed1aff6cfa94136f9069616aea2,https://api.github.com/repos/pytorch/pytorch/commits/814227899fe8fed1aff6cfa94136f9069616aea2,2019-12-05T20:49:19Z,1003,636,367
29252,2859281673,"{'login': 'nairbv', 'id': 582713, 'node_id': 'MDQ6VXNlcjU4MjcxMw==', 'avatar_url': 'https://avatars1.githubusercontent.com/u/582713?v=4', 'gravatar_id': '', 'url': 'https://api.github.com/users/nairbv', 'html_url': 'https://github.com/nairbv', 'followers_url': 'https://api.github.com/users/nairbv/followers', 'following_url': 'https://api.github.com/users/nairbv/following{/other_user}', 'gists_url': 'https://api.github.com/users/nairbv/gists{/gist_id}', 'starred_url': 'https://api.github.com/users/nairbv/starred{/owner}{/repo}', 'subscriptions_url': 'https://api.github.com/users/nairbv/subscriptions', 'organizations_url': 'https://api.github.com/users/nairbv/orgs', 'repos_url': 'https://api.github.com/users/nairbv/repos', 'events_url': 'https://api.github.com/users/nairbv/events{/privacy}', 'received_events_url': 'https://api.github.com/users/nairbv/received_events', 'type': 'User', 'site_admin': False}",referenced,5c8b8eb331d4e0a1c6f502aa90e36a4a96521c7a,https://api.github.com/repos/pytorch/pytorch/commits/5c8b8eb331d4e0a1c6f502aa90e36a4a96521c7a,2019-12-05T20:49:23Z,88,61,27
29252,2859347340,"{'login': 'nairbv', 'id': 582713, 'node_id': 'MDQ6VXNlcjU4MjcxMw==', 'avatar_url': 'https://avatars1.githubusercontent.com/u/582713?v=4', 'gravatar_id': '', 'url': 'https://api.github.com/users/nairbv', 'html_url': 'https://github.com/nairbv', 'followers_url': 'https://api.github.com/users/nairbv/followers', 'following_url': 'https://api.github.com/users/nairbv/following{/other_user}', 'gists_url': 'https://api.github.com/users/nairbv/gists{/gist_id}', 'starred_url': 'https://api.github.com/users/nairbv/starred{/owner}{/repo}', 'subscriptions_url': 'https://api.github.com/users/nairbv/subscriptions', 'organizations_url': 'https://api.github.com/users/nairbv/orgs', 'repos_url': 'https://api.github.com/users/nairbv/repos', 'events_url': 'https://api.github.com/users/nairbv/events{/privacy}', 'received_events_url': 'https://api.github.com/users/nairbv/received_events', 'type': 'User', 'site_admin': False}",referenced,0ba9ad5c0accd9e583142976f1fbe5c307a04fbd,https://api.github.com/repos/pytorch/pytorch/commits/0ba9ad5c0accd9e583142976f1fbe5c307a04fbd,2019-12-05T21:13:12Z,2,1,1
29252,2859347585,"{'login': 'nairbv', 'id': 582713, 'node_id': 'MDQ6VXNlcjU4MjcxMw==', 'avatar_url': 'https://avatars1.githubusercontent.com/u/582713?v=4', 'gravatar_id': '', 'url': 'https://api.github.com/users/nairbv', 'html_url': 'https://github.com/nairbv', 'followers_url': 'https://api.github.com/users/nairbv/followers', 'following_url': 'https://api.github.com/users/nairbv/following{/other_user}', 'gists_url': 'https://api.github.com/users/nairbv/gists{/gist_id}', 'starred_url': 'https://api.github.com/users/nairbv/starred{/owner}{/repo}', 'subscriptions_url': 'https://api.github.com/users/nairbv/subscriptions', 'organizations_url': 'https://api.github.com/users/nairbv/orgs', 'repos_url': 'https://api.github.com/users/nairbv/repos', 'events_url': 'https://api.github.com/users/nairbv/events{/privacy}', 'received_events_url': 'https://api.github.com/users/nairbv/received_events', 'type': 'User', 'site_admin': False}",referenced,95e30548e9143673992f2e48f714fae8d0ef76a4,https://api.github.com/repos/pytorch/pytorch/commits/95e30548e9143673992f2e48f714fae8d0ef76a4,2019-12-05T21:13:18Z,88,61,27
29252,2859611606,"{'login': 'nairbv', 'id': 582713, 'node_id': 'MDQ6VXNlcjU4MjcxMw==', 'avatar_url': 'https://avatars1.githubusercontent.com/u/582713?v=4', 'gravatar_id': '', 'url': 'https://api.github.com/users/nairbv', 'html_url': 'https://github.com/nairbv', 'followers_url': 'https://api.github.com/users/nairbv/followers', 'following_url': 'https://api.github.com/users/nairbv/following{/other_user}', 'gists_url': 'https://api.github.com/users/nairbv/gists{/gist_id}', 'starred_url': 'https://api.github.com/users/nairbv/starred{/owner}{/repo}', 'subscriptions_url': 'https://api.github.com/users/nairbv/subscriptions', 'organizations_url': 'https://api.github.com/users/nairbv/orgs', 'repos_url': 'https://api.github.com/users/nairbv/repos', 'events_url': 'https://api.github.com/users/nairbv/events{/privacy}', 'received_events_url': 'https://api.github.com/users/nairbv/received_events', 'type': 'User', 'site_admin': False}",referenced,5e0c4c4fe99162b8939fb43beb77cc3c6605f837,https://api.github.com/repos/pytorch/pytorch/commits/5e0c4c4fe99162b8939fb43beb77cc3c6605f837,2019-12-05T22:57:20Z,295,101,194
29252,2859611765,"{'login': 'nairbv', 'id': 582713, 'node_id': 'MDQ6VXNlcjU4MjcxMw==', 'avatar_url': 'https://avatars1.githubusercontent.com/u/582713?v=4', 'gravatar_id': '', 'url': 'https://api.github.com/users/nairbv', 'html_url': 'https://github.com/nairbv', 'followers_url': 'https://api.github.com/users/nairbv/followers', 'following_url': 'https://api.github.com/users/nairbv/following{/other_user}', 'gists_url': 'https://api.github.com/users/nairbv/gists{/gist_id}', 'starred_url': 'https://api.github.com/users/nairbv/starred{/owner}{/repo}', 'subscriptions_url': 'https://api.github.com/users/nairbv/subscriptions', 'organizations_url': 'https://api.github.com/users/nairbv/orgs', 'repos_url': 'https://api.github.com/users/nairbv/repos', 'events_url': 'https://api.github.com/users/nairbv/events{/privacy}', 'received_events_url': 'https://api.github.com/users/nairbv/received_events', 'type': 'User', 'site_admin': False}",referenced,28ea01c07cba6cfff0d9bf6c652d24f58405f0fb,https://api.github.com/repos/pytorch/pytorch/commits/28ea01c07cba6cfff0d9bf6c652d24f58405f0fb,2019-12-05T22:57:26Z,80,53,27
29211,2816809781,"{'login': 'facebook-github-bot', 'id': 6422482, 'node_id': 'MDQ6VXNlcjY0MjI0ODI=', 'avatar_url': 'https://avatars3.githubusercontent.com/u/6422482?v=4', 'gravatar_id': '', 'url': 'https://api.github.com/users/facebook-github-bot', 'html_url': 'https://github.com/facebook-github-bot', 'followers_url': 'https://api.github.com/users/facebook-github-bot/followers', 'following_url': 'https://api.github.com/users/facebook-github-bot/following{/other_user}', 'gists_url': 'https://api.github.com/users/facebook-github-bot/gists{/gist_id}', 'starred_url': 'https://api.github.com/users/facebook-github-bot/starred{/owner}{/repo}', 'subscriptions_url': 'https://api.github.com/users/facebook-github-bot/subscriptions', 'organizations_url': 'https://api.github.com/users/facebook-github-bot/orgs', 'repos_url': 'https://api.github.com/users/facebook-github-bot/repos', 'events_url': 'https://api.github.com/users/facebook-github-bot/events{/privacy}', 'received_events_url': 'https://api.github.com/users/facebook-github-bot/received_events', 'type': 'User', 'site_admin': False}",closed,ae6af8d55faa6efa6018d20fec3a4909acd36a4e,https://api.github.com/repos/pytorch/pytorch/commits/ae6af8d55faa6efa6018d20fec3a4909acd36a4e,2019-11-20T21:06:58Z,27,21,6
29162,2780177365,"{'login': 'facebook-github-bot', 'id': 6422482, 'node_id': 'MDQ6VXNlcjY0MjI0ODI=', 'avatar_url': 'https://avatars3.githubusercontent.com/u/6422482?v=4', 'gravatar_id': '', 'url': 'https://api.github.com/users/facebook-github-bot', 'html_url': 'https://github.com/facebook-github-bot', 'followers_url': 'https://api.github.com/users/facebook-github-bot/followers', 'following_url': 'https://api.github.com/users/facebook-github-bot/following{/other_user}', 'gists_url': 'https://api.github.com/users/facebook-github-bot/gists{/gist_id}', 'starred_url': 'https://api.github.com/users/facebook-github-bot/starred{/owner}{/repo}', 'subscriptions_url': 'https://api.github.com/users/facebook-github-bot/subscriptions', 'organizations_url': 'https://api.github.com/users/facebook-github-bot/orgs', 'repos_url': 'https://api.github.com/users/facebook-github-bot/repos', 'events_url': 'https://api.github.com/users/facebook-github-bot/events{/privacy}', 'received_events_url': 'https://api.github.com/users/facebook-github-bot/received_events', 'type': 'User', 'site_admin': False}",referenced,86c64440c9169d94bffb58b523da1db00c896703,https://api.github.com/repos/pytorch/pytorch/commits/86c64440c9169d94bffb58b523da1db00c896703,2019-11-07T17:20:33Z,354,177,177
29161,2858936587,"{'login': 'facebook-github-bot', 'id': 6422482, 'node_id': 'MDQ6VXNlcjY0MjI0ODI=', 'avatar_url': 'https://avatars3.githubusercontent.com/u/6422482?v=4', 'gravatar_id': '', 'url': 'https://api.github.com/users/facebook-github-bot', 'html_url': 'https://github.com/facebook-github-bot', 'followers_url': 'https://api.github.com/users/facebook-github-bot/followers', 'following_url': 'https://api.github.com/users/facebook-github-bot/following{/other_user}', 'gists_url': 'https://api.github.com/users/facebook-github-bot/gists{/gist_id}', 'starred_url': 'https://api.github.com/users/facebook-github-bot/starred{/owner}{/repo}', 'subscriptions_url': 'https://api.github.com/users/facebook-github-bot/subscriptions', 'organizations_url': 'https://api.github.com/users/facebook-github-bot/orgs', 'repos_url': 'https://api.github.com/users/facebook-github-bot/repos', 'events_url': 'https://api.github.com/users/facebook-github-bot/events{/privacy}', 'received_events_url': 'https://api.github.com/users/facebook-github-bot/received_events', 'type': 'User', 'site_admin': False}",closed,f531815526c69f432e46fadece44f5d3a9b70e30,https://api.github.com/repos/pytorch/pytorch/commits/f531815526c69f432e46fadece44f5d3a9b70e30,2019-12-05T18:55:48Z,463,254,209
29159,2789932091,"{'login': 'facebook-github-bot', 'id': 6422482, 'node_id': 'MDQ6VXNlcjY0MjI0ODI=', 'avatar_url': 'https://avatars3.githubusercontent.com/u/6422482?v=4', 'gravatar_id': '', 'url': 'https://api.github.com/users/facebook-github-bot', 'html_url': 'https://github.com/facebook-github-bot', 'followers_url': 'https://api.github.com/users/facebook-github-bot/followers', 'following_url': 'https://api.github.com/users/facebook-github-bot/following{/other_user}', 'gists_url': 'https://api.github.com/users/facebook-github-bot/gists{/gist_id}', 'starred_url': 'https://api.github.com/users/facebook-github-bot/starred{/owner}{/repo}', 'subscriptions_url': 'https://api.github.com/users/facebook-github-bot/subscriptions', 'organizations_url': 'https://api.github.com/users/facebook-github-bot/orgs', 'repos_url': 'https://api.github.com/users/facebook-github-bot/repos', 'events_url': 'https://api.github.com/users/facebook-github-bot/events{/privacy}', 'received_events_url': 'https://api.github.com/users/facebook-github-bot/received_events', 'type': 'User', 'site_admin': False}",referenced,5249c43d9396bc19c8778b5c1fe0c2213af76314,https://api.github.com/repos/pytorch/pytorch/commits/5249c43d9396bc19c8778b5c1fe0c2213af76314,2019-11-12T02:28:06Z,131,68,63
29159,2794087085,"{'login': 'facebook-github-bot', 'id': 6422482, 'node_id': 'MDQ6VXNlcjY0MjI0ODI=', 'avatar_url': 'https://avatars3.githubusercontent.com/u/6422482?v=4', 'gravatar_id': '', 'url': 'https://api.github.com/users/facebook-github-bot', 'html_url': 'https://github.com/facebook-github-bot', 'followers_url': 'https://api.github.com/users/facebook-github-bot/followers', 'following_url': 'https://api.github.com/users/facebook-github-bot/following{/other_user}', 'gists_url': 'https://api.github.com/users/facebook-github-bot/gists{/gist_id}', 'starred_url': 'https://api.github.com/users/facebook-github-bot/starred{/owner}{/repo}', 'subscriptions_url': 'https://api.github.com/users/facebook-github-bot/subscriptions', 'organizations_url': 'https://api.github.com/users/facebook-github-bot/orgs', 'repos_url': 'https://api.github.com/users/facebook-github-bot/repos', 'events_url': 'https://api.github.com/users/facebook-github-bot/events{/privacy}', 'received_events_url': 'https://api.github.com/users/facebook-github-bot/received_events', 'type': 'User', 'site_admin': False}",referenced,d8732b3b43983dd16d8f3c4bfd3970adc4c03b89,https://api.github.com/repos/pytorch/pytorch/commits/d8732b3b43983dd16d8f3c4bfd3970adc4c03b89,2019-11-13T06:48:36Z,301,155,146
29153,2775779054,"{'login': 'nairbv', 'id': 582713, 'node_id': 'MDQ6VXNlcjU4MjcxMw==', 'avatar_url': 'https://avatars1.githubusercontent.com/u/582713?v=4', 'gravatar_id': '', 'url': 'https://api.github.com/users/nairbv', 'html_url': 'https://github.com/nairbv', 'followers_url': 'https://api.github.com/users/nairbv/followers', 'following_url': 'https://api.github.com/users/nairbv/following{/other_user}', 'gists_url': 'https://api.github.com/users/nairbv/gists{/gist_id}', 'starred_url': 'https://api.github.com/users/nairbv/starred{/owner}{/repo}', 'subscriptions_url': 'https://api.github.com/users/nairbv/subscriptions', 'organizations_url': 'https://api.github.com/users/nairbv/orgs', 'repos_url': 'https://api.github.com/users/nairbv/repos', 'events_url': 'https://api.github.com/users/nairbv/events{/privacy}', 'received_events_url': 'https://api.github.com/users/nairbv/received_events', 'type': 'User', 'site_admin': False}",referenced,0fc5f60de34205f76a94309def2f2f8665dd676f,https://api.github.com/repos/pytorch/pytorch/commits/0fc5f60de34205f76a94309def2f2f8665dd676f,2019-11-06T15:33:13Z,2432,1292,1140
29153,2780085617,"{'login': 'nairbv', 'id': 582713, 'node_id': 'MDQ6VXNlcjU4MjcxMw==', 'avatar_url': 'https://avatars1.githubusercontent.com/u/582713?v=4', 'gravatar_id': '', 'url': 'https://api.github.com/users/nairbv', 'html_url': 'https://github.com/nairbv', 'followers_url': 'https://api.github.com/users/nairbv/followers', 'following_url': 'https://api.github.com/users/nairbv/following{/other_user}', 'gists_url': 'https://api.github.com/users/nairbv/gists{/gist_id}', 'starred_url': 'https://api.github.com/users/nairbv/starred{/owner}{/repo}', 'subscriptions_url': 'https://api.github.com/users/nairbv/subscriptions', 'organizations_url': 'https://api.github.com/users/nairbv/orgs', 'repos_url': 'https://api.github.com/users/nairbv/repos', 'events_url': 'https://api.github.com/users/nairbv/events{/privacy}', 'received_events_url': 'https://api.github.com/users/nairbv/received_events', 'type': 'User', 'site_admin': False}",referenced,e7abbcd293009c85df2e6f956514dc408c509133,https://api.github.com/repos/pytorch/pytorch/commits/e7abbcd293009c85df2e6f956514dc408c509133,2019-11-07T16:53:14Z,12110,7156,4954
29153,2784420599,"{'login': 'nairbv', 'id': 582713, 'node_id': 'MDQ6VXNlcjU4MjcxMw==', 'avatar_url': 'https://avatars1.githubusercontent.com/u/582713?v=4', 'gravatar_id': '', 'url': 'https://api.github.com/users/nairbv', 'html_url': 'https://github.com/nairbv', 'followers_url': 'https://api.github.com/users/nairbv/followers', 'following_url': 'https://api.github.com/users/nairbv/following{/other_user}', 'gists_url': 'https://api.github.com/users/nairbv/gists{/gist_id}', 'starred_url': 'https://api.github.com/users/nairbv/starred{/owner}{/repo}', 'subscriptions_url': 'https://api.github.com/users/nairbv/subscriptions', 'organizations_url': 'https://api.github.com/users/nairbv/orgs', 'repos_url': 'https://api.github.com/users/nairbv/repos', 'events_url': 'https://api.github.com/users/nairbv/events{/privacy}', 'received_events_url': 'https://api.github.com/users/nairbv/received_events', 'type': 'User', 'site_admin': False}",referenced,4c2b07ee4bac8ad82a3cc7e30d0bad6e09cc9efa,https://api.github.com/repos/pytorch/pytorch/commits/4c2b07ee4bac8ad82a3cc7e30d0bad6e09cc9efa,2019-11-08T20:14:47Z,45,18,27
29153,2793493909,"{'login': 'nairbv', 'id': 582713, 'node_id': 'MDQ6VXNlcjU4MjcxMw==', 'avatar_url': 'https://avatars1.githubusercontent.com/u/582713?v=4', 'gravatar_id': '', 'url': 'https://api.github.com/users/nairbv', 'html_url': 'https://github.com/nairbv', 'followers_url': 'https://api.github.com/users/nairbv/followers', 'following_url': 'https://api.github.com/users/nairbv/following{/other_user}', 'gists_url': 'https://api.github.com/users/nairbv/gists{/gist_id}', 'starred_url': 'https://api.github.com/users/nairbv/starred{/owner}{/repo}', 'subscriptions_url': 'https://api.github.com/users/nairbv/subscriptions', 'organizations_url': 'https://api.github.com/users/nairbv/orgs', 'repos_url': 'https://api.github.com/users/nairbv/repos', 'events_url': 'https://api.github.com/users/nairbv/events{/privacy}', 'received_events_url': 'https://api.github.com/users/nairbv/received_events', 'type': 'User', 'site_admin': False}",referenced,7896381b359fdb0016b3f7e02223077bf04e5c92,https://api.github.com/repos/pytorch/pytorch/commits/7896381b359fdb0016b3f7e02223077bf04e5c92,2019-11-13T00:32:58Z,21168,14105,7063
29153,2796701492,"{'login': 'nairbv', 'id': 582713, 'node_id': 'MDQ6VXNlcjU4MjcxMw==', 'avatar_url': 'https://avatars1.githubusercontent.com/u/582713?v=4', 'gravatar_id': '', 'url': 'https://api.github.com/users/nairbv', 'html_url': 'https://github.com/nairbv', 'followers_url': 'https://api.github.com/users/nairbv/followers', 'following_url': 'https://api.github.com/users/nairbv/following{/other_user}', 'gists_url': 'https://api.github.com/users/nairbv/gists{/gist_id}', 'starred_url': 'https://api.github.com/users/nairbv/starred{/owner}{/repo}', 'subscriptions_url': 'https://api.github.com/users/nairbv/subscriptions', 'organizations_url': 'https://api.github.com/users/nairbv/orgs', 'repos_url': 'https://api.github.com/users/nairbv/repos', 'events_url': 'https://api.github.com/users/nairbv/events{/privacy}', 'received_events_url': 'https://api.github.com/users/nairbv/received_events', 'type': 'User', 'site_admin': False}",referenced,8fdbded5e61bf96c752d2f819b4db366812039dc,https://api.github.com/repos/pytorch/pytorch/commits/8fdbded5e61bf96c752d2f819b4db366812039dc,2019-11-13T20:24:27Z,681,375,306
29153,2797060457,"{'login': 'nairbv', 'id': 582713, 'node_id': 'MDQ6VXNlcjU4MjcxMw==', 'avatar_url': 'https://avatars1.githubusercontent.com/u/582713?v=4', 'gravatar_id': '', 'url': 'https://api.github.com/users/nairbv', 'html_url': 'https://github.com/nairbv', 'followers_url': 'https://api.github.com/users/nairbv/followers', 'following_url': 'https://api.github.com/users/nairbv/following{/other_user}', 'gists_url': 'https://api.github.com/users/nairbv/gists{/gist_id}', 'starred_url': 'https://api.github.com/users/nairbv/starred{/owner}{/repo}', 'subscriptions_url': 'https://api.github.com/users/nairbv/subscriptions', 'organizations_url': 'https://api.github.com/users/nairbv/orgs', 'repos_url': 'https://api.github.com/users/nairbv/repos', 'events_url': 'https://api.github.com/users/nairbv/events{/privacy}', 'received_events_url': 'https://api.github.com/users/nairbv/received_events', 'type': 'User', 'site_admin': False}",referenced,bca824385bf4e1acb3637b1e5ea120c7c385a8cc,https://api.github.com/repos/pytorch/pytorch/commits/bca824385bf4e1acb3637b1e5ea120c7c385a8cc,2019-11-13T22:32:24Z,2406,1448,958
29153,2808316912,"{'login': 'nairbv', 'id': 582713, 'node_id': 'MDQ6VXNlcjU4MjcxMw==', 'avatar_url': 'https://avatars1.githubusercontent.com/u/582713?v=4', 'gravatar_id': '', 'url': 'https://api.github.com/users/nairbv', 'html_url': 'https://github.com/nairbv', 'followers_url': 'https://api.github.com/users/nairbv/followers', 'following_url': 'https://api.github.com/users/nairbv/following{/other_user}', 'gists_url': 'https://api.github.com/users/nairbv/gists{/gist_id}', 'starred_url': 'https://api.github.com/users/nairbv/starred{/owner}{/repo}', 'subscriptions_url': 'https://api.github.com/users/nairbv/subscriptions', 'organizations_url': 'https://api.github.com/users/nairbv/orgs', 'repos_url': 'https://api.github.com/users/nairbv/repos', 'events_url': 'https://api.github.com/users/nairbv/events{/privacy}', 'received_events_url': 'https://api.github.com/users/nairbv/received_events', 'type': 'User', 'site_admin': False}",referenced,c74455cdc9765774811cb8f86d765cc0ee46ac94,https://api.github.com/repos/pytorch/pytorch/commits/c74455cdc9765774811cb8f86d765cc0ee46ac94,2019-11-18T16:58:53Z,11256,7399,3857
29153,2809026867,"{'login': 'facebook-github-bot', 'id': 6422482, 'node_id': 'MDQ6VXNlcjY0MjI0ODI=', 'avatar_url': 'https://avatars3.githubusercontent.com/u/6422482?v=4', 'gravatar_id': '', 'url': 'https://api.github.com/users/facebook-github-bot', 'html_url': 'https://github.com/facebook-github-bot', 'followers_url': 'https://api.github.com/users/facebook-github-bot/followers', 'following_url': 'https://api.github.com/users/facebook-github-bot/following{/other_user}', 'gists_url': 'https://api.github.com/users/facebook-github-bot/gists{/gist_id}', 'starred_url': 'https://api.github.com/users/facebook-github-bot/starred{/owner}{/repo}', 'subscriptions_url': 'https://api.github.com/users/facebook-github-bot/subscriptions', 'organizations_url': 'https://api.github.com/users/facebook-github-bot/orgs', 'repos_url': 'https://api.github.com/users/facebook-github-bot/repos', 'events_url': 'https://api.github.com/users/facebook-github-bot/events{/privacy}', 'received_events_url': 'https://api.github.com/users/facebook-github-bot/received_events', 'type': 'User', 'site_admin': False}",closed,adfb8a4888c5c471aae0201f5a5a62ee1def8f0b,https://api.github.com/repos/pytorch/pytorch/commits/adfb8a4888c5c471aae0201f5a5a62ee1def8f0b,2019-11-18T20:42:18Z,51,38,13
29117,2772461045,"{'login': 'rohan-varma', 'id': 8039770, 'node_id': 'MDQ6VXNlcjgwMzk3NzA=', 'avatar_url': 'https://avatars2.githubusercontent.com/u/8039770?v=4', 'gravatar_id': '', 'url': 'https://api.github.com/users/rohan-varma', 'html_url': 'https://github.com/rohan-varma', 'followers_url': 'https://api.github.com/users/rohan-varma/followers', 'following_url': 'https://api.github.com/users/rohan-varma/following{/other_user}', 'gists_url': 'https://api.github.com/users/rohan-varma/gists{/gist_id}', 'starred_url': 'https://api.github.com/users/rohan-varma/starred{/owner}{/repo}', 'subscriptions_url': 'https://api.github.com/users/rohan-varma/subscriptions', 'organizations_url': 'https://api.github.com/users/rohan-varma/orgs', 'repos_url': 'https://api.github.com/users/rohan-varma/repos', 'events_url': 'https://api.github.com/users/rohan-varma/events{/privacy}', 'received_events_url': 'https://api.github.com/users/rohan-varma/received_events', 'type': 'User', 'site_admin': False}",referenced,90fa48940a38452980a67c7d47ca2b1e8865f644,https://api.github.com/repos/pytorch/pytorch/commits/90fa48940a38452980a67c7d47ca2b1e8865f644,2019-11-05T18:23:48Z,7,4,3
29117,2772465366,"{'login': 'rohan-varma', 'id': 8039770, 'node_id': 'MDQ6VXNlcjgwMzk3NzA=', 'avatar_url': 'https://avatars2.githubusercontent.com/u/8039770?v=4', 'gravatar_id': '', 'url': 'https://api.github.com/users/rohan-varma', 'html_url': 'https://github.com/rohan-varma', 'followers_url': 'https://api.github.com/users/rohan-varma/followers', 'following_url': 'https://api.github.com/users/rohan-varma/following{/other_user}', 'gists_url': 'https://api.github.com/users/rohan-varma/gists{/gist_id}', 'starred_url': 'https://api.github.com/users/rohan-varma/starred{/owner}{/repo}', 'subscriptions_url': 'https://api.github.com/users/rohan-varma/subscriptions', 'organizations_url': 'https://api.github.com/users/rohan-varma/orgs', 'repos_url': 'https://api.github.com/users/rohan-varma/repos', 'events_url': 'https://api.github.com/users/rohan-varma/events{/privacy}', 'received_events_url': 'https://api.github.com/users/rohan-varma/received_events', 'type': 'User', 'site_admin': False}",referenced,edb11b3ec15b00a5225bb9be0bd7d4632e8f4b9d,https://api.github.com/repos/pytorch/pytorch/commits/edb11b3ec15b00a5225bb9be0bd7d4632e8f4b9d,2019-11-05T18:25:07Z,2,1,1
29099,2871636843,"{'login': 'suo', 'id': 1617424, 'node_id': 'MDQ6VXNlcjE2MTc0MjQ=', 'avatar_url': 'https://avatars2.githubusercontent.com/u/1617424?v=4', 'gravatar_id': '', 'url': 'https://api.github.com/users/suo', 'html_url': 'https://github.com/suo', 'followers_url': 'https://api.github.com/users/suo/followers', 'following_url': 'https://api.github.com/users/suo/following{/other_user}', 'gists_url': 'https://api.github.com/users/suo/gists{/gist_id}', 'starred_url': 'https://api.github.com/users/suo/starred{/owner}{/repo}', 'subscriptions_url': 'https://api.github.com/users/suo/subscriptions', 'organizations_url': 'https://api.github.com/users/suo/orgs', 'repos_url': 'https://api.github.com/users/suo/repos', 'events_url': 'https://api.github.com/users/suo/events{/privacy}', 'received_events_url': 'https://api.github.com/users/suo/received_events', 'type': 'User', 'site_admin': False}",referenced,d8c3ed43e0b6809446dae0c99645718ea12fb047,https://api.github.com/repos/pytorch/pytorch/commits/d8c3ed43e0b6809446dae0c99645718ea12fb047,2019-12-10T18:40:12Z,6,4,2
29099,2871637266,"{'login': 'suo', 'id': 1617424, 'node_id': 'MDQ6VXNlcjE2MTc0MjQ=', 'avatar_url': 'https://avatars2.githubusercontent.com/u/1617424?v=4', 'gravatar_id': '', 'url': 'https://api.github.com/users/suo', 'html_url': 'https://github.com/suo', 'followers_url': 'https://api.github.com/users/suo/followers', 'following_url': 'https://api.github.com/users/suo/following{/other_user}', 'gists_url': 'https://api.github.com/users/suo/gists{/gist_id}', 'starred_url': 'https://api.github.com/users/suo/starred{/owner}{/repo}', 'subscriptions_url': 'https://api.github.com/users/suo/subscriptions', 'organizations_url': 'https://api.github.com/users/suo/orgs', 'repos_url': 'https://api.github.com/users/suo/repos', 'events_url': 'https://api.github.com/users/suo/events{/privacy}', 'received_events_url': 'https://api.github.com/users/suo/received_events', 'type': 'User', 'site_admin': False}",referenced,f4ba985a3d12976f2d7a51f5360863c8f6d9c0a9,https://api.github.com/repos/pytorch/pytorch/commits/f4ba985a3d12976f2d7a51f5360863c8f6d9c0a9,2019-12-10T18:40:19Z,6,4,2
29099,2872191346,"{'login': 'suo', 'id': 1617424, 'node_id': 'MDQ6VXNlcjE2MTc0MjQ=', 'avatar_url': 'https://avatars2.githubusercontent.com/u/1617424?v=4', 'gravatar_id': '', 'url': 'https://api.github.com/users/suo', 'html_url': 'https://github.com/suo', 'followers_url': 'https://api.github.com/users/suo/followers', 'following_url': 'https://api.github.com/users/suo/following{/other_user}', 'gists_url': 'https://api.github.com/users/suo/gists{/gist_id}', 'starred_url': 'https://api.github.com/users/suo/starred{/owner}{/repo}', 'subscriptions_url': 'https://api.github.com/users/suo/subscriptions', 'organizations_url': 'https://api.github.com/users/suo/orgs', 'repos_url': 'https://api.github.com/users/suo/repos', 'events_url': 'https://api.github.com/users/suo/events{/privacy}', 'received_events_url': 'https://api.github.com/users/suo/received_events', 'type': 'User', 'site_admin': False}",referenced,c0f50b3a92808465d269eef69cc39c6dc674d7ef,https://api.github.com/repos/pytorch/pytorch/commits/c0f50b3a92808465d269eef69cc39c6dc674d7ef,2019-12-10T21:46:31Z,2,1,1
29099,2872191531,"{'login': 'suo', 'id': 1617424, 'node_id': 'MDQ6VXNlcjE2MTc0MjQ=', 'avatar_url': 'https://avatars2.githubusercontent.com/u/1617424?v=4', 'gravatar_id': '', 'url': 'https://api.github.com/users/suo', 'html_url': 'https://github.com/suo', 'followers_url': 'https://api.github.com/users/suo/followers', 'following_url': 'https://api.github.com/users/suo/following{/other_user}', 'gists_url': 'https://api.github.com/users/suo/gists{/gist_id}', 'starred_url': 'https://api.github.com/users/suo/starred{/owner}{/repo}', 'subscriptions_url': 'https://api.github.com/users/suo/subscriptions', 'organizations_url': 'https://api.github.com/users/suo/orgs', 'repos_url': 'https://api.github.com/users/suo/repos', 'events_url': 'https://api.github.com/users/suo/events{/privacy}', 'received_events_url': 'https://api.github.com/users/suo/received_events', 'type': 'User', 'site_admin': False}",referenced,14d0b49bd32f910d1dbbba4267445693b07fd25d,https://api.github.com/repos/pytorch/pytorch/commits/14d0b49bd32f910d1dbbba4267445693b07fd25d,2019-12-10T21:46:35Z,6,4,2
29099,2872322457,"{'login': 'facebook-github-bot', 'id': 6422482, 'node_id': 'MDQ6VXNlcjY0MjI0ODI=', 'avatar_url': 'https://avatars3.githubusercontent.com/u/6422482?v=4', 'gravatar_id': '', 'url': 'https://api.github.com/users/facebook-github-bot', 'html_url': 'https://github.com/facebook-github-bot', 'followers_url': 'https://api.github.com/users/facebook-github-bot/followers', 'following_url': 'https://api.github.com/users/facebook-github-bot/following{/other_user}', 'gists_url': 'https://api.github.com/users/facebook-github-bot/gists{/gist_id}', 'starred_url': 'https://api.github.com/users/facebook-github-bot/starred{/owner}{/repo}', 'subscriptions_url': 'https://api.github.com/users/facebook-github-bot/subscriptions', 'organizations_url': 'https://api.github.com/users/facebook-github-bot/orgs', 'repos_url': 'https://api.github.com/users/facebook-github-bot/repos', 'events_url': 'https://api.github.com/users/facebook-github-bot/events{/privacy}', 'received_events_url': 'https://api.github.com/users/facebook-github-bot/received_events', 'type': 'User', 'site_admin': False}",closed,e3d40f857b7e51b1eec2a63e1b81a4afdebf869a,https://api.github.com/repos/pytorch/pytorch/commits/e3d40f857b7e51b1eec2a63e1b81a4afdebf869a,2019-12-10T22:36:27Z,6,4,2
29065,2821278532,"{'login': 'facebook-github-bot', 'id': 6422482, 'node_id': 'MDQ6VXNlcjY0MjI0ODI=', 'avatar_url': 'https://avatars3.githubusercontent.com/u/6422482?v=4', 'gravatar_id': '', 'url': 'https://api.github.com/users/facebook-github-bot', 'html_url': 'https://github.com/facebook-github-bot', 'followers_url': 'https://api.github.com/users/facebook-github-bot/followers', 'following_url': 'https://api.github.com/users/facebook-github-bot/following{/other_user}', 'gists_url': 'https://api.github.com/users/facebook-github-bot/gists{/gist_id}', 'starred_url': 'https://api.github.com/users/facebook-github-bot/starred{/owner}{/repo}', 'subscriptions_url': 'https://api.github.com/users/facebook-github-bot/subscriptions', 'organizations_url': 'https://api.github.com/users/facebook-github-bot/orgs', 'repos_url': 'https://api.github.com/users/facebook-github-bot/repos', 'events_url': 'https://api.github.com/users/facebook-github-bot/events{/privacy}', 'received_events_url': 'https://api.github.com/users/facebook-github-bot/received_events', 'type': 'User', 'site_admin': False}",closed,f4b9690f2d609094a6d952a9c8d247447a6e1b2d,https://api.github.com/repos/pytorch/pytorch/commits/f4b9690f2d609094a6d952a9c8d247447a6e1b2d,2019-11-21T21:45:47Z,352,189,163
29058,2776128671,"{'login': 'facebook-github-bot', 'id': 6422482, 'node_id': 'MDQ6VXNlcjY0MjI0ODI=', 'avatar_url': 'https://avatars3.githubusercontent.com/u/6422482?v=4', 'gravatar_id': '', 'url': 'https://api.github.com/users/facebook-github-bot', 'html_url': 'https://github.com/facebook-github-bot', 'followers_url': 'https://api.github.com/users/facebook-github-bot/followers', 'following_url': 'https://api.github.com/users/facebook-github-bot/following{/other_user}', 'gists_url': 'https://api.github.com/users/facebook-github-bot/gists{/gist_id}', 'starred_url': 'https://api.github.com/users/facebook-github-bot/starred{/owner}{/repo}', 'subscriptions_url': 'https://api.github.com/users/facebook-github-bot/subscriptions', 'organizations_url': 'https://api.github.com/users/facebook-github-bot/orgs', 'repos_url': 'https://api.github.com/users/facebook-github-bot/repos', 'events_url': 'https://api.github.com/users/facebook-github-bot/events{/privacy}', 'received_events_url': 'https://api.github.com/users/facebook-github-bot/received_events', 'type': 'User', 'site_admin': False}",closed,d05da7dad347ffecc3ea0f1f191d1cdb2ad5d89f,https://api.github.com/repos/pytorch/pytorch/commits/d05da7dad347ffecc3ea0f1f191d1cdb2ad5d89f,2019-11-06T17:02:42Z,6,6,0
29004,2763475801,"{'login': 'facebook-github-bot', 'id': 6422482, 'node_id': 'MDQ6VXNlcjY0MjI0ODI=', 'avatar_url': 'https://avatars3.githubusercontent.com/u/6422482?v=4', 'gravatar_id': '', 'url': 'https://api.github.com/users/facebook-github-bot', 'html_url': 'https://github.com/facebook-github-bot', 'followers_url': 'https://api.github.com/users/facebook-github-bot/followers', 'following_url': 'https://api.github.com/users/facebook-github-bot/following{/other_user}', 'gists_url': 'https://api.github.com/users/facebook-github-bot/gists{/gist_id}', 'starred_url': 'https://api.github.com/users/facebook-github-bot/starred{/owner}{/repo}', 'subscriptions_url': 'https://api.github.com/users/facebook-github-bot/subscriptions', 'organizations_url': 'https://api.github.com/users/facebook-github-bot/orgs', 'repos_url': 'https://api.github.com/users/facebook-github-bot/repos', 'events_url': 'https://api.github.com/users/facebook-github-bot/events{/privacy}', 'received_events_url': 'https://api.github.com/users/facebook-github-bot/received_events', 'type': 'User', 'site_admin': False}",referenced,31c932d9abb9e0cfb64da0286d0d7438a2999234,https://api.github.com/repos/pytorch/pytorch/commits/31c932d9abb9e0cfb64da0286d0d7438a2999234,2019-11-01T15:00:53Z,2,1,1
28969,2761128448,"{'login': 'ezyang', 'id': 13564, 'node_id': 'MDQ6VXNlcjEzNTY0', 'avatar_url': 'https://avatars0.githubusercontent.com/u/13564?v=4', 'gravatar_id': '', 'url': 'https://api.github.com/users/ezyang', 'html_url': 'https://github.com/ezyang', 'followers_url': 'https://api.github.com/users/ezyang/followers', 'following_url': 'https://api.github.com/users/ezyang/following{/other_user}', 'gists_url': 'https://api.github.com/users/ezyang/gists{/gist_id}', 'starred_url': 'https://api.github.com/users/ezyang/starred{/owner}{/repo}', 'subscriptions_url': 'https://api.github.com/users/ezyang/subscriptions', 'organizations_url': 'https://api.github.com/users/ezyang/orgs', 'repos_url': 'https://api.github.com/users/ezyang/repos', 'events_url': 'https://api.github.com/users/ezyang/events{/privacy}', 'received_events_url': 'https://api.github.com/users/ezyang/received_events', 'type': 'User', 'site_admin': False}",referenced,a8439248f332b9773a9b85a09eba60b134ef405a,https://api.github.com/repos/pytorch/pytorch/commits/a8439248f332b9773a9b85a09eba60b134ef405a,2019-10-31T19:25:49Z,16,10,6
28969,2761128793,"{'login': 'ezyang', 'id': 13564, 'node_id': 'MDQ6VXNlcjEzNTY0', 'avatar_url': 'https://avatars0.githubusercontent.com/u/13564?v=4', 'gravatar_id': '', 'url': 'https://api.github.com/users/ezyang', 'html_url': 'https://github.com/ezyang', 'followers_url': 'https://api.github.com/users/ezyang/followers', 'following_url': 'https://api.github.com/users/ezyang/following{/other_user}', 'gists_url': 'https://api.github.com/users/ezyang/gists{/gist_id}', 'starred_url': 'https://api.github.com/users/ezyang/starred{/owner}{/repo}', 'subscriptions_url': 'https://api.github.com/users/ezyang/subscriptions', 'organizations_url': 'https://api.github.com/users/ezyang/orgs', 'repos_url': 'https://api.github.com/users/ezyang/repos', 'events_url': 'https://api.github.com/users/ezyang/events{/privacy}', 'received_events_url': 'https://api.github.com/users/ezyang/received_events', 'type': 'User', 'site_admin': False}",referenced,75c0f9d526edc8255b523824e8f477ca02a30480,https://api.github.com/repos/pytorch/pytorch/commits/75c0f9d526edc8255b523824e8f477ca02a30480,2019-10-31T19:25:57Z,16,10,6
28969,2768362686,"{'login': 'facebook-github-bot', 'id': 6422482, 'node_id': 'MDQ6VXNlcjY0MjI0ODI=', 'avatar_url': 'https://avatars3.githubusercontent.com/u/6422482?v=4', 'gravatar_id': '', 'url': 'https://api.github.com/users/facebook-github-bot', 'html_url': 'https://github.com/facebook-github-bot', 'followers_url': 'https://api.github.com/users/facebook-github-bot/followers', 'following_url': 'https://api.github.com/users/facebook-github-bot/following{/other_user}', 'gists_url': 'https://api.github.com/users/facebook-github-bot/gists{/gist_id}', 'starred_url': 'https://api.github.com/users/facebook-github-bot/starred{/owner}{/repo}', 'subscriptions_url': 'https://api.github.com/users/facebook-github-bot/subscriptions', 'organizations_url': 'https://api.github.com/users/facebook-github-bot/orgs', 'repos_url': 'https://api.github.com/users/facebook-github-bot/repos', 'events_url': 'https://api.github.com/users/facebook-github-bot/events{/privacy}', 'received_events_url': 'https://api.github.com/users/facebook-github-bot/received_events', 'type': 'User', 'site_admin': False}",closed,0fbce158288250f076420dc3794a0f13c250830d,https://api.github.com/repos/pytorch/pytorch/commits/0fbce158288250f076420dc3794a0f13c250830d,2019-11-04T16:30:29Z,16,10,6
28958,2764472777,"{'login': 'facebook-github-bot', 'id': 6422482, 'node_id': 'MDQ6VXNlcjY0MjI0ODI=', 'avatar_url': 'https://avatars3.githubusercontent.com/u/6422482?v=4', 'gravatar_id': '', 'url': 'https://api.github.com/users/facebook-github-bot', 'html_url': 'https://github.com/facebook-github-bot', 'followers_url': 'https://api.github.com/users/facebook-github-bot/followers', 'following_url': 'https://api.github.com/users/facebook-github-bot/following{/other_user}', 'gists_url': 'https://api.github.com/users/facebook-github-bot/gists{/gist_id}', 'starred_url': 'https://api.github.com/users/facebook-github-bot/starred{/owner}{/repo}', 'subscriptions_url': 'https://api.github.com/users/facebook-github-bot/subscriptions', 'organizations_url': 'https://api.github.com/users/facebook-github-bot/orgs', 'repos_url': 'https://api.github.com/users/facebook-github-bot/repos', 'events_url': 'https://api.github.com/users/facebook-github-bot/events{/privacy}', 'received_events_url': 'https://api.github.com/users/facebook-github-bot/received_events', 'type': 'User', 'site_admin': False}",referenced,cddda17394d4d763d47059678d2ce2d8c9c677b0,https://api.github.com/repos/pytorch/pytorch/commits/cddda17394d4d763d47059678d2ce2d8c9c677b0,2019-11-01T20:59:15Z,3,2,1
28923,2789187503,"{'login': 'zhaojuanmao', 'id': 48731194, 'node_id': 'MDQ6VXNlcjQ4NzMxMTk0', 'avatar_url': 'https://avatars0.githubusercontent.com/u/48731194?v=4', 'gravatar_id': '', 'url': 'https://api.github.com/users/zhaojuanmao', 'html_url': 'https://github.com/zhaojuanmao', 'followers_url': 'https://api.github.com/users/zhaojuanmao/followers', 'following_url': 'https://api.github.com/users/zhaojuanmao/following{/other_user}', 'gists_url': 'https://api.github.com/users/zhaojuanmao/gists{/gist_id}', 'starred_url': 'https://api.github.com/users/zhaojuanmao/starred{/owner}{/repo}', 'subscriptions_url': 'https://api.github.com/users/zhaojuanmao/subscriptions', 'organizations_url': 'https://api.github.com/users/zhaojuanmao/orgs', 'repos_url': 'https://api.github.com/users/zhaojuanmao/repos', 'events_url': 'https://api.github.com/users/zhaojuanmao/events{/privacy}', 'received_events_url': 'https://api.github.com/users/zhaojuanmao/received_events', 'type': 'User', 'site_admin': False}",referenced,d74d10975676d55d197be767dc6e7b3aba1dc080,https://api.github.com/repos/pytorch/pytorch/commits/d74d10975676d55d197be767dc6e7b3aba1dc080,2019-11-11T20:18:37Z,248,200,48
28923,2789188383,"{'login': 'zhaojuanmao', 'id': 48731194, 'node_id': 'MDQ6VXNlcjQ4NzMxMTk0', 'avatar_url': 'https://avatars0.githubusercontent.com/u/48731194?v=4', 'gravatar_id': '', 'url': 'https://api.github.com/users/zhaojuanmao', 'html_url': 'https://github.com/zhaojuanmao', 'followers_url': 'https://api.github.com/users/zhaojuanmao/followers', 'following_url': 'https://api.github.com/users/zhaojuanmao/following{/other_user}', 'gists_url': 'https://api.github.com/users/zhaojuanmao/gists{/gist_id}', 'starred_url': 'https://api.github.com/users/zhaojuanmao/starred{/owner}{/repo}', 'subscriptions_url': 'https://api.github.com/users/zhaojuanmao/subscriptions', 'organizations_url': 'https://api.github.com/users/zhaojuanmao/orgs', 'repos_url': 'https://api.github.com/users/zhaojuanmao/repos', 'events_url': 'https://api.github.com/users/zhaojuanmao/events{/privacy}', 'received_events_url': 'https://api.github.com/users/zhaojuanmao/received_events', 'type': 'User', 'site_admin': False}",referenced,2cb5b9a44da6ce51e6115e42e2966c7267a5fb09,https://api.github.com/repos/pytorch/pytorch/commits/2cb5b9a44da6ce51e6115e42e2966c7267a5fb09,2019-11-11T20:19:00Z,248,200,48
28923,2809747944,"{'login': 'zhaojuanmao', 'id': 48731194, 'node_id': 'MDQ6VXNlcjQ4NzMxMTk0', 'avatar_url': 'https://avatars0.githubusercontent.com/u/48731194?v=4', 'gravatar_id': '', 'url': 'https://api.github.com/users/zhaojuanmao', 'html_url': 'https://github.com/zhaojuanmao', 'followers_url': 'https://api.github.com/users/zhaojuanmao/followers', 'following_url': 'https://api.github.com/users/zhaojuanmao/following{/other_user}', 'gists_url': 'https://api.github.com/users/zhaojuanmao/gists{/gist_id}', 'starred_url': 'https://api.github.com/users/zhaojuanmao/starred{/owner}{/repo}', 'subscriptions_url': 'https://api.github.com/users/zhaojuanmao/subscriptions', 'organizations_url': 'https://api.github.com/users/zhaojuanmao/orgs', 'repos_url': 'https://api.github.com/users/zhaojuanmao/repos', 'events_url': 'https://api.github.com/users/zhaojuanmao/events{/privacy}', 'received_events_url': 'https://api.github.com/users/zhaojuanmao/received_events', 'type': 'User', 'site_admin': False}",referenced,f5ef3fad057e03190ea5dee08ed30acc7d20993b,https://api.github.com/repos/pytorch/pytorch/commits/f5ef3fad057e03190ea5dee08ed30acc7d20993b,2019-11-19T02:07:43Z,21099,13499,7600
28923,2814591053,"{'login': 'zhaojuanmao', 'id': 48731194, 'node_id': 'MDQ6VXNlcjQ4NzMxMTk0', 'avatar_url': 'https://avatars0.githubusercontent.com/u/48731194?v=4', 'gravatar_id': '', 'url': 'https://api.github.com/users/zhaojuanmao', 'html_url': 'https://github.com/zhaojuanmao', 'followers_url': 'https://api.github.com/users/zhaojuanmao/followers', 'following_url': 'https://api.github.com/users/zhaojuanmao/following{/other_user}', 'gists_url': 'https://api.github.com/users/zhaojuanmao/gists{/gist_id}', 'starred_url': 'https://api.github.com/users/zhaojuanmao/starred{/owner}{/repo}', 'subscriptions_url': 'https://api.github.com/users/zhaojuanmao/subscriptions', 'organizations_url': 'https://api.github.com/users/zhaojuanmao/orgs', 'repos_url': 'https://api.github.com/users/zhaojuanmao/repos', 'events_url': 'https://api.github.com/users/zhaojuanmao/events{/privacy}', 'received_events_url': 'https://api.github.com/users/zhaojuanmao/received_events', 'type': 'User', 'site_admin': False}",referenced,4373f1f6c5cc7c078170e53281f77c4a3d7d91ff,https://api.github.com/repos/pytorch/pytorch/commits/4373f1f6c5cc7c078170e53281f77c4a3d7d91ff,2019-11-20T09:51:08Z,8632,6851,1781
28923,2814591242,"{'login': 'zhaojuanmao', 'id': 48731194, 'node_id': 'MDQ6VXNlcjQ4NzMxMTk0', 'avatar_url': 'https://avatars0.githubusercontent.com/u/48731194?v=4', 'gravatar_id': '', 'url': 'https://api.github.com/users/zhaojuanmao', 'html_url': 'https://github.com/zhaojuanmao', 'followers_url': 'https://api.github.com/users/zhaojuanmao/followers', 'following_url': 'https://api.github.com/users/zhaojuanmao/following{/other_user}', 'gists_url': 'https://api.github.com/users/zhaojuanmao/gists{/gist_id}', 'starred_url': 'https://api.github.com/users/zhaojuanmao/starred{/owner}{/repo}', 'subscriptions_url': 'https://api.github.com/users/zhaojuanmao/subscriptions', 'organizations_url': 'https://api.github.com/users/zhaojuanmao/orgs', 'repos_url': 'https://api.github.com/users/zhaojuanmao/repos', 'events_url': 'https://api.github.com/users/zhaojuanmao/events{/privacy}', 'received_events_url': 'https://api.github.com/users/zhaojuanmao/received_events', 'type': 'User', 'site_admin': False}",referenced,f6ef9ed40ee4f8133180153c07e6a80c253f3ca1,https://api.github.com/repos/pytorch/pytorch/commits/f6ef9ed40ee4f8133180153c07e6a80c253f3ca1,2019-11-20T09:51:12Z,356,201,155
28885,2783806868,"{'login': 'facebook-github-bot', 'id': 6422482, 'node_id': 'MDQ6VXNlcjY0MjI0ODI=', 'avatar_url': 'https://avatars3.githubusercontent.com/u/6422482?v=4', 'gravatar_id': '', 'url': 'https://api.github.com/users/facebook-github-bot', 'html_url': 'https://github.com/facebook-github-bot', 'followers_url': 'https://api.github.com/users/facebook-github-bot/followers', 'following_url': 'https://api.github.com/users/facebook-github-bot/following{/other_user}', 'gists_url': 'https://api.github.com/users/facebook-github-bot/gists{/gist_id}', 'starred_url': 'https://api.github.com/users/facebook-github-bot/starred{/owner}{/repo}', 'subscriptions_url': 'https://api.github.com/users/facebook-github-bot/subscriptions', 'organizations_url': 'https://api.github.com/users/facebook-github-bot/orgs', 'repos_url': 'https://api.github.com/users/facebook-github-bot/repos', 'events_url': 'https://api.github.com/users/facebook-github-bot/events{/privacy}', 'received_events_url': 'https://api.github.com/users/facebook-github-bot/received_events', 'type': 'User', 'site_admin': False}",closed,63675b1969d5437384851e0e543b2fe9785334ce,https://api.github.com/repos/pytorch/pytorch/commits/63675b1969d5437384851e0e543b2fe9785334ce,2019-11-08T16:31:32Z,256,82,174
28819,2797388905,"{'login': 'mrshenli', 'id': 16999635, 'node_id': 'MDQ6VXNlcjE2OTk5NjM1', 'avatar_url': 'https://avatars2.githubusercontent.com/u/16999635?v=4', 'gravatar_id': '', 'url': 'https://api.github.com/users/mrshenli', 'html_url': 'https://github.com/mrshenli', 'followers_url': 'https://api.github.com/users/mrshenli/followers', 'following_url': 'https://api.github.com/users/mrshenli/following{/other_user}', 'gists_url': 'https://api.github.com/users/mrshenli/gists{/gist_id}', 'starred_url': 'https://api.github.com/users/mrshenli/starred{/owner}{/repo}', 'subscriptions_url': 'https://api.github.com/users/mrshenli/subscriptions', 'organizations_url': 'https://api.github.com/users/mrshenli/orgs', 'repos_url': 'https://api.github.com/users/mrshenli/repos', 'events_url': 'https://api.github.com/users/mrshenli/events{/privacy}', 'received_events_url': 'https://api.github.com/users/mrshenli/received_events', 'type': 'User', 'site_admin': False}",referenced,5a1eb7ff451d317fb3515ea5d4ea313c89212cd0,https://api.github.com/repos/pytorch/pytorch/commits/5a1eb7ff451d317fb3515ea5d4ea313c89212cd0,2019-11-14T01:17:19Z,4222,2713,1509
28819,2797396950,"{'login': 'mrshenli', 'id': 16999635, 'node_id': 'MDQ6VXNlcjE2OTk5NjM1', 'avatar_url': 'https://avatars2.githubusercontent.com/u/16999635?v=4', 'gravatar_id': '', 'url': 'https://api.github.com/users/mrshenli', 'html_url': 'https://github.com/mrshenli', 'followers_url': 'https://api.github.com/users/mrshenli/followers', 'following_url': 'https://api.github.com/users/mrshenli/following{/other_user}', 'gists_url': 'https://api.github.com/users/mrshenli/gists{/gist_id}', 'starred_url': 'https://api.github.com/users/mrshenli/starred{/owner}{/repo}', 'subscriptions_url': 'https://api.github.com/users/mrshenli/subscriptions', 'organizations_url': 'https://api.github.com/users/mrshenli/orgs', 'repos_url': 'https://api.github.com/users/mrshenli/repos', 'events_url': 'https://api.github.com/users/mrshenli/events{/privacy}', 'received_events_url': 'https://api.github.com/users/mrshenli/received_events', 'type': 'User', 'site_admin': False}",referenced,549a4be84fe615de676cf4967a20dfd72d83ff70,https://api.github.com/repos/pytorch/pytorch/commits/549a4be84fe615de676cf4967a20dfd72d83ff70,2019-11-14T01:22:25Z,7,0,7
28819,2797818777,"{'login': 'mrshenli', 'id': 16999635, 'node_id': 'MDQ6VXNlcjE2OTk5NjM1', 'avatar_url': 'https://avatars2.githubusercontent.com/u/16999635?v=4', 'gravatar_id': '', 'url': 'https://api.github.com/users/mrshenli', 'html_url': 'https://github.com/mrshenli', 'followers_url': 'https://api.github.com/users/mrshenli/followers', 'following_url': 'https://api.github.com/users/mrshenli/following{/other_user}', 'gists_url': 'https://api.github.com/users/mrshenli/gists{/gist_id}', 'starred_url': 'https://api.github.com/users/mrshenli/starred{/owner}{/repo}', 'subscriptions_url': 'https://api.github.com/users/mrshenli/subscriptions', 'organizations_url': 'https://api.github.com/users/mrshenli/orgs', 'repos_url': 'https://api.github.com/users/mrshenli/repos', 'events_url': 'https://api.github.com/users/mrshenli/events{/privacy}', 'received_events_url': 'https://api.github.com/users/mrshenli/received_events', 'type': 'User', 'site_admin': False}",referenced,9c06273bda0e607d76a41088cbe4c0ad39b1668d,https://api.github.com/repos/pytorch/pytorch/commits/9c06273bda0e607d76a41088cbe4c0ad39b1668d,2019-11-14T06:00:37Z,13,7,6
28819,2797906403,"{'login': 'mrshenli', 'id': 16999635, 'node_id': 'MDQ6VXNlcjE2OTk5NjM1', 'avatar_url': 'https://avatars2.githubusercontent.com/u/16999635?v=4', 'gravatar_id': '', 'url': 'https://api.github.com/users/mrshenli', 'html_url': 'https://github.com/mrshenli', 'followers_url': 'https://api.github.com/users/mrshenli/followers', 'following_url': 'https://api.github.com/users/mrshenli/following{/other_user}', 'gists_url': 'https://api.github.com/users/mrshenli/gists{/gist_id}', 'starred_url': 'https://api.github.com/users/mrshenli/starred{/owner}{/repo}', 'subscriptions_url': 'https://api.github.com/users/mrshenli/subscriptions', 'organizations_url': 'https://api.github.com/users/mrshenli/orgs', 'repos_url': 'https://api.github.com/users/mrshenli/repos', 'events_url': 'https://api.github.com/users/mrshenli/events{/privacy}', 'received_events_url': 'https://api.github.com/users/mrshenli/received_events', 'type': 'User', 'site_admin': False}",referenced,f528ebb45d3f88e070fe02d1eb9dc3a5dd3e58e7,https://api.github.com/repos/pytorch/pytorch/commits/f528ebb45d3f88e070fe02d1eb9dc3a5dd3e58e7,2019-11-14T06:46:14Z,10,5,5
28819,2800773696,"{'login': 'mrshenli', 'id': 16999635, 'node_id': 'MDQ6VXNlcjE2OTk5NjM1', 'avatar_url': 'https://avatars2.githubusercontent.com/u/16999635?v=4', 'gravatar_id': '', 'url': 'https://api.github.com/users/mrshenli', 'html_url': 'https://github.com/mrshenli', 'followers_url': 'https://api.github.com/users/mrshenli/followers', 'following_url': 'https://api.github.com/users/mrshenli/following{/other_user}', 'gists_url': 'https://api.github.com/users/mrshenli/gists{/gist_id}', 'starred_url': 'https://api.github.com/users/mrshenli/starred{/owner}{/repo}', 'subscriptions_url': 'https://api.github.com/users/mrshenli/subscriptions', 'organizations_url': 'https://api.github.com/users/mrshenli/orgs', 'repos_url': 'https://api.github.com/users/mrshenli/repos', 'events_url': 'https://api.github.com/users/mrshenli/events{/privacy}', 'received_events_url': 'https://api.github.com/users/mrshenli/received_events', 'type': 'User', 'site_admin': False}",referenced,fc82c90528142ae2b68ba7be624d3119ffc3fae1,https://api.github.com/repos/pytorch/pytorch/commits/fc82c90528142ae2b68ba7be624d3119ffc3fae1,2019-11-14T22:18:54Z,1,1,0
28819,2801646973,"{'login': 'facebook-github-bot', 'id': 6422482, 'node_id': 'MDQ6VXNlcjY0MjI0ODI=', 'avatar_url': 'https://avatars3.githubusercontent.com/u/6422482?v=4', 'gravatar_id': '', 'url': 'https://api.github.com/users/facebook-github-bot', 'html_url': 'https://github.com/facebook-github-bot', 'followers_url': 'https://api.github.com/users/facebook-github-bot/followers', 'following_url': 'https://api.github.com/users/facebook-github-bot/following{/other_user}', 'gists_url': 'https://api.github.com/users/facebook-github-bot/gists{/gist_id}', 'starred_url': 'https://api.github.com/users/facebook-github-bot/starred{/owner}{/repo}', 'subscriptions_url': 'https://api.github.com/users/facebook-github-bot/subscriptions', 'organizations_url': 'https://api.github.com/users/facebook-github-bot/orgs', 'repos_url': 'https://api.github.com/users/facebook-github-bot/repos', 'events_url': 'https://api.github.com/users/facebook-github-bot/events{/privacy}', 'received_events_url': 'https://api.github.com/users/facebook-github-bot/received_events', 'type': 'User', 'site_admin': False}",closed,e1a309a647c5096bddaf44c423cc5dea8d6cae6c,https://api.github.com/repos/pytorch/pytorch/commits/e1a309a647c5096bddaf44c423cc5dea8d6cae6c,2019-11-15T07:02:23Z,70,54,16
28792,2762142928,"{'login': 'facebook-github-bot', 'id': 6422482, 'node_id': 'MDQ6VXNlcjY0MjI0ODI=', 'avatar_url': 'https://avatars3.githubusercontent.com/u/6422482?v=4', 'gravatar_id': '', 'url': 'https://api.github.com/users/facebook-github-bot', 'html_url': 'https://github.com/facebook-github-bot', 'followers_url': 'https://api.github.com/users/facebook-github-bot/followers', 'following_url': 'https://api.github.com/users/facebook-github-bot/following{/other_user}', 'gists_url': 'https://api.github.com/users/facebook-github-bot/gists{/gist_id}', 'starred_url': 'https://api.github.com/users/facebook-github-bot/starred{/owner}{/repo}', 'subscriptions_url': 'https://api.github.com/users/facebook-github-bot/subscriptions', 'organizations_url': 'https://api.github.com/users/facebook-github-bot/orgs', 'repos_url': 'https://api.github.com/users/facebook-github-bot/repos', 'events_url': 'https://api.github.com/users/facebook-github-bot/events{/privacy}', 'received_events_url': 'https://api.github.com/users/facebook-github-bot/received_events', 'type': 'User', 'site_admin': False}",closed,1c8ef29ac5e23acaee20109196263dd13336cf7d,https://api.github.com/repos/pytorch/pytorch/commits/1c8ef29ac5e23acaee20109196263dd13336cf7d,2019-11-01T04:27:03Z,358,2,356
28789,2764452162,"{'login': 'facebook-github-bot', 'id': 6422482, 'node_id': 'MDQ6VXNlcjY0MjI0ODI=', 'avatar_url': 'https://avatars3.githubusercontent.com/u/6422482?v=4', 'gravatar_id': '', 'url': 'https://api.github.com/users/facebook-github-bot', 'html_url': 'https://github.com/facebook-github-bot', 'followers_url': 'https://api.github.com/users/facebook-github-bot/followers', 'following_url': 'https://api.github.com/users/facebook-github-bot/following{/other_user}', 'gists_url': 'https://api.github.com/users/facebook-github-bot/gists{/gist_id}', 'starred_url': 'https://api.github.com/users/facebook-github-bot/starred{/owner}{/repo}', 'subscriptions_url': 'https://api.github.com/users/facebook-github-bot/subscriptions', 'organizations_url': 'https://api.github.com/users/facebook-github-bot/orgs', 'repos_url': 'https://api.github.com/users/facebook-github-bot/repos', 'events_url': 'https://api.github.com/users/facebook-github-bot/events{/privacy}', 'received_events_url': 'https://api.github.com/users/facebook-github-bot/received_events', 'type': 'User', 'site_admin': False}",closed,d8d7af0811c31d030c04bf60d016f7e88b00dce3,https://api.github.com/repos/pytorch/pytorch/commits/d8d7af0811c31d030c04bf60d016f7e88b00dce3,2019-11-01T20:50:36Z,2,1,1
28753,2757116993,"{'login': 'facebook-github-bot', 'id': 6422482, 'node_id': 'MDQ6VXNlcjY0MjI0ODI=', 'avatar_url': 'https://avatars3.githubusercontent.com/u/6422482?v=4', 'gravatar_id': '', 'url': 'https://api.github.com/users/facebook-github-bot', 'html_url': 'https://github.com/facebook-github-bot', 'followers_url': 'https://api.github.com/users/facebook-github-bot/followers', 'following_url': 'https://api.github.com/users/facebook-github-bot/following{/other_user}', 'gists_url': 'https://api.github.com/users/facebook-github-bot/gists{/gist_id}', 'starred_url': 'https://api.github.com/users/facebook-github-bot/starred{/owner}{/repo}', 'subscriptions_url': 'https://api.github.com/users/facebook-github-bot/subscriptions', 'organizations_url': 'https://api.github.com/users/facebook-github-bot/orgs', 'repos_url': 'https://api.github.com/users/facebook-github-bot/repos', 'events_url': 'https://api.github.com/users/facebook-github-bot/events{/privacy}', 'received_events_url': 'https://api.github.com/users/facebook-github-bot/received_events', 'type': 'User', 'site_admin': False}",referenced,50fd20b64a97cc75a94f95c5b08cbf9d0580340c,https://api.github.com/repos/pytorch/pytorch/commits/50fd20b64a97cc75a94f95c5b08cbf9d0580340c,2019-10-30T18:11:26Z,1,1,0
28714,2779954357,"{'login': 'facebook-github-bot', 'id': 6422482, 'node_id': 'MDQ6VXNlcjY0MjI0ODI=', 'avatar_url': 'https://avatars3.githubusercontent.com/u/6422482?v=4', 'gravatar_id': '', 'url': 'https://api.github.com/users/facebook-github-bot', 'html_url': 'https://github.com/facebook-github-bot', 'followers_url': 'https://api.github.com/users/facebook-github-bot/followers', 'following_url': 'https://api.github.com/users/facebook-github-bot/following{/other_user}', 'gists_url': 'https://api.github.com/users/facebook-github-bot/gists{/gist_id}', 'starred_url': 'https://api.github.com/users/facebook-github-bot/starred{/owner}{/repo}', 'subscriptions_url': 'https://api.github.com/users/facebook-github-bot/subscriptions', 'organizations_url': 'https://api.github.com/users/facebook-github-bot/orgs', 'repos_url': 'https://api.github.com/users/facebook-github-bot/repos', 'events_url': 'https://api.github.com/users/facebook-github-bot/events{/privacy}', 'received_events_url': 'https://api.github.com/users/facebook-github-bot/received_events', 'type': 'User', 'site_admin': False}",referenced,5d70b11d36dce08c896415ca7254b8c727803501,https://api.github.com/repos/pytorch/pytorch/commits/5d70b11d36dce08c896415ca7254b8c727803501,2019-11-07T16:18:09Z,20,14,6
28658,2772344202,"{'login': 'facebook-github-bot', 'id': 6422482, 'node_id': 'MDQ6VXNlcjY0MjI0ODI=', 'avatar_url': 'https://avatars3.githubusercontent.com/u/6422482?v=4', 'gravatar_id': '', 'url': 'https://api.github.com/users/facebook-github-bot', 'html_url': 'https://github.com/facebook-github-bot', 'followers_url': 'https://api.github.com/users/facebook-github-bot/followers', 'following_url': 'https://api.github.com/users/facebook-github-bot/following{/other_user}', 'gists_url': 'https://api.github.com/users/facebook-github-bot/gists{/gist_id}', 'starred_url': 'https://api.github.com/users/facebook-github-bot/starred{/owner}{/repo}', 'subscriptions_url': 'https://api.github.com/users/facebook-github-bot/subscriptions', 'organizations_url': 'https://api.github.com/users/facebook-github-bot/orgs', 'repos_url': 'https://api.github.com/users/facebook-github-bot/repos', 'events_url': 'https://api.github.com/users/facebook-github-bot/events{/privacy}', 'received_events_url': 'https://api.github.com/users/facebook-github-bot/received_events', 'type': 'User', 'site_admin': False}",closed,c99cdfeb7daa557570e06edc6f0378ce405564cf,https://api.github.com/repos/pytorch/pytorch/commits/c99cdfeb7daa557570e06edc6f0378ce405564cf,2019-11-05T17:45:33Z,6,6,0
28649,2852078233,"{'login': 'facebook-github-bot', 'id': 6422482, 'node_id': 'MDQ6VXNlcjY0MjI0ODI=', 'avatar_url': 'https://avatars3.githubusercontent.com/u/6422482?v=4', 'gravatar_id': '', 'url': 'https://api.github.com/users/facebook-github-bot', 'html_url': 'https://github.com/facebook-github-bot', 'followers_url': 'https://api.github.com/users/facebook-github-bot/followers', 'following_url': 'https://api.github.com/users/facebook-github-bot/following{/other_user}', 'gists_url': 'https://api.github.com/users/facebook-github-bot/gists{/gist_id}', 'starred_url': 'https://api.github.com/users/facebook-github-bot/starred{/owner}{/repo}', 'subscriptions_url': 'https://api.github.com/users/facebook-github-bot/subscriptions', 'organizations_url': 'https://api.github.com/users/facebook-github-bot/orgs', 'repos_url': 'https://api.github.com/users/facebook-github-bot/repos', 'events_url': 'https://api.github.com/users/facebook-github-bot/events{/privacy}', 'received_events_url': 'https://api.github.com/users/facebook-github-bot/received_events', 'type': 'User', 'site_admin': False}",closed,3cf8382984087dcff095b6b0681da241682d5df6,https://api.github.com/repos/pytorch/pytorch/commits/3cf8382984087dcff095b6b0681da241682d5df6,2019-12-03T23:43:06Z,59,55,4
28646,2744981251,"{'login': 'zou3519', 'id': 5652049, 'node_id': 'MDQ6VXNlcjU2NTIwNDk=', 'avatar_url': 'https://avatars3.githubusercontent.com/u/5652049?v=4', 'gravatar_id': '', 'url': 'https://api.github.com/users/zou3519', 'html_url': 'https://github.com/zou3519', 'followers_url': 'https://api.github.com/users/zou3519/followers', 'following_url': 'https://api.github.com/users/zou3519/following{/other_user}', 'gists_url': 'https://api.github.com/users/zou3519/gists{/gist_id}', 'starred_url': 'https://api.github.com/users/zou3519/starred{/owner}{/repo}', 'subscriptions_url': 'https://api.github.com/users/zou3519/subscriptions', 'organizations_url': 'https://api.github.com/users/zou3519/orgs', 'repos_url': 'https://api.github.com/users/zou3519/repos', 'events_url': 'https://api.github.com/users/zou3519/events{/privacy}', 'received_events_url': 'https://api.github.com/users/zou3519/received_events', 'type': 'User', 'site_admin': False}",referenced,b7c80428c4dd780fe8d549fb85766627d7b797fe,https://api.github.com/repos/pytorch/pytorch/commits/b7c80428c4dd780fe8d549fb85766627d7b797fe,2019-10-25T17:46:58Z,24,22,2
28646,2744981583,"{'login': 'zou3519', 'id': 5652049, 'node_id': 'MDQ6VXNlcjU2NTIwNDk=', 'avatar_url': 'https://avatars3.githubusercontent.com/u/5652049?v=4', 'gravatar_id': '', 'url': 'https://api.github.com/users/zou3519', 'html_url': 'https://github.com/zou3519', 'followers_url': 'https://api.github.com/users/zou3519/followers', 'following_url': 'https://api.github.com/users/zou3519/following{/other_user}', 'gists_url': 'https://api.github.com/users/zou3519/gists{/gist_id}', 'starred_url': 'https://api.github.com/users/zou3519/starred{/owner}{/repo}', 'subscriptions_url': 'https://api.github.com/users/zou3519/subscriptions', 'organizations_url': 'https://api.github.com/users/zou3519/orgs', 'repos_url': 'https://api.github.com/users/zou3519/repos', 'events_url': 'https://api.github.com/users/zou3519/events{/privacy}', 'received_events_url': 'https://api.github.com/users/zou3519/received_events', 'type': 'User', 'site_admin': False}",referenced,d24ba45a2101fe398ac0520dcb344b8608c27561,https://api.github.com/repos/pytorch/pytorch/commits/d24ba45a2101fe398ac0520dcb344b8608c27561,2019-10-25T17:47:05Z,24,22,2
28646,2744989180,"{'login': 'zou3519', 'id': 5652049, 'node_id': 'MDQ6VXNlcjU2NTIwNDk=', 'avatar_url': 'https://avatars3.githubusercontent.com/u/5652049?v=4', 'gravatar_id': '', 'url': 'https://api.github.com/users/zou3519', 'html_url': 'https://github.com/zou3519', 'followers_url': 'https://api.github.com/users/zou3519/followers', 'following_url': 'https://api.github.com/users/zou3519/following{/other_user}', 'gists_url': 'https://api.github.com/users/zou3519/gists{/gist_id}', 'starred_url': 'https://api.github.com/users/zou3519/starred{/owner}{/repo}', 'subscriptions_url': 'https://api.github.com/users/zou3519/subscriptions', 'organizations_url': 'https://api.github.com/users/zou3519/orgs', 'repos_url': 'https://api.github.com/users/zou3519/repos', 'events_url': 'https://api.github.com/users/zou3519/events{/privacy}', 'received_events_url': 'https://api.github.com/users/zou3519/received_events', 'type': 'User', 'site_admin': False}",referenced,24834429d7ae900c97a58bdbefe994ff4f272d96,https://api.github.com/repos/pytorch/pytorch/commits/24834429d7ae900c97a58bdbefe994ff4f272d96,2019-10-25T17:50:04Z,8,4,4
28646,2744989383,"{'login': 'zou3519', 'id': 5652049, 'node_id': 'MDQ6VXNlcjU2NTIwNDk=', 'avatar_url': 'https://avatars3.githubusercontent.com/u/5652049?v=4', 'gravatar_id': '', 'url': 'https://api.github.com/users/zou3519', 'html_url': 'https://github.com/zou3519', 'followers_url': 'https://api.github.com/users/zou3519/followers', 'following_url': 'https://api.github.com/users/zou3519/following{/other_user}', 'gists_url': 'https://api.github.com/users/zou3519/gists{/gist_id}', 'starred_url': 'https://api.github.com/users/zou3519/starred{/owner}{/repo}', 'subscriptions_url': 'https://api.github.com/users/zou3519/subscriptions', 'organizations_url': 'https://api.github.com/users/zou3519/orgs', 'repos_url': 'https://api.github.com/users/zou3519/repos', 'events_url': 'https://api.github.com/users/zou3519/events{/privacy}', 'received_events_url': 'https://api.github.com/users/zou3519/received_events', 'type': 'User', 'site_admin': False}",referenced,0ebeb403d96a19220c357651a532a81f10c6d83d,https://api.github.com/repos/pytorch/pytorch/commits/0ebeb403d96a19220c357651a532a81f10c6d83d,2019-10-25T17:50:08Z,24,22,2
28646,2745291737,"{'login': 'zou3519', 'id': 5652049, 'node_id': 'MDQ6VXNlcjU2NTIwNDk=', 'avatar_url': 'https://avatars3.githubusercontent.com/u/5652049?v=4', 'gravatar_id': '', 'url': 'https://api.github.com/users/zou3519', 'html_url': 'https://github.com/zou3519', 'followers_url': 'https://api.github.com/users/zou3519/followers', 'following_url': 'https://api.github.com/users/zou3519/following{/other_user}', 'gists_url': 'https://api.github.com/users/zou3519/gists{/gist_id}', 'starred_url': 'https://api.github.com/users/zou3519/starred{/owner}{/repo}', 'subscriptions_url': 'https://api.github.com/users/zou3519/subscriptions', 'organizations_url': 'https://api.github.com/users/zou3519/orgs', 'repos_url': 'https://api.github.com/users/zou3519/repos', 'events_url': 'https://api.github.com/users/zou3519/events{/privacy}', 'received_events_url': 'https://api.github.com/users/zou3519/received_events', 'type': 'User', 'site_admin': False}",referenced,fba0c89c62b0eba95adb043a747b30d6e099c171,https://api.github.com/repos/pytorch/pytorch/commits/fba0c89c62b0eba95adb043a747b30d6e099c171,2019-10-25T19:48:55Z,13,7,6
28646,2745291911,"{'login': 'zou3519', 'id': 5652049, 'node_id': 'MDQ6VXNlcjU2NTIwNDk=', 'avatar_url': 'https://avatars3.githubusercontent.com/u/5652049?v=4', 'gravatar_id': '', 'url': 'https://api.github.com/users/zou3519', 'html_url': 'https://github.com/zou3519', 'followers_url': 'https://api.github.com/users/zou3519/followers', 'following_url': 'https://api.github.com/users/zou3519/following{/other_user}', 'gists_url': 'https://api.github.com/users/zou3519/gists{/gist_id}', 'starred_url': 'https://api.github.com/users/zou3519/starred{/owner}{/repo}', 'subscriptions_url': 'https://api.github.com/users/zou3519/subscriptions', 'organizations_url': 'https://api.github.com/users/zou3519/orgs', 'repos_url': 'https://api.github.com/users/zou3519/repos', 'events_url': 'https://api.github.com/users/zou3519/events{/privacy}', 'received_events_url': 'https://api.github.com/users/zou3519/received_events', 'type': 'User', 'site_admin': False}",referenced,aa7135cb2ec65be04d16436eb85ed6b2ffb4b182,https://api.github.com/repos/pytorch/pytorch/commits/aa7135cb2ec65be04d16436eb85ed6b2ffb4b182,2019-10-25T19:49:00Z,25,23,2
28646,2745297698,"{'login': 'zou3519', 'id': 5652049, 'node_id': 'MDQ6VXNlcjU2NTIwNDk=', 'avatar_url': 'https://avatars3.githubusercontent.com/u/5652049?v=4', 'gravatar_id': '', 'url': 'https://api.github.com/users/zou3519', 'html_url': 'https://github.com/zou3519', 'followers_url': 'https://api.github.com/users/zou3519/followers', 'following_url': 'https://api.github.com/users/zou3519/following{/other_user}', 'gists_url': 'https://api.github.com/users/zou3519/gists{/gist_id}', 'starred_url': 'https://api.github.com/users/zou3519/starred{/owner}{/repo}', 'subscriptions_url': 'https://api.github.com/users/zou3519/subscriptions', 'organizations_url': 'https://api.github.com/users/zou3519/orgs', 'repos_url': 'https://api.github.com/users/zou3519/repos', 'events_url': 'https://api.github.com/users/zou3519/events{/privacy}', 'received_events_url': 'https://api.github.com/users/zou3519/received_events', 'type': 'User', 'site_admin': False}",referenced,629e0647e0d20ef5f429f66042f487db8d3d7414,https://api.github.com/repos/pytorch/pytorch/commits/629e0647e0d20ef5f429f66042f487db8d3d7414,2019-10-25T19:51:28Z,2,1,1
28646,2745297886,"{'login': 'zou3519', 'id': 5652049, 'node_id': 'MDQ6VXNlcjU2NTIwNDk=', 'avatar_url': 'https://avatars3.githubusercontent.com/u/5652049?v=4', 'gravatar_id': '', 'url': 'https://api.github.com/users/zou3519', 'html_url': 'https://github.com/zou3519', 'followers_url': 'https://api.github.com/users/zou3519/followers', 'following_url': 'https://api.github.com/users/zou3519/following{/other_user}', 'gists_url': 'https://api.github.com/users/zou3519/gists{/gist_id}', 'starred_url': 'https://api.github.com/users/zou3519/starred{/owner}{/repo}', 'subscriptions_url': 'https://api.github.com/users/zou3519/subscriptions', 'organizations_url': 'https://api.github.com/users/zou3519/orgs', 'repos_url': 'https://api.github.com/users/zou3519/repos', 'events_url': 'https://api.github.com/users/zou3519/events{/privacy}', 'received_events_url': 'https://api.github.com/users/zou3519/received_events', 'type': 'User', 'site_admin': False}",referenced,b5fd7612140317f86c59992fdc229aa9d3d18713,https://api.github.com/repos/pytorch/pytorch/commits/b5fd7612140317f86c59992fdc229aa9d3d18713,2019-10-25T19:51:33Z,25,23,2
28646,2748614589,"{'login': 'facebook-github-bot', 'id': 6422482, 'node_id': 'MDQ6VXNlcjY0MjI0ODI=', 'avatar_url': 'https://avatars3.githubusercontent.com/u/6422482?v=4', 'gravatar_id': '', 'url': 'https://api.github.com/users/facebook-github-bot', 'html_url': 'https://github.com/facebook-github-bot', 'followers_url': 'https://api.github.com/users/facebook-github-bot/followers', 'following_url': 'https://api.github.com/users/facebook-github-bot/following{/other_user}', 'gists_url': 'https://api.github.com/users/facebook-github-bot/gists{/gist_id}', 'starred_url': 'https://api.github.com/users/facebook-github-bot/starred{/owner}{/repo}', 'subscriptions_url': 'https://api.github.com/users/facebook-github-bot/subscriptions', 'organizations_url': 'https://api.github.com/users/facebook-github-bot/orgs', 'repos_url': 'https://api.github.com/users/facebook-github-bot/repos', 'events_url': 'https://api.github.com/users/facebook-github-bot/events{/privacy}', 'received_events_url': 'https://api.github.com/users/facebook-github-bot/received_events', 'type': 'User', 'site_admin': False}",closed,5da932ad728ed61f3fe09ccb7dfa8a4795a45efb,https://api.github.com/repos/pytorch/pytorch/commits/5da932ad728ed61f3fe09ccb7dfa8a4795a45efb,2019-10-28T14:01:35Z,25,23,2
28646,2762092041,"{'login': 'soumith', 'id': 1310570, 'node_id': 'MDQ6VXNlcjEzMTA1NzA=', 'avatar_url': 'https://avatars0.githubusercontent.com/u/1310570?v=4', 'gravatar_id': '', 'url': 'https://api.github.com/users/soumith', 'html_url': 'https://github.com/soumith', 'followers_url': 'https://api.github.com/users/soumith/followers', 'following_url': 'https://api.github.com/users/soumith/following{/other_user}', 'gists_url': 'https://api.github.com/users/soumith/gists{/gist_id}', 'starred_url': 'https://api.github.com/users/soumith/starred{/owner}{/repo}', 'subscriptions_url': 'https://api.github.com/users/soumith/subscriptions', 'organizations_url': 'https://api.github.com/users/soumith/orgs', 'repos_url': 'https://api.github.com/users/soumith/repos', 'events_url': 'https://api.github.com/users/soumith/events{/privacy}', 'received_events_url': 'https://api.github.com/users/soumith/received_events', 'type': 'User', 'site_admin': False}",referenced,bd9766a36a6b87ce7818bceb50c09fde252b168f,https://api.github.com/repos/pytorch/pytorch/commits/bd9766a36a6b87ce7818bceb50c09fde252b168f,2019-11-01T03:46:21Z,25,23,2
28583,2757629646,"{'login': 'facebook-github-bot', 'id': 6422482, 'node_id': 'MDQ6VXNlcjY0MjI0ODI=', 'avatar_url': 'https://avatars3.githubusercontent.com/u/6422482?v=4', 'gravatar_id': '', 'url': 'https://api.github.com/users/facebook-github-bot', 'html_url': 'https://github.com/facebook-github-bot', 'followers_url': 'https://api.github.com/users/facebook-github-bot/followers', 'following_url': 'https://api.github.com/users/facebook-github-bot/following{/other_user}', 'gists_url': 'https://api.github.com/users/facebook-github-bot/gists{/gist_id}', 'starred_url': 'https://api.github.com/users/facebook-github-bot/starred{/owner}{/repo}', 'subscriptions_url': 'https://api.github.com/users/facebook-github-bot/subscriptions', 'organizations_url': 'https://api.github.com/users/facebook-github-bot/orgs', 'repos_url': 'https://api.github.com/users/facebook-github-bot/repos', 'events_url': 'https://api.github.com/users/facebook-github-bot/events{/privacy}', 'received_events_url': 'https://api.github.com/users/facebook-github-bot/received_events', 'type': 'User', 'site_admin': False}",closed,f5edb62a7fe422e7e60c06698f310697cf268b77,https://api.github.com/repos/pytorch/pytorch/commits/f5edb62a7fe422e7e60c06698f310697cf268b77,2019-10-30T20:57:22Z,2,1,1
28575,2771766836,"{'login': 'facebook-github-bot', 'id': 6422482, 'node_id': 'MDQ6VXNlcjY0MjI0ODI=', 'avatar_url': 'https://avatars3.githubusercontent.com/u/6422482?v=4', 'gravatar_id': '', 'url': 'https://api.github.com/users/facebook-github-bot', 'html_url': 'https://github.com/facebook-github-bot', 'followers_url': 'https://api.github.com/users/facebook-github-bot/followers', 'following_url': 'https://api.github.com/users/facebook-github-bot/following{/other_user}', 'gists_url': 'https://api.github.com/users/facebook-github-bot/gists{/gist_id}', 'starred_url': 'https://api.github.com/users/facebook-github-bot/starred{/owner}{/repo}', 'subscriptions_url': 'https://api.github.com/users/facebook-github-bot/subscriptions', 'organizations_url': 'https://api.github.com/users/facebook-github-bot/orgs', 'repos_url': 'https://api.github.com/users/facebook-github-bot/repos', 'events_url': 'https://api.github.com/users/facebook-github-bot/events{/privacy}', 'received_events_url': 'https://api.github.com/users/facebook-github-bot/received_events', 'type': 'User', 'site_admin': False}",closed,2c3c702d297b6a784474a092eea2bf2fbb980322,https://api.github.com/repos/pytorch/pytorch/commits/2c3c702d297b6a784474a092eea2bf2fbb980322,2019-11-05T15:10:50Z,36,29,7
28559,2739407910,"{'login': 'suo', 'id': 1617424, 'node_id': 'MDQ6VXNlcjE2MTc0MjQ=', 'avatar_url': 'https://avatars2.githubusercontent.com/u/1617424?v=4', 'gravatar_id': '', 'url': 'https://api.github.com/users/suo', 'html_url': 'https://github.com/suo', 'followers_url': 'https://api.github.com/users/suo/followers', 'following_url': 'https://api.github.com/users/suo/following{/other_user}', 'gists_url': 'https://api.github.com/users/suo/gists{/gist_id}', 'starred_url': 'https://api.github.com/users/suo/starred{/owner}{/repo}', 'subscriptions_url': 'https://api.github.com/users/suo/subscriptions', 'organizations_url': 'https://api.github.com/users/suo/orgs', 'repos_url': 'https://api.github.com/users/suo/repos', 'events_url': 'https://api.github.com/users/suo/events{/privacy}', 'received_events_url': 'https://api.github.com/users/suo/received_events', 'type': 'User', 'site_admin': False}",referenced,628dfbfb01b0320fdba1de0ff98cd62347a65dd1,https://api.github.com/repos/pytorch/pytorch/commits/628dfbfb01b0320fdba1de0ff98cd62347a65dd1,2019-10-24T05:40:05Z,147,132,15
28559,2739408070,"{'login': 'suo', 'id': 1617424, 'node_id': 'MDQ6VXNlcjE2MTc0MjQ=', 'avatar_url': 'https://avatars2.githubusercontent.com/u/1617424?v=4', 'gravatar_id': '', 'url': 'https://api.github.com/users/suo', 'html_url': 'https://github.com/suo', 'followers_url': 'https://api.github.com/users/suo/followers', 'following_url': 'https://api.github.com/users/suo/following{/other_user}', 'gists_url': 'https://api.github.com/users/suo/gists{/gist_id}', 'starred_url': 'https://api.github.com/users/suo/starred{/owner}{/repo}', 'subscriptions_url': 'https://api.github.com/users/suo/subscriptions', 'organizations_url': 'https://api.github.com/users/suo/orgs', 'repos_url': 'https://api.github.com/users/suo/repos', 'events_url': 'https://api.github.com/users/suo/events{/privacy}', 'received_events_url': 'https://api.github.com/users/suo/received_events', 'type': 'User', 'site_admin': False}",referenced,2c45c0552afb94bf1c9491a39f8987856d90f5b3,https://api.github.com/repos/pytorch/pytorch/commits/2c45c0552afb94bf1c9491a39f8987856d90f5b3,2019-10-24T05:40:11Z,147,132,15
28559,2741414205,"{'login': 'suo', 'id': 1617424, 'node_id': 'MDQ6VXNlcjE2MTc0MjQ=', 'avatar_url': 'https://avatars2.githubusercontent.com/u/1617424?v=4', 'gravatar_id': '', 'url': 'https://api.github.com/users/suo', 'html_url': 'https://github.com/suo', 'followers_url': 'https://api.github.com/users/suo/followers', 'following_url': 'https://api.github.com/users/suo/following{/other_user}', 'gists_url': 'https://api.github.com/users/suo/gists{/gist_id}', 'starred_url': 'https://api.github.com/users/suo/starred{/owner}{/repo}', 'subscriptions_url': 'https://api.github.com/users/suo/subscriptions', 'organizations_url': 'https://api.github.com/users/suo/orgs', 'repos_url': 'https://api.github.com/users/suo/repos', 'events_url': 'https://api.github.com/users/suo/events{/privacy}', 'received_events_url': 'https://api.github.com/users/suo/received_events', 'type': 'User', 'site_admin': False}",referenced,26090d933c57fdf5899263d094cc44fb7b692d71,https://api.github.com/repos/pytorch/pytorch/commits/26090d933c57fdf5899263d094cc44fb7b692d71,2019-10-24T16:23:35Z,2,1,1
28559,2741414368,"{'login': 'suo', 'id': 1617424, 'node_id': 'MDQ6VXNlcjE2MTc0MjQ=', 'avatar_url': 'https://avatars2.githubusercontent.com/u/1617424?v=4', 'gravatar_id': '', 'url': 'https://api.github.com/users/suo', 'html_url': 'https://github.com/suo', 'followers_url': 'https://api.github.com/users/suo/followers', 'following_url': 'https://api.github.com/users/suo/following{/other_user}', 'gists_url': 'https://api.github.com/users/suo/gists{/gist_id}', 'starred_url': 'https://api.github.com/users/suo/starred{/owner}{/repo}', 'subscriptions_url': 'https://api.github.com/users/suo/subscriptions', 'organizations_url': 'https://api.github.com/users/suo/orgs', 'repos_url': 'https://api.github.com/users/suo/repos', 'events_url': 'https://api.github.com/users/suo/events{/privacy}', 'received_events_url': 'https://api.github.com/users/suo/received_events', 'type': 'User', 'site_admin': False}",referenced,12add950993c0d1e78e839e52c21b59545902d08,https://api.github.com/repos/pytorch/pytorch/commits/12add950993c0d1e78e839e52c21b59545902d08,2019-10-24T16:23:38Z,147,132,15
28559,2742209144,"{'login': 'suo', 'id': 1617424, 'node_id': 'MDQ6VXNlcjE2MTc0MjQ=', 'avatar_url': 'https://avatars2.githubusercontent.com/u/1617424?v=4', 'gravatar_id': '', 'url': 'https://api.github.com/users/suo', 'html_url': 'https://github.com/suo', 'followers_url': 'https://api.github.com/users/suo/followers', 'following_url': 'https://api.github.com/users/suo/following{/other_user}', 'gists_url': 'https://api.github.com/users/suo/gists{/gist_id}', 'starred_url': 'https://api.github.com/users/suo/starred{/owner}{/repo}', 'subscriptions_url': 'https://api.github.com/users/suo/subscriptions', 'organizations_url': 'https://api.github.com/users/suo/orgs', 'repos_url': 'https://api.github.com/users/suo/repos', 'events_url': 'https://api.github.com/users/suo/events{/privacy}', 'received_events_url': 'https://api.github.com/users/suo/received_events', 'type': 'User', 'site_admin': False}",referenced,aaab5b488a884da050244694cccab50347f8ffa3,https://api.github.com/repos/pytorch/pytorch/commits/aaab5b488a884da050244694cccab50347f8ffa3,2019-10-24T21:00:50Z,3961,2431,1530
28559,2742977920,"{'login': 'facebook-github-bot', 'id': 6422482, 'node_id': 'MDQ6VXNlcjY0MjI0ODI=', 'avatar_url': 'https://avatars3.githubusercontent.com/u/6422482?v=4', 'gravatar_id': '', 'url': 'https://api.github.com/users/facebook-github-bot', 'html_url': 'https://github.com/facebook-github-bot', 'followers_url': 'https://api.github.com/users/facebook-github-bot/followers', 'following_url': 'https://api.github.com/users/facebook-github-bot/following{/other_user}', 'gists_url': 'https://api.github.com/users/facebook-github-bot/gists{/gist_id}', 'starred_url': 'https://api.github.com/users/facebook-github-bot/starred{/owner}{/repo}', 'subscriptions_url': 'https://api.github.com/users/facebook-github-bot/subscriptions', 'organizations_url': 'https://api.github.com/users/facebook-github-bot/orgs', 'repos_url': 'https://api.github.com/users/facebook-github-bot/repos', 'events_url': 'https://api.github.com/users/facebook-github-bot/events{/privacy}', 'received_events_url': 'https://api.github.com/users/facebook-github-bot/received_events', 'type': 'User', 'site_admin': False}",closed,2181dd516e2b3b0ea1e11008bdaf40415584475c,https://api.github.com/repos/pytorch/pytorch/commits/2181dd516e2b3b0ea1e11008bdaf40415584475c,2019-10-25T05:23:54Z,148,133,15
28537,2776558816,"{'login': 'driazati', 'id': 9407960, 'node_id': 'MDQ6VXNlcjk0MDc5NjA=', 'avatar_url': 'https://avatars3.githubusercontent.com/u/9407960?v=4', 'gravatar_id': '', 'url': 'https://api.github.com/users/driazati', 'html_url': 'https://github.com/driazati', 'followers_url': 'https://api.github.com/users/driazati/followers', 'following_url': 'https://api.github.com/users/driazati/following{/other_user}', 'gists_url': 'https://api.github.com/users/driazati/gists{/gist_id}', 'starred_url': 'https://api.github.com/users/driazati/starred{/owner}{/repo}', 'subscriptions_url': 'https://api.github.com/users/driazati/subscriptions', 'organizations_url': 'https://api.github.com/users/driazati/orgs', 'repos_url': 'https://api.github.com/users/driazati/repos', 'events_url': 'https://api.github.com/users/driazati/events{/privacy}', 'received_events_url': 'https://api.github.com/users/driazati/received_events', 'type': 'User', 'site_admin': False}",referenced,d4b22767b0b1aaa1cc99b31f69f03f94cdb4dbe9,https://api.github.com/repos/pytorch/pytorch/commits/d4b22767b0b1aaa1cc99b31f69f03f94cdb4dbe9,2019-11-06T19:17:55Z,64,43,21
28537,2933107862,"{'login': 'facebook-github-bot', 'id': 6422482, 'node_id': 'MDQ6VXNlcjY0MjI0ODI=', 'avatar_url': 'https://avatars3.githubusercontent.com/u/6422482?v=4', 'gravatar_id': '', 'url': 'https://api.github.com/users/facebook-github-bot', 'html_url': 'https://github.com/facebook-github-bot', 'followers_url': 'https://api.github.com/users/facebook-github-bot/followers', 'following_url': 'https://api.github.com/users/facebook-github-bot/following{/other_user}', 'gists_url': 'https://api.github.com/users/facebook-github-bot/gists{/gist_id}', 'starred_url': 'https://api.github.com/users/facebook-github-bot/starred{/owner}{/repo}', 'subscriptions_url': 'https://api.github.com/users/facebook-github-bot/subscriptions', 'organizations_url': 'https://api.github.com/users/facebook-github-bot/orgs', 'repos_url': 'https://api.github.com/users/facebook-github-bot/repos', 'events_url': 'https://api.github.com/users/facebook-github-bot/events{/privacy}', 'received_events_url': 'https://api.github.com/users/facebook-github-bot/received_events', 'type': 'User', 'site_admin': False}",referenced,883fb5434ab5f046e8c224bc606fe4976d8a626b,https://api.github.com/repos/pytorch/pytorch/commits/883fb5434ab5f046e8c224bc606fe4976d8a626b,2020-01-08T23:41:39Z,261,178,83
28518,2742825549,"{'login': 'z-a-f', 'id': 4216323, 'node_id': 'MDQ6VXNlcjQyMTYzMjM=', 'avatar_url': 'https://avatars2.githubusercontent.com/u/4216323?v=4', 'gravatar_id': '', 'url': 'https://api.github.com/users/z-a-f', 'html_url': 'https://github.com/z-a-f', 'followers_url': 'https://api.github.com/users/z-a-f/followers', 'following_url': 'https://api.github.com/users/z-a-f/following{/other_user}', 'gists_url': 'https://api.github.com/users/z-a-f/gists{/gist_id}', 'starred_url': 'https://api.github.com/users/z-a-f/starred{/owner}{/repo}', 'subscriptions_url': 'https://api.github.com/users/z-a-f/subscriptions', 'organizations_url': 'https://api.github.com/users/z-a-f/orgs', 'repos_url': 'https://api.github.com/users/z-a-f/repos', 'events_url': 'https://api.github.com/users/z-a-f/events{/privacy}', 'received_events_url': 'https://api.github.com/users/z-a-f/received_events', 'type': 'User', 'site_admin': False}",referenced,297af584ff2788008108f65093df9d03e192d183,https://api.github.com/repos/pytorch/pytorch/commits/297af584ff2788008108f65093df9d03e192d183,2019-10-25T03:26:37Z,14,13,1
28518,2742825713,"{'login': 'z-a-f', 'id': 4216323, 'node_id': 'MDQ6VXNlcjQyMTYzMjM=', 'avatar_url': 'https://avatars2.githubusercontent.com/u/4216323?v=4', 'gravatar_id': '', 'url': 'https://api.github.com/users/z-a-f', 'html_url': 'https://github.com/z-a-f', 'followers_url': 'https://api.github.com/users/z-a-f/followers', 'following_url': 'https://api.github.com/users/z-a-f/following{/other_user}', 'gists_url': 'https://api.github.com/users/z-a-f/gists{/gist_id}', 'starred_url': 'https://api.github.com/users/z-a-f/starred{/owner}{/repo}', 'subscriptions_url': 'https://api.github.com/users/z-a-f/subscriptions', 'organizations_url': 'https://api.github.com/users/z-a-f/orgs', 'repos_url': 'https://api.github.com/users/z-a-f/repos', 'events_url': 'https://api.github.com/users/z-a-f/events{/privacy}', 'received_events_url': 'https://api.github.com/users/z-a-f/received_events', 'type': 'User', 'site_admin': False}",referenced,79b383ec03027c00f09fbe5a43449636c8cd4eb3,https://api.github.com/repos/pytorch/pytorch/commits/79b383ec03027c00f09fbe5a43449636c8cd4eb3,2019-10-25T03:26:43Z,14,13,1
28518,2742914629,"{'login': 'z-a-f', 'id': 4216323, 'node_id': 'MDQ6VXNlcjQyMTYzMjM=', 'avatar_url': 'https://avatars2.githubusercontent.com/u/4216323?v=4', 'gravatar_id': '', 'url': 'https://api.github.com/users/z-a-f', 'html_url': 'https://github.com/z-a-f', 'followers_url': 'https://api.github.com/users/z-a-f/followers', 'following_url': 'https://api.github.com/users/z-a-f/following{/other_user}', 'gists_url': 'https://api.github.com/users/z-a-f/gists{/gist_id}', 'starred_url': 'https://api.github.com/users/z-a-f/starred{/owner}{/repo}', 'subscriptions_url': 'https://api.github.com/users/z-a-f/subscriptions', 'organizations_url': 'https://api.github.com/users/z-a-f/orgs', 'repos_url': 'https://api.github.com/users/z-a-f/repos', 'events_url': 'https://api.github.com/users/z-a-f/events{/privacy}', 'received_events_url': 'https://api.github.com/users/z-a-f/received_events', 'type': 'User', 'site_admin': False}",referenced,522f29bfc3faadb7026d7e3cae7cb57ffdcdceb9,https://api.github.com/repos/pytorch/pytorch/commits/522f29bfc3faadb7026d7e3cae7cb57ffdcdceb9,2019-10-25T04:36:11Z,2,1,1
28518,2742914808,"{'login': 'z-a-f', 'id': 4216323, 'node_id': 'MDQ6VXNlcjQyMTYzMjM=', 'avatar_url': 'https://avatars2.githubusercontent.com/u/4216323?v=4', 'gravatar_id': '', 'url': 'https://api.github.com/users/z-a-f', 'html_url': 'https://github.com/z-a-f', 'followers_url': 'https://api.github.com/users/z-a-f/followers', 'following_url': 'https://api.github.com/users/z-a-f/following{/other_user}', 'gists_url': 'https://api.github.com/users/z-a-f/gists{/gist_id}', 'starred_url': 'https://api.github.com/users/z-a-f/starred{/owner}{/repo}', 'subscriptions_url': 'https://api.github.com/users/z-a-f/subscriptions', 'organizations_url': 'https://api.github.com/users/z-a-f/orgs', 'repos_url': 'https://api.github.com/users/z-a-f/repos', 'events_url': 'https://api.github.com/users/z-a-f/events{/privacy}', 'received_events_url': 'https://api.github.com/users/z-a-f/received_events', 'type': 'User', 'site_admin': False}",referenced,f711ba8700a688771e6a895566a0d7e8ca2adce7,https://api.github.com/repos/pytorch/pytorch/commits/f711ba8700a688771e6a895566a0d7e8ca2adce7,2019-10-25T04:36:20Z,14,13,1
28518,2745353342,"{'login': 'z-a-f', 'id': 4216323, 'node_id': 'MDQ6VXNlcjQyMTYzMjM=', 'avatar_url': 'https://avatars2.githubusercontent.com/u/4216323?v=4', 'gravatar_id': '', 'url': 'https://api.github.com/users/z-a-f', 'html_url': 'https://github.com/z-a-f', 'followers_url': 'https://api.github.com/users/z-a-f/followers', 'following_url': 'https://api.github.com/users/z-a-f/following{/other_user}', 'gists_url': 'https://api.github.com/users/z-a-f/gists{/gist_id}', 'starred_url': 'https://api.github.com/users/z-a-f/starred{/owner}{/repo}', 'subscriptions_url': 'https://api.github.com/users/z-a-f/subscriptions', 'organizations_url': 'https://api.github.com/users/z-a-f/orgs', 'repos_url': 'https://api.github.com/users/z-a-f/repos', 'events_url': 'https://api.github.com/users/z-a-f/events{/privacy}', 'received_events_url': 'https://api.github.com/users/z-a-f/received_events', 'type': 'User', 'site_admin': False}",referenced,88fb32c4b936991a9bd7c74bdac58e8a873cf3e0,https://api.github.com/repos/pytorch/pytorch/commits/88fb32c4b936991a9bd7c74bdac58e8a873cf3e0,2019-10-25T20:14:28Z,2662,1775,887
28518,2745353659,"{'login': 'z-a-f', 'id': 4216323, 'node_id': 'MDQ6VXNlcjQyMTYzMjM=', 'avatar_url': 'https://avatars2.githubusercontent.com/u/4216323?v=4', 'gravatar_id': '', 'url': 'https://api.github.com/users/z-a-f', 'html_url': 'https://github.com/z-a-f', 'followers_url': 'https://api.github.com/users/z-a-f/followers', 'following_url': 'https://api.github.com/users/z-a-f/following{/other_user}', 'gists_url': 'https://api.github.com/users/z-a-f/gists{/gist_id}', 'starred_url': 'https://api.github.com/users/z-a-f/starred{/owner}{/repo}', 'subscriptions_url': 'https://api.github.com/users/z-a-f/subscriptions', 'organizations_url': 'https://api.github.com/users/z-a-f/orgs', 'repos_url': 'https://api.github.com/users/z-a-f/repos', 'events_url': 'https://api.github.com/users/z-a-f/events{/privacy}', 'received_events_url': 'https://api.github.com/users/z-a-f/received_events', 'type': 'User', 'site_admin': False}",referenced,af87a0cb74deb53f2fac9edcf5da7314581c3185,https://api.github.com/repos/pytorch/pytorch/commits/af87a0cb74deb53f2fac9edcf5da7314581c3185,2019-10-25T20:14:34Z,16,15,1
28518,2745364786,"{'login': 'z-a-f', 'id': 4216323, 'node_id': 'MDQ6VXNlcjQyMTYzMjM=', 'avatar_url': 'https://avatars2.githubusercontent.com/u/4216323?v=4', 'gravatar_id': '', 'url': 'https://api.github.com/users/z-a-f', 'html_url': 'https://github.com/z-a-f', 'followers_url': 'https://api.github.com/users/z-a-f/followers', 'following_url': 'https://api.github.com/users/z-a-f/following{/other_user}', 'gists_url': 'https://api.github.com/users/z-a-f/gists{/gist_id}', 'starred_url': 'https://api.github.com/users/z-a-f/starred{/owner}{/repo}', 'subscriptions_url': 'https://api.github.com/users/z-a-f/subscriptions', 'organizations_url': 'https://api.github.com/users/z-a-f/orgs', 'repos_url': 'https://api.github.com/users/z-a-f/repos', 'events_url': 'https://api.github.com/users/z-a-f/events{/privacy}', 'received_events_url': 'https://api.github.com/users/z-a-f/received_events', 'type': 'User', 'site_admin': False}",referenced,ddf404f6b61aed0fcac9c28347034ab96e150c4a,https://api.github.com/repos/pytorch/pytorch/commits/ddf404f6b61aed0fcac9c28347034ab96e150c4a,2019-10-25T20:19:10Z,3,2,1
28518,2745365060,"{'login': 'z-a-f', 'id': 4216323, 'node_id': 'MDQ6VXNlcjQyMTYzMjM=', 'avatar_url': 'https://avatars2.githubusercontent.com/u/4216323?v=4', 'gravatar_id': '', 'url': 'https://api.github.com/users/z-a-f', 'html_url': 'https://github.com/z-a-f', 'followers_url': 'https://api.github.com/users/z-a-f/followers', 'following_url': 'https://api.github.com/users/z-a-f/following{/other_user}', 'gists_url': 'https://api.github.com/users/z-a-f/gists{/gist_id}', 'starred_url': 'https://api.github.com/users/z-a-f/starred{/owner}{/repo}', 'subscriptions_url': 'https://api.github.com/users/z-a-f/subscriptions', 'organizations_url': 'https://api.github.com/users/z-a-f/orgs', 'repos_url': 'https://api.github.com/users/z-a-f/repos', 'events_url': 'https://api.github.com/users/z-a-f/events{/privacy}', 'received_events_url': 'https://api.github.com/users/z-a-f/received_events', 'type': 'User', 'site_admin': False}",referenced,4856b9c6d01ea83400ed8e7c0d01fe0e0e035bca,https://api.github.com/repos/pytorch/pytorch/commits/4856b9c6d01ea83400ed8e7c0d01fe0e0e035bca,2019-10-25T20:19:18Z,17,16,1
28518,2745366708,"{'login': 'z-a-f', 'id': 4216323, 'node_id': 'MDQ6VXNlcjQyMTYzMjM=', 'avatar_url': 'https://avatars2.githubusercontent.com/u/4216323?v=4', 'gravatar_id': '', 'url': 'https://api.github.com/users/z-a-f', 'html_url': 'https://github.com/z-a-f', 'followers_url': 'https://api.github.com/users/z-a-f/followers', 'following_url': 'https://api.github.com/users/z-a-f/following{/other_user}', 'gists_url': 'https://api.github.com/users/z-a-f/gists{/gist_id}', 'starred_url': 'https://api.github.com/users/z-a-f/starred{/owner}{/repo}', 'subscriptions_url': 'https://api.github.com/users/z-a-f/subscriptions', 'organizations_url': 'https://api.github.com/users/z-a-f/orgs', 'repos_url': 'https://api.github.com/users/z-a-f/repos', 'events_url': 'https://api.github.com/users/z-a-f/events{/privacy}', 'received_events_url': 'https://api.github.com/users/z-a-f/received_events', 'type': 'User', 'site_admin': False}",referenced,b52635266cf14ba9739db7845c1179487f85d18a,https://api.github.com/repos/pytorch/pytorch/commits/b52635266cf14ba9739db7845c1179487f85d18a,2019-10-25T20:20:02Z,2,1,1
28518,2745366939,"{'login': 'z-a-f', 'id': 4216323, 'node_id': 'MDQ6VXNlcjQyMTYzMjM=', 'avatar_url': 'https://avatars2.githubusercontent.com/u/4216323?v=4', 'gravatar_id': '', 'url': 'https://api.github.com/users/z-a-f', 'html_url': 'https://github.com/z-a-f', 'followers_url': 'https://api.github.com/users/z-a-f/followers', 'following_url': 'https://api.github.com/users/z-a-f/following{/other_user}', 'gists_url': 'https://api.github.com/users/z-a-f/gists{/gist_id}', 'starred_url': 'https://api.github.com/users/z-a-f/starred{/owner}{/repo}', 'subscriptions_url': 'https://api.github.com/users/z-a-f/subscriptions', 'organizations_url': 'https://api.github.com/users/z-a-f/orgs', 'repos_url': 'https://api.github.com/users/z-a-f/repos', 'events_url': 'https://api.github.com/users/z-a-f/events{/privacy}', 'received_events_url': 'https://api.github.com/users/z-a-f/received_events', 'type': 'User', 'site_admin': False}",referenced,29ed41ea7e9a5946fab638f3d356123d3f91c27e,https://api.github.com/repos/pytorch/pytorch/commits/29ed41ea7e9a5946fab638f3d356123d3f91c27e,2019-10-25T20:20:10Z,17,16,1
28518,2745451760,"{'login': 'z-a-f', 'id': 4216323, 'node_id': 'MDQ6VXNlcjQyMTYzMjM=', 'avatar_url': 'https://avatars2.githubusercontent.com/u/4216323?v=4', 'gravatar_id': '', 'url': 'https://api.github.com/users/z-a-f', 'html_url': 'https://github.com/z-a-f', 'followers_url': 'https://api.github.com/users/z-a-f/followers', 'following_url': 'https://api.github.com/users/z-a-f/following{/other_user}', 'gists_url': 'https://api.github.com/users/z-a-f/gists{/gist_id}', 'starred_url': 'https://api.github.com/users/z-a-f/starred{/owner}{/repo}', 'subscriptions_url': 'https://api.github.com/users/z-a-f/subscriptions', 'organizations_url': 'https://api.github.com/users/z-a-f/orgs', 'repos_url': 'https://api.github.com/users/z-a-f/repos', 'events_url': 'https://api.github.com/users/z-a-f/events{/privacy}', 'received_events_url': 'https://api.github.com/users/z-a-f/received_events', 'type': 'User', 'site_admin': False}",referenced,55e7684d7d2aa6efb56125272ab5ad72e0694481,https://api.github.com/repos/pytorch/pytorch/commits/55e7684d7d2aa6efb56125272ab5ad72e0694481,2019-10-25T20:54:26Z,2,1,1
28518,2745452106,"{'login': 'z-a-f', 'id': 4216323, 'node_id': 'MDQ6VXNlcjQyMTYzMjM=', 'avatar_url': 'https://avatars2.githubusercontent.com/u/4216323?v=4', 'gravatar_id': '', 'url': 'https://api.github.com/users/z-a-f', 'html_url': 'https://github.com/z-a-f', 'followers_url': 'https://api.github.com/users/z-a-f/followers', 'following_url': 'https://api.github.com/users/z-a-f/following{/other_user}', 'gists_url': 'https://api.github.com/users/z-a-f/gists{/gist_id}', 'starred_url': 'https://api.github.com/users/z-a-f/starred{/owner}{/repo}', 'subscriptions_url': 'https://api.github.com/users/z-a-f/subscriptions', 'organizations_url': 'https://api.github.com/users/z-a-f/orgs', 'repos_url': 'https://api.github.com/users/z-a-f/repos', 'events_url': 'https://api.github.com/users/z-a-f/events{/privacy}', 'received_events_url': 'https://api.github.com/users/z-a-f/received_events', 'type': 'User', 'site_admin': False}",referenced,6b1a18de5791b98dabe3b9cbbf8fa5a2b5cfeb52,https://api.github.com/repos/pytorch/pytorch/commits/6b1a18de5791b98dabe3b9cbbf8fa5a2b5cfeb52,2019-10-25T20:54:34Z,17,16,1
28518,2749445335,"{'login': 'z-a-f', 'id': 4216323, 'node_id': 'MDQ6VXNlcjQyMTYzMjM=', 'avatar_url': 'https://avatars2.githubusercontent.com/u/4216323?v=4', 'gravatar_id': '', 'url': 'https://api.github.com/users/z-a-f', 'html_url': 'https://github.com/z-a-f', 'followers_url': 'https://api.github.com/users/z-a-f/followers', 'following_url': 'https://api.github.com/users/z-a-f/following{/other_user}', 'gists_url': 'https://api.github.com/users/z-a-f/gists{/gist_id}', 'starred_url': 'https://api.github.com/users/z-a-f/starred{/owner}{/repo}', 'subscriptions_url': 'https://api.github.com/users/z-a-f/subscriptions', 'organizations_url': 'https://api.github.com/users/z-a-f/orgs', 'repos_url': 'https://api.github.com/users/z-a-f/repos', 'events_url': 'https://api.github.com/users/z-a-f/events{/privacy}', 'received_events_url': 'https://api.github.com/users/z-a-f/received_events', 'type': 'User', 'site_admin': False}",referenced,ed6d5fd6fee73e36b12ffaa644b179beb628219f,https://api.github.com/repos/pytorch/pytorch/commits/ed6d5fd6fee73e36b12ffaa644b179beb628219f,2019-10-28T17:37:47Z,3857,2543,1314
28518,2749445697,"{'login': 'z-a-f', 'id': 4216323, 'node_id': 'MDQ6VXNlcjQyMTYzMjM=', 'avatar_url': 'https://avatars2.githubusercontent.com/u/4216323?v=4', 'gravatar_id': '', 'url': 'https://api.github.com/users/z-a-f', 'html_url': 'https://github.com/z-a-f', 'followers_url': 'https://api.github.com/users/z-a-f/followers', 'following_url': 'https://api.github.com/users/z-a-f/following{/other_user}', 'gists_url': 'https://api.github.com/users/z-a-f/gists{/gist_id}', 'starred_url': 'https://api.github.com/users/z-a-f/starred{/owner}{/repo}', 'subscriptions_url': 'https://api.github.com/users/z-a-f/subscriptions', 'organizations_url': 'https://api.github.com/users/z-a-f/orgs', 'repos_url': 'https://api.github.com/users/z-a-f/repos', 'events_url': 'https://api.github.com/users/z-a-f/events{/privacy}', 'received_events_url': 'https://api.github.com/users/z-a-f/received_events', 'type': 'User', 'site_admin': False}",referenced,0c0a5476d64a6cb7429e87de23d883917e15b371,https://api.github.com/repos/pytorch/pytorch/commits/0c0a5476d64a6cb7429e87de23d883917e15b371,2019-10-28T17:37:54Z,17,16,1
28518,2753452791,"{'login': 'z-a-f', 'id': 4216323, 'node_id': 'MDQ6VXNlcjQyMTYzMjM=', 'avatar_url': 'https://avatars2.githubusercontent.com/u/4216323?v=4', 'gravatar_id': '', 'url': 'https://api.github.com/users/z-a-f', 'html_url': 'https://github.com/z-a-f', 'followers_url': 'https://api.github.com/users/z-a-f/followers', 'following_url': 'https://api.github.com/users/z-a-f/following{/other_user}', 'gists_url': 'https://api.github.com/users/z-a-f/gists{/gist_id}', 'starred_url': 'https://api.github.com/users/z-a-f/starred{/owner}{/repo}', 'subscriptions_url': 'https://api.github.com/users/z-a-f/subscriptions', 'organizations_url': 'https://api.github.com/users/z-a-f/orgs', 'repos_url': 'https://api.github.com/users/z-a-f/repos', 'events_url': 'https://api.github.com/users/z-a-f/events{/privacy}', 'received_events_url': 'https://api.github.com/users/z-a-f/received_events', 'type': 'User', 'site_admin': False}",referenced,05d793759d01336d171b07c68ba849f1ae4e11a5,https://api.github.com/repos/pytorch/pytorch/commits/05d793759d01336d171b07c68ba849f1ae4e11a5,2019-10-29T19:09:22Z,3145,2223,922
28518,2753453060,"{'login': 'z-a-f', 'id': 4216323, 'node_id': 'MDQ6VXNlcjQyMTYzMjM=', 'avatar_url': 'https://avatars2.githubusercontent.com/u/4216323?v=4', 'gravatar_id': '', 'url': 'https://api.github.com/users/z-a-f', 'html_url': 'https://github.com/z-a-f', 'followers_url': 'https://api.github.com/users/z-a-f/followers', 'following_url': 'https://api.github.com/users/z-a-f/following{/other_user}', 'gists_url': 'https://api.github.com/users/z-a-f/gists{/gist_id}', 'starred_url': 'https://api.github.com/users/z-a-f/starred{/owner}{/repo}', 'subscriptions_url': 'https://api.github.com/users/z-a-f/subscriptions', 'organizations_url': 'https://api.github.com/users/z-a-f/orgs', 'repos_url': 'https://api.github.com/users/z-a-f/repos', 'events_url': 'https://api.github.com/users/z-a-f/events{/privacy}', 'received_events_url': 'https://api.github.com/users/z-a-f/received_events', 'type': 'User', 'site_admin': False}",referenced,9566b20ad77707536ee354269bca166ecf332768,https://api.github.com/repos/pytorch/pytorch/commits/9566b20ad77707536ee354269bca166ecf332768,2019-10-29T19:09:28Z,17,16,1
28518,2753709877,"{'login': 'z-a-f', 'id': 4216323, 'node_id': 'MDQ6VXNlcjQyMTYzMjM=', 'avatar_url': 'https://avatars2.githubusercontent.com/u/4216323?v=4', 'gravatar_id': '', 'url': 'https://api.github.com/users/z-a-f', 'html_url': 'https://github.com/z-a-f', 'followers_url': 'https://api.github.com/users/z-a-f/followers', 'following_url': 'https://api.github.com/users/z-a-f/following{/other_user}', 'gists_url': 'https://api.github.com/users/z-a-f/gists{/gist_id}', 'starred_url': 'https://api.github.com/users/z-a-f/starred{/owner}{/repo}', 'subscriptions_url': 'https://api.github.com/users/z-a-f/subscriptions', 'organizations_url': 'https://api.github.com/users/z-a-f/orgs', 'repos_url': 'https://api.github.com/users/z-a-f/repos', 'events_url': 'https://api.github.com/users/z-a-f/events{/privacy}', 'received_events_url': 'https://api.github.com/users/z-a-f/received_events', 'type': 'User', 'site_admin': False}",referenced,0c42d1bc591db5684732c11ed4b8cbbeff32acc8,https://api.github.com/repos/pytorch/pytorch/commits/0c42d1bc591db5684732c11ed4b8cbbeff32acc8,2019-10-29T20:33:04Z,1918,1450,468
28518,2753710212,"{'login': 'z-a-f', 'id': 4216323, 'node_id': 'MDQ6VXNlcjQyMTYzMjM=', 'avatar_url': 'https://avatars2.githubusercontent.com/u/4216323?v=4', 'gravatar_id': '', 'url': 'https://api.github.com/users/z-a-f', 'html_url': 'https://github.com/z-a-f', 'followers_url': 'https://api.github.com/users/z-a-f/followers', 'following_url': 'https://api.github.com/users/z-a-f/following{/other_user}', 'gists_url': 'https://api.github.com/users/z-a-f/gists{/gist_id}', 'starred_url': 'https://api.github.com/users/z-a-f/starred{/owner}{/repo}', 'subscriptions_url': 'https://api.github.com/users/z-a-f/subscriptions', 'organizations_url': 'https://api.github.com/users/z-a-f/orgs', 'repos_url': 'https://api.github.com/users/z-a-f/repos', 'events_url': 'https://api.github.com/users/z-a-f/events{/privacy}', 'received_events_url': 'https://api.github.com/users/z-a-f/received_events', 'type': 'User', 'site_admin': False}",referenced,0c81f8ab307040de4f35610455f5f10dd9eeec73,https://api.github.com/repos/pytorch/pytorch/commits/0c81f8ab307040de4f35610455f5f10dd9eeec73,2019-10-29T20:33:11Z,17,16,1
28518,2758012401,"{'login': 'facebook-github-bot', 'id': 6422482, 'node_id': 'MDQ6VXNlcjY0MjI0ODI=', 'avatar_url': 'https://avatars3.githubusercontent.com/u/6422482?v=4', 'gravatar_id': '', 'url': 'https://api.github.com/users/facebook-github-bot', 'html_url': 'https://github.com/facebook-github-bot', 'followers_url': 'https://api.github.com/users/facebook-github-bot/followers', 'following_url': 'https://api.github.com/users/facebook-github-bot/following{/other_user}', 'gists_url': 'https://api.github.com/users/facebook-github-bot/gists{/gist_id}', 'starred_url': 'https://api.github.com/users/facebook-github-bot/starred{/owner}{/repo}', 'subscriptions_url': 'https://api.github.com/users/facebook-github-bot/subscriptions', 'organizations_url': 'https://api.github.com/users/facebook-github-bot/orgs', 'repos_url': 'https://api.github.com/users/facebook-github-bot/repos', 'events_url': 'https://api.github.com/users/facebook-github-bot/events{/privacy}', 'received_events_url': 'https://api.github.com/users/facebook-github-bot/received_events', 'type': 'User', 'site_admin': False}",closed,28be2d4994cffd2cc31d41c3995d0953b7c23849,https://api.github.com/repos/pytorch/pytorch/commits/28be2d4994cffd2cc31d41c3995d0953b7c23849,2019-10-30T23:51:38Z,17,16,1
28457,2746594503,"{'login': 'facebook-github-bot', 'id': 6422482, 'node_id': 'MDQ6VXNlcjY0MjI0ODI=', 'avatar_url': 'https://avatars3.githubusercontent.com/u/6422482?v=4', 'gravatar_id': '', 'url': 'https://api.github.com/users/facebook-github-bot', 'html_url': 'https://github.com/facebook-github-bot', 'followers_url': 'https://api.github.com/users/facebook-github-bot/followers', 'following_url': 'https://api.github.com/users/facebook-github-bot/following{/other_user}', 'gists_url': 'https://api.github.com/users/facebook-github-bot/gists{/gist_id}', 'starred_url': 'https://api.github.com/users/facebook-github-bot/starred{/owner}{/repo}', 'subscriptions_url': 'https://api.github.com/users/facebook-github-bot/subscriptions', 'organizations_url': 'https://api.github.com/users/facebook-github-bot/orgs', 'repos_url': 'https://api.github.com/users/facebook-github-bot/repos', 'events_url': 'https://api.github.com/users/facebook-github-bot/events{/privacy}', 'received_events_url': 'https://api.github.com/users/facebook-github-bot/received_events', 'type': 'User', 'site_admin': False}",closed,764e0ee88245c435be6934a5a06316c64ea171cc,https://api.github.com/repos/pytorch/pytorch/commits/764e0ee88245c435be6934a5a06316c64ea171cc,2019-10-27T11:44:03Z,26,21,5
28430,2928698085,"{'login': 'facebook-github-bot', 'id': 6422482, 'node_id': 'MDQ6VXNlcjY0MjI0ODI=', 'avatar_url': 'https://avatars3.githubusercontent.com/u/6422482?v=4', 'gravatar_id': '', 'url': 'https://api.github.com/users/facebook-github-bot', 'html_url': 'https://github.com/facebook-github-bot', 'followers_url': 'https://api.github.com/users/facebook-github-bot/followers', 'following_url': 'https://api.github.com/users/facebook-github-bot/following{/other_user}', 'gists_url': 'https://api.github.com/users/facebook-github-bot/gists{/gist_id}', 'starred_url': 'https://api.github.com/users/facebook-github-bot/starred{/owner}{/repo}', 'subscriptions_url': 'https://api.github.com/users/facebook-github-bot/subscriptions', 'organizations_url': 'https://api.github.com/users/facebook-github-bot/orgs', 'repos_url': 'https://api.github.com/users/facebook-github-bot/repos', 'events_url': 'https://api.github.com/users/facebook-github-bot/events{/privacy}', 'received_events_url': 'https://api.github.com/users/facebook-github-bot/received_events', 'type': 'User', 'site_admin': False}",closed,0e5a6700cc4b6991ccd949759fb8b7f31845125d,https://api.github.com/repos/pytorch/pytorch/commits/0e5a6700cc4b6991ccd949759fb8b7f31845125d,2020-01-07T18:58:05Z,277,168,109
28430,2948387076,"{'login': 'facebook-github-bot', 'id': 6422482, 'node_id': 'MDQ6VXNlcjY0MjI0ODI=', 'avatar_url': 'https://avatars3.githubusercontent.com/u/6422482?v=4', 'gravatar_id': '', 'url': 'https://api.github.com/users/facebook-github-bot', 'html_url': 'https://github.com/facebook-github-bot', 'followers_url': 'https://api.github.com/users/facebook-github-bot/followers', 'following_url': 'https://api.github.com/users/facebook-github-bot/following{/other_user}', 'gists_url': 'https://api.github.com/users/facebook-github-bot/gists{/gist_id}', 'starred_url': 'https://api.github.com/users/facebook-github-bot/starred{/owner}{/repo}', 'subscriptions_url': 'https://api.github.com/users/facebook-github-bot/subscriptions', 'organizations_url': 'https://api.github.com/users/facebook-github-bot/orgs', 'repos_url': 'https://api.github.com/users/facebook-github-bot/repos', 'events_url': 'https://api.github.com/users/facebook-github-bot/events{/privacy}', 'received_events_url': 'https://api.github.com/users/facebook-github-bot/received_events', 'type': 'User', 'site_admin': False}",referenced,b0ac425dc4a1340b82b1c58391fb1e4718815617,https://api.github.com/repos/pytorch/pytorch/commits/b0ac425dc4a1340b82b1c58391fb1e4718815617,2020-01-14T19:44:42Z,340,226,114
28389,2852036176,"{'login': 'facebook-github-bot', 'id': 6422482, 'node_id': 'MDQ6VXNlcjY0MjI0ODI=', 'avatar_url': 'https://avatars3.githubusercontent.com/u/6422482?v=4', 'gravatar_id': '', 'url': 'https://api.github.com/users/facebook-github-bot', 'html_url': 'https://github.com/facebook-github-bot', 'followers_url': 'https://api.github.com/users/facebook-github-bot/followers', 'following_url': 'https://api.github.com/users/facebook-github-bot/following{/other_user}', 'gists_url': 'https://api.github.com/users/facebook-github-bot/gists{/gist_id}', 'starred_url': 'https://api.github.com/users/facebook-github-bot/starred{/owner}{/repo}', 'subscriptions_url': 'https://api.github.com/users/facebook-github-bot/subscriptions', 'organizations_url': 'https://api.github.com/users/facebook-github-bot/orgs', 'repos_url': 'https://api.github.com/users/facebook-github-bot/repos', 'events_url': 'https://api.github.com/users/facebook-github-bot/events{/privacy}', 'received_events_url': 'https://api.github.com/users/facebook-github-bot/received_events', 'type': 'User', 'site_admin': False}",closed,dcd1216efeffe4302d6e3c8806af617fc3b27cf7,https://api.github.com/repos/pytorch/pytorch/commits/dcd1216efeffe4302d6e3c8806af617fc3b27cf7,2019-12-03T23:23:44Z,61,61,0
28365,2734819537,"{'login': 'facebook-github-bot', 'id': 6422482, 'node_id': 'MDQ6VXNlcjY0MjI0ODI=', 'avatar_url': 'https://avatars3.githubusercontent.com/u/6422482?v=4', 'gravatar_id': '', 'url': 'https://api.github.com/users/facebook-github-bot', 'html_url': 'https://github.com/facebook-github-bot', 'followers_url': 'https://api.github.com/users/facebook-github-bot/followers', 'following_url': 'https://api.github.com/users/facebook-github-bot/following{/other_user}', 'gists_url': 'https://api.github.com/users/facebook-github-bot/gists{/gist_id}', 'starred_url': 'https://api.github.com/users/facebook-github-bot/starred{/owner}{/repo}', 'subscriptions_url': 'https://api.github.com/users/facebook-github-bot/subscriptions', 'organizations_url': 'https://api.github.com/users/facebook-github-bot/orgs', 'repos_url': 'https://api.github.com/users/facebook-github-bot/repos', 'events_url': 'https://api.github.com/users/facebook-github-bot/events{/privacy}', 'received_events_url': 'https://api.github.com/users/facebook-github-bot/received_events', 'type': 'User', 'site_admin': False}",closed,a5354adb08be1fd66391c6b8dae7aac3be7ac258,https://api.github.com/repos/pytorch/pytorch/commits/a5354adb08be1fd66391c6b8dae7aac3be7ac258,2019-10-22T21:05:06Z,14,3,11
28360,2899019511,"{'login': 'eellison', 'id': 11477974, 'node_id': 'MDQ6VXNlcjExNDc3OTc0', 'avatar_url': 'https://avatars2.githubusercontent.com/u/11477974?v=4', 'gravatar_id': '', 'url': 'https://api.github.com/users/eellison', 'html_url': 'https://github.com/eellison', 'followers_url': 'https://api.github.com/users/eellison/followers', 'following_url': 'https://api.github.com/users/eellison/following{/other_user}', 'gists_url': 'https://api.github.com/users/eellison/gists{/gist_id}', 'starred_url': 'https://api.github.com/users/eellison/starred{/owner}{/repo}', 'subscriptions_url': 'https://api.github.com/users/eellison/subscriptions', 'organizations_url': 'https://api.github.com/users/eellison/orgs', 'repos_url': 'https://api.github.com/users/eellison/repos', 'events_url': 'https://api.github.com/users/eellison/events{/privacy}', 'received_events_url': 'https://api.github.com/users/eellison/received_events', 'type': 'User', 'site_admin': False}",referenced,d8319f4bd5741561f7223d2bc8ad1a6b3adee1fe,https://api.github.com/repos/pytorch/pytorch/commits/d8319f4bd5741561f7223d2bc8ad1a6b3adee1fe,2019-12-19T23:05:49Z,41,7,34
28360,2899026783,"{'login': 'eellison', 'id': 11477974, 'node_id': 'MDQ6VXNlcjExNDc3OTc0', 'avatar_url': 'https://avatars2.githubusercontent.com/u/11477974?v=4', 'gravatar_id': '', 'url': 'https://api.github.com/users/eellison', 'html_url': 'https://github.com/eellison', 'followers_url': 'https://api.github.com/users/eellison/followers', 'following_url': 'https://api.github.com/users/eellison/following{/other_user}', 'gists_url': 'https://api.github.com/users/eellison/gists{/gist_id}', 'starred_url': 'https://api.github.com/users/eellison/starred{/owner}{/repo}', 'subscriptions_url': 'https://api.github.com/users/eellison/subscriptions', 'organizations_url': 'https://api.github.com/users/eellison/orgs', 'repos_url': 'https://api.github.com/users/eellison/repos', 'events_url': 'https://api.github.com/users/eellison/events{/privacy}', 'received_events_url': 'https://api.github.com/users/eellison/received_events', 'type': 'User', 'site_admin': False}",referenced,3f9eb58e6cea9fd89c2a90503b10417833087d1f,https://api.github.com/repos/pytorch/pytorch/commits/3f9eb58e6cea9fd89c2a90503b10417833087d1f,2019-12-19T23:09:20Z,13,6,7
28360,2914628780,"{'login': 'eellison', 'id': 11477974, 'node_id': 'MDQ6VXNlcjExNDc3OTc0', 'avatar_url': 'https://avatars2.githubusercontent.com/u/11477974?v=4', 'gravatar_id': '', 'url': 'https://api.github.com/users/eellison', 'html_url': 'https://github.com/eellison', 'followers_url': 'https://api.github.com/users/eellison/followers', 'following_url': 'https://api.github.com/users/eellison/following{/other_user}', 'gists_url': 'https://api.github.com/users/eellison/gists{/gist_id}', 'starred_url': 'https://api.github.com/users/eellison/starred{/owner}{/repo}', 'subscriptions_url': 'https://api.github.com/users/eellison/subscriptions', 'organizations_url': 'https://api.github.com/users/eellison/orgs', 'repos_url': 'https://api.github.com/users/eellison/repos', 'events_url': 'https://api.github.com/users/eellison/events{/privacy}', 'received_events_url': 'https://api.github.com/users/eellison/received_events', 'type': 'User', 'site_admin': False}",referenced,57fee06fbba1d577507bf9063e9423c5627a399a,https://api.github.com/repos/pytorch/pytorch/commits/57fee06fbba1d577507bf9063e9423c5627a399a,2019-12-30T20:21:58Z,48,34,14
28360,2918448016,"{'login': 'eellison', 'id': 11477974, 'node_id': 'MDQ6VXNlcjExNDc3OTc0', 'avatar_url': 'https://avatars2.githubusercontent.com/u/11477974?v=4', 'gravatar_id': '', 'url': 'https://api.github.com/users/eellison', 'html_url': 'https://github.com/eellison', 'followers_url': 'https://api.github.com/users/eellison/followers', 'following_url': 'https://api.github.com/users/eellison/following{/other_user}', 'gists_url': 'https://api.github.com/users/eellison/gists{/gist_id}', 'starred_url': 'https://api.github.com/users/eellison/starred{/owner}{/repo}', 'subscriptions_url': 'https://api.github.com/users/eellison/subscriptions', 'organizations_url': 'https://api.github.com/users/eellison/orgs', 'repos_url': 'https://api.github.com/users/eellison/repos', 'events_url': 'https://api.github.com/users/eellison/events{/privacy}', 'received_events_url': 'https://api.github.com/users/eellison/received_events', 'type': 'User', 'site_admin': False}",referenced,46b7d88a8acb44a00c135320e480ade99fbc3da2,https://api.github.com/repos/pytorch/pytorch/commits/46b7d88a8acb44a00c135320e480ade99fbc3da2,2020-01-02T18:34:36Z,14376,9537,4839
28360,2932183580,"{'login': 'eellison', 'id': 11477974, 'node_id': 'MDQ6VXNlcjExNDc3OTc0', 'avatar_url': 'https://avatars2.githubusercontent.com/u/11477974?v=4', 'gravatar_id': '', 'url': 'https://api.github.com/users/eellison', 'html_url': 'https://github.com/eellison', 'followers_url': 'https://api.github.com/users/eellison/followers', 'following_url': 'https://api.github.com/users/eellison/following{/other_user}', 'gists_url': 'https://api.github.com/users/eellison/gists{/gist_id}', 'starred_url': 'https://api.github.com/users/eellison/starred{/owner}{/repo}', 'subscriptions_url': 'https://api.github.com/users/eellison/subscriptions', 'organizations_url': 'https://api.github.com/users/eellison/orgs', 'repos_url': 'https://api.github.com/users/eellison/repos', 'events_url': 'https://api.github.com/users/eellison/events{/privacy}', 'received_events_url': 'https://api.github.com/users/eellison/received_events', 'type': 'User', 'site_admin': False}",referenced,649dc23473b5a6469054ef5b8ae0bb24cfd146e8,https://api.github.com/repos/pytorch/pytorch/commits/649dc23473b5a6469054ef5b8ae0bb24cfd146e8,2020-01-08T18:01:05Z,4939,3048,1891
28360,2933221221,"{'login': 'facebook-github-bot', 'id': 6422482, 'node_id': 'MDQ6VXNlcjY0MjI0ODI=', 'avatar_url': 'https://avatars3.githubusercontent.com/u/6422482?v=4', 'gravatar_id': '', 'url': 'https://api.github.com/users/facebook-github-bot', 'html_url': 'https://github.com/facebook-github-bot', 'followers_url': 'https://api.github.com/users/facebook-github-bot/followers', 'following_url': 'https://api.github.com/users/facebook-github-bot/following{/other_user}', 'gists_url': 'https://api.github.com/users/facebook-github-bot/gists{/gist_id}', 'starred_url': 'https://api.github.com/users/facebook-github-bot/starred{/owner}{/repo}', 'subscriptions_url': 'https://api.github.com/users/facebook-github-bot/subscriptions', 'organizations_url': 'https://api.github.com/users/facebook-github-bot/orgs', 'repos_url': 'https://api.github.com/users/facebook-github-bot/repos', 'events_url': 'https://api.github.com/users/facebook-github-bot/events{/privacy}', 'received_events_url': 'https://api.github.com/users/facebook-github-bot/received_events', 'type': 'User', 'site_admin': False}",referenced,319cc21108da87bea879700107a30ddeff3bfb92,https://api.github.com/repos/pytorch/pytorch/commits/319cc21108da87bea879700107a30ddeff3bfb92,2020-01-09T00:47:21Z,99,87,12
28360,2949120046,"{'login': 'facebook-github-bot', 'id': 6422482, 'node_id': 'MDQ6VXNlcjY0MjI0ODI=', 'avatar_url': 'https://avatars3.githubusercontent.com/u/6422482?v=4', 'gravatar_id': '', 'url': 'https://api.github.com/users/facebook-github-bot', 'html_url': 'https://github.com/facebook-github-bot', 'followers_url': 'https://api.github.com/users/facebook-github-bot/followers', 'following_url': 'https://api.github.com/users/facebook-github-bot/following{/other_user}', 'gists_url': 'https://api.github.com/users/facebook-github-bot/gists{/gist_id}', 'starred_url': 'https://api.github.com/users/facebook-github-bot/starred{/owner}{/repo}', 'subscriptions_url': 'https://api.github.com/users/facebook-github-bot/subscriptions', 'organizations_url': 'https://api.github.com/users/facebook-github-bot/orgs', 'repos_url': 'https://api.github.com/users/facebook-github-bot/repos', 'events_url': 'https://api.github.com/users/facebook-github-bot/events{/privacy}', 'received_events_url': 'https://api.github.com/users/facebook-github-bot/received_events', 'type': 'User', 'site_admin': False}",closed,02c3493a84d28f5c930b076a3890f4272a7e6db4,https://api.github.com/repos/pytorch/pytorch/commits/02c3493a84d28f5c930b076a3890f4272a7e6db4,2020-01-15T00:42:37Z,770,447,323
28347,2821166646,"{'login': 'facebook-github-bot', 'id': 6422482, 'node_id': 'MDQ6VXNlcjY0MjI0ODI=', 'avatar_url': 'https://avatars3.githubusercontent.com/u/6422482?v=4', 'gravatar_id': '', 'url': 'https://api.github.com/users/facebook-github-bot', 'html_url': 'https://github.com/facebook-github-bot', 'followers_url': 'https://api.github.com/users/facebook-github-bot/followers', 'following_url': 'https://api.github.com/users/facebook-github-bot/following{/other_user}', 'gists_url': 'https://api.github.com/users/facebook-github-bot/gists{/gist_id}', 'starred_url': 'https://api.github.com/users/facebook-github-bot/starred{/owner}{/repo}', 'subscriptions_url': 'https://api.github.com/users/facebook-github-bot/subscriptions', 'organizations_url': 'https://api.github.com/users/facebook-github-bot/orgs', 'repos_url': 'https://api.github.com/users/facebook-github-bot/repos', 'events_url': 'https://api.github.com/users/facebook-github-bot/events{/privacy}', 'received_events_url': 'https://api.github.com/users/facebook-github-bot/received_events', 'type': 'User', 'site_admin': False}",closed,0fdbb762d1a9e6b9c262760b6b67bcb3d0814407,https://api.github.com/repos/pytorch/pytorch/commits/0fdbb762d1a9e6b9c262760b6b67bcb3d0814407,2019-11-21T21:06:35Z,31,27,4
28305,2740981780,"{'login': 'ezyang', 'id': 13564, 'node_id': 'MDQ6VXNlcjEzNTY0', 'avatar_url': 'https://avatars0.githubusercontent.com/u/13564?v=4', 'gravatar_id': '', 'url': 'https://api.github.com/users/ezyang', 'html_url': 'https://github.com/ezyang', 'followers_url': 'https://api.github.com/users/ezyang/followers', 'following_url': 'https://api.github.com/users/ezyang/following{/other_user}', 'gists_url': 'https://api.github.com/users/ezyang/gists{/gist_id}', 'starred_url': 'https://api.github.com/users/ezyang/starred{/owner}{/repo}', 'subscriptions_url': 'https://api.github.com/users/ezyang/subscriptions', 'organizations_url': 'https://api.github.com/users/ezyang/orgs', 'repos_url': 'https://api.github.com/users/ezyang/repos', 'events_url': 'https://api.github.com/users/ezyang/events{/privacy}', 'received_events_url': 'https://api.github.com/users/ezyang/received_events', 'type': 'User', 'site_admin': False}",referenced,935bef419187a601d59d2629b56491b7c7d10a38,https://api.github.com/repos/pytorch/pytorch/commits/935bef419187a601d59d2629b56491b7c7d10a38,2019-10-24T14:24:45Z,4,4,0
28305,2741014217,"{'login': 'ezyang', 'id': 13564, 'node_id': 'MDQ6VXNlcjEzNTY0', 'avatar_url': 'https://avatars0.githubusercontent.com/u/13564?v=4', 'gravatar_id': '', 'url': 'https://api.github.com/users/ezyang', 'html_url': 'https://github.com/ezyang', 'followers_url': 'https://api.github.com/users/ezyang/followers', 'following_url': 'https://api.github.com/users/ezyang/following{/other_user}', 'gists_url': 'https://api.github.com/users/ezyang/gists{/gist_id}', 'starred_url': 'https://api.github.com/users/ezyang/starred{/owner}{/repo}', 'subscriptions_url': 'https://api.github.com/users/ezyang/subscriptions', 'organizations_url': 'https://api.github.com/users/ezyang/orgs', 'repos_url': 'https://api.github.com/users/ezyang/repos', 'events_url': 'https://api.github.com/users/ezyang/events{/privacy}', 'received_events_url': 'https://api.github.com/users/ezyang/received_events', 'type': 'User', 'site_admin': False}",referenced,186fd3f1832ca712611e69c2deabc0b913c2bd92,https://api.github.com/repos/pytorch/pytorch/commits/186fd3f1832ca712611e69c2deabc0b913c2bd92,2019-10-24T14:32:59Z,4,4,0
28305,2744897218,"{'login': 'facebook-github-bot', 'id': 6422482, 'node_id': 'MDQ6VXNlcjY0MjI0ODI=', 'avatar_url': 'https://avatars3.githubusercontent.com/u/6422482?v=4', 'gravatar_id': '', 'url': 'https://api.github.com/users/facebook-github-bot', 'html_url': 'https://github.com/facebook-github-bot', 'followers_url': 'https://api.github.com/users/facebook-github-bot/followers', 'following_url': 'https://api.github.com/users/facebook-github-bot/following{/other_user}', 'gists_url': 'https://api.github.com/users/facebook-github-bot/gists{/gist_id}', 'starred_url': 'https://api.github.com/users/facebook-github-bot/starred{/owner}{/repo}', 'subscriptions_url': 'https://api.github.com/users/facebook-github-bot/subscriptions', 'organizations_url': 'https://api.github.com/users/facebook-github-bot/orgs', 'repos_url': 'https://api.github.com/users/facebook-github-bot/repos', 'events_url': 'https://api.github.com/users/facebook-github-bot/events{/privacy}', 'received_events_url': 'https://api.github.com/users/facebook-github-bot/received_events', 'type': 'User', 'site_admin': False}",closed,68ab162099618f4e35fe37ae1318c5b1a40bdac3,https://api.github.com/repos/pytorch/pytorch/commits/68ab162099618f4e35fe37ae1318c5b1a40bdac3,2019-10-25T17:14:14Z,8,8,0
28302,2737175408,"{'login': 'mrshenli', 'id': 16999635, 'node_id': 'MDQ6VXNlcjE2OTk5NjM1', 'avatar_url': 'https://avatars2.githubusercontent.com/u/16999635?v=4', 'gravatar_id': '', 'url': 'https://api.github.com/users/mrshenli', 'html_url': 'https://github.com/mrshenli', 'followers_url': 'https://api.github.com/users/mrshenli/followers', 'following_url': 'https://api.github.com/users/mrshenli/following{/other_user}', 'gists_url': 'https://api.github.com/users/mrshenli/gists{/gist_id}', 'starred_url': 'https://api.github.com/users/mrshenli/starred{/owner}{/repo}', 'subscriptions_url': 'https://api.github.com/users/mrshenli/subscriptions', 'organizations_url': 'https://api.github.com/users/mrshenli/orgs', 'repos_url': 'https://api.github.com/users/mrshenli/repos', 'events_url': 'https://api.github.com/users/mrshenli/events{/privacy}', 'received_events_url': 'https://api.github.com/users/mrshenli/received_events', 'type': 'User', 'site_admin': False}",referenced,ec6a05312c1cbfd6610bc05df792eed197133341,https://api.github.com/repos/pytorch/pytorch/commits/ec6a05312c1cbfd6610bc05df792eed197133341,2019-10-23T13:58:54Z,13242,9578,3664
28302,2737501507,"{'login': 'mrshenli', 'id': 16999635, 'node_id': 'MDQ6VXNlcjE2OTk5NjM1', 'avatar_url': 'https://avatars2.githubusercontent.com/u/16999635?v=4', 'gravatar_id': '', 'url': 'https://api.github.com/users/mrshenli', 'html_url': 'https://github.com/mrshenli', 'followers_url': 'https://api.github.com/users/mrshenli/followers', 'following_url': 'https://api.github.com/users/mrshenli/following{/other_user}', 'gists_url': 'https://api.github.com/users/mrshenli/gists{/gist_id}', 'starred_url': 'https://api.github.com/users/mrshenli/starred{/owner}{/repo}', 'subscriptions_url': 'https://api.github.com/users/mrshenli/subscriptions', 'organizations_url': 'https://api.github.com/users/mrshenli/orgs', 'repos_url': 'https://api.github.com/users/mrshenli/repos', 'events_url': 'https://api.github.com/users/mrshenli/events{/privacy}', 'received_events_url': 'https://api.github.com/users/mrshenli/received_events', 'type': 'User', 'site_admin': False}",referenced,46e9ed6783b70e7c437ffbcf3fdcbd8647fa2494,https://api.github.com/repos/pytorch/pytorch/commits/46e9ed6783b70e7c437ffbcf3fdcbd8647fa2494,2019-10-23T15:20:02Z,4,2,2
28302,2737565073,"{'login': 'mrshenli', 'id': 16999635, 'node_id': 'MDQ6VXNlcjE2OTk5NjM1', 'avatar_url': 'https://avatars2.githubusercontent.com/u/16999635?v=4', 'gravatar_id': '', 'url': 'https://api.github.com/users/mrshenli', 'html_url': 'https://github.com/mrshenli', 'followers_url': 'https://api.github.com/users/mrshenli/followers', 'following_url': 'https://api.github.com/users/mrshenli/following{/other_user}', 'gists_url': 'https://api.github.com/users/mrshenli/gists{/gist_id}', 'starred_url': 'https://api.github.com/users/mrshenli/starred{/owner}{/repo}', 'subscriptions_url': 'https://api.github.com/users/mrshenli/subscriptions', 'organizations_url': 'https://api.github.com/users/mrshenli/orgs', 'repos_url': 'https://api.github.com/users/mrshenli/repos', 'events_url': 'https://api.github.com/users/mrshenli/events{/privacy}', 'received_events_url': 'https://api.github.com/users/mrshenli/received_events', 'type': 'User', 'site_admin': False}",referenced,d18cc6c13e6f348c771d726cdd25267838cc3b56,https://api.github.com/repos/pytorch/pytorch/commits/d18cc6c13e6f348c771d726cdd25267838cc3b56,2019-10-23T15:36:20Z,20,10,10
28302,2738089652,"{'login': 'mrshenli', 'id': 16999635, 'node_id': 'MDQ6VXNlcjE2OTk5NjM1', 'avatar_url': 'https://avatars2.githubusercontent.com/u/16999635?v=4', 'gravatar_id': '', 'url': 'https://api.github.com/users/mrshenli', 'html_url': 'https://github.com/mrshenli', 'followers_url': 'https://api.github.com/users/mrshenli/followers', 'following_url': 'https://api.github.com/users/mrshenli/following{/other_user}', 'gists_url': 'https://api.github.com/users/mrshenli/gists{/gist_id}', 'starred_url': 'https://api.github.com/users/mrshenli/starred{/owner}{/repo}', 'subscriptions_url': 'https://api.github.com/users/mrshenli/subscriptions', 'organizations_url': 'https://api.github.com/users/mrshenli/orgs', 'repos_url': 'https://api.github.com/users/mrshenli/repos', 'events_url': 'https://api.github.com/users/mrshenli/events{/privacy}', 'received_events_url': 'https://api.github.com/users/mrshenli/received_events', 'type': 'User', 'site_admin': False}",referenced,43132d5ff3943d59582618200d2b1f8ae609ec1a,https://api.github.com/repos/pytorch/pytorch/commits/43132d5ff3943d59582618200d2b1f8ae609ec1a,2019-10-23T18:19:27Z,6,0,6
28216,2738494299,"{'login': 'facebook-github-bot', 'id': 6422482, 'node_id': 'MDQ6VXNlcjY0MjI0ODI=', 'avatar_url': 'https://avatars3.githubusercontent.com/u/6422482?v=4', 'gravatar_id': '', 'url': 'https://api.github.com/users/facebook-github-bot', 'html_url': 'https://github.com/facebook-github-bot', 'followers_url': 'https://api.github.com/users/facebook-github-bot/followers', 'following_url': 'https://api.github.com/users/facebook-github-bot/following{/other_user}', 'gists_url': 'https://api.github.com/users/facebook-github-bot/gists{/gist_id}', 'starred_url': 'https://api.github.com/users/facebook-github-bot/starred{/owner}{/repo}', 'subscriptions_url': 'https://api.github.com/users/facebook-github-bot/subscriptions', 'organizations_url': 'https://api.github.com/users/facebook-github-bot/orgs', 'repos_url': 'https://api.github.com/users/facebook-github-bot/repos', 'events_url': 'https://api.github.com/users/facebook-github-bot/events{/privacy}', 'received_events_url': 'https://api.github.com/users/facebook-github-bot/received_events', 'type': 'User', 'site_admin': False}",closed,1c53a74e266ec90c57f32f041ff7747b86246f47,https://api.github.com/repos/pytorch/pytorch/commits/1c53a74e266ec90c57f32f041ff7747b86246f47,2019-10-23T20:39:18Z,4,2,2
28198,2759992670,"{'login': 'facebook-github-bot', 'id': 6422482, 'node_id': 'MDQ6VXNlcjY0MjI0ODI=', 'avatar_url': 'https://avatars3.githubusercontent.com/u/6422482?v=4', 'gravatar_id': '', 'url': 'https://api.github.com/users/facebook-github-bot', 'html_url': 'https://github.com/facebook-github-bot', 'followers_url': 'https://api.github.com/users/facebook-github-bot/followers', 'following_url': 'https://api.github.com/users/facebook-github-bot/following{/other_user}', 'gists_url': 'https://api.github.com/users/facebook-github-bot/gists{/gist_id}', 'starred_url': 'https://api.github.com/users/facebook-github-bot/starred{/owner}{/repo}', 'subscriptions_url': 'https://api.github.com/users/facebook-github-bot/subscriptions', 'organizations_url': 'https://api.github.com/users/facebook-github-bot/orgs', 'repos_url': 'https://api.github.com/users/facebook-github-bot/repos', 'events_url': 'https://api.github.com/users/facebook-github-bot/events{/privacy}', 'received_events_url': 'https://api.github.com/users/facebook-github-bot/received_events', 'type': 'User', 'site_admin': False}",closed,fe8804695bd5a72616a4088ca046af26fed11c16,https://api.github.com/repos/pytorch/pytorch/commits/fe8804695bd5a72616a4088ca046af26fed11c16,2019-10-31T14:18:59Z,8,4,4
28126,2722113807,"{'login': 'rohan-varma', 'id': 8039770, 'node_id': 'MDQ6VXNlcjgwMzk3NzA=', 'avatar_url': 'https://avatars2.githubusercontent.com/u/8039770?v=4', 'gravatar_id': '', 'url': 'https://api.github.com/users/rohan-varma', 'html_url': 'https://github.com/rohan-varma', 'followers_url': 'https://api.github.com/users/rohan-varma/followers', 'following_url': 'https://api.github.com/users/rohan-varma/following{/other_user}', 'gists_url': 'https://api.github.com/users/rohan-varma/gists{/gist_id}', 'starred_url': 'https://api.github.com/users/rohan-varma/starred{/owner}{/repo}', 'subscriptions_url': 'https://api.github.com/users/rohan-varma/subscriptions', 'organizations_url': 'https://api.github.com/users/rohan-varma/orgs', 'repos_url': 'https://api.github.com/users/rohan-varma/repos', 'events_url': 'https://api.github.com/users/rohan-varma/events{/privacy}', 'received_events_url': 'https://api.github.com/users/rohan-varma/received_events', 'type': 'User', 'site_admin': False}",referenced,2637c109391342e02120e92bcbdca811c6b9a674,https://api.github.com/repos/pytorch/pytorch/commits/2637c109391342e02120e92bcbdca811c6b9a674,2019-10-17T17:19:29Z,22,9,13
28126,2722119482,"{'login': 'rohan-varma', 'id': 8039770, 'node_id': 'MDQ6VXNlcjgwMzk3NzA=', 'avatar_url': 'https://avatars2.githubusercontent.com/u/8039770?v=4', 'gravatar_id': '', 'url': 'https://api.github.com/users/rohan-varma', 'html_url': 'https://github.com/rohan-varma', 'followers_url': 'https://api.github.com/users/rohan-varma/followers', 'following_url': 'https://api.github.com/users/rohan-varma/following{/other_user}', 'gists_url': 'https://api.github.com/users/rohan-varma/gists{/gist_id}', 'starred_url': 'https://api.github.com/users/rohan-varma/starred{/owner}{/repo}', 'subscriptions_url': 'https://api.github.com/users/rohan-varma/subscriptions', 'organizations_url': 'https://api.github.com/users/rohan-varma/orgs', 'repos_url': 'https://api.github.com/users/rohan-varma/repos', 'events_url': 'https://api.github.com/users/rohan-varma/events{/privacy}', 'received_events_url': 'https://api.github.com/users/rohan-varma/received_events', 'type': 'User', 'site_admin': False}",referenced,8180bee2169babeef697863c0cddccab10f70d05,https://api.github.com/repos/pytorch/pytorch/commits/8180bee2169babeef697863c0cddccab10f70d05,2019-10-17T17:21:24Z,10,9,1
28126,2722126558,"{'login': 'rohan-varma', 'id': 8039770, 'node_id': 'MDQ6VXNlcjgwMzk3NzA=', 'avatar_url': 'https://avatars2.githubusercontent.com/u/8039770?v=4', 'gravatar_id': '', 'url': 'https://api.github.com/users/rohan-varma', 'html_url': 'https://github.com/rohan-varma', 'followers_url': 'https://api.github.com/users/rohan-varma/followers', 'following_url': 'https://api.github.com/users/rohan-varma/following{/other_user}', 'gists_url': 'https://api.github.com/users/rohan-varma/gists{/gist_id}', 'starred_url': 'https://api.github.com/users/rohan-varma/starred{/owner}{/repo}', 'subscriptions_url': 'https://api.github.com/users/rohan-varma/subscriptions', 'organizations_url': 'https://api.github.com/users/rohan-varma/orgs', 'repos_url': 'https://api.github.com/users/rohan-varma/repos', 'events_url': 'https://api.github.com/users/rohan-varma/events{/privacy}', 'received_events_url': 'https://api.github.com/users/rohan-varma/received_events', 'type': 'User', 'site_admin': False}",referenced,4a65692e6d9d5289886f715525848d213d374801,https://api.github.com/repos/pytorch/pytorch/commits/4a65692e6d9d5289886f715525848d213d374801,2019-10-17T17:23:49Z,2,0,2
28126,2722189772,"{'login': 'rohan-varma', 'id': 8039770, 'node_id': 'MDQ6VXNlcjgwMzk3NzA=', 'avatar_url': 'https://avatars2.githubusercontent.com/u/8039770?v=4', 'gravatar_id': '', 'url': 'https://api.github.com/users/rohan-varma', 'html_url': 'https://github.com/rohan-varma', 'followers_url': 'https://api.github.com/users/rohan-varma/followers', 'following_url': 'https://api.github.com/users/rohan-varma/following{/other_user}', 'gists_url': 'https://api.github.com/users/rohan-varma/gists{/gist_id}', 'starred_url': 'https://api.github.com/users/rohan-varma/starred{/owner}{/repo}', 'subscriptions_url': 'https://api.github.com/users/rohan-varma/subscriptions', 'organizations_url': 'https://api.github.com/users/rohan-varma/orgs', 'repos_url': 'https://api.github.com/users/rohan-varma/repos', 'events_url': 'https://api.github.com/users/rohan-varma/events{/privacy}', 'received_events_url': 'https://api.github.com/users/rohan-varma/received_events', 'type': 'User', 'site_admin': False}",referenced,b49f02cce3e7b835cf5250a768b27793571617bc,https://api.github.com/repos/pytorch/pytorch/commits/b49f02cce3e7b835cf5250a768b27793571617bc,2019-10-17T17:45:21Z,2682,1572,1110
28126,2726432132,"{'login': 'rohan-varma', 'id': 8039770, 'node_id': 'MDQ6VXNlcjgwMzk3NzA=', 'avatar_url': 'https://avatars2.githubusercontent.com/u/8039770?v=4', 'gravatar_id': '', 'url': 'https://api.github.com/users/rohan-varma', 'html_url': 'https://github.com/rohan-varma', 'followers_url': 'https://api.github.com/users/rohan-varma/followers', 'following_url': 'https://api.github.com/users/rohan-varma/following{/other_user}', 'gists_url': 'https://api.github.com/users/rohan-varma/gists{/gist_id}', 'starred_url': 'https://api.github.com/users/rohan-varma/starred{/owner}{/repo}', 'subscriptions_url': 'https://api.github.com/users/rohan-varma/subscriptions', 'organizations_url': 'https://api.github.com/users/rohan-varma/orgs', 'repos_url': 'https://api.github.com/users/rohan-varma/repos', 'events_url': 'https://api.github.com/users/rohan-varma/events{/privacy}', 'received_events_url': 'https://api.github.com/users/rohan-varma/received_events', 'type': 'User', 'site_admin': False}",referenced,1e2d89f7047c629e34bea45d2fa2c05ec8565768,https://api.github.com/repos/pytorch/pytorch/commits/1e2d89f7047c629e34bea45d2fa2c05ec8565768,2019-10-18T22:32:06Z,3209,2536,673
28126,2726605409,"{'login': 'rohan-varma', 'id': 8039770, 'node_id': 'MDQ6VXNlcjgwMzk3NzA=', 'avatar_url': 'https://avatars2.githubusercontent.com/u/8039770?v=4', 'gravatar_id': '', 'url': 'https://api.github.com/users/rohan-varma', 'html_url': 'https://github.com/rohan-varma', 'followers_url': 'https://api.github.com/users/rohan-varma/followers', 'following_url': 'https://api.github.com/users/rohan-varma/following{/other_user}', 'gists_url': 'https://api.github.com/users/rohan-varma/gists{/gist_id}', 'starred_url': 'https://api.github.com/users/rohan-varma/starred{/owner}{/repo}', 'subscriptions_url': 'https://api.github.com/users/rohan-varma/subscriptions', 'organizations_url': 'https://api.github.com/users/rohan-varma/orgs', 'repos_url': 'https://api.github.com/users/rohan-varma/repos', 'events_url': 'https://api.github.com/users/rohan-varma/events{/privacy}', 'received_events_url': 'https://api.github.com/users/rohan-varma/received_events', 'type': 'User', 'site_admin': False}",referenced,bbcb649bf0dcb4c6c2b3c418ae4fe1ae607340ea,https://api.github.com/repos/pytorch/pytorch/commits/bbcb649bf0dcb4c6c2b3c418ae4fe1ae607340ea,2019-10-19T00:34:25Z,78,42,36
28126,2726616859,"{'login': 'rohan-varma', 'id': 8039770, 'node_id': 'MDQ6VXNlcjgwMzk3NzA=', 'avatar_url': 'https://avatars2.githubusercontent.com/u/8039770?v=4', 'gravatar_id': '', 'url': 'https://api.github.com/users/rohan-varma', 'html_url': 'https://github.com/rohan-varma', 'followers_url': 'https://api.github.com/users/rohan-varma/followers', 'following_url': 'https://api.github.com/users/rohan-varma/following{/other_user}', 'gists_url': 'https://api.github.com/users/rohan-varma/gists{/gist_id}', 'starred_url': 'https://api.github.com/users/rohan-varma/starred{/owner}{/repo}', 'subscriptions_url': 'https://api.github.com/users/rohan-varma/subscriptions', 'organizations_url': 'https://api.github.com/users/rohan-varma/orgs', 'repos_url': 'https://api.github.com/users/rohan-varma/repos', 'events_url': 'https://api.github.com/users/rohan-varma/events{/privacy}', 'received_events_url': 'https://api.github.com/users/rohan-varma/received_events', 'type': 'User', 'site_admin': False}",referenced,5bda32269c49b741c3770a9356949bdb4fea4bce,https://api.github.com/repos/pytorch/pytorch/commits/5bda32269c49b741c3770a9356949bdb4fea4bce,2019-10-19T00:44:44Z,2,1,1
28126,2726651422,"{'login': 'rohan-varma', 'id': 8039770, 'node_id': 'MDQ6VXNlcjgwMzk3NzA=', 'avatar_url': 'https://avatars2.githubusercontent.com/u/8039770?v=4', 'gravatar_id': '', 'url': 'https://api.github.com/users/rohan-varma', 'html_url': 'https://github.com/rohan-varma', 'followers_url': 'https://api.github.com/users/rohan-varma/followers', 'following_url': 'https://api.github.com/users/rohan-varma/following{/other_user}', 'gists_url': 'https://api.github.com/users/rohan-varma/gists{/gist_id}', 'starred_url': 'https://api.github.com/users/rohan-varma/starred{/owner}{/repo}', 'subscriptions_url': 'https://api.github.com/users/rohan-varma/subscriptions', 'organizations_url': 'https://api.github.com/users/rohan-varma/orgs', 'repos_url': 'https://api.github.com/users/rohan-varma/repos', 'events_url': 'https://api.github.com/users/rohan-varma/events{/privacy}', 'received_events_url': 'https://api.github.com/users/rohan-varma/received_events', 'type': 'User', 'site_admin': False}",referenced,8d224d2b270768569f845d18f85e8af84c20bf26,https://api.github.com/repos/pytorch/pytorch/commits/8d224d2b270768569f845d18f85e8af84c20bf26,2019-10-19T01:21:41Z,11,7,4
28126,2726701932,"{'login': 'rohan-varma', 'id': 8039770, 'node_id': 'MDQ6VXNlcjgwMzk3NzA=', 'avatar_url': 'https://avatars2.githubusercontent.com/u/8039770?v=4', 'gravatar_id': '', 'url': 'https://api.github.com/users/rohan-varma', 'html_url': 'https://github.com/rohan-varma', 'followers_url': 'https://api.github.com/users/rohan-varma/followers', 'following_url': 'https://api.github.com/users/rohan-varma/following{/other_user}', 'gists_url': 'https://api.github.com/users/rohan-varma/gists{/gist_id}', 'starred_url': 'https://api.github.com/users/rohan-varma/starred{/owner}{/repo}', 'subscriptions_url': 'https://api.github.com/users/rohan-varma/subscriptions', 'organizations_url': 'https://api.github.com/users/rohan-varma/orgs', 'repos_url': 'https://api.github.com/users/rohan-varma/repos', 'events_url': 'https://api.github.com/users/rohan-varma/events{/privacy}', 'received_events_url': 'https://api.github.com/users/rohan-varma/received_events', 'type': 'User', 'site_admin': False}",referenced,6a5ad708d7cf7684b1e4e1571ca0c80e329b3f3f,https://api.github.com/repos/pytorch/pytorch/commits/6a5ad708d7cf7684b1e4e1571ca0c80e329b3f3f,2019-10-19T02:20:03Z,29,19,10
28124,2735651610,"{'login': 'rohan-varma', 'id': 8039770, 'node_id': 'MDQ6VXNlcjgwMzk3NzA=', 'avatar_url': 'https://avatars2.githubusercontent.com/u/8039770?v=4', 'gravatar_id': '', 'url': 'https://api.github.com/users/rohan-varma', 'html_url': 'https://github.com/rohan-varma', 'followers_url': 'https://api.github.com/users/rohan-varma/followers', 'following_url': 'https://api.github.com/users/rohan-varma/following{/other_user}', 'gists_url': 'https://api.github.com/users/rohan-varma/gists{/gist_id}', 'starred_url': 'https://api.github.com/users/rohan-varma/starred{/owner}{/repo}', 'subscriptions_url': 'https://api.github.com/users/rohan-varma/subscriptions', 'organizations_url': 'https://api.github.com/users/rohan-varma/orgs', 'repos_url': 'https://api.github.com/users/rohan-varma/repos', 'events_url': 'https://api.github.com/users/rohan-varma/events{/privacy}', 'received_events_url': 'https://api.github.com/users/rohan-varma/received_events', 'type': 'User', 'site_admin': False}",referenced,a0db593f6cde27c263f3812138b73ae0a2043953,https://api.github.com/repos/pytorch/pytorch/commits/a0db593f6cde27c263f3812138b73ae0a2043953,2019-10-23T05:21:33Z,4,2,2
28124,2735711747,"{'login': 'rohan-varma', 'id': 8039770, 'node_id': 'MDQ6VXNlcjgwMzk3NzA=', 'avatar_url': 'https://avatars2.githubusercontent.com/u/8039770?v=4', 'gravatar_id': '', 'url': 'https://api.github.com/users/rohan-varma', 'html_url': 'https://github.com/rohan-varma', 'followers_url': 'https://api.github.com/users/rohan-varma/followers', 'following_url': 'https://api.github.com/users/rohan-varma/following{/other_user}', 'gists_url': 'https://api.github.com/users/rohan-varma/gists{/gist_id}', 'starred_url': 'https://api.github.com/users/rohan-varma/starred{/owner}{/repo}', 'subscriptions_url': 'https://api.github.com/users/rohan-varma/subscriptions', 'organizations_url': 'https://api.github.com/users/rohan-varma/orgs', 'repos_url': 'https://api.github.com/users/rohan-varma/repos', 'events_url': 'https://api.github.com/users/rohan-varma/events{/privacy}', 'received_events_url': 'https://api.github.com/users/rohan-varma/received_events', 'type': 'User', 'site_admin': False}",referenced,4b3024939da80993d8c17d50f530ffa4275e9514,https://api.github.com/repos/pytorch/pytorch/commits/4b3024939da80993d8c17d50f530ffa4275e9514,2019-10-23T05:57:36Z,2,1,1
28124,2739194222,"{'login': 'rohan-varma', 'id': 8039770, 'node_id': 'MDQ6VXNlcjgwMzk3NzA=', 'avatar_url': 'https://avatars2.githubusercontent.com/u/8039770?v=4', 'gravatar_id': '', 'url': 'https://api.github.com/users/rohan-varma', 'html_url': 'https://github.com/rohan-varma', 'followers_url': 'https://api.github.com/users/rohan-varma/followers', 'following_url': 'https://api.github.com/users/rohan-varma/following{/other_user}', 'gists_url': 'https://api.github.com/users/rohan-varma/gists{/gist_id}', 'starred_url': 'https://api.github.com/users/rohan-varma/starred{/owner}{/repo}', 'subscriptions_url': 'https://api.github.com/users/rohan-varma/subscriptions', 'organizations_url': 'https://api.github.com/users/rohan-varma/orgs', 'repos_url': 'https://api.github.com/users/rohan-varma/repos', 'events_url': 'https://api.github.com/users/rohan-varma/events{/privacy}', 'received_events_url': 'https://api.github.com/users/rohan-varma/received_events', 'type': 'User', 'site_admin': False}",referenced,64d720fc241c5a25e24acba1c2918a4f4bddc6d9,https://api.github.com/repos/pytorch/pytorch/commits/64d720fc241c5a25e24acba1c2918a4f4bddc6d9,2019-10-24T03:11:54Z,10980,7724,3256
28124,2742443366,"{'login': 'rohan-varma', 'id': 8039770, 'node_id': 'MDQ6VXNlcjgwMzk3NzA=', 'avatar_url': 'https://avatars2.githubusercontent.com/u/8039770?v=4', 'gravatar_id': '', 'url': 'https://api.github.com/users/rohan-varma', 'html_url': 'https://github.com/rohan-varma', 'followers_url': 'https://api.github.com/users/rohan-varma/followers', 'following_url': 'https://api.github.com/users/rohan-varma/following{/other_user}', 'gists_url': 'https://api.github.com/users/rohan-varma/gists{/gist_id}', 'starred_url': 'https://api.github.com/users/rohan-varma/starred{/owner}{/repo}', 'subscriptions_url': 'https://api.github.com/users/rohan-varma/subscriptions', 'organizations_url': 'https://api.github.com/users/rohan-varma/orgs', 'repos_url': 'https://api.github.com/users/rohan-varma/repos', 'events_url': 'https://api.github.com/users/rohan-varma/events{/privacy}', 'received_events_url': 'https://api.github.com/users/rohan-varma/received_events', 'type': 'User', 'site_admin': False}",referenced,695c32070d25dcbb62dae4151bfc898ea2f3b0e6,https://api.github.com/repos/pytorch/pytorch/commits/695c32070d25dcbb62dae4151bfc898ea2f3b0e6,2019-10-24T22:47:42Z,4284,2882,1402
28124,2742451210,"{'login': 'rohan-varma', 'id': 8039770, 'node_id': 'MDQ6VXNlcjgwMzk3NzA=', 'avatar_url': 'https://avatars2.githubusercontent.com/u/8039770?v=4', 'gravatar_id': '', 'url': 'https://api.github.com/users/rohan-varma', 'html_url': 'https://github.com/rohan-varma', 'followers_url': 'https://api.github.com/users/rohan-varma/followers', 'following_url': 'https://api.github.com/users/rohan-varma/following{/other_user}', 'gists_url': 'https://api.github.com/users/rohan-varma/gists{/gist_id}', 'starred_url': 'https://api.github.com/users/rohan-varma/starred{/owner}{/repo}', 'subscriptions_url': 'https://api.github.com/users/rohan-varma/subscriptions', 'organizations_url': 'https://api.github.com/users/rohan-varma/orgs', 'repos_url': 'https://api.github.com/users/rohan-varma/repos', 'events_url': 'https://api.github.com/users/rohan-varma/events{/privacy}', 'received_events_url': 'https://api.github.com/users/rohan-varma/received_events', 'type': 'User', 'site_admin': False}",referenced,a01156fe6c10d862f0117a879ccbec60b8d4401b,https://api.github.com/repos/pytorch/pytorch/commits/a01156fe6c10d862f0117a879ccbec60b8d4401b,2019-10-24T22:52:19Z,7,2,5
28124,2742915210,"{'login': 'rohan-varma', 'id': 8039770, 'node_id': 'MDQ6VXNlcjgwMzk3NzA=', 'avatar_url': 'https://avatars2.githubusercontent.com/u/8039770?v=4', 'gravatar_id': '', 'url': 'https://api.github.com/users/rohan-varma', 'html_url': 'https://github.com/rohan-varma', 'followers_url': 'https://api.github.com/users/rohan-varma/followers', 'following_url': 'https://api.github.com/users/rohan-varma/following{/other_user}', 'gists_url': 'https://api.github.com/users/rohan-varma/gists{/gist_id}', 'starred_url': 'https://api.github.com/users/rohan-varma/starred{/owner}{/repo}', 'subscriptions_url': 'https://api.github.com/users/rohan-varma/subscriptions', 'organizations_url': 'https://api.github.com/users/rohan-varma/orgs', 'repos_url': 'https://api.github.com/users/rohan-varma/repos', 'events_url': 'https://api.github.com/users/rohan-varma/events{/privacy}', 'received_events_url': 'https://api.github.com/users/rohan-varma/received_events', 'type': 'User', 'site_admin': False}",referenced,217389ec3f6bb125c7dd28f9e656e25a4f09fa7d,https://api.github.com/repos/pytorch/pytorch/commits/217389ec3f6bb125c7dd28f9e656e25a4f09fa7d,2019-10-25T04:36:38Z,404,346,58
28124,2742916953,"{'login': 'rohan-varma', 'id': 8039770, 'node_id': 'MDQ6VXNlcjgwMzk3NzA=', 'avatar_url': 'https://avatars2.githubusercontent.com/u/8039770?v=4', 'gravatar_id': '', 'url': 'https://api.github.com/users/rohan-varma', 'html_url': 'https://github.com/rohan-varma', 'followers_url': 'https://api.github.com/users/rohan-varma/followers', 'following_url': 'https://api.github.com/users/rohan-varma/following{/other_user}', 'gists_url': 'https://api.github.com/users/rohan-varma/gists{/gist_id}', 'starred_url': 'https://api.github.com/users/rohan-varma/starred{/owner}{/repo}', 'subscriptions_url': 'https://api.github.com/users/rohan-varma/subscriptions', 'organizations_url': 'https://api.github.com/users/rohan-varma/orgs', 'repos_url': 'https://api.github.com/users/rohan-varma/repos', 'events_url': 'https://api.github.com/users/rohan-varma/events{/privacy}', 'received_events_url': 'https://api.github.com/users/rohan-varma/received_events', 'type': 'User', 'site_admin': False}",referenced,683d78ec855ed20c7d141bda492081e7fff3630f,https://api.github.com/repos/pytorch/pytorch/commits/683d78ec855ed20c7d141bda492081e7fff3630f,2019-10-25T04:38:05Z,1,0,1
28060,2780177356,"{'login': 'facebook-github-bot', 'id': 6422482, 'node_id': 'MDQ6VXNlcjY0MjI0ODI=', 'avatar_url': 'https://avatars3.githubusercontent.com/u/6422482?v=4', 'gravatar_id': '', 'url': 'https://api.github.com/users/facebook-github-bot', 'html_url': 'https://github.com/facebook-github-bot', 'followers_url': 'https://api.github.com/users/facebook-github-bot/followers', 'following_url': 'https://api.github.com/users/facebook-github-bot/following{/other_user}', 'gists_url': 'https://api.github.com/users/facebook-github-bot/gists{/gist_id}', 'starred_url': 'https://api.github.com/users/facebook-github-bot/starred{/owner}{/repo}', 'subscriptions_url': 'https://api.github.com/users/facebook-github-bot/subscriptions', 'organizations_url': 'https://api.github.com/users/facebook-github-bot/orgs', 'repos_url': 'https://api.github.com/users/facebook-github-bot/repos', 'events_url': 'https://api.github.com/users/facebook-github-bot/events{/privacy}', 'received_events_url': 'https://api.github.com/users/facebook-github-bot/received_events', 'type': 'User', 'site_admin': False}",closed,86c64440c9169d94bffb58b523da1db00c896703,https://api.github.com/repos/pytorch/pytorch/commits/86c64440c9169d94bffb58b523da1db00c896703,2019-11-07T17:20:33Z,354,177,177
28015,2719618365,"{'login': 'z-a-f', 'id': 4216323, 'node_id': 'MDQ6VXNlcjQyMTYzMjM=', 'avatar_url': 'https://avatars2.githubusercontent.com/u/4216323?v=4', 'gravatar_id': '', 'url': 'https://api.github.com/users/z-a-f', 'html_url': 'https://github.com/z-a-f', 'followers_url': 'https://api.github.com/users/z-a-f/followers', 'following_url': 'https://api.github.com/users/z-a-f/following{/other_user}', 'gists_url': 'https://api.github.com/users/z-a-f/gists{/gist_id}', 'starred_url': 'https://api.github.com/users/z-a-f/starred{/owner}{/repo}', 'subscriptions_url': 'https://api.github.com/users/z-a-f/subscriptions', 'organizations_url': 'https://api.github.com/users/z-a-f/orgs', 'repos_url': 'https://api.github.com/users/z-a-f/repos', 'events_url': 'https://api.github.com/users/z-a-f/events{/privacy}', 'received_events_url': 'https://api.github.com/users/z-a-f/received_events', 'type': 'User', 'site_admin': False}",referenced,8a3bc01b625258e7a0466e1d8068f63c8d73ed60,https://api.github.com/repos/pytorch/pytorch/commits/8a3bc01b625258e7a0466e1d8068f63c8d73ed60,2019-10-17T01:46:35Z,20,18,2
28015,2719618670,"{'login': 'z-a-f', 'id': 4216323, 'node_id': 'MDQ6VXNlcjQyMTYzMjM=', 'avatar_url': 'https://avatars2.githubusercontent.com/u/4216323?v=4', 'gravatar_id': '', 'url': 'https://api.github.com/users/z-a-f', 'html_url': 'https://github.com/z-a-f', 'followers_url': 'https://api.github.com/users/z-a-f/followers', 'following_url': 'https://api.github.com/users/z-a-f/following{/other_user}', 'gists_url': 'https://api.github.com/users/z-a-f/gists{/gist_id}', 'starred_url': 'https://api.github.com/users/z-a-f/starred{/owner}{/repo}', 'subscriptions_url': 'https://api.github.com/users/z-a-f/subscriptions', 'organizations_url': 'https://api.github.com/users/z-a-f/orgs', 'repos_url': 'https://api.github.com/users/z-a-f/repos', 'events_url': 'https://api.github.com/users/z-a-f/events{/privacy}', 'received_events_url': 'https://api.github.com/users/z-a-f/received_events', 'type': 'User', 'site_admin': False}",referenced,1e9c36ed938d41b7e5f9bb24ed798b5b8d2da403,https://api.github.com/repos/pytorch/pytorch/commits/1e9c36ed938d41b7e5f9bb24ed798b5b8d2da403,2019-10-17T01:46:49Z,20,18,2
28015,2722779391,"{'login': 'facebook-github-bot', 'id': 6422482, 'node_id': 'MDQ6VXNlcjY0MjI0ODI=', 'avatar_url': 'https://avatars3.githubusercontent.com/u/6422482?v=4', 'gravatar_id': '', 'url': 'https://api.github.com/users/facebook-github-bot', 'html_url': 'https://github.com/facebook-github-bot', 'followers_url': 'https://api.github.com/users/facebook-github-bot/followers', 'following_url': 'https://api.github.com/users/facebook-github-bot/following{/other_user}', 'gists_url': 'https://api.github.com/users/facebook-github-bot/gists{/gist_id}', 'starred_url': 'https://api.github.com/users/facebook-github-bot/starred{/owner}{/repo}', 'subscriptions_url': 'https://api.github.com/users/facebook-github-bot/subscriptions', 'organizations_url': 'https://api.github.com/users/facebook-github-bot/orgs', 'repos_url': 'https://api.github.com/users/facebook-github-bot/repos', 'events_url': 'https://api.github.com/users/facebook-github-bot/events{/privacy}', 'received_events_url': 'https://api.github.com/users/facebook-github-bot/received_events', 'type': 'User', 'site_admin': False}",closed,07b5666a87078de0fda8d25b1f0757a5acb3661d,https://api.github.com/repos/pytorch/pytorch/commits/07b5666a87078de0fda8d25b1f0757a5acb3661d,2019-10-17T21:12:06Z,18,17,1
28010,2722101965,"{'login': 'nairbv', 'id': 582713, 'node_id': 'MDQ6VXNlcjU4MjcxMw==', 'avatar_url': 'https://avatars1.githubusercontent.com/u/582713?v=4', 'gravatar_id': '', 'url': 'https://api.github.com/users/nairbv', 'html_url': 'https://github.com/nairbv', 'followers_url': 'https://api.github.com/users/nairbv/followers', 'following_url': 'https://api.github.com/users/nairbv/following{/other_user}', 'gists_url': 'https://api.github.com/users/nairbv/gists{/gist_id}', 'starred_url': 'https://api.github.com/users/nairbv/starred{/owner}{/repo}', 'subscriptions_url': 'https://api.github.com/users/nairbv/subscriptions', 'organizations_url': 'https://api.github.com/users/nairbv/orgs', 'repos_url': 'https://api.github.com/users/nairbv/repos', 'events_url': 'https://api.github.com/users/nairbv/events{/privacy}', 'received_events_url': 'https://api.github.com/users/nairbv/received_events', 'type': 'User', 'site_admin': False}",referenced,6d31f3abcb032a82d924bf46f346e70b51c96a5e,https://api.github.com/repos/pytorch/pytorch/commits/6d31f3abcb032a82d924bf46f346e70b51c96a5e,2019-10-17T17:15:26Z,5,1,4
28010,2722138568,"{'login': 'nairbv', 'id': 582713, 'node_id': 'MDQ6VXNlcjU4MjcxMw==', 'avatar_url': 'https://avatars1.githubusercontent.com/u/582713?v=4', 'gravatar_id': '', 'url': 'https://api.github.com/users/nairbv', 'html_url': 'https://github.com/nairbv', 'followers_url': 'https://api.github.com/users/nairbv/followers', 'following_url': 'https://api.github.com/users/nairbv/following{/other_user}', 'gists_url': 'https://api.github.com/users/nairbv/gists{/gist_id}', 'starred_url': 'https://api.github.com/users/nairbv/starred{/owner}{/repo}', 'subscriptions_url': 'https://api.github.com/users/nairbv/subscriptions', 'organizations_url': 'https://api.github.com/users/nairbv/orgs', 'repos_url': 'https://api.github.com/users/nairbv/repos', 'events_url': 'https://api.github.com/users/nairbv/events{/privacy}', 'received_events_url': 'https://api.github.com/users/nairbv/received_events', 'type': 'User', 'site_admin': False}",referenced,871ce92d112ce8f3aad222f36ef4694716fbbfa0,https://api.github.com/repos/pytorch/pytorch/commits/871ce92d112ce8f3aad222f36ef4694716fbbfa0,2019-10-17T17:27:48Z,10,5,5
28010,2722544887,"{'login': 'nairbv', 'id': 582713, 'node_id': 'MDQ6VXNlcjU4MjcxMw==', 'avatar_url': 'https://avatars1.githubusercontent.com/u/582713?v=4', 'gravatar_id': '', 'url': 'https://api.github.com/users/nairbv', 'html_url': 'https://github.com/nairbv', 'followers_url': 'https://api.github.com/users/nairbv/followers', 'following_url': 'https://api.github.com/users/nairbv/following{/other_user}', 'gists_url': 'https://api.github.com/users/nairbv/gists{/gist_id}', 'starred_url': 'https://api.github.com/users/nairbv/starred{/owner}{/repo}', 'subscriptions_url': 'https://api.github.com/users/nairbv/subscriptions', 'organizations_url': 'https://api.github.com/users/nairbv/orgs', 'repos_url': 'https://api.github.com/users/nairbv/repos', 'events_url': 'https://api.github.com/users/nairbv/events{/privacy}', 'received_events_url': 'https://api.github.com/users/nairbv/received_events', 'type': 'User', 'site_admin': False}",referenced,69ba5c37425c85d08e87d0fe64d3f884f0bb254e,https://api.github.com/repos/pytorch/pytorch/commits/69ba5c37425c85d08e87d0fe64d3f884f0bb254e,2019-10-17T19:48:28Z,10367,6254,4113
28010,2722650672,"{'login': 'nairbv', 'id': 582713, 'node_id': 'MDQ6VXNlcjU4MjcxMw==', 'avatar_url': 'https://avatars1.githubusercontent.com/u/582713?v=4', 'gravatar_id': '', 'url': 'https://api.github.com/users/nairbv', 'html_url': 'https://github.com/nairbv', 'followers_url': 'https://api.github.com/users/nairbv/followers', 'following_url': 'https://api.github.com/users/nairbv/following{/other_user}', 'gists_url': 'https://api.github.com/users/nairbv/gists{/gist_id}', 'starred_url': 'https://api.github.com/users/nairbv/starred{/owner}{/repo}', 'subscriptions_url': 'https://api.github.com/users/nairbv/subscriptions', 'organizations_url': 'https://api.github.com/users/nairbv/orgs', 'repos_url': 'https://api.github.com/users/nairbv/repos', 'events_url': 'https://api.github.com/users/nairbv/events{/privacy}', 'received_events_url': 'https://api.github.com/users/nairbv/received_events', 'type': 'User', 'site_admin': False}",referenced,9e1bcd8cd8d545458c5a50ab395d1a4caefbb393,https://api.github.com/repos/pytorch/pytorch/commits/9e1bcd8cd8d545458c5a50ab395d1a4caefbb393,2019-10-17T20:24:44Z,2,1,1
28010,2731222540,"{'login': 'nairbv', 'id': 582713, 'node_id': 'MDQ6VXNlcjU4MjcxMw==', 'avatar_url': 'https://avatars1.githubusercontent.com/u/582713?v=4', 'gravatar_id': '', 'url': 'https://api.github.com/users/nairbv', 'html_url': 'https://github.com/nairbv', 'followers_url': 'https://api.github.com/users/nairbv/followers', 'following_url': 'https://api.github.com/users/nairbv/following{/other_user}', 'gists_url': 'https://api.github.com/users/nairbv/gists{/gist_id}', 'starred_url': 'https://api.github.com/users/nairbv/starred{/owner}{/repo}', 'subscriptions_url': 'https://api.github.com/users/nairbv/subscriptions', 'organizations_url': 'https://api.github.com/users/nairbv/orgs', 'repos_url': 'https://api.github.com/users/nairbv/repos', 'events_url': 'https://api.github.com/users/nairbv/events{/privacy}', 'received_events_url': 'https://api.github.com/users/nairbv/received_events', 'type': 'User', 'site_admin': False}",referenced,a8d7633eb71f87b42d39327484f52508dd487f1f,https://api.github.com/repos/pytorch/pytorch/commits/a8d7633eb71f87b42d39327484f52508dd487f1f,2019-10-21T20:51:10Z,424,379,45
28010,2731250694,"{'login': 'nairbv', 'id': 582713, 'node_id': 'MDQ6VXNlcjU4MjcxMw==', 'avatar_url': 'https://avatars1.githubusercontent.com/u/582713?v=4', 'gravatar_id': '', 'url': 'https://api.github.com/users/nairbv', 'html_url': 'https://github.com/nairbv', 'followers_url': 'https://api.github.com/users/nairbv/followers', 'following_url': 'https://api.github.com/users/nairbv/following{/other_user}', 'gists_url': 'https://api.github.com/users/nairbv/gists{/gist_id}', 'starred_url': 'https://api.github.com/users/nairbv/starred{/owner}{/repo}', 'subscriptions_url': 'https://api.github.com/users/nairbv/subscriptions', 'organizations_url': 'https://api.github.com/users/nairbv/orgs', 'repos_url': 'https://api.github.com/users/nairbv/repos', 'events_url': 'https://api.github.com/users/nairbv/events{/privacy}', 'received_events_url': 'https://api.github.com/users/nairbv/received_events', 'type': 'User', 'site_admin': False}",referenced,36e98748caed17689a48dc1979bbfb070fcd012e,https://api.github.com/repos/pytorch/pytorch/commits/36e98748caed17689a48dc1979bbfb070fcd012e,2019-10-21T21:00:38Z,4923,3569,1354
28010,2731499883,"{'login': 'nairbv', 'id': 582713, 'node_id': 'MDQ6VXNlcjU4MjcxMw==', 'avatar_url': 'https://avatars1.githubusercontent.com/u/582713?v=4', 'gravatar_id': '', 'url': 'https://api.github.com/users/nairbv', 'html_url': 'https://github.com/nairbv', 'followers_url': 'https://api.github.com/users/nairbv/followers', 'following_url': 'https://api.github.com/users/nairbv/following{/other_user}', 'gists_url': 'https://api.github.com/users/nairbv/gists{/gist_id}', 'starred_url': 'https://api.github.com/users/nairbv/starred{/owner}{/repo}', 'subscriptions_url': 'https://api.github.com/users/nairbv/subscriptions', 'organizations_url': 'https://api.github.com/users/nairbv/orgs', 'repos_url': 'https://api.github.com/users/nairbv/repos', 'events_url': 'https://api.github.com/users/nairbv/events{/privacy}', 'received_events_url': 'https://api.github.com/users/nairbv/received_events', 'type': 'User', 'site_admin': False}",referenced,fea11844486be6c3167fb1d5366fa0f62d07ac81,https://api.github.com/repos/pytorch/pytorch/commits/fea11844486be6c3167fb1d5366fa0f62d07ac81,2019-10-21T22:45:49Z,176,154,22
28010,2734200327,"{'login': 'facebook-github-bot', 'id': 6422482, 'node_id': 'MDQ6VXNlcjY0MjI0ODI=', 'avatar_url': 'https://avatars3.githubusercontent.com/u/6422482?v=4', 'gravatar_id': '', 'url': 'https://api.github.com/users/facebook-github-bot', 'html_url': 'https://github.com/facebook-github-bot', 'followers_url': 'https://api.github.com/users/facebook-github-bot/followers', 'following_url': 'https://api.github.com/users/facebook-github-bot/following{/other_user}', 'gists_url': 'https://api.github.com/users/facebook-github-bot/gists{/gist_id}', 'starred_url': 'https://api.github.com/users/facebook-github-bot/starred{/owner}{/repo}', 'subscriptions_url': 'https://api.github.com/users/facebook-github-bot/subscriptions', 'organizations_url': 'https://api.github.com/users/facebook-github-bot/orgs', 'repos_url': 'https://api.github.com/users/facebook-github-bot/repos', 'events_url': 'https://api.github.com/users/facebook-github-bot/events{/privacy}', 'received_events_url': 'https://api.github.com/users/facebook-github-bot/received_events', 'type': 'User', 'site_admin': False}",closed,3fce612cb12c455d69803466cd18bd09a2e4613d,https://api.github.com/repos/pytorch/pytorch/commits/3fce612cb12c455d69803466cd18bd09a2e4613d,2019-10-22T17:38:42Z,92,61,31
28010,2762104976,"{'login': 'soumith', 'id': 1310570, 'node_id': 'MDQ6VXNlcjEzMTA1NzA=', 'avatar_url': 'https://avatars0.githubusercontent.com/u/1310570?v=4', 'gravatar_id': '', 'url': 'https://api.github.com/users/soumith', 'html_url': 'https://github.com/soumith', 'followers_url': 'https://api.github.com/users/soumith/followers', 'following_url': 'https://api.github.com/users/soumith/following{/other_user}', 'gists_url': 'https://api.github.com/users/soumith/gists{/gist_id}', 'starred_url': 'https://api.github.com/users/soumith/starred{/owner}{/repo}', 'subscriptions_url': 'https://api.github.com/users/soumith/subscriptions', 'organizations_url': 'https://api.github.com/users/soumith/orgs', 'repos_url': 'https://api.github.com/users/soumith/repos', 'events_url': 'https://api.github.com/users/soumith/events{/privacy}', 'received_events_url': 'https://api.github.com/users/soumith/received_events', 'type': 'User', 'site_admin': False}",referenced,cc98c93bf358ea155651853c8f7ad626770c8a3c,https://api.github.com/repos/pytorch/pytorch/commits/cc98c93bf358ea155651853c8f7ad626770c8a3c,2019-11-01T03:56:20Z,117,77,40
28009,2718409663,"{'login': 'facebook-github-bot', 'id': 6422482, 'node_id': 'MDQ6VXNlcjY0MjI0ODI=', 'avatar_url': 'https://avatars3.githubusercontent.com/u/6422482?v=4', 'gravatar_id': '', 'url': 'https://api.github.com/users/facebook-github-bot', 'html_url': 'https://github.com/facebook-github-bot', 'followers_url': 'https://api.github.com/users/facebook-github-bot/followers', 'following_url': 'https://api.github.com/users/facebook-github-bot/following{/other_user}', 'gists_url': 'https://api.github.com/users/facebook-github-bot/gists{/gist_id}', 'starred_url': 'https://api.github.com/users/facebook-github-bot/starred{/owner}{/repo}', 'subscriptions_url': 'https://api.github.com/users/facebook-github-bot/subscriptions', 'organizations_url': 'https://api.github.com/users/facebook-github-bot/orgs', 'repos_url': 'https://api.github.com/users/facebook-github-bot/repos', 'events_url': 'https://api.github.com/users/facebook-github-bot/events{/privacy}', 'received_events_url': 'https://api.github.com/users/facebook-github-bot/received_events', 'type': 'User', 'site_admin': False}",closed,2d2fe14a60d5deae092d4605caeba698c73245d7,https://api.github.com/repos/pytorch/pytorch/commits/2d2fe14a60d5deae092d4605caeba698c73245d7,2019-10-16T17:02:31Z,18,10,8
27963,2790003830,"{'login': 'jamesr66a', 'id': 4685384, 'node_id': 'MDQ6VXNlcjQ2ODUzODQ=', 'avatar_url': 'https://avatars2.githubusercontent.com/u/4685384?v=4', 'gravatar_id': '', 'url': 'https://api.github.com/users/jamesr66a', 'html_url': 'https://github.com/jamesr66a', 'followers_url': 'https://api.github.com/users/jamesr66a/followers', 'following_url': 'https://api.github.com/users/jamesr66a/following{/other_user}', 'gists_url': 'https://api.github.com/users/jamesr66a/gists{/gist_id}', 'starred_url': 'https://api.github.com/users/jamesr66a/starred{/owner}{/repo}', 'subscriptions_url': 'https://api.github.com/users/jamesr66a/subscriptions', 'organizations_url': 'https://api.github.com/users/jamesr66a/orgs', 'repos_url': 'https://api.github.com/users/jamesr66a/repos', 'events_url': 'https://api.github.com/users/jamesr66a/events{/privacy}', 'received_events_url': 'https://api.github.com/users/jamesr66a/received_events', 'type': 'User', 'site_admin': False}",referenced,bf953d54aaa5139f0976cecb8eb0779b64d2c24c,https://api.github.com/repos/pytorch/pytorch/commits/bf953d54aaa5139f0976cecb8eb0779b64d2c24c,2019-11-12T03:16:07Z,8,1,7
27963,2792495647,"{'login': 'jamesr66a', 'id': 4685384, 'node_id': 'MDQ6VXNlcjQ2ODUzODQ=', 'avatar_url': 'https://avatars2.githubusercontent.com/u/4685384?v=4', 'gravatar_id': '', 'url': 'https://api.github.com/users/jamesr66a', 'html_url': 'https://github.com/jamesr66a', 'followers_url': 'https://api.github.com/users/jamesr66a/followers', 'following_url': 'https://api.github.com/users/jamesr66a/following{/other_user}', 'gists_url': 'https://api.github.com/users/jamesr66a/gists{/gist_id}', 'starred_url': 'https://api.github.com/users/jamesr66a/starred{/owner}{/repo}', 'subscriptions_url': 'https://api.github.com/users/jamesr66a/subscriptions', 'organizations_url': 'https://api.github.com/users/jamesr66a/orgs', 'repos_url': 'https://api.github.com/users/jamesr66a/repos', 'events_url': 'https://api.github.com/users/jamesr66a/events{/privacy}', 'received_events_url': 'https://api.github.com/users/jamesr66a/received_events', 'type': 'User', 'site_admin': False}",referenced,b54e5fb7804a7d344ab466741ae3ac369dda6f36,https://api.github.com/repos/pytorch/pytorch/commits/b54e5fb7804a7d344ab466741ae3ac369dda6f36,2019-11-12T18:15:21Z,4734,2615,2119
27963,2793543299,"{'login': 'jamesr66a', 'id': 4685384, 'node_id': 'MDQ6VXNlcjQ2ODUzODQ=', 'avatar_url': 'https://avatars2.githubusercontent.com/u/4685384?v=4', 'gravatar_id': '', 'url': 'https://api.github.com/users/jamesr66a', 'html_url': 'https://github.com/jamesr66a', 'followers_url': 'https://api.github.com/users/jamesr66a/followers', 'following_url': 'https://api.github.com/users/jamesr66a/following{/other_user}', 'gists_url': 'https://api.github.com/users/jamesr66a/gists{/gist_id}', 'starred_url': 'https://api.github.com/users/jamesr66a/starred{/owner}{/repo}', 'subscriptions_url': 'https://api.github.com/users/jamesr66a/subscriptions', 'organizations_url': 'https://api.github.com/users/jamesr66a/orgs', 'repos_url': 'https://api.github.com/users/jamesr66a/repos', 'events_url': 'https://api.github.com/users/jamesr66a/events{/privacy}', 'received_events_url': 'https://api.github.com/users/jamesr66a/received_events', 'type': 'User', 'site_admin': False}",referenced,3387a14f5dfab5af4168c5ef4024e498c3923913,https://api.github.com/repos/pytorch/pytorch/commits/3387a14f5dfab5af4168c5ef4024e498c3923913,2019-11-13T01:02:24Z,3439,2125,1314
27963,2797447452,"{'login': 'jianyuh', 'id': 2187690, 'node_id': 'MDQ6VXNlcjIxODc2OTA=', 'avatar_url': 'https://avatars3.githubusercontent.com/u/2187690?v=4', 'gravatar_id': '', 'url': 'https://api.github.com/users/jianyuh', 'html_url': 'https://github.com/jianyuh', 'followers_url': 'https://api.github.com/users/jianyuh/followers', 'following_url': 'https://api.github.com/users/jianyuh/following{/other_user}', 'gists_url': 'https://api.github.com/users/jianyuh/gists{/gist_id}', 'starred_url': 'https://api.github.com/users/jianyuh/starred{/owner}{/repo}', 'subscriptions_url': 'https://api.github.com/users/jianyuh/subscriptions', 'organizations_url': 'https://api.github.com/users/jianyuh/orgs', 'repos_url': 'https://api.github.com/users/jianyuh/repos', 'events_url': 'https://api.github.com/users/jianyuh/events{/privacy}', 'received_events_url': 'https://api.github.com/users/jianyuh/received_events', 'type': 'User', 'site_admin': False}",referenced,30cdfc013a4baec48b9f8eb92d0be5cd6eec4d23,https://api.github.com/repos/pytorch/pytorch/commits/30cdfc013a4baec48b9f8eb92d0be5cd6eec4d23,2019-11-14T01:54:39Z,13,9,4
27963,2797448027,"{'login': 'jianyuh', 'id': 2187690, 'node_id': 'MDQ6VXNlcjIxODc2OTA=', 'avatar_url': 'https://avatars3.githubusercontent.com/u/2187690?v=4', 'gravatar_id': '', 'url': 'https://api.github.com/users/jianyuh', 'html_url': 'https://github.com/jianyuh', 'followers_url': 'https://api.github.com/users/jianyuh/followers', 'following_url': 'https://api.github.com/users/jianyuh/following{/other_user}', 'gists_url': 'https://api.github.com/users/jianyuh/gists{/gist_id}', 'starred_url': 'https://api.github.com/users/jianyuh/starred{/owner}{/repo}', 'subscriptions_url': 'https://api.github.com/users/jianyuh/subscriptions', 'organizations_url': 'https://api.github.com/users/jianyuh/orgs', 'repos_url': 'https://api.github.com/users/jianyuh/repos', 'events_url': 'https://api.github.com/users/jianyuh/events{/privacy}', 'received_events_url': 'https://api.github.com/users/jianyuh/received_events', 'type': 'User', 'site_admin': False}",referenced,b37fbd2d190a96c9d166498234c1f5a82b6e0b00,https://api.github.com/repos/pytorch/pytorch/commits/b37fbd2d190a96c9d166498234c1f5a82b6e0b00,2019-11-14T01:55:00Z,13,9,4
27954,2777415150,"{'login': 'facebook-github-bot', 'id': 6422482, 'node_id': 'MDQ6VXNlcjY0MjI0ODI=', 'avatar_url': 'https://avatars3.githubusercontent.com/u/6422482?v=4', 'gravatar_id': '', 'url': 'https://api.github.com/users/facebook-github-bot', 'html_url': 'https://github.com/facebook-github-bot', 'followers_url': 'https://api.github.com/users/facebook-github-bot/followers', 'following_url': 'https://api.github.com/users/facebook-github-bot/following{/other_user}', 'gists_url': 'https://api.github.com/users/facebook-github-bot/gists{/gist_id}', 'starred_url': 'https://api.github.com/users/facebook-github-bot/starred{/owner}{/repo}', 'subscriptions_url': 'https://api.github.com/users/facebook-github-bot/subscriptions', 'organizations_url': 'https://api.github.com/users/facebook-github-bot/orgs', 'repos_url': 'https://api.github.com/users/facebook-github-bot/repos', 'events_url': 'https://api.github.com/users/facebook-github-bot/events{/privacy}', 'received_events_url': 'https://api.github.com/users/facebook-github-bot/received_events', 'type': 'User', 'site_admin': False}",closed,f17e02fd947511f50e22542f8e2bc6df706954d1,https://api.github.com/repos/pytorch/pytorch/commits/f17e02fd947511f50e22542f8e2bc6df706954d1,2019-11-07T01:02:25Z,99,52,47
27954,2780388056,"{'login': 'jamesr66a', 'id': 4685384, 'node_id': 'MDQ6VXNlcjQ2ODUzODQ=', 'avatar_url': 'https://avatars2.githubusercontent.com/u/4685384?v=4', 'gravatar_id': '', 'url': 'https://api.github.com/users/jamesr66a', 'html_url': 'https://github.com/jamesr66a', 'followers_url': 'https://api.github.com/users/jamesr66a/followers', 'following_url': 'https://api.github.com/users/jamesr66a/following{/other_user}', 'gists_url': 'https://api.github.com/users/jamesr66a/gists{/gist_id}', 'starred_url': 'https://api.github.com/users/jamesr66a/starred{/owner}{/repo}', 'subscriptions_url': 'https://api.github.com/users/jamesr66a/subscriptions', 'organizations_url': 'https://api.github.com/users/jamesr66a/orgs', 'repos_url': 'https://api.github.com/users/jamesr66a/repos', 'events_url': 'https://api.github.com/users/jamesr66a/events{/privacy}', 'received_events_url': 'https://api.github.com/users/jamesr66a/received_events', 'type': 'User', 'site_admin': False}",referenced,846ae58bf0e3298415039f05e9fa49f62ef8ec66,https://api.github.com/repos/pytorch/pytorch/commits/846ae58bf0e3298415039f05e9fa49f62ef8ec66,2019-11-07T18:29:28Z,6,6,0
27954,2780960013,"{'login': 'facebook-github-bot', 'id': 6422482, 'node_id': 'MDQ6VXNlcjY0MjI0ODI=', 'avatar_url': 'https://avatars3.githubusercontent.com/u/6422482?v=4', 'gravatar_id': '', 'url': 'https://api.github.com/users/facebook-github-bot', 'html_url': 'https://github.com/facebook-github-bot', 'followers_url': 'https://api.github.com/users/facebook-github-bot/followers', 'following_url': 'https://api.github.com/users/facebook-github-bot/following{/other_user}', 'gists_url': 'https://api.github.com/users/facebook-github-bot/gists{/gist_id}', 'starred_url': 'https://api.github.com/users/facebook-github-bot/starred{/owner}{/repo}', 'subscriptions_url': 'https://api.github.com/users/facebook-github-bot/subscriptions', 'organizations_url': 'https://api.github.com/users/facebook-github-bot/orgs', 'repos_url': 'https://api.github.com/users/facebook-github-bot/repos', 'events_url': 'https://api.github.com/users/facebook-github-bot/events{/privacy}', 'received_events_url': 'https://api.github.com/users/facebook-github-bot/received_events', 'type': 'User', 'site_admin': False}",referenced,821f8bfc2fe9b57712a40723ae4983712f568fc7,https://api.github.com/repos/pytorch/pytorch/commits/821f8bfc2fe9b57712a40723ae4983712f568fc7,2019-11-07T21:45:50Z,105,58,47
27938,2825470378,"{'login': 'facebook-github-bot', 'id': 6422482, 'node_id': 'MDQ6VXNlcjY0MjI0ODI=', 'avatar_url': 'https://avatars3.githubusercontent.com/u/6422482?v=4', 'gravatar_id': '', 'url': 'https://api.github.com/users/facebook-github-bot', 'html_url': 'https://github.com/facebook-github-bot', 'followers_url': 'https://api.github.com/users/facebook-github-bot/followers', 'following_url': 'https://api.github.com/users/facebook-github-bot/following{/other_user}', 'gists_url': 'https://api.github.com/users/facebook-github-bot/gists{/gist_id}', 'starred_url': 'https://api.github.com/users/facebook-github-bot/starred{/owner}{/repo}', 'subscriptions_url': 'https://api.github.com/users/facebook-github-bot/subscriptions', 'organizations_url': 'https://api.github.com/users/facebook-github-bot/orgs', 'repos_url': 'https://api.github.com/users/facebook-github-bot/repos', 'events_url': 'https://api.github.com/users/facebook-github-bot/events{/privacy}', 'received_events_url': 'https://api.github.com/users/facebook-github-bot/received_events', 'type': 'User', 'site_admin': False}",referenced,7c4b9042ababa32dcd49e8d35114c81c53027431,https://api.github.com/repos/pytorch/pytorch/commits/7c4b9042ababa32dcd49e8d35114c81c53027431,2019-11-23T17:29:43Z,79,67,12
27938,2899122620,"{'login': 'mingbowan', 'id': 2181364, 'node_id': 'MDQ6VXNlcjIxODEzNjQ=', 'avatar_url': 'https://avatars2.githubusercontent.com/u/2181364?v=4', 'gravatar_id': '', 'url': 'https://api.github.com/users/mingbowan', 'html_url': 'https://github.com/mingbowan', 'followers_url': 'https://api.github.com/users/mingbowan/followers', 'following_url': 'https://api.github.com/users/mingbowan/following{/other_user}', 'gists_url': 'https://api.github.com/users/mingbowan/gists{/gist_id}', 'starred_url': 'https://api.github.com/users/mingbowan/starred{/owner}{/repo}', 'subscriptions_url': 'https://api.github.com/users/mingbowan/subscriptions', 'organizations_url': 'https://api.github.com/users/mingbowan/orgs', 'repos_url': 'https://api.github.com/users/mingbowan/repos', 'events_url': 'https://api.github.com/users/mingbowan/events{/privacy}', 'received_events_url': 'https://api.github.com/users/mingbowan/received_events', 'type': 'User', 'site_admin': False}",referenced,9e7dc37f902af78b26739410766e79e63f53e27f,https://api.github.com/repos/pytorch/pytorch/commits/9e7dc37f902af78b26739410766e79e63f53e27f,2019-12-20T00:01:12Z,79,67,12
27875,2780946729,"{'login': 'ezyang', 'id': 13564, 'node_id': 'MDQ6VXNlcjEzNTY0', 'avatar_url': 'https://avatars0.githubusercontent.com/u/13564?v=4', 'gravatar_id': '', 'url': 'https://api.github.com/users/ezyang', 'html_url': 'https://github.com/ezyang', 'followers_url': 'https://api.github.com/users/ezyang/followers', 'following_url': 'https://api.github.com/users/ezyang/following{/other_user}', 'gists_url': 'https://api.github.com/users/ezyang/gists{/gist_id}', 'starred_url': 'https://api.github.com/users/ezyang/starred{/owner}{/repo}', 'subscriptions_url': 'https://api.github.com/users/ezyang/subscriptions', 'organizations_url': 'https://api.github.com/users/ezyang/orgs', 'repos_url': 'https://api.github.com/users/ezyang/repos', 'events_url': 'https://api.github.com/users/ezyang/events{/privacy}', 'received_events_url': 'https://api.github.com/users/ezyang/received_events', 'type': 'User', 'site_admin': False}",referenced,d39b893098f1dfcb45d6bd52481ef50fc1131481,https://api.github.com/repos/pytorch/pytorch/commits/d39b893098f1dfcb45d6bd52481ef50fc1131481,2019-11-07T21:41:11Z,9,8,1
27875,2780947277,"{'login': 'ezyang', 'id': 13564, 'node_id': 'MDQ6VXNlcjEzNTY0', 'avatar_url': 'https://avatars0.githubusercontent.com/u/13564?v=4', 'gravatar_id': '', 'url': 'https://api.github.com/users/ezyang', 'html_url': 'https://github.com/ezyang', 'followers_url': 'https://api.github.com/users/ezyang/followers', 'following_url': 'https://api.github.com/users/ezyang/following{/other_user}', 'gists_url': 'https://api.github.com/users/ezyang/gists{/gist_id}', 'starred_url': 'https://api.github.com/users/ezyang/starred{/owner}{/repo}', 'subscriptions_url': 'https://api.github.com/users/ezyang/subscriptions', 'organizations_url': 'https://api.github.com/users/ezyang/orgs', 'repos_url': 'https://api.github.com/users/ezyang/repos', 'events_url': 'https://api.github.com/users/ezyang/events{/privacy}', 'received_events_url': 'https://api.github.com/users/ezyang/received_events', 'type': 'User', 'site_admin': False}",referenced,1793f513e0e4dfc67290f697a0f25deb07be02a4,https://api.github.com/repos/pytorch/pytorch/commits/1793f513e0e4dfc67290f697a0f25deb07be02a4,2019-11-07T21:41:21Z,9,8,1
27875,2788479024,"{'login': 'facebook-github-bot', 'id': 6422482, 'node_id': 'MDQ6VXNlcjY0MjI0ODI=', 'avatar_url': 'https://avatars3.githubusercontent.com/u/6422482?v=4', 'gravatar_id': '', 'url': 'https://api.github.com/users/facebook-github-bot', 'html_url': 'https://github.com/facebook-github-bot', 'followers_url': 'https://api.github.com/users/facebook-github-bot/followers', 'following_url': 'https://api.github.com/users/facebook-github-bot/following{/other_user}', 'gists_url': 'https://api.github.com/users/facebook-github-bot/gists{/gist_id}', 'starred_url': 'https://api.github.com/users/facebook-github-bot/starred{/owner}{/repo}', 'subscriptions_url': 'https://api.github.com/users/facebook-github-bot/subscriptions', 'organizations_url': 'https://api.github.com/users/facebook-github-bot/orgs', 'repos_url': 'https://api.github.com/users/facebook-github-bot/repos', 'events_url': 'https://api.github.com/users/facebook-github-bot/events{/privacy}', 'received_events_url': 'https://api.github.com/users/facebook-github-bot/received_events', 'type': 'User', 'site_admin': False}",closed,b141754b7fa1f048fb27dfbd5cb3491419156273,https://api.github.com/repos/pytorch/pytorch/commits/b141754b7fa1f048fb27dfbd5cb3491419156273,2019-11-11T16:11:09Z,9,8,1
27874,2734925789,"{'login': 'vincentqb', 'id': 3047868, 'node_id': 'MDQ6VXNlcjMwNDc4Njg=', 'avatar_url': 'https://avatars0.githubusercontent.com/u/3047868?v=4', 'gravatar_id': '', 'url': 'https://api.github.com/users/vincentqb', 'html_url': 'https://github.com/vincentqb', 'followers_url': 'https://api.github.com/users/vincentqb/followers', 'following_url': 'https://api.github.com/users/vincentqb/following{/other_user}', 'gists_url': 'https://api.github.com/users/vincentqb/gists{/gist_id}', 'starred_url': 'https://api.github.com/users/vincentqb/starred{/owner}{/repo}', 'subscriptions_url': 'https://api.github.com/users/vincentqb/subscriptions', 'organizations_url': 'https://api.github.com/users/vincentqb/orgs', 'repos_url': 'https://api.github.com/users/vincentqb/repos', 'events_url': 'https://api.github.com/users/vincentqb/events{/privacy}', 'received_events_url': 'https://api.github.com/users/vincentqb/received_events', 'type': 'User', 'site_admin': False}",referenced,2265d993ccbd1b485c940897be4fe7bcbefdb2a7,https://api.github.com/repos/pytorch/pytorch/commits/2265d993ccbd1b485c940897be4fe7bcbefdb2a7,2019-10-22T21:42:42Z,14,7,7
27874,2734926187,"{'login': 'vincentqb', 'id': 3047868, 'node_id': 'MDQ6VXNlcjMwNDc4Njg=', 'avatar_url': 'https://avatars0.githubusercontent.com/u/3047868?v=4', 'gravatar_id': '', 'url': 'https://api.github.com/users/vincentqb', 'html_url': 'https://github.com/vincentqb', 'followers_url': 'https://api.github.com/users/vincentqb/followers', 'following_url': 'https://api.github.com/users/vincentqb/following{/other_user}', 'gists_url': 'https://api.github.com/users/vincentqb/gists{/gist_id}', 'starred_url': 'https://api.github.com/users/vincentqb/starred{/owner}{/repo}', 'subscriptions_url': 'https://api.github.com/users/vincentqb/subscriptions', 'organizations_url': 'https://api.github.com/users/vincentqb/orgs', 'repos_url': 'https://api.github.com/users/vincentqb/repos', 'events_url': 'https://api.github.com/users/vincentqb/events{/privacy}', 'received_events_url': 'https://api.github.com/users/vincentqb/received_events', 'type': 'User', 'site_admin': False}",referenced,2319c729c8d98ef1d68faf7e288b6dad475175e1,https://api.github.com/repos/pytorch/pytorch/commits/2319c729c8d98ef1d68faf7e288b6dad475175e1,2019-10-22T21:42:50Z,14,7,7
27874,2738065469,"{'login': 'facebook-github-bot', 'id': 6422482, 'node_id': 'MDQ6VXNlcjY0MjI0ODI=', 'avatar_url': 'https://avatars3.githubusercontent.com/u/6422482?v=4', 'gravatar_id': '', 'url': 'https://api.github.com/users/facebook-github-bot', 'html_url': 'https://github.com/facebook-github-bot', 'followers_url': 'https://api.github.com/users/facebook-github-bot/followers', 'following_url': 'https://api.github.com/users/facebook-github-bot/following{/other_user}', 'gists_url': 'https://api.github.com/users/facebook-github-bot/gists{/gist_id}', 'starred_url': 'https://api.github.com/users/facebook-github-bot/starred{/owner}{/repo}', 'subscriptions_url': 'https://api.github.com/users/facebook-github-bot/subscriptions', 'organizations_url': 'https://api.github.com/users/facebook-github-bot/orgs', 'repos_url': 'https://api.github.com/users/facebook-github-bot/repos', 'events_url': 'https://api.github.com/users/facebook-github-bot/events{/privacy}', 'received_events_url': 'https://api.github.com/users/facebook-github-bot/received_events', 'type': 'User', 'site_admin': False}",closed,d1d2358d3131087cba1593569d30496d7c86817c,https://api.github.com/repos/pytorch/pytorch/commits/d1d2358d3131087cba1593569d30496d7c86817c,2019-10-23T18:11:36Z,14,7,7
27849,2731219852,"{'login': 'z-a-f', 'id': 4216323, 'node_id': 'MDQ6VXNlcjQyMTYzMjM=', 'avatar_url': 'https://avatars2.githubusercontent.com/u/4216323?v=4', 'gravatar_id': '', 'url': 'https://api.github.com/users/z-a-f', 'html_url': 'https://github.com/z-a-f', 'followers_url': 'https://api.github.com/users/z-a-f/followers', 'following_url': 'https://api.github.com/users/z-a-f/following{/other_user}', 'gists_url': 'https://api.github.com/users/z-a-f/gists{/gist_id}', 'starred_url': 'https://api.github.com/users/z-a-f/starred{/owner}{/repo}', 'subscriptions_url': 'https://api.github.com/users/z-a-f/subscriptions', 'organizations_url': 'https://api.github.com/users/z-a-f/orgs', 'repos_url': 'https://api.github.com/users/z-a-f/repos', 'events_url': 'https://api.github.com/users/z-a-f/events{/privacy}', 'received_events_url': 'https://api.github.com/users/z-a-f/received_events', 'type': 'User', 'site_admin': False}",referenced,dc2cc44a4ee2abb7c34b0ebdfedf07bc55d8617a,https://api.github.com/repos/pytorch/pytorch/commits/dc2cc44a4ee2abb7c34b0ebdfedf07bc55d8617a,2019-10-21T20:50:17Z,15173,9855,5318
27844,2725628599,"{'login': 'facebook-github-bot', 'id': 6422482, 'node_id': 'MDQ6VXNlcjY0MjI0ODI=', 'avatar_url': 'https://avatars3.githubusercontent.com/u/6422482?v=4', 'gravatar_id': '', 'url': 'https://api.github.com/users/facebook-github-bot', 'html_url': 'https://github.com/facebook-github-bot', 'followers_url': 'https://api.github.com/users/facebook-github-bot/followers', 'following_url': 'https://api.github.com/users/facebook-github-bot/following{/other_user}', 'gists_url': 'https://api.github.com/users/facebook-github-bot/gists{/gist_id}', 'starred_url': 'https://api.github.com/users/facebook-github-bot/starred{/owner}{/repo}', 'subscriptions_url': 'https://api.github.com/users/facebook-github-bot/subscriptions', 'organizations_url': 'https://api.github.com/users/facebook-github-bot/orgs', 'repos_url': 'https://api.github.com/users/facebook-github-bot/repos', 'events_url': 'https://api.github.com/users/facebook-github-bot/events{/privacy}', 'received_events_url': 'https://api.github.com/users/facebook-github-bot/received_events', 'type': 'User', 'site_admin': False}",closed,d2eceee54b0545b4a12ad8b2b9d2263e9af4dd7d,https://api.github.com/repos/pytorch/pytorch/commits/d2eceee54b0545b4a12ad8b2b9d2263e9af4dd7d,2019-10-18T17:18:24Z,19,16,3
27842,2928394839,"{'login': 'facebook-github-bot', 'id': 6422482, 'node_id': 'MDQ6VXNlcjY0MjI0ODI=', 'avatar_url': 'https://avatars3.githubusercontent.com/u/6422482?v=4', 'gravatar_id': '', 'url': 'https://api.github.com/users/facebook-github-bot', 'html_url': 'https://github.com/facebook-github-bot', 'followers_url': 'https://api.github.com/users/facebook-github-bot/followers', 'following_url': 'https://api.github.com/users/facebook-github-bot/following{/other_user}', 'gists_url': 'https://api.github.com/users/facebook-github-bot/gists{/gist_id}', 'starred_url': 'https://api.github.com/users/facebook-github-bot/starred{/owner}{/repo}', 'subscriptions_url': 'https://api.github.com/users/facebook-github-bot/subscriptions', 'organizations_url': 'https://api.github.com/users/facebook-github-bot/orgs', 'repos_url': 'https://api.github.com/users/facebook-github-bot/repos', 'events_url': 'https://api.github.com/users/facebook-github-bot/events{/privacy}', 'received_events_url': 'https://api.github.com/users/facebook-github-bot/received_events', 'type': 'User', 'site_admin': False}",referenced,20c5dd59bda182f526e2302623db89cad934c235,https://api.github.com/repos/pytorch/pytorch/commits/20c5dd59bda182f526e2302623db89cad934c235,2020-01-07T17:13:46Z,85,84,1
27824,2722870130,"{'login': 'nairbv', 'id': 582713, 'node_id': 'MDQ6VXNlcjU4MjcxMw==', 'avatar_url': 'https://avatars1.githubusercontent.com/u/582713?v=4', 'gravatar_id': '', 'url': 'https://api.github.com/users/nairbv', 'html_url': 'https://github.com/nairbv', 'followers_url': 'https://api.github.com/users/nairbv/followers', 'following_url': 'https://api.github.com/users/nairbv/following{/other_user}', 'gists_url': 'https://api.github.com/users/nairbv/gists{/gist_id}', 'starred_url': 'https://api.github.com/users/nairbv/starred{/owner}{/repo}', 'subscriptions_url': 'https://api.github.com/users/nairbv/subscriptions', 'organizations_url': 'https://api.github.com/users/nairbv/orgs', 'repos_url': 'https://api.github.com/users/nairbv/repos', 'events_url': 'https://api.github.com/users/nairbv/events{/privacy}', 'received_events_url': 'https://api.github.com/users/nairbv/received_events', 'type': 'User', 'site_admin': False}",referenced,d8aa9f5ca6d6159f8d364ee138dd5d3858d6c3f4,https://api.github.com/repos/pytorch/pytorch/commits/d8aa9f5ca6d6159f8d364ee138dd5d3858d6c3f4,2019-10-17T21:48:58Z,19,9,10
27824,2722870428,"{'login': 'nairbv', 'id': 582713, 'node_id': 'MDQ6VXNlcjU4MjcxMw==', 'avatar_url': 'https://avatars1.githubusercontent.com/u/582713?v=4', 'gravatar_id': '', 'url': 'https://api.github.com/users/nairbv', 'html_url': 'https://github.com/nairbv', 'followers_url': 'https://api.github.com/users/nairbv/followers', 'following_url': 'https://api.github.com/users/nairbv/following{/other_user}', 'gists_url': 'https://api.github.com/users/nairbv/gists{/gist_id}', 'starred_url': 'https://api.github.com/users/nairbv/starred{/owner}{/repo}', 'subscriptions_url': 'https://api.github.com/users/nairbv/subscriptions', 'organizations_url': 'https://api.github.com/users/nairbv/orgs', 'repos_url': 'https://api.github.com/users/nairbv/repos', 'events_url': 'https://api.github.com/users/nairbv/events{/privacy}', 'received_events_url': 'https://api.github.com/users/nairbv/received_events', 'type': 'User', 'site_admin': False}",referenced,89d4719c60068b0e1a990c6b96b90e0494bbce44,https://api.github.com/repos/pytorch/pytorch/commits/89d4719c60068b0e1a990c6b96b90e0494bbce44,2019-10-17T21:49:05Z,19,9,10
27824,2731222689,"{'login': 'nairbv', 'id': 582713, 'node_id': 'MDQ6VXNlcjU4MjcxMw==', 'avatar_url': 'https://avatars1.githubusercontent.com/u/582713?v=4', 'gravatar_id': '', 'url': 'https://api.github.com/users/nairbv', 'html_url': 'https://github.com/nairbv', 'followers_url': 'https://api.github.com/users/nairbv/followers', 'following_url': 'https://api.github.com/users/nairbv/following{/other_user}', 'gists_url': 'https://api.github.com/users/nairbv/gists{/gist_id}', 'starred_url': 'https://api.github.com/users/nairbv/starred{/owner}{/repo}', 'subscriptions_url': 'https://api.github.com/users/nairbv/subscriptions', 'organizations_url': 'https://api.github.com/users/nairbv/orgs', 'repos_url': 'https://api.github.com/users/nairbv/repos', 'events_url': 'https://api.github.com/users/nairbv/events{/privacy}', 'received_events_url': 'https://api.github.com/users/nairbv/received_events', 'type': 'User', 'site_admin': False}",referenced,e7cdc85ae1800ca0d73ca9d312ac2982d1117cf6,https://api.github.com/repos/pytorch/pytorch/commits/e7cdc85ae1800ca0d73ca9d312ac2982d1117cf6,2019-10-21T20:51:13Z,424,379,45
27824,2731222925,"{'login': 'nairbv', 'id': 582713, 'node_id': 'MDQ6VXNlcjU4MjcxMw==', 'avatar_url': 'https://avatars1.githubusercontent.com/u/582713?v=4', 'gravatar_id': '', 'url': 'https://api.github.com/users/nairbv', 'html_url': 'https://github.com/nairbv', 'followers_url': 'https://api.github.com/users/nairbv/followers', 'following_url': 'https://api.github.com/users/nairbv/following{/other_user}', 'gists_url': 'https://api.github.com/users/nairbv/gists{/gist_id}', 'starred_url': 'https://api.github.com/users/nairbv/starred{/owner}{/repo}', 'subscriptions_url': 'https://api.github.com/users/nairbv/subscriptions', 'organizations_url': 'https://api.github.com/users/nairbv/orgs', 'repos_url': 'https://api.github.com/users/nairbv/repos', 'events_url': 'https://api.github.com/users/nairbv/events{/privacy}', 'received_events_url': 'https://api.github.com/users/nairbv/received_events', 'type': 'User', 'site_admin': False}",referenced,dd27457a33b0358a9fea39846689e4540718a705,https://api.github.com/repos/pytorch/pytorch/commits/dd27457a33b0358a9fea39846689e4540718a705,2019-10-21T20:51:17Z,19,9,10
27824,2731250717,"{'login': 'nairbv', 'id': 582713, 'node_id': 'MDQ6VXNlcjU4MjcxMw==', 'avatar_url': 'https://avatars1.githubusercontent.com/u/582713?v=4', 'gravatar_id': '', 'url': 'https://api.github.com/users/nairbv', 'html_url': 'https://github.com/nairbv', 'followers_url': 'https://api.github.com/users/nairbv/followers', 'following_url': 'https://api.github.com/users/nairbv/following{/other_user}', 'gists_url': 'https://api.github.com/users/nairbv/gists{/gist_id}', 'starred_url': 'https://api.github.com/users/nairbv/starred{/owner}{/repo}', 'subscriptions_url': 'https://api.github.com/users/nairbv/subscriptions', 'organizations_url': 'https://api.github.com/users/nairbv/orgs', 'repos_url': 'https://api.github.com/users/nairbv/repos', 'events_url': 'https://api.github.com/users/nairbv/events{/privacy}', 'received_events_url': 'https://api.github.com/users/nairbv/received_events', 'type': 'User', 'site_admin': False}",referenced,4f3f68eb18719cd403be5844bfeba5da2ce82163,https://api.github.com/repos/pytorch/pytorch/commits/4f3f68eb18719cd403be5844bfeba5da2ce82163,2019-10-21T21:00:38Z,4923,3569,1354
27820,2714500786,"{'login': 'facebook-github-bot', 'id': 6422482, 'node_id': 'MDQ6VXNlcjY0MjI0ODI=', 'avatar_url': 'https://avatars3.githubusercontent.com/u/6422482?v=4', 'gravatar_id': '', 'url': 'https://api.github.com/users/facebook-github-bot', 'html_url': 'https://github.com/facebook-github-bot', 'followers_url': 'https://api.github.com/users/facebook-github-bot/followers', 'following_url': 'https://api.github.com/users/facebook-github-bot/following{/other_user}', 'gists_url': 'https://api.github.com/users/facebook-github-bot/gists{/gist_id}', 'starred_url': 'https://api.github.com/users/facebook-github-bot/starred{/owner}{/repo}', 'subscriptions_url': 'https://api.github.com/users/facebook-github-bot/subscriptions', 'organizations_url': 'https://api.github.com/users/facebook-github-bot/orgs', 'repos_url': 'https://api.github.com/users/facebook-github-bot/repos', 'events_url': 'https://api.github.com/users/facebook-github-bot/events{/privacy}', 'received_events_url': 'https://api.github.com/users/facebook-github-bot/received_events', 'type': 'User', 'site_admin': False}",closed,498ca083a6595569497540c77ea0c7de074c2a32,https://api.github.com/repos/pytorch/pytorch/commits/498ca083a6595569497540c77ea0c7de074c2a32,2019-10-15T15:42:11Z,4,4,0
27820,3066423456,"{'login': 'facebook-github-bot', 'id': 6422482, 'node_id': 'MDQ6VXNlcjY0MjI0ODI=', 'avatar_url': 'https://avatars3.githubusercontent.com/u/6422482?v=4', 'gravatar_id': '', 'url': 'https://api.github.com/users/facebook-github-bot', 'html_url': 'https://github.com/facebook-github-bot', 'followers_url': 'https://api.github.com/users/facebook-github-bot/followers', 'following_url': 'https://api.github.com/users/facebook-github-bot/following{/other_user}', 'gists_url': 'https://api.github.com/users/facebook-github-bot/gists{/gist_id}', 'starred_url': 'https://api.github.com/users/facebook-github-bot/starred{/owner}{/repo}', 'subscriptions_url': 'https://api.github.com/users/facebook-github-bot/subscriptions', 'organizations_url': 'https://api.github.com/users/facebook-github-bot/orgs', 'repos_url': 'https://api.github.com/users/facebook-github-bot/repos', 'events_url': 'https://api.github.com/users/facebook-github-bot/events{/privacy}', 'received_events_url': 'https://api.github.com/users/facebook-github-bot/received_events', 'type': 'User', 'site_admin': False}",referenced,6a275b696e3e5bd043b97ddbab0d1f6dbcfd6675,https://api.github.com/repos/pytorch/pytorch/commits/6a275b696e3e5bd043b97ddbab0d1f6dbcfd6675,2020-02-24T18:11:38Z,5,3,2
27820,3083149138,"{'login': 'hczhu', 'id': 2289363, 'node_id': 'MDQ6VXNlcjIyODkzNjM=', 'avatar_url': 'https://avatars0.githubusercontent.com/u/2289363?v=4', 'gravatar_id': '', 'url': 'https://api.github.com/users/hczhu', 'html_url': 'https://github.com/hczhu', 'followers_url': 'https://api.github.com/users/hczhu/followers', 'following_url': 'https://api.github.com/users/hczhu/following{/other_user}', 'gists_url': 'https://api.github.com/users/hczhu/gists{/gist_id}', 'starred_url': 'https://api.github.com/users/hczhu/starred{/owner}{/repo}', 'subscriptions_url': 'https://api.github.com/users/hczhu/subscriptions', 'organizations_url': 'https://api.github.com/users/hczhu/orgs', 'repos_url': 'https://api.github.com/users/hczhu/repos', 'events_url': 'https://api.github.com/users/hczhu/events{/privacy}', 'received_events_url': 'https://api.github.com/users/hczhu/received_events', 'type': 'User', 'site_admin': False}",referenced,c66c75450a3bd01eeef7b250eb79562fdc19fec9,https://api.github.com/repos/pytorch/pytorch/commits/c66c75450a3bd01eeef7b250eb79562fdc19fec9,2020-02-28T18:58:26Z,5,3,2
27811,2711401342,"{'login': 'facebook-github-bot', 'id': 6422482, 'node_id': 'MDQ6VXNlcjY0MjI0ODI=', 'avatar_url': 'https://avatars3.githubusercontent.com/u/6422482?v=4', 'gravatar_id': '', 'url': 'https://api.github.com/users/facebook-github-bot', 'html_url': 'https://github.com/facebook-github-bot', 'followers_url': 'https://api.github.com/users/facebook-github-bot/followers', 'following_url': 'https://api.github.com/users/facebook-github-bot/following{/other_user}', 'gists_url': 'https://api.github.com/users/facebook-github-bot/gists{/gist_id}', 'starred_url': 'https://api.github.com/users/facebook-github-bot/starred{/owner}{/repo}', 'subscriptions_url': 'https://api.github.com/users/facebook-github-bot/subscriptions', 'organizations_url': 'https://api.github.com/users/facebook-github-bot/orgs', 'repos_url': 'https://api.github.com/users/facebook-github-bot/repos', 'events_url': 'https://api.github.com/users/facebook-github-bot/events{/privacy}', 'received_events_url': 'https://api.github.com/users/facebook-github-bot/received_events', 'type': 'User', 'site_admin': False}",referenced,169327f557bcf9f0a1300e23336d07479320b0a7,https://api.github.com/repos/pytorch/pytorch/commits/169327f557bcf9f0a1300e23336d07479320b0a7,2019-10-14T18:26:02Z,14,14,0
27811,2711424386,"{'login': 'dzhulgakov', 'id': 17890620, 'node_id': 'MDQ6VXNlcjE3ODkwNjIw', 'avatar_url': 'https://avatars2.githubusercontent.com/u/17890620?v=4', 'gravatar_id': '', 'url': 'https://api.github.com/users/dzhulgakov', 'html_url': 'https://github.com/dzhulgakov', 'followers_url': 'https://api.github.com/users/dzhulgakov/followers', 'following_url': 'https://api.github.com/users/dzhulgakov/following{/other_user}', 'gists_url': 'https://api.github.com/users/dzhulgakov/gists{/gist_id}', 'starred_url': 'https://api.github.com/users/dzhulgakov/starred{/owner}{/repo}', 'subscriptions_url': 'https://api.github.com/users/dzhulgakov/subscriptions', 'organizations_url': 'https://api.github.com/users/dzhulgakov/orgs', 'repos_url': 'https://api.github.com/users/dzhulgakov/repos', 'events_url': 'https://api.github.com/users/dzhulgakov/events{/privacy}', 'received_events_url': 'https://api.github.com/users/dzhulgakov/received_events', 'type': 'User', 'site_admin': False}",referenced,80ae6d294b37d712400b3d84e8d4e8e6a410efe4,https://api.github.com/repos/pytorch/pytorch/commits/80ae6d294b37d712400b3d84e8d4e8e6a410efe4,2019-10-14T18:34:32Z,14,14,0
27811,2757435397,"{'login': 'soumith', 'id': 1310570, 'node_id': 'MDQ6VXNlcjEzMTA1NzA=', 'avatar_url': 'https://avatars0.githubusercontent.com/u/1310570?v=4', 'gravatar_id': '', 'url': 'https://api.github.com/users/soumith', 'html_url': 'https://github.com/soumith', 'followers_url': 'https://api.github.com/users/soumith/followers', 'following_url': 'https://api.github.com/users/soumith/following{/other_user}', 'gists_url': 'https://api.github.com/users/soumith/gists{/gist_id}', 'starred_url': 'https://api.github.com/users/soumith/starred{/owner}{/repo}', 'subscriptions_url': 'https://api.github.com/users/soumith/subscriptions', 'organizations_url': 'https://api.github.com/users/soumith/orgs', 'repos_url': 'https://api.github.com/users/soumith/repos', 'events_url': 'https://api.github.com/users/soumith/events{/privacy}', 'received_events_url': 'https://api.github.com/users/soumith/received_events', 'type': 'User', 'site_admin': False}",referenced,9d45ee1d8116d15499e6f7484ecc118fb9f49d0f,https://api.github.com/repos/pytorch/pytorch/commits/9d45ee1d8116d15499e6f7484ecc118fb9f49d0f,2019-10-30T19:53:30Z,14,14,0
27783,2710931073,"{'login': 'facebook-github-bot', 'id': 6422482, 'node_id': 'MDQ6VXNlcjY0MjI0ODI=', 'avatar_url': 'https://avatars3.githubusercontent.com/u/6422482?v=4', 'gravatar_id': '', 'url': 'https://api.github.com/users/facebook-github-bot', 'html_url': 'https://github.com/facebook-github-bot', 'followers_url': 'https://api.github.com/users/facebook-github-bot/followers', 'following_url': 'https://api.github.com/users/facebook-github-bot/following{/other_user}', 'gists_url': 'https://api.github.com/users/facebook-github-bot/gists{/gist_id}', 'starred_url': 'https://api.github.com/users/facebook-github-bot/starred{/owner}{/repo}', 'subscriptions_url': 'https://api.github.com/users/facebook-github-bot/subscriptions', 'organizations_url': 'https://api.github.com/users/facebook-github-bot/orgs', 'repos_url': 'https://api.github.com/users/facebook-github-bot/repos', 'events_url': 'https://api.github.com/users/facebook-github-bot/events{/privacy}', 'received_events_url': 'https://api.github.com/users/facebook-github-bot/received_events', 'type': 'User', 'site_admin': False}",closed,82a69a690fa29b683acd7393c4da91270d1ecbfe,https://api.github.com/repos/pytorch/pytorch/commits/82a69a690fa29b683acd7393c4da91270d1ecbfe,2019-10-14T15:47:15Z,38,36,2
27783,2762096647,"{'login': 'soumith', 'id': 1310570, 'node_id': 'MDQ6VXNlcjEzMTA1NzA=', 'avatar_url': 'https://avatars0.githubusercontent.com/u/1310570?v=4', 'gravatar_id': '', 'url': 'https://api.github.com/users/soumith', 'html_url': 'https://github.com/soumith', 'followers_url': 'https://api.github.com/users/soumith/followers', 'following_url': 'https://api.github.com/users/soumith/following{/other_user}', 'gists_url': 'https://api.github.com/users/soumith/gists{/gist_id}', 'starred_url': 'https://api.github.com/users/soumith/starred{/owner}{/repo}', 'subscriptions_url': 'https://api.github.com/users/soumith/subscriptions', 'organizations_url': 'https://api.github.com/users/soumith/orgs', 'repos_url': 'https://api.github.com/users/soumith/repos', 'events_url': 'https://api.github.com/users/soumith/events{/privacy}', 'received_events_url': 'https://api.github.com/users/soumith/received_events', 'type': 'User', 'site_admin': False}",referenced,eb8e8c1bcfb54a71bdb3714ad053464d4dfb4190,https://api.github.com/repos/pytorch/pytorch/commits/eb8e8c1bcfb54a71bdb3714ad053464d4dfb4190,2019-11-01T03:49:11Z,81,77,4
27753,2780889309,"{'login': 'zou3519', 'id': 5652049, 'node_id': 'MDQ6VXNlcjU2NTIwNDk=', 'avatar_url': 'https://avatars3.githubusercontent.com/u/5652049?v=4', 'gravatar_id': '', 'url': 'https://api.github.com/users/zou3519', 'html_url': 'https://github.com/zou3519', 'followers_url': 'https://api.github.com/users/zou3519/followers', 'following_url': 'https://api.github.com/users/zou3519/following{/other_user}', 'gists_url': 'https://api.github.com/users/zou3519/gists{/gist_id}', 'starred_url': 'https://api.github.com/users/zou3519/starred{/owner}{/repo}', 'subscriptions_url': 'https://api.github.com/users/zou3519/subscriptions', 'organizations_url': 'https://api.github.com/users/zou3519/orgs', 'repos_url': 'https://api.github.com/users/zou3519/repos', 'events_url': 'https://api.github.com/users/zou3519/events{/privacy}', 'received_events_url': 'https://api.github.com/users/zou3519/received_events', 'type': 'User', 'site_admin': False}",referenced,981c6e73a339e48215e95de9c25d50252a45e82d,https://api.github.com/repos/pytorch/pytorch/commits/981c6e73a339e48215e95de9c25d50252a45e82d,2019-11-07T21:21:14Z,7,3,4
27753,2780889751,"{'login': 'zou3519', 'id': 5652049, 'node_id': 'MDQ6VXNlcjU2NTIwNDk=', 'avatar_url': 'https://avatars3.githubusercontent.com/u/5652049?v=4', 'gravatar_id': '', 'url': 'https://api.github.com/users/zou3519', 'html_url': 'https://github.com/zou3519', 'followers_url': 'https://api.github.com/users/zou3519/followers', 'following_url': 'https://api.github.com/users/zou3519/following{/other_user}', 'gists_url': 'https://api.github.com/users/zou3519/gists{/gist_id}', 'starred_url': 'https://api.github.com/users/zou3519/starred{/owner}{/repo}', 'subscriptions_url': 'https://api.github.com/users/zou3519/subscriptions', 'organizations_url': 'https://api.github.com/users/zou3519/orgs', 'repos_url': 'https://api.github.com/users/zou3519/repos', 'events_url': 'https://api.github.com/users/zou3519/events{/privacy}', 'received_events_url': 'https://api.github.com/users/zou3519/received_events', 'type': 'User', 'site_admin': False}",referenced,c568a3353184ba620894358b186eaf2d43762319,https://api.github.com/repos/pytorch/pytorch/commits/c568a3353184ba620894358b186eaf2d43762319,2019-11-07T21:21:22Z,7,3,4
27753,2788672424,"{'login': 'zou3519', 'id': 5652049, 'node_id': 'MDQ6VXNlcjU2NTIwNDk=', 'avatar_url': 'https://avatars3.githubusercontent.com/u/5652049?v=4', 'gravatar_id': '', 'url': 'https://api.github.com/users/zou3519', 'html_url': 'https://github.com/zou3519', 'followers_url': 'https://api.github.com/users/zou3519/followers', 'following_url': 'https://api.github.com/users/zou3519/following{/other_user}', 'gists_url': 'https://api.github.com/users/zou3519/gists{/gist_id}', 'starred_url': 'https://api.github.com/users/zou3519/starred{/owner}{/repo}', 'subscriptions_url': 'https://api.github.com/users/zou3519/subscriptions', 'organizations_url': 'https://api.github.com/users/zou3519/orgs', 'repos_url': 'https://api.github.com/users/zou3519/repos', 'events_url': 'https://api.github.com/users/zou3519/events{/privacy}', 'received_events_url': 'https://api.github.com/users/zou3519/received_events', 'type': 'User', 'site_admin': False}",referenced,4c090537ed6dd88ce6739e7c0a9bf6b34c6ae067,https://api.github.com/repos/pytorch/pytorch/commits/4c090537ed6dd88ce6739e7c0a9bf6b34c6ae067,2019-11-11T17:11:26Z,10999,7881,3118
27753,2788672537,"{'login': 'zou3519', 'id': 5652049, 'node_id': 'MDQ6VXNlcjU2NTIwNDk=', 'avatar_url': 'https://avatars3.githubusercontent.com/u/5652049?v=4', 'gravatar_id': '', 'url': 'https://api.github.com/users/zou3519', 'html_url': 'https://github.com/zou3519', 'followers_url': 'https://api.github.com/users/zou3519/followers', 'following_url': 'https://api.github.com/users/zou3519/following{/other_user}', 'gists_url': 'https://api.github.com/users/zou3519/gists{/gist_id}', 'starred_url': 'https://api.github.com/users/zou3519/starred{/owner}{/repo}', 'subscriptions_url': 'https://api.github.com/users/zou3519/subscriptions', 'organizations_url': 'https://api.github.com/users/zou3519/orgs', 'repos_url': 'https://api.github.com/users/zou3519/repos', 'events_url': 'https://api.github.com/users/zou3519/events{/privacy}', 'received_events_url': 'https://api.github.com/users/zou3519/received_events', 'type': 'User', 'site_admin': False}",referenced,4874b0e39de4456ee43da03a55f66a9a679321bc,https://api.github.com/repos/pytorch/pytorch/commits/4874b0e39de4456ee43da03a55f66a9a679321bc,2019-11-11T17:11:28Z,7,3,4
27753,2789388883,"{'login': 'facebook-github-bot', 'id': 6422482, 'node_id': 'MDQ6VXNlcjY0MjI0ODI=', 'avatar_url': 'https://avatars3.githubusercontent.com/u/6422482?v=4', 'gravatar_id': '', 'url': 'https://api.github.com/users/facebook-github-bot', 'html_url': 'https://github.com/facebook-github-bot', 'followers_url': 'https://api.github.com/users/facebook-github-bot/followers', 'following_url': 'https://api.github.com/users/facebook-github-bot/following{/other_user}', 'gists_url': 'https://api.github.com/users/facebook-github-bot/gists{/gist_id}', 'starred_url': 'https://api.github.com/users/facebook-github-bot/starred{/owner}{/repo}', 'subscriptions_url': 'https://api.github.com/users/facebook-github-bot/subscriptions', 'organizations_url': 'https://api.github.com/users/facebook-github-bot/orgs', 'repos_url': 'https://api.github.com/users/facebook-github-bot/repos', 'events_url': 'https://api.github.com/users/facebook-github-bot/events{/privacy}', 'received_events_url': 'https://api.github.com/users/facebook-github-bot/received_events', 'type': 'User', 'site_admin': False}",closed,cedca377bd005d68f553648c5b36dbd58a62a520,https://api.github.com/repos/pytorch/pytorch/commits/cedca377bd005d68f553648c5b36dbd58a62a520,2019-11-11T21:32:45Z,7,3,4
27737,2710532316,"{'login': 'facebook-github-bot', 'id': 6422482, 'node_id': 'MDQ6VXNlcjY0MjI0ODI=', 'avatar_url': 'https://avatars3.githubusercontent.com/u/6422482?v=4', 'gravatar_id': '', 'url': 'https://api.github.com/users/facebook-github-bot', 'html_url': 'https://github.com/facebook-github-bot', 'followers_url': 'https://api.github.com/users/facebook-github-bot/followers', 'following_url': 'https://api.github.com/users/facebook-github-bot/following{/other_user}', 'gists_url': 'https://api.github.com/users/facebook-github-bot/gists{/gist_id}', 'starred_url': 'https://api.github.com/users/facebook-github-bot/starred{/owner}{/repo}', 'subscriptions_url': 'https://api.github.com/users/facebook-github-bot/subscriptions', 'organizations_url': 'https://api.github.com/users/facebook-github-bot/orgs', 'repos_url': 'https://api.github.com/users/facebook-github-bot/repos', 'events_url': 'https://api.github.com/users/facebook-github-bot/events{/privacy}', 'received_events_url': 'https://api.github.com/users/facebook-github-bot/received_events', 'type': 'User', 'site_admin': False}",closed,4bcedb66702a49c6c7e89f0a35321312bc5efcdb,https://api.github.com/repos/pytorch/pytorch/commits/4bcedb66702a49c6c7e89f0a35321312bc5efcdb,2019-10-14T13:57:47Z,13,7,6
27730,2715253088,"{'login': 'vincentqb', 'id': 3047868, 'node_id': 'MDQ6VXNlcjMwNDc4Njg=', 'avatar_url': 'https://avatars0.githubusercontent.com/u/3047868?v=4', 'gravatar_id': '', 'url': 'https://api.github.com/users/vincentqb', 'html_url': 'https://github.com/vincentqb', 'followers_url': 'https://api.github.com/users/vincentqb/followers', 'following_url': 'https://api.github.com/users/vincentqb/following{/other_user}', 'gists_url': 'https://api.github.com/users/vincentqb/gists{/gist_id}', 'starred_url': 'https://api.github.com/users/vincentqb/starred{/owner}{/repo}', 'subscriptions_url': 'https://api.github.com/users/vincentqb/subscriptions', 'organizations_url': 'https://api.github.com/users/vincentqb/orgs', 'repos_url': 'https://api.github.com/users/vincentqb/repos', 'events_url': 'https://api.github.com/users/vincentqb/events{/privacy}', 'received_events_url': 'https://api.github.com/users/vincentqb/received_events', 'type': 'User', 'site_admin': False}",referenced,fcdb83e0e89689d32394dabd4aced52794189a1d,https://api.github.com/repos/pytorch/pytorch/commits/fcdb83e0e89689d32394dabd4aced52794189a1d,2019-10-15T19:54:56Z,4,3,1
27730,2718026345,"{'login': 'vincentqb', 'id': 3047868, 'node_id': 'MDQ6VXNlcjMwNDc4Njg=', 'avatar_url': 'https://avatars0.githubusercontent.com/u/3047868?v=4', 'gravatar_id': '', 'url': 'https://api.github.com/users/vincentqb', 'html_url': 'https://github.com/vincentqb', 'followers_url': 'https://api.github.com/users/vincentqb/followers', 'following_url': 'https://api.github.com/users/vincentqb/following{/other_user}', 'gists_url': 'https://api.github.com/users/vincentqb/gists{/gist_id}', 'starred_url': 'https://api.github.com/users/vincentqb/starred{/owner}{/repo}', 'subscriptions_url': 'https://api.github.com/users/vincentqb/subscriptions', 'organizations_url': 'https://api.github.com/users/vincentqb/orgs', 'repos_url': 'https://api.github.com/users/vincentqb/repos', 'events_url': 'https://api.github.com/users/vincentqb/events{/privacy}', 'received_events_url': 'https://api.github.com/users/vincentqb/received_events', 'type': 'User', 'site_admin': False}",referenced,738f99bc0f200a784c5732d2647caa94246b649b,https://api.github.com/repos/pytorch/pytorch/commits/738f99bc0f200a784c5732d2647caa94246b649b,2019-10-16T15:11:37Z,10,5,5
27730,2738530484,"{'login': 'facebook-github-bot', 'id': 6422482, 'node_id': 'MDQ6VXNlcjY0MjI0ODI=', 'avatar_url': 'https://avatars3.githubusercontent.com/u/6422482?v=4', 'gravatar_id': '', 'url': 'https://api.github.com/users/facebook-github-bot', 'html_url': 'https://github.com/facebook-github-bot', 'followers_url': 'https://api.github.com/users/facebook-github-bot/followers', 'following_url': 'https://api.github.com/users/facebook-github-bot/following{/other_user}', 'gists_url': 'https://api.github.com/users/facebook-github-bot/gists{/gist_id}', 'starred_url': 'https://api.github.com/users/facebook-github-bot/starred{/owner}{/repo}', 'subscriptions_url': 'https://api.github.com/users/facebook-github-bot/subscriptions', 'organizations_url': 'https://api.github.com/users/facebook-github-bot/orgs', 'repos_url': 'https://api.github.com/users/facebook-github-bot/repos', 'events_url': 'https://api.github.com/users/facebook-github-bot/events{/privacy}', 'received_events_url': 'https://api.github.com/users/facebook-github-bot/received_events', 'type': 'User', 'site_admin': False}",referenced,cbddc77ac579ee0dc62a98b231915a148598aecc,https://api.github.com/repos/pytorch/pytorch/commits/cbddc77ac579ee0dc62a98b231915a148598aecc,2019-10-23T20:51:43Z,27,9,18
27729,2711401339,"{'login': 'facebook-github-bot', 'id': 6422482, 'node_id': 'MDQ6VXNlcjY0MjI0ODI=', 'avatar_url': 'https://avatars3.githubusercontent.com/u/6422482?v=4', 'gravatar_id': '', 'url': 'https://api.github.com/users/facebook-github-bot', 'html_url': 'https://github.com/facebook-github-bot', 'followers_url': 'https://api.github.com/users/facebook-github-bot/followers', 'following_url': 'https://api.github.com/users/facebook-github-bot/following{/other_user}', 'gists_url': 'https://api.github.com/users/facebook-github-bot/gists{/gist_id}', 'starred_url': 'https://api.github.com/users/facebook-github-bot/starred{/owner}{/repo}', 'subscriptions_url': 'https://api.github.com/users/facebook-github-bot/subscriptions', 'organizations_url': 'https://api.github.com/users/facebook-github-bot/orgs', 'repos_url': 'https://api.github.com/users/facebook-github-bot/repos', 'events_url': 'https://api.github.com/users/facebook-github-bot/events{/privacy}', 'received_events_url': 'https://api.github.com/users/facebook-github-bot/received_events', 'type': 'User', 'site_admin': False}",referenced,169327f557bcf9f0a1300e23336d07479320b0a7,https://api.github.com/repos/pytorch/pytorch/commits/169327f557bcf9f0a1300e23336d07479320b0a7,2019-10-14T18:26:02Z,14,14,0
27729,2711424383,"{'login': 'dzhulgakov', 'id': 17890620, 'node_id': 'MDQ6VXNlcjE3ODkwNjIw', 'avatar_url': 'https://avatars2.githubusercontent.com/u/17890620?v=4', 'gravatar_id': '', 'url': 'https://api.github.com/users/dzhulgakov', 'html_url': 'https://github.com/dzhulgakov', 'followers_url': 'https://api.github.com/users/dzhulgakov/followers', 'following_url': 'https://api.github.com/users/dzhulgakov/following{/other_user}', 'gists_url': 'https://api.github.com/users/dzhulgakov/gists{/gist_id}', 'starred_url': 'https://api.github.com/users/dzhulgakov/starred{/owner}{/repo}', 'subscriptions_url': 'https://api.github.com/users/dzhulgakov/subscriptions', 'organizations_url': 'https://api.github.com/users/dzhulgakov/orgs', 'repos_url': 'https://api.github.com/users/dzhulgakov/repos', 'events_url': 'https://api.github.com/users/dzhulgakov/events{/privacy}', 'received_events_url': 'https://api.github.com/users/dzhulgakov/received_events', 'type': 'User', 'site_admin': False}",referenced,80ae6d294b37d712400b3d84e8d4e8e6a410efe4,https://api.github.com/repos/pytorch/pytorch/commits/80ae6d294b37d712400b3d84e8d4e8e6a410efe4,2019-10-14T18:34:32Z,14,14,0
27729,2757435392,"{'login': 'soumith', 'id': 1310570, 'node_id': 'MDQ6VXNlcjEzMTA1NzA=', 'avatar_url': 'https://avatars0.githubusercontent.com/u/1310570?v=4', 'gravatar_id': '', 'url': 'https://api.github.com/users/soumith', 'html_url': 'https://github.com/soumith', 'followers_url': 'https://api.github.com/users/soumith/followers', 'following_url': 'https://api.github.com/users/soumith/following{/other_user}', 'gists_url': 'https://api.github.com/users/soumith/gists{/gist_id}', 'starred_url': 'https://api.github.com/users/soumith/starred{/owner}{/repo}', 'subscriptions_url': 'https://api.github.com/users/soumith/subscriptions', 'organizations_url': 'https://api.github.com/users/soumith/orgs', 'repos_url': 'https://api.github.com/users/soumith/repos', 'events_url': 'https://api.github.com/users/soumith/events{/privacy}', 'received_events_url': 'https://api.github.com/users/soumith/received_events', 'type': 'User', 'site_admin': False}",referenced,9d45ee1d8116d15499e6f7484ecc118fb9f49d0f,https://api.github.com/repos/pytorch/pytorch/commits/9d45ee1d8116d15499e6f7484ecc118fb9f49d0f,2019-10-30T19:53:30Z,14,14,0
27703,2707106510,"{'login': 'facebook-github-bot', 'id': 6422482, 'node_id': 'MDQ6VXNlcjY0MjI0ODI=', 'avatar_url': 'https://avatars3.githubusercontent.com/u/6422482?v=4', 'gravatar_id': '', 'url': 'https://api.github.com/users/facebook-github-bot', 'html_url': 'https://github.com/facebook-github-bot', 'followers_url': 'https://api.github.com/users/facebook-github-bot/followers', 'following_url': 'https://api.github.com/users/facebook-github-bot/following{/other_user}', 'gists_url': 'https://api.github.com/users/facebook-github-bot/gists{/gist_id}', 'starred_url': 'https://api.github.com/users/facebook-github-bot/starred{/owner}{/repo}', 'subscriptions_url': 'https://api.github.com/users/facebook-github-bot/subscriptions', 'organizations_url': 'https://api.github.com/users/facebook-github-bot/orgs', 'repos_url': 'https://api.github.com/users/facebook-github-bot/repos', 'events_url': 'https://api.github.com/users/facebook-github-bot/events{/privacy}', 'received_events_url': 'https://api.github.com/users/facebook-github-bot/received_events', 'type': 'User', 'site_admin': False}",referenced,f35d7d4614f46b987e6c7dcd8640663b3c53a402,https://api.github.com/repos/pytorch/pytorch/commits/f35d7d4614f46b987e6c7dcd8640663b3c53a402,2019-10-11T18:49:26Z,33,30,3
27648,2763311564,"{'login': 'ezyang', 'id': 13564, 'node_id': 'MDQ6VXNlcjEzNTY0', 'avatar_url': 'https://avatars0.githubusercontent.com/u/13564?v=4', 'gravatar_id': '', 'url': 'https://api.github.com/users/ezyang', 'html_url': 'https://github.com/ezyang', 'followers_url': 'https://api.github.com/users/ezyang/followers', 'following_url': 'https://api.github.com/users/ezyang/following{/other_user}', 'gists_url': 'https://api.github.com/users/ezyang/gists{/gist_id}', 'starred_url': 'https://api.github.com/users/ezyang/starred{/owner}{/repo}', 'subscriptions_url': 'https://api.github.com/users/ezyang/subscriptions', 'organizations_url': 'https://api.github.com/users/ezyang/orgs', 'repos_url': 'https://api.github.com/users/ezyang/repos', 'events_url': 'https://api.github.com/users/ezyang/events{/privacy}', 'received_events_url': 'https://api.github.com/users/ezyang/received_events', 'type': 'User', 'site_admin': False}",referenced,c6f21f2524fc70fa10f5497df3c29d3b8ac9d732,https://api.github.com/repos/pytorch/pytorch/commits/c6f21f2524fc70fa10f5497df3c29d3b8ac9d732,2019-11-01T14:10:05Z,4,2,2
27648,2763312039,"{'login': 'ezyang', 'id': 13564, 'node_id': 'MDQ6VXNlcjEzNTY0', 'avatar_url': 'https://avatars0.githubusercontent.com/u/13564?v=4', 'gravatar_id': '', 'url': 'https://api.github.com/users/ezyang', 'html_url': 'https://github.com/ezyang', 'followers_url': 'https://api.github.com/users/ezyang/followers', 'following_url': 'https://api.github.com/users/ezyang/following{/other_user}', 'gists_url': 'https://api.github.com/users/ezyang/gists{/gist_id}', 'starred_url': 'https://api.github.com/users/ezyang/starred{/owner}{/repo}', 'subscriptions_url': 'https://api.github.com/users/ezyang/subscriptions', 'organizations_url': 'https://api.github.com/users/ezyang/orgs', 'repos_url': 'https://api.github.com/users/ezyang/repos', 'events_url': 'https://api.github.com/users/ezyang/events{/privacy}', 'received_events_url': 'https://api.github.com/users/ezyang/received_events', 'type': 'User', 'site_admin': False}",referenced,780946b5cb1ea435fe0cb4bc78d3fab75dfcb759,https://api.github.com/repos/pytorch/pytorch/commits/780946b5cb1ea435fe0cb4bc78d3fab75dfcb759,2019-11-01T14:10:14Z,4,2,2
27648,2769534628,"{'login': 'facebook-github-bot', 'id': 6422482, 'node_id': 'MDQ6VXNlcjY0MjI0ODI=', 'avatar_url': 'https://avatars3.githubusercontent.com/u/6422482?v=4', 'gravatar_id': '', 'url': 'https://api.github.com/users/facebook-github-bot', 'html_url': 'https://github.com/facebook-github-bot', 'followers_url': 'https://api.github.com/users/facebook-github-bot/followers', 'following_url': 'https://api.github.com/users/facebook-github-bot/following{/other_user}', 'gists_url': 'https://api.github.com/users/facebook-github-bot/gists{/gist_id}', 'starred_url': 'https://api.github.com/users/facebook-github-bot/starred{/owner}{/repo}', 'subscriptions_url': 'https://api.github.com/users/facebook-github-bot/subscriptions', 'organizations_url': 'https://api.github.com/users/facebook-github-bot/orgs', 'repos_url': 'https://api.github.com/users/facebook-github-bot/repos', 'events_url': 'https://api.github.com/users/facebook-github-bot/events{/privacy}', 'received_events_url': 'https://api.github.com/users/facebook-github-bot/received_events', 'type': 'User', 'site_admin': False}",closed,379f3ae3eaf251f7224715a4e64126266dc87e55,https://api.github.com/repos/pytorch/pytorch/commits/379f3ae3eaf251f7224715a4e64126266dc87e55,2019-11-04T23:05:07Z,4,2,2
27605,2704424456,"{'login': 'facebook-github-bot', 'id': 6422482, 'node_id': 'MDQ6VXNlcjY0MjI0ODI=', 'avatar_url': 'https://avatars3.githubusercontent.com/u/6422482?v=4', 'gravatar_id': '', 'url': 'https://api.github.com/users/facebook-github-bot', 'html_url': 'https://github.com/facebook-github-bot', 'followers_url': 'https://api.github.com/users/facebook-github-bot/followers', 'following_url': 'https://api.github.com/users/facebook-github-bot/following{/other_user}', 'gists_url': 'https://api.github.com/users/facebook-github-bot/gists{/gist_id}', 'starred_url': 'https://api.github.com/users/facebook-github-bot/starred{/owner}{/repo}', 'subscriptions_url': 'https://api.github.com/users/facebook-github-bot/subscriptions', 'organizations_url': 'https://api.github.com/users/facebook-github-bot/orgs', 'repos_url': 'https://api.github.com/users/facebook-github-bot/repos', 'events_url': 'https://api.github.com/users/facebook-github-bot/events{/privacy}', 'received_events_url': 'https://api.github.com/users/facebook-github-bot/received_events', 'type': 'User', 'site_admin': False}",closed,f7d7c4b72fd936181416f55b4f15c05de7076110,https://api.github.com/repos/pytorch/pytorch/commits/f7d7c4b72fd936181416f55b4f15c05de7076110,2019-10-10T22:38:19Z,10,9,1
27569,2945576783,"{'login': 'facebook-github-bot', 'id': 6422482, 'node_id': 'MDQ6VXNlcjY0MjI0ODI=', 'avatar_url': 'https://avatars3.githubusercontent.com/u/6422482?v=4', 'gravatar_id': '', 'url': 'https://api.github.com/users/facebook-github-bot', 'html_url': 'https://github.com/facebook-github-bot', 'followers_url': 'https://api.github.com/users/facebook-github-bot/followers', 'following_url': 'https://api.github.com/users/facebook-github-bot/following{/other_user}', 'gists_url': 'https://api.github.com/users/facebook-github-bot/gists{/gist_id}', 'starred_url': 'https://api.github.com/users/facebook-github-bot/starred{/owner}{/repo}', 'subscriptions_url': 'https://api.github.com/users/facebook-github-bot/subscriptions', 'organizations_url': 'https://api.github.com/users/facebook-github-bot/orgs', 'repos_url': 'https://api.github.com/users/facebook-github-bot/repos', 'events_url': 'https://api.github.com/users/facebook-github-bot/events{/privacy}', 'received_events_url': 'https://api.github.com/users/facebook-github-bot/received_events', 'type': 'User', 'site_admin': False}",closed,a472f0201f51064b8d35a6179da05c9abf32ed8b,https://api.github.com/repos/pytorch/pytorch/commits/a472f0201f51064b8d35a6179da05c9abf32ed8b,2020-01-14T03:45:42Z,128,128,0
27568,2699696096,"{'login': 'facebook-github-bot', 'id': 6422482, 'node_id': 'MDQ6VXNlcjY0MjI0ODI=', 'avatar_url': 'https://avatars3.githubusercontent.com/u/6422482?v=4', 'gravatar_id': '', 'url': 'https://api.github.com/users/facebook-github-bot', 'html_url': 'https://github.com/facebook-github-bot', 'followers_url': 'https://api.github.com/users/facebook-github-bot/followers', 'following_url': 'https://api.github.com/users/facebook-github-bot/following{/other_user}', 'gists_url': 'https://api.github.com/users/facebook-github-bot/gists{/gist_id}', 'starred_url': 'https://api.github.com/users/facebook-github-bot/starred{/owner}{/repo}', 'subscriptions_url': 'https://api.github.com/users/facebook-github-bot/subscriptions', 'organizations_url': 'https://api.github.com/users/facebook-github-bot/orgs', 'repos_url': 'https://api.github.com/users/facebook-github-bot/repos', 'events_url': 'https://api.github.com/users/facebook-github-bot/events{/privacy}', 'received_events_url': 'https://api.github.com/users/facebook-github-bot/received_events', 'type': 'User', 'site_admin': False}",closed,b9b9fd4fadc4d4fa0b030941a35011956eafa10b,https://api.github.com/repos/pytorch/pytorch/commits/b9b9fd4fadc4d4fa0b030941a35011956eafa10b,2019-10-09T16:31:39Z,12,11,1
27568,2757665010,"{'login': 'facebook-github-bot', 'id': 6422482, 'node_id': 'MDQ6VXNlcjY0MjI0ODI=', 'avatar_url': 'https://avatars3.githubusercontent.com/u/6422482?v=4', 'gravatar_id': '', 'url': 'https://api.github.com/users/facebook-github-bot', 'html_url': 'https://github.com/facebook-github-bot', 'followers_url': 'https://api.github.com/users/facebook-github-bot/followers', 'following_url': 'https://api.github.com/users/facebook-github-bot/following{/other_user}', 'gists_url': 'https://api.github.com/users/facebook-github-bot/gists{/gist_id}', 'starred_url': 'https://api.github.com/users/facebook-github-bot/starred{/owner}{/repo}', 'subscriptions_url': 'https://api.github.com/users/facebook-github-bot/subscriptions', 'organizations_url': 'https://api.github.com/users/facebook-github-bot/orgs', 'repos_url': 'https://api.github.com/users/facebook-github-bot/repos', 'events_url': 'https://api.github.com/users/facebook-github-bot/events{/privacy}', 'received_events_url': 'https://api.github.com/users/facebook-github-bot/received_events', 'type': 'User', 'site_admin': False}",closed,732a3d8f8cba05026638f07d34f50e60ea59b02c,https://api.github.com/repos/pytorch/pytorch/commits/732a3d8f8cba05026638f07d34f50e60ea59b02c,2019-10-30T21:09:48Z,3,2,1
27512,2871048594,"{'login': 'facebook-github-bot', 'id': 6422482, 'node_id': 'MDQ6VXNlcjY0MjI0ODI=', 'avatar_url': 'https://avatars3.githubusercontent.com/u/6422482?v=4', 'gravatar_id': '', 'url': 'https://api.github.com/users/facebook-github-bot', 'html_url': 'https://github.com/facebook-github-bot', 'followers_url': 'https://api.github.com/users/facebook-github-bot/followers', 'following_url': 'https://api.github.com/users/facebook-github-bot/following{/other_user}', 'gists_url': 'https://api.github.com/users/facebook-github-bot/gists{/gist_id}', 'starred_url': 'https://api.github.com/users/facebook-github-bot/starred{/owner}{/repo}', 'subscriptions_url': 'https://api.github.com/users/facebook-github-bot/subscriptions', 'organizations_url': 'https://api.github.com/users/facebook-github-bot/orgs', 'repos_url': 'https://api.github.com/users/facebook-github-bot/repos', 'events_url': 'https://api.github.com/users/facebook-github-bot/events{/privacy}', 'received_events_url': 'https://api.github.com/users/facebook-github-bot/received_events', 'type': 'User', 'site_admin': False}",closed,f48a8901c580fc7d192477de1ff8806bdd1c5164,https://api.github.com/repos/pytorch/pytorch/commits/f48a8901c580fc7d192477de1ff8806bdd1c5164,2019-12-10T15:51:58Z,89,85,4
27506,2732008802,"{'login': 'eellison', 'id': 11477974, 'node_id': 'MDQ6VXNlcjExNDc3OTc0', 'avatar_url': 'https://avatars2.githubusercontent.com/u/11477974?v=4', 'gravatar_id': '', 'url': 'https://api.github.com/users/eellison', 'html_url': 'https://github.com/eellison', 'followers_url': 'https://api.github.com/users/eellison/followers', 'following_url': 'https://api.github.com/users/eellison/following{/other_user}', 'gists_url': 'https://api.github.com/users/eellison/gists{/gist_id}', 'starred_url': 'https://api.github.com/users/eellison/starred{/owner}{/repo}', 'subscriptions_url': 'https://api.github.com/users/eellison/subscriptions', 'organizations_url': 'https://api.github.com/users/eellison/orgs', 'repos_url': 'https://api.github.com/users/eellison/repos', 'events_url': 'https://api.github.com/users/eellison/events{/privacy}', 'received_events_url': 'https://api.github.com/users/eellison/received_events', 'type': 'User', 'site_admin': False}",referenced,9a0717a5b286ef4e40e99bf5f6de97ba685a73d0,https://api.github.com/repos/pytorch/pytorch/commits/9a0717a5b286ef4e40e99bf5f6de97ba685a73d0,2019-10-22T05:30:19Z,10,5,5
27506,2732069719,"{'login': 'eellison', 'id': 11477974, 'node_id': 'MDQ6VXNlcjExNDc3OTc0', 'avatar_url': 'https://avatars2.githubusercontent.com/u/11477974?v=4', 'gravatar_id': '', 'url': 'https://api.github.com/users/eellison', 'html_url': 'https://github.com/eellison', 'followers_url': 'https://api.github.com/users/eellison/followers', 'following_url': 'https://api.github.com/users/eellison/following{/other_user}', 'gists_url': 'https://api.github.com/users/eellison/gists{/gist_id}', 'starred_url': 'https://api.github.com/users/eellison/starred{/owner}{/repo}', 'subscriptions_url': 'https://api.github.com/users/eellison/subscriptions', 'organizations_url': 'https://api.github.com/users/eellison/orgs', 'repos_url': 'https://api.github.com/users/eellison/repos', 'events_url': 'https://api.github.com/users/eellison/events{/privacy}', 'received_events_url': 'https://api.github.com/users/eellison/received_events', 'type': 'User', 'site_admin': False}",referenced,55b5d1246271fcccc5b5f9d3a28ad1d6d57a0aa9,https://api.github.com/repos/pytorch/pytorch/commits/55b5d1246271fcccc5b5f9d3a28ad1d6d57a0aa9,2019-10-22T06:11:51Z,26369,17296,9073
27506,2753951368,"{'login': 'eellison', 'id': 11477974, 'node_id': 'MDQ6VXNlcjExNDc3OTc0', 'avatar_url': 'https://avatars2.githubusercontent.com/u/11477974?v=4', 'gravatar_id': '', 'url': 'https://api.github.com/users/eellison', 'html_url': 'https://github.com/eellison', 'followers_url': 'https://api.github.com/users/eellison/followers', 'following_url': 'https://api.github.com/users/eellison/following{/other_user}', 'gists_url': 'https://api.github.com/users/eellison/gists{/gist_id}', 'starred_url': 'https://api.github.com/users/eellison/starred{/owner}{/repo}', 'subscriptions_url': 'https://api.github.com/users/eellison/subscriptions', 'organizations_url': 'https://api.github.com/users/eellison/orgs', 'repos_url': 'https://api.github.com/users/eellison/repos', 'events_url': 'https://api.github.com/users/eellison/events{/privacy}', 'received_events_url': 'https://api.github.com/users/eellison/received_events', 'type': 'User', 'site_admin': False}",referenced,529485fd81efa7218ad2c35994a83977c86004c6,https://api.github.com/repos/pytorch/pytorch/commits/529485fd81efa7218ad2c35994a83977c86004c6,2019-10-29T21:56:39Z,329,181,148
27506,2754178589,"{'login': 'eellison', 'id': 11477974, 'node_id': 'MDQ6VXNlcjExNDc3OTc0', 'avatar_url': 'https://avatars2.githubusercontent.com/u/11477974?v=4', 'gravatar_id': '', 'url': 'https://api.github.com/users/eellison', 'html_url': 'https://github.com/eellison', 'followers_url': 'https://api.github.com/users/eellison/followers', 'following_url': 'https://api.github.com/users/eellison/following{/other_user}', 'gists_url': 'https://api.github.com/users/eellison/gists{/gist_id}', 'starred_url': 'https://api.github.com/users/eellison/starred{/owner}{/repo}', 'subscriptions_url': 'https://api.github.com/users/eellison/subscriptions', 'organizations_url': 'https://api.github.com/users/eellison/orgs', 'repos_url': 'https://api.github.com/users/eellison/repos', 'events_url': 'https://api.github.com/users/eellison/events{/privacy}', 'received_events_url': 'https://api.github.com/users/eellison/received_events', 'type': 'User', 'site_admin': False}",referenced,28999ca98a72040c70ff88617a8fea0f25ba696e,https://api.github.com/repos/pytorch/pytorch/commits/28999ca98a72040c70ff88617a8fea0f25ba696e,2019-10-29T23:46:05Z,18075,12158,5917
27506,2757107676,"{'login': 'eellison', 'id': 11477974, 'node_id': 'MDQ6VXNlcjExNDc3OTc0', 'avatar_url': 'https://avatars2.githubusercontent.com/u/11477974?v=4', 'gravatar_id': '', 'url': 'https://api.github.com/users/eellison', 'html_url': 'https://github.com/eellison', 'followers_url': 'https://api.github.com/users/eellison/followers', 'following_url': 'https://api.github.com/users/eellison/following{/other_user}', 'gists_url': 'https://api.github.com/users/eellison/gists{/gist_id}', 'starred_url': 'https://api.github.com/users/eellison/starred{/owner}{/repo}', 'subscriptions_url': 'https://api.github.com/users/eellison/subscriptions', 'organizations_url': 'https://api.github.com/users/eellison/orgs', 'repos_url': 'https://api.github.com/users/eellison/repos', 'events_url': 'https://api.github.com/users/eellison/events{/privacy}', 'received_events_url': 'https://api.github.com/users/eellison/received_events', 'type': 'User', 'site_admin': False}",referenced,7b7694988ab9fb9e4cbaac25a62d012cda7ea5f7,https://api.github.com/repos/pytorch/pytorch/commits/7b7694988ab9fb9e4cbaac25a62d012cda7ea5f7,2019-10-30T18:08:40Z,5,3,2
27506,2757369549,"{'login': 'eellison', 'id': 11477974, 'node_id': 'MDQ6VXNlcjExNDc3OTc0', 'avatar_url': 'https://avatars2.githubusercontent.com/u/11477974?v=4', 'gravatar_id': '', 'url': 'https://api.github.com/users/eellison', 'html_url': 'https://github.com/eellison', 'followers_url': 'https://api.github.com/users/eellison/followers', 'following_url': 'https://api.github.com/users/eellison/following{/other_user}', 'gists_url': 'https://api.github.com/users/eellison/gists{/gist_id}', 'starred_url': 'https://api.github.com/users/eellison/starred{/owner}{/repo}', 'subscriptions_url': 'https://api.github.com/users/eellison/subscriptions', 'organizations_url': 'https://api.github.com/users/eellison/orgs', 'repos_url': 'https://api.github.com/users/eellison/repos', 'events_url': 'https://api.github.com/users/eellison/events{/privacy}', 'received_events_url': 'https://api.github.com/users/eellison/received_events', 'type': 'User', 'site_admin': False}",referenced,ba400d612bf82d349e57eb466fbd5fe6dcec356c,https://api.github.com/repos/pytorch/pytorch/commits/ba400d612bf82d349e57eb466fbd5fe6dcec356c,2019-10-30T19:31:28Z,13,7,6
27506,2764247611,"{'login': 'eellison', 'id': 11477974, 'node_id': 'MDQ6VXNlcjExNDc3OTc0', 'avatar_url': 'https://avatars2.githubusercontent.com/u/11477974?v=4', 'gravatar_id': '', 'url': 'https://api.github.com/users/eellison', 'html_url': 'https://github.com/eellison', 'followers_url': 'https://api.github.com/users/eellison/followers', 'following_url': 'https://api.github.com/users/eellison/following{/other_user}', 'gists_url': 'https://api.github.com/users/eellison/gists{/gist_id}', 'starred_url': 'https://api.github.com/users/eellison/starred{/owner}{/repo}', 'subscriptions_url': 'https://api.github.com/users/eellison/subscriptions', 'organizations_url': 'https://api.github.com/users/eellison/orgs', 'repos_url': 'https://api.github.com/users/eellison/repos', 'events_url': 'https://api.github.com/users/eellison/events{/privacy}', 'received_events_url': 'https://api.github.com/users/eellison/received_events', 'type': 'User', 'site_admin': False}",referenced,e896c200b37beaf42d3579862669802a3e1fda76,https://api.github.com/repos/pytorch/pytorch/commits/e896c200b37beaf42d3579862669802a3e1fda76,2019-11-01T19:25:41Z,168,76,92
27506,2764370555,"{'login': 'eellison', 'id': 11477974, 'node_id': 'MDQ6VXNlcjExNDc3OTc0', 'avatar_url': 'https://avatars2.githubusercontent.com/u/11477974?v=4', 'gravatar_id': '', 'url': 'https://api.github.com/users/eellison', 'html_url': 'https://github.com/eellison', 'followers_url': 'https://api.github.com/users/eellison/followers', 'following_url': 'https://api.github.com/users/eellison/following{/other_user}', 'gists_url': 'https://api.github.com/users/eellison/gists{/gist_id}', 'starred_url': 'https://api.github.com/users/eellison/starred{/owner}{/repo}', 'subscriptions_url': 'https://api.github.com/users/eellison/subscriptions', 'organizations_url': 'https://api.github.com/users/eellison/orgs', 'repos_url': 'https://api.github.com/users/eellison/repos', 'events_url': 'https://api.github.com/users/eellison/events{/privacy}', 'received_events_url': 'https://api.github.com/users/eellison/received_events', 'type': 'User', 'site_admin': False}",referenced,f44f42cb565e07e333132b63c708243f0a03c93b,https://api.github.com/repos/pytorch/pytorch/commits/f44f42cb565e07e333132b63c708243f0a03c93b,2019-11-01T20:17:18Z,13,5,8
27506,2768541635,"{'login': 'facebook-github-bot', 'id': 6422482, 'node_id': 'MDQ6VXNlcjY0MjI0ODI=', 'avatar_url': 'https://avatars3.githubusercontent.com/u/6422482?v=4', 'gravatar_id': '', 'url': 'https://api.github.com/users/facebook-github-bot', 'html_url': 'https://github.com/facebook-github-bot', 'followers_url': 'https://api.github.com/users/facebook-github-bot/followers', 'following_url': 'https://api.github.com/users/facebook-github-bot/following{/other_user}', 'gists_url': 'https://api.github.com/users/facebook-github-bot/gists{/gist_id}', 'starred_url': 'https://api.github.com/users/facebook-github-bot/starred{/owner}{/repo}', 'subscriptions_url': 'https://api.github.com/users/facebook-github-bot/subscriptions', 'organizations_url': 'https://api.github.com/users/facebook-github-bot/orgs', 'repos_url': 'https://api.github.com/users/facebook-github-bot/repos', 'events_url': 'https://api.github.com/users/facebook-github-bot/events{/privacy}', 'received_events_url': 'https://api.github.com/users/facebook-github-bot/received_events', 'type': 'User', 'site_admin': False}",referenced,fdeef45852578a068a62abba253a87aab857dc5f,https://api.github.com/repos/pytorch/pytorch/commits/fdeef45852578a068a62abba253a87aab857dc5f,2019-11-04T17:19:52Z,779,555,224
27495,2882855333,"{'login': 'driazati', 'id': 9407960, 'node_id': 'MDQ6VXNlcjk0MDc5NjA=', 'avatar_url': 'https://avatars3.githubusercontent.com/u/9407960?v=4', 'gravatar_id': '', 'url': 'https://api.github.com/users/driazati', 'html_url': 'https://github.com/driazati', 'followers_url': 'https://api.github.com/users/driazati/followers', 'following_url': 'https://api.github.com/users/driazati/following{/other_user}', 'gists_url': 'https://api.github.com/users/driazati/gists{/gist_id}', 'starred_url': 'https://api.github.com/users/driazati/starred{/owner}{/repo}', 'subscriptions_url': 'https://api.github.com/users/driazati/subscriptions', 'organizations_url': 'https://api.github.com/users/driazati/orgs', 'repos_url': 'https://api.github.com/users/driazati/repos', 'events_url': 'https://api.github.com/users/driazati/events{/privacy}', 'received_events_url': 'https://api.github.com/users/driazati/received_events', 'type': 'User', 'site_admin': False}",referenced,f765522fc4f7344688bae3b063830fdc5503de2d,https://api.github.com/repos/pytorch/pytorch/commits/f765522fc4f7344688bae3b063830fdc5503de2d,2019-12-13T22:33:37Z,287,170,117
27495,2895378847,"{'login': 'facebook-github-bot', 'id': 6422482, 'node_id': 'MDQ6VXNlcjY0MjI0ODI=', 'avatar_url': 'https://avatars3.githubusercontent.com/u/6422482?v=4', 'gravatar_id': '', 'url': 'https://api.github.com/users/facebook-github-bot', 'html_url': 'https://github.com/facebook-github-bot', 'followers_url': 'https://api.github.com/users/facebook-github-bot/followers', 'following_url': 'https://api.github.com/users/facebook-github-bot/following{/other_user}', 'gists_url': 'https://api.github.com/users/facebook-github-bot/gists{/gist_id}', 'starred_url': 'https://api.github.com/users/facebook-github-bot/starred{/owner}{/repo}', 'subscriptions_url': 'https://api.github.com/users/facebook-github-bot/subscriptions', 'organizations_url': 'https://api.github.com/users/facebook-github-bot/orgs', 'repos_url': 'https://api.github.com/users/facebook-github-bot/repos', 'events_url': 'https://api.github.com/users/facebook-github-bot/events{/privacy}', 'received_events_url': 'https://api.github.com/users/facebook-github-bot/received_events', 'type': 'User', 'site_admin': False}",closed,148bcd3ee50ca547288da64d7e3ecb65178e3b40,https://api.github.com/repos/pytorch/pytorch/commits/148bcd3ee50ca547288da64d7e3ecb65178e3b40,2019-12-18T23:24:57Z,329,205,124
27464,2741430511,"{'login': 'facebook-github-bot', 'id': 6422482, 'node_id': 'MDQ6VXNlcjY0MjI0ODI=', 'avatar_url': 'https://avatars3.githubusercontent.com/u/6422482?v=4', 'gravatar_id': '', 'url': 'https://api.github.com/users/facebook-github-bot', 'html_url': 'https://github.com/facebook-github-bot', 'followers_url': 'https://api.github.com/users/facebook-github-bot/followers', 'following_url': 'https://api.github.com/users/facebook-github-bot/following{/other_user}', 'gists_url': 'https://api.github.com/users/facebook-github-bot/gists{/gist_id}', 'starred_url': 'https://api.github.com/users/facebook-github-bot/starred{/owner}{/repo}', 'subscriptions_url': 'https://api.github.com/users/facebook-github-bot/subscriptions', 'organizations_url': 'https://api.github.com/users/facebook-github-bot/orgs', 'repos_url': 'https://api.github.com/users/facebook-github-bot/repos', 'events_url': 'https://api.github.com/users/facebook-github-bot/events{/privacy}', 'received_events_url': 'https://api.github.com/users/facebook-github-bot/received_events', 'type': 'User', 'site_admin': False}",referenced,136bb07a93b779acbc84ff341bc397551a8cfcc2,https://api.github.com/repos/pytorch/pytorch/commits/136bb07a93b779acbc84ff341bc397551a8cfcc2,2019-10-24T16:28:56Z,49,49,0
27443,2696083274,"{'login': 'facebook-github-bot', 'id': 6422482, 'node_id': 'MDQ6VXNlcjY0MjI0ODI=', 'avatar_url': 'https://avatars3.githubusercontent.com/u/6422482?v=4', 'gravatar_id': '', 'url': 'https://api.github.com/users/facebook-github-bot', 'html_url': 'https://github.com/facebook-github-bot', 'followers_url': 'https://api.github.com/users/facebook-github-bot/followers', 'following_url': 'https://api.github.com/users/facebook-github-bot/following{/other_user}', 'gists_url': 'https://api.github.com/users/facebook-github-bot/gists{/gist_id}', 'starred_url': 'https://api.github.com/users/facebook-github-bot/starred{/owner}{/repo}', 'subscriptions_url': 'https://api.github.com/users/facebook-github-bot/subscriptions', 'organizations_url': 'https://api.github.com/users/facebook-github-bot/orgs', 'repos_url': 'https://api.github.com/users/facebook-github-bot/repos', 'events_url': 'https://api.github.com/users/facebook-github-bot/events{/privacy}', 'received_events_url': 'https://api.github.com/users/facebook-github-bot/received_events', 'type': 'User', 'site_admin': False}",referenced,16ece1c9daefe58ba56db63d9c930a21411998d9,https://api.github.com/repos/pytorch/pytorch/commits/16ece1c9daefe58ba56db63d9c930a21411998d9,2019-10-08T16:32:00Z,6,3,3
27443,2699717822,"{'login': 'IvanKobzarev', 'id': 6638825, 'node_id': 'MDQ6VXNlcjY2Mzg4MjU=', 'avatar_url': 'https://avatars3.githubusercontent.com/u/6638825?v=4', 'gravatar_id': '', 'url': 'https://api.github.com/users/IvanKobzarev', 'html_url': 'https://github.com/IvanKobzarev', 'followers_url': 'https://api.github.com/users/IvanKobzarev/followers', 'following_url': 'https://api.github.com/users/IvanKobzarev/following{/other_user}', 'gists_url': 'https://api.github.com/users/IvanKobzarev/gists{/gist_id}', 'starred_url': 'https://api.github.com/users/IvanKobzarev/starred{/owner}{/repo}', 'subscriptions_url': 'https://api.github.com/users/IvanKobzarev/subscriptions', 'organizations_url': 'https://api.github.com/users/IvanKobzarev/orgs', 'repos_url': 'https://api.github.com/users/IvanKobzarev/repos', 'events_url': 'https://api.github.com/users/IvanKobzarev/events{/privacy}', 'received_events_url': 'https://api.github.com/users/IvanKobzarev/received_events', 'type': 'User', 'site_admin': False}",referenced,5645ce923ebf6147baf21095ea788c41152aef76,https://api.github.com/repos/pytorch/pytorch/commits/5645ce923ebf6147baf21095ea788c41152aef76,2019-10-09T16:38:47Z,6,3,3
27442,2692872968,"{'login': 'soumith', 'id': 1310570, 'node_id': 'MDQ6VXNlcjEzMTA1NzA=', 'avatar_url': 'https://avatars0.githubusercontent.com/u/1310570?v=4', 'gravatar_id': '', 'url': 'https://api.github.com/users/soumith', 'html_url': 'https://github.com/soumith', 'followers_url': 'https://api.github.com/users/soumith/followers', 'following_url': 'https://api.github.com/users/soumith/following{/other_user}', 'gists_url': 'https://api.github.com/users/soumith/gists{/gist_id}', 'starred_url': 'https://api.github.com/users/soumith/starred{/owner}{/repo}', 'subscriptions_url': 'https://api.github.com/users/soumith/subscriptions', 'organizations_url': 'https://api.github.com/users/soumith/orgs', 'repos_url': 'https://api.github.com/users/soumith/repos', 'events_url': 'https://api.github.com/users/soumith/events{/privacy}', 'received_events_url': 'https://api.github.com/users/soumith/received_events', 'type': 'User', 'site_admin': False}",referenced,17613ad73c30700123cbae2120d128325d2d5084,https://api.github.com/repos/pytorch/pytorch/commits/17613ad73c30700123cbae2120d128325d2d5084,2019-10-07T18:32:51Z,26,25,1
27442,2701078765,"{'login': 'facebook-github-bot', 'id': 6422482, 'node_id': 'MDQ6VXNlcjY0MjI0ODI=', 'avatar_url': 'https://avatars3.githubusercontent.com/u/6422482?v=4', 'gravatar_id': '', 'url': 'https://api.github.com/users/facebook-github-bot', 'html_url': 'https://github.com/facebook-github-bot', 'followers_url': 'https://api.github.com/users/facebook-github-bot/followers', 'following_url': 'https://api.github.com/users/facebook-github-bot/following{/other_user}', 'gists_url': 'https://api.github.com/users/facebook-github-bot/gists{/gist_id}', 'starred_url': 'https://api.github.com/users/facebook-github-bot/starred{/owner}{/repo}', 'subscriptions_url': 'https://api.github.com/users/facebook-github-bot/subscriptions', 'organizations_url': 'https://api.github.com/users/facebook-github-bot/orgs', 'repos_url': 'https://api.github.com/users/facebook-github-bot/repos', 'events_url': 'https://api.github.com/users/facebook-github-bot/events{/privacy}', 'received_events_url': 'https://api.github.com/users/facebook-github-bot/received_events', 'type': 'User', 'site_admin': False}",closed,e66e00cd1700df179816a1555f28691cdec029c1,https://api.github.com/repos/pytorch/pytorch/commits/e66e00cd1700df179816a1555f28691cdec029c1,2019-10-10T02:26:58Z,26,25,1
27401,2732008800,"{'login': 'eellison', 'id': 11477974, 'node_id': 'MDQ6VXNlcjExNDc3OTc0', 'avatar_url': 'https://avatars2.githubusercontent.com/u/11477974?v=4', 'gravatar_id': '', 'url': 'https://api.github.com/users/eellison', 'html_url': 'https://github.com/eellison', 'followers_url': 'https://api.github.com/users/eellison/followers', 'following_url': 'https://api.github.com/users/eellison/following{/other_user}', 'gists_url': 'https://api.github.com/users/eellison/gists{/gist_id}', 'starred_url': 'https://api.github.com/users/eellison/starred{/owner}{/repo}', 'subscriptions_url': 'https://api.github.com/users/eellison/subscriptions', 'organizations_url': 'https://api.github.com/users/eellison/orgs', 'repos_url': 'https://api.github.com/users/eellison/repos', 'events_url': 'https://api.github.com/users/eellison/events{/privacy}', 'received_events_url': 'https://api.github.com/users/eellison/received_events', 'type': 'User', 'site_admin': False}",referenced,9a0717a5b286ef4e40e99bf5f6de97ba685a73d0,https://api.github.com/repos/pytorch/pytorch/commits/9a0717a5b286ef4e40e99bf5f6de97ba685a73d0,2019-10-22T05:30:18Z,10,5,5
27401,2732069717,"{'login': 'eellison', 'id': 11477974, 'node_id': 'MDQ6VXNlcjExNDc3OTc0', 'avatar_url': 'https://avatars2.githubusercontent.com/u/11477974?v=4', 'gravatar_id': '', 'url': 'https://api.github.com/users/eellison', 'html_url': 'https://github.com/eellison', 'followers_url': 'https://api.github.com/users/eellison/followers', 'following_url': 'https://api.github.com/users/eellison/following{/other_user}', 'gists_url': 'https://api.github.com/users/eellison/gists{/gist_id}', 'starred_url': 'https://api.github.com/users/eellison/starred{/owner}{/repo}', 'subscriptions_url': 'https://api.github.com/users/eellison/subscriptions', 'organizations_url': 'https://api.github.com/users/eellison/orgs', 'repos_url': 'https://api.github.com/users/eellison/repos', 'events_url': 'https://api.github.com/users/eellison/events{/privacy}', 'received_events_url': 'https://api.github.com/users/eellison/received_events', 'type': 'User', 'site_admin': False}",referenced,55b5d1246271fcccc5b5f9d3a28ad1d6d57a0aa9,https://api.github.com/repos/pytorch/pytorch/commits/55b5d1246271fcccc5b5f9d3a28ad1d6d57a0aa9,2019-10-22T06:11:51Z,26369,17296,9073
27401,2753951365,"{'login': 'eellison', 'id': 11477974, 'node_id': 'MDQ6VXNlcjExNDc3OTc0', 'avatar_url': 'https://avatars2.githubusercontent.com/u/11477974?v=4', 'gravatar_id': '', 'url': 'https://api.github.com/users/eellison', 'html_url': 'https://github.com/eellison', 'followers_url': 'https://api.github.com/users/eellison/followers', 'following_url': 'https://api.github.com/users/eellison/following{/other_user}', 'gists_url': 'https://api.github.com/users/eellison/gists{/gist_id}', 'starred_url': 'https://api.github.com/users/eellison/starred{/owner}{/repo}', 'subscriptions_url': 'https://api.github.com/users/eellison/subscriptions', 'organizations_url': 'https://api.github.com/users/eellison/orgs', 'repos_url': 'https://api.github.com/users/eellison/repos', 'events_url': 'https://api.github.com/users/eellison/events{/privacy}', 'received_events_url': 'https://api.github.com/users/eellison/received_events', 'type': 'User', 'site_admin': False}",referenced,529485fd81efa7218ad2c35994a83977c86004c6,https://api.github.com/repos/pytorch/pytorch/commits/529485fd81efa7218ad2c35994a83977c86004c6,2019-10-29T21:56:39Z,329,181,148
27401,2754178586,"{'login': 'eellison', 'id': 11477974, 'node_id': 'MDQ6VXNlcjExNDc3OTc0', 'avatar_url': 'https://avatars2.githubusercontent.com/u/11477974?v=4', 'gravatar_id': '', 'url': 'https://api.github.com/users/eellison', 'html_url': 'https://github.com/eellison', 'followers_url': 'https://api.github.com/users/eellison/followers', 'following_url': 'https://api.github.com/users/eellison/following{/other_user}', 'gists_url': 'https://api.github.com/users/eellison/gists{/gist_id}', 'starred_url': 'https://api.github.com/users/eellison/starred{/owner}{/repo}', 'subscriptions_url': 'https://api.github.com/users/eellison/subscriptions', 'organizations_url': 'https://api.github.com/users/eellison/orgs', 'repos_url': 'https://api.github.com/users/eellison/repos', 'events_url': 'https://api.github.com/users/eellison/events{/privacy}', 'received_events_url': 'https://api.github.com/users/eellison/received_events', 'type': 'User', 'site_admin': False}",referenced,28999ca98a72040c70ff88617a8fea0f25ba696e,https://api.github.com/repos/pytorch/pytorch/commits/28999ca98a72040c70ff88617a8fea0f25ba696e,2019-10-29T23:46:04Z,18075,12158,5917
27401,2757107672,"{'login': 'eellison', 'id': 11477974, 'node_id': 'MDQ6VXNlcjExNDc3OTc0', 'avatar_url': 'https://avatars2.githubusercontent.com/u/11477974?v=4', 'gravatar_id': '', 'url': 'https://api.github.com/users/eellison', 'html_url': 'https://github.com/eellison', 'followers_url': 'https://api.github.com/users/eellison/followers', 'following_url': 'https://api.github.com/users/eellison/following{/other_user}', 'gists_url': 'https://api.github.com/users/eellison/gists{/gist_id}', 'starred_url': 'https://api.github.com/users/eellison/starred{/owner}{/repo}', 'subscriptions_url': 'https://api.github.com/users/eellison/subscriptions', 'organizations_url': 'https://api.github.com/users/eellison/orgs', 'repos_url': 'https://api.github.com/users/eellison/repos', 'events_url': 'https://api.github.com/users/eellison/events{/privacy}', 'received_events_url': 'https://api.github.com/users/eellison/received_events', 'type': 'User', 'site_admin': False}",referenced,7b7694988ab9fb9e4cbaac25a62d012cda7ea5f7,https://api.github.com/repos/pytorch/pytorch/commits/7b7694988ab9fb9e4cbaac25a62d012cda7ea5f7,2019-10-30T18:08:40Z,5,3,2
27401,2757369547,"{'login': 'eellison', 'id': 11477974, 'node_id': 'MDQ6VXNlcjExNDc3OTc0', 'avatar_url': 'https://avatars2.githubusercontent.com/u/11477974?v=4', 'gravatar_id': '', 'url': 'https://api.github.com/users/eellison', 'html_url': 'https://github.com/eellison', 'followers_url': 'https://api.github.com/users/eellison/followers', 'following_url': 'https://api.github.com/users/eellison/following{/other_user}', 'gists_url': 'https://api.github.com/users/eellison/gists{/gist_id}', 'starred_url': 'https://api.github.com/users/eellison/starred{/owner}{/repo}', 'subscriptions_url': 'https://api.github.com/users/eellison/subscriptions', 'organizations_url': 'https://api.github.com/users/eellison/orgs', 'repos_url': 'https://api.github.com/users/eellison/repos', 'events_url': 'https://api.github.com/users/eellison/events{/privacy}', 'received_events_url': 'https://api.github.com/users/eellison/received_events', 'type': 'User', 'site_admin': False}",referenced,ba400d612bf82d349e57eb466fbd5fe6dcec356c,https://api.github.com/repos/pytorch/pytorch/commits/ba400d612bf82d349e57eb466fbd5fe6dcec356c,2019-10-30T19:31:28Z,13,7,6
27401,2764247609,"{'login': 'eellison', 'id': 11477974, 'node_id': 'MDQ6VXNlcjExNDc3OTc0', 'avatar_url': 'https://avatars2.githubusercontent.com/u/11477974?v=4', 'gravatar_id': '', 'url': 'https://api.github.com/users/eellison', 'html_url': 'https://github.com/eellison', 'followers_url': 'https://api.github.com/users/eellison/followers', 'following_url': 'https://api.github.com/users/eellison/following{/other_user}', 'gists_url': 'https://api.github.com/users/eellison/gists{/gist_id}', 'starred_url': 'https://api.github.com/users/eellison/starred{/owner}{/repo}', 'subscriptions_url': 'https://api.github.com/users/eellison/subscriptions', 'organizations_url': 'https://api.github.com/users/eellison/orgs', 'repos_url': 'https://api.github.com/users/eellison/repos', 'events_url': 'https://api.github.com/users/eellison/events{/privacy}', 'received_events_url': 'https://api.github.com/users/eellison/received_events', 'type': 'User', 'site_admin': False}",referenced,e896c200b37beaf42d3579862669802a3e1fda76,https://api.github.com/repos/pytorch/pytorch/commits/e896c200b37beaf42d3579862669802a3e1fda76,2019-11-01T19:25:41Z,168,76,92
27401,2764370553,"{'login': 'eellison', 'id': 11477974, 'node_id': 'MDQ6VXNlcjExNDc3OTc0', 'avatar_url': 'https://avatars2.githubusercontent.com/u/11477974?v=4', 'gravatar_id': '', 'url': 'https://api.github.com/users/eellison', 'html_url': 'https://github.com/eellison', 'followers_url': 'https://api.github.com/users/eellison/followers', 'following_url': 'https://api.github.com/users/eellison/following{/other_user}', 'gists_url': 'https://api.github.com/users/eellison/gists{/gist_id}', 'starred_url': 'https://api.github.com/users/eellison/starred{/owner}{/repo}', 'subscriptions_url': 'https://api.github.com/users/eellison/subscriptions', 'organizations_url': 'https://api.github.com/users/eellison/orgs', 'repos_url': 'https://api.github.com/users/eellison/repos', 'events_url': 'https://api.github.com/users/eellison/events{/privacy}', 'received_events_url': 'https://api.github.com/users/eellison/received_events', 'type': 'User', 'site_admin': False}",referenced,f44f42cb565e07e333132b63c708243f0a03c93b,https://api.github.com/repos/pytorch/pytorch/commits/f44f42cb565e07e333132b63c708243f0a03c93b,2019-11-01T20:17:18Z,13,5,8
27401,2768541631,"{'login': 'facebook-github-bot', 'id': 6422482, 'node_id': 'MDQ6VXNlcjY0MjI0ODI=', 'avatar_url': 'https://avatars3.githubusercontent.com/u/6422482?v=4', 'gravatar_id': '', 'url': 'https://api.github.com/users/facebook-github-bot', 'html_url': 'https://github.com/facebook-github-bot', 'followers_url': 'https://api.github.com/users/facebook-github-bot/followers', 'following_url': 'https://api.github.com/users/facebook-github-bot/following{/other_user}', 'gists_url': 'https://api.github.com/users/facebook-github-bot/gists{/gist_id}', 'starred_url': 'https://api.github.com/users/facebook-github-bot/starred{/owner}{/repo}', 'subscriptions_url': 'https://api.github.com/users/facebook-github-bot/subscriptions', 'organizations_url': 'https://api.github.com/users/facebook-github-bot/orgs', 'repos_url': 'https://api.github.com/users/facebook-github-bot/repos', 'events_url': 'https://api.github.com/users/facebook-github-bot/events{/privacy}', 'received_events_url': 'https://api.github.com/users/facebook-github-bot/received_events', 'type': 'User', 'site_admin': False}",referenced,fdeef45852578a068a62abba253a87aab857dc5f,https://api.github.com/repos/pytorch/pytorch/commits/fdeef45852578a068a62abba253a87aab857dc5f,2019-11-04T17:19:52Z,779,555,224
27366,2696612329,"{'login': 'facebook-github-bot', 'id': 6422482, 'node_id': 'MDQ6VXNlcjY0MjI0ODI=', 'avatar_url': 'https://avatars3.githubusercontent.com/u/6422482?v=4', 'gravatar_id': '', 'url': 'https://api.github.com/users/facebook-github-bot', 'html_url': 'https://github.com/facebook-github-bot', 'followers_url': 'https://api.github.com/users/facebook-github-bot/followers', 'following_url': 'https://api.github.com/users/facebook-github-bot/following{/other_user}', 'gists_url': 'https://api.github.com/users/facebook-github-bot/gists{/gist_id}', 'starred_url': 'https://api.github.com/users/facebook-github-bot/starred{/owner}{/repo}', 'subscriptions_url': 'https://api.github.com/users/facebook-github-bot/subscriptions', 'organizations_url': 'https://api.github.com/users/facebook-github-bot/orgs', 'repos_url': 'https://api.github.com/users/facebook-github-bot/repos', 'events_url': 'https://api.github.com/users/facebook-github-bot/events{/privacy}', 'received_events_url': 'https://api.github.com/users/facebook-github-bot/received_events', 'type': 'User', 'site_admin': False}",referenced,c1c176d91bc7a7f47aecf01454548381f4c20e16,https://api.github.com/repos/pytorch/pytorch/commits/c1c176d91bc7a7f47aecf01454548381f4c20e16,2019-10-08T19:31:41Z,34,33,1
27365,2748981003,"{'login': 'facebook-github-bot', 'id': 6422482, 'node_id': 'MDQ6VXNlcjY0MjI0ODI=', 'avatar_url': 'https://avatars3.githubusercontent.com/u/6422482?v=4', 'gravatar_id': '', 'url': 'https://api.github.com/users/facebook-github-bot', 'html_url': 'https://github.com/facebook-github-bot', 'followers_url': 'https://api.github.com/users/facebook-github-bot/followers', 'following_url': 'https://api.github.com/users/facebook-github-bot/following{/other_user}', 'gists_url': 'https://api.github.com/users/facebook-github-bot/gists{/gist_id}', 'starred_url': 'https://api.github.com/users/facebook-github-bot/starred{/owner}{/repo}', 'subscriptions_url': 'https://api.github.com/users/facebook-github-bot/subscriptions', 'organizations_url': 'https://api.github.com/users/facebook-github-bot/orgs', 'repos_url': 'https://api.github.com/users/facebook-github-bot/repos', 'events_url': 'https://api.github.com/users/facebook-github-bot/events{/privacy}', 'received_events_url': 'https://api.github.com/users/facebook-github-bot/received_events', 'type': 'User', 'site_admin': False}",referenced,4230132baf259bf10336b27755a1e0d6ae6927e7,https://api.github.com/repos/pytorch/pytorch/commits/4230132baf259bf10336b27755a1e0d6ae6927e7,2019-10-28T15:31:47Z,24,22,2
27355,2696146975,"{'login': 'facebook-github-bot', 'id': 6422482, 'node_id': 'MDQ6VXNlcjY0MjI0ODI=', 'avatar_url': 'https://avatars3.githubusercontent.com/u/6422482?v=4', 'gravatar_id': '', 'url': 'https://api.github.com/users/facebook-github-bot', 'html_url': 'https://github.com/facebook-github-bot', 'followers_url': 'https://api.github.com/users/facebook-github-bot/followers', 'following_url': 'https://api.github.com/users/facebook-github-bot/following{/other_user}', 'gists_url': 'https://api.github.com/users/facebook-github-bot/gists{/gist_id}', 'starred_url': 'https://api.github.com/users/facebook-github-bot/starred{/owner}{/repo}', 'subscriptions_url': 'https://api.github.com/users/facebook-github-bot/subscriptions', 'organizations_url': 'https://api.github.com/users/facebook-github-bot/orgs', 'repos_url': 'https://api.github.com/users/facebook-github-bot/repos', 'events_url': 'https://api.github.com/users/facebook-github-bot/events{/privacy}', 'received_events_url': 'https://api.github.com/users/facebook-github-bot/received_events', 'type': 'User', 'site_admin': False}",referenced,7f183a978f31a87a7350c526386cec92bb6b2740,https://api.github.com/repos/pytorch/pytorch/commits/7f183a978f31a87a7350c526386cec92bb6b2740,2019-10-08T16:52:55Z,892,477,415
27350,2690103959,"{'login': 'dreiss', 'id': 4121, 'node_id': 'MDQ6VXNlcjQxMjE=', 'avatar_url': 'https://avatars0.githubusercontent.com/u/4121?v=4', 'gravatar_id': '', 'url': 'https://api.github.com/users/dreiss', 'html_url': 'https://github.com/dreiss', 'followers_url': 'https://api.github.com/users/dreiss/followers', 'following_url': 'https://api.github.com/users/dreiss/following{/other_user}', 'gists_url': 'https://api.github.com/users/dreiss/gists{/gist_id}', 'starred_url': 'https://api.github.com/users/dreiss/starred{/owner}{/repo}', 'subscriptions_url': 'https://api.github.com/users/dreiss/subscriptions', 'organizations_url': 'https://api.github.com/users/dreiss/orgs', 'repos_url': 'https://api.github.com/users/dreiss/repos', 'events_url': 'https://api.github.com/users/dreiss/events{/privacy}', 'received_events_url': 'https://api.github.com/users/dreiss/received_events', 'type': 'User', 'site_admin': False}",referenced,1fcc9635dc5904a99512006ceecb4f4d7404fa44,https://api.github.com/repos/pytorch/pytorch/commits/1fcc9635dc5904a99512006ceecb4f4d7404fa44,2019-10-06T19:38:52Z,349,186,163
27350,2690113416,"{'login': 'dreiss', 'id': 4121, 'node_id': 'MDQ6VXNlcjQxMjE=', 'avatar_url': 'https://avatars0.githubusercontent.com/u/4121?v=4', 'gravatar_id': '', 'url': 'https://api.github.com/users/dreiss', 'html_url': 'https://github.com/dreiss', 'followers_url': 'https://api.github.com/users/dreiss/followers', 'following_url': 'https://api.github.com/users/dreiss/following{/other_user}', 'gists_url': 'https://api.github.com/users/dreiss/gists{/gist_id}', 'starred_url': 'https://api.github.com/users/dreiss/starred{/owner}{/repo}', 'subscriptions_url': 'https://api.github.com/users/dreiss/subscriptions', 'organizations_url': 'https://api.github.com/users/dreiss/orgs', 'repos_url': 'https://api.github.com/users/dreiss/repos', 'events_url': 'https://api.github.com/users/dreiss/events{/privacy}', 'received_events_url': 'https://api.github.com/users/dreiss/received_events', 'type': 'User', 'site_admin': False}",referenced,9d172030dfbdfd571fc0a987b986bd26d2d5bf7a,https://api.github.com/repos/pytorch/pytorch/commits/9d172030dfbdfd571fc0a987b986bd26d2d5bf7a,2019-10-06T19:57:07Z,9337,271,9066
27350,2692668851,"{'login': 'dreiss', 'id': 4121, 'node_id': 'MDQ6VXNlcjQxMjE=', 'avatar_url': 'https://avatars0.githubusercontent.com/u/4121?v=4', 'gravatar_id': '', 'url': 'https://api.github.com/users/dreiss', 'html_url': 'https://github.com/dreiss', 'followers_url': 'https://api.github.com/users/dreiss/followers', 'following_url': 'https://api.github.com/users/dreiss/following{/other_user}', 'gists_url': 'https://api.github.com/users/dreiss/gists{/gist_id}', 'starred_url': 'https://api.github.com/users/dreiss/starred{/owner}{/repo}', 'subscriptions_url': 'https://api.github.com/users/dreiss/subscriptions', 'organizations_url': 'https://api.github.com/users/dreiss/orgs', 'repos_url': 'https://api.github.com/users/dreiss/repos', 'events_url': 'https://api.github.com/users/dreiss/events{/privacy}', 'received_events_url': 'https://api.github.com/users/dreiss/received_events', 'type': 'User', 'site_admin': False}",referenced,84c7666e6605333126c5c41b5d6f5023aee839c6,https://api.github.com/repos/pytorch/pytorch/commits/84c7666e6605333126c5c41b5d6f5023aee839c6,2019-10-07T17:24:39Z,70,35,35
27350,2693252611,"{'login': 'dreiss', 'id': 4121, 'node_id': 'MDQ6VXNlcjQxMjE=', 'avatar_url': 'https://avatars0.githubusercontent.com/u/4121?v=4', 'gravatar_id': '', 'url': 'https://api.github.com/users/dreiss', 'html_url': 'https://github.com/dreiss', 'followers_url': 'https://api.github.com/users/dreiss/followers', 'following_url': 'https://api.github.com/users/dreiss/following{/other_user}', 'gists_url': 'https://api.github.com/users/dreiss/gists{/gist_id}', 'starred_url': 'https://api.github.com/users/dreiss/starred{/owner}{/repo}', 'subscriptions_url': 'https://api.github.com/users/dreiss/subscriptions', 'organizations_url': 'https://api.github.com/users/dreiss/orgs', 'repos_url': 'https://api.github.com/users/dreiss/repos', 'events_url': 'https://api.github.com/users/dreiss/events{/privacy}', 'received_events_url': 'https://api.github.com/users/dreiss/received_events', 'type': 'User', 'site_admin': False}",referenced,bd513ebf4024928b9636fe10f6bfe20c3a666fa2,https://api.github.com/repos/pytorch/pytorch/commits/bd513ebf4024928b9636fe10f6bfe20c3a666fa2,2019-10-07T20:44:37Z,10,0,10
27350,2693567569,"{'login': 'dreiss', 'id': 4121, 'node_id': 'MDQ6VXNlcjQxMjE=', 'avatar_url': 'https://avatars0.githubusercontent.com/u/4121?v=4', 'gravatar_id': '', 'url': 'https://api.github.com/users/dreiss', 'html_url': 'https://github.com/dreiss', 'followers_url': 'https://api.github.com/users/dreiss/followers', 'following_url': 'https://api.github.com/users/dreiss/following{/other_user}', 'gists_url': 'https://api.github.com/users/dreiss/gists{/gist_id}', 'starred_url': 'https://api.github.com/users/dreiss/starred{/owner}{/repo}', 'subscriptions_url': 'https://api.github.com/users/dreiss/subscriptions', 'organizations_url': 'https://api.github.com/users/dreiss/orgs', 'repos_url': 'https://api.github.com/users/dreiss/repos', 'events_url': 'https://api.github.com/users/dreiss/events{/privacy}', 'received_events_url': 'https://api.github.com/users/dreiss/received_events', 'type': 'User', 'site_admin': False}",referenced,ca118821d77cbd38ff5cde489fe29e83f9e4aa65,https://api.github.com/repos/pytorch/pytorch/commits/ca118821d77cbd38ff5cde489fe29e83f9e4aa65,2019-10-07T23:01:11Z,152,150,2
27350,2693664024,"{'login': 'facebook-github-bot', 'id': 6422482, 'node_id': 'MDQ6VXNlcjY0MjI0ODI=', 'avatar_url': 'https://avatars3.githubusercontent.com/u/6422482?v=4', 'gravatar_id': '', 'url': 'https://api.github.com/users/facebook-github-bot', 'html_url': 'https://github.com/facebook-github-bot', 'followers_url': 'https://api.github.com/users/facebook-github-bot/followers', 'following_url': 'https://api.github.com/users/facebook-github-bot/following{/other_user}', 'gists_url': 'https://api.github.com/users/facebook-github-bot/gists{/gist_id}', 'starred_url': 'https://api.github.com/users/facebook-github-bot/starred{/owner}{/repo}', 'subscriptions_url': 'https://api.github.com/users/facebook-github-bot/subscriptions', 'organizations_url': 'https://api.github.com/users/facebook-github-bot/orgs', 'repos_url': 'https://api.github.com/users/facebook-github-bot/repos', 'events_url': 'https://api.github.com/users/facebook-github-bot/events{/privacy}', 'received_events_url': 'https://api.github.com/users/facebook-github-bot/received_events', 'type': 'User', 'site_admin': False}",referenced,1ffa81d772e2e85648537fe6db4e247b264811a0,https://api.github.com/repos/pytorch/pytorch/commits/1ffa81d772e2e85648537fe6db4e247b264811a0,2019-10-08T00:01:47Z,375,199,176
27350,2696871122,"{'login': 'soumith', 'id': 1310570, 'node_id': 'MDQ6VXNlcjEzMTA1NzA=', 'avatar_url': 'https://avatars0.githubusercontent.com/u/1310570?v=4', 'gravatar_id': '', 'url': 'https://api.github.com/users/soumith', 'html_url': 'https://github.com/soumith', 'followers_url': 'https://api.github.com/users/soumith/followers', 'following_url': 'https://api.github.com/users/soumith/following{/other_user}', 'gists_url': 'https://api.github.com/users/soumith/gists{/gist_id}', 'starred_url': 'https://api.github.com/users/soumith/starred{/owner}{/repo}', 'subscriptions_url': 'https://api.github.com/users/soumith/subscriptions', 'organizations_url': 'https://api.github.com/users/soumith/orgs', 'repos_url': 'https://api.github.com/users/soumith/repos', 'events_url': 'https://api.github.com/users/soumith/events{/privacy}', 'received_events_url': 'https://api.github.com/users/soumith/received_events', 'type': 'User', 'site_admin': False}",referenced,6bae48c1279d547b3b307c1cca06b01fb809a68a,https://api.github.com/repos/pytorch/pytorch/commits/6bae48c1279d547b3b307c1cca06b01fb809a68a,2019-10-08T21:01:35Z,375,199,176
27291,2684402600,"{'login': 'ezyang', 'id': 13564, 'node_id': 'MDQ6VXNlcjEzNTY0', 'avatar_url': 'https://avatars0.githubusercontent.com/u/13564?v=4', 'gravatar_id': '', 'url': 'https://api.github.com/users/ezyang', 'html_url': 'https://github.com/ezyang', 'followers_url': 'https://api.github.com/users/ezyang/followers', 'following_url': 'https://api.github.com/users/ezyang/following{/other_user}', 'gists_url': 'https://api.github.com/users/ezyang/gists{/gist_id}', 'starred_url': 'https://api.github.com/users/ezyang/starred{/owner}{/repo}', 'subscriptions_url': 'https://api.github.com/users/ezyang/subscriptions', 'organizations_url': 'https://api.github.com/users/ezyang/orgs', 'repos_url': 'https://api.github.com/users/ezyang/repos', 'events_url': 'https://api.github.com/users/ezyang/events{/privacy}', 'received_events_url': 'https://api.github.com/users/ezyang/received_events', 'type': 'User', 'site_admin': False}",referenced,12053a981cfd6e25c97a1dc8314e4ea313111ec9,https://api.github.com/repos/pytorch/pytorch/commits/12053a981cfd6e25c97a1dc8314e4ea313111ec9,2019-10-03T15:04:58Z,35,16,19
27291,2684402705,"{'login': 'ezyang', 'id': 13564, 'node_id': 'MDQ6VXNlcjEzNTY0', 'avatar_url': 'https://avatars0.githubusercontent.com/u/13564?v=4', 'gravatar_id': '', 'url': 'https://api.github.com/users/ezyang', 'html_url': 'https://github.com/ezyang', 'followers_url': 'https://api.github.com/users/ezyang/followers', 'following_url': 'https://api.github.com/users/ezyang/following{/other_user}', 'gists_url': 'https://api.github.com/users/ezyang/gists{/gist_id}', 'starred_url': 'https://api.github.com/users/ezyang/starred{/owner}{/repo}', 'subscriptions_url': 'https://api.github.com/users/ezyang/subscriptions', 'organizations_url': 'https://api.github.com/users/ezyang/orgs', 'repos_url': 'https://api.github.com/users/ezyang/repos', 'events_url': 'https://api.github.com/users/ezyang/events{/privacy}', 'received_events_url': 'https://api.github.com/users/ezyang/received_events', 'type': 'User', 'site_admin': False}",referenced,86c2f25138466b9ccf4db7a6e26ca6b7ca854a35,https://api.github.com/repos/pytorch/pytorch/commits/86c2f25138466b9ccf4db7a6e26ca6b7ca854a35,2019-10-03T15:05:00Z,35,16,19
27291,2684610386,"{'login': 'ezyang', 'id': 13564, 'node_id': 'MDQ6VXNlcjEzNTY0', 'avatar_url': 'https://avatars0.githubusercontent.com/u/13564?v=4', 'gravatar_id': '', 'url': 'https://api.github.com/users/ezyang', 'html_url': 'https://github.com/ezyang', 'followers_url': 'https://api.github.com/users/ezyang/followers', 'following_url': 'https://api.github.com/users/ezyang/following{/other_user}', 'gists_url': 'https://api.github.com/users/ezyang/gists{/gist_id}', 'starred_url': 'https://api.github.com/users/ezyang/starred{/owner}{/repo}', 'subscriptions_url': 'https://api.github.com/users/ezyang/subscriptions', 'organizations_url': 'https://api.github.com/users/ezyang/orgs', 'repos_url': 'https://api.github.com/users/ezyang/repos', 'events_url': 'https://api.github.com/users/ezyang/events{/privacy}', 'received_events_url': 'https://api.github.com/users/ezyang/received_events', 'type': 'User', 'site_admin': False}",referenced,af7ae6016a1077fcf440501dd4664c7cee33090d,https://api.github.com/repos/pytorch/pytorch/commits/af7ae6016a1077fcf440501dd4664c7cee33090d,2019-10-03T16:04:40Z,22,22,0
27291,2684610828,"{'login': 'ezyang', 'id': 13564, 'node_id': 'MDQ6VXNlcjEzNTY0', 'avatar_url': 'https://avatars0.githubusercontent.com/u/13564?v=4', 'gravatar_id': '', 'url': 'https://api.github.com/users/ezyang', 'html_url': 'https://github.com/ezyang', 'followers_url': 'https://api.github.com/users/ezyang/followers', 'following_url': 'https://api.github.com/users/ezyang/following{/other_user}', 'gists_url': 'https://api.github.com/users/ezyang/gists{/gist_id}', 'starred_url': 'https://api.github.com/users/ezyang/starred{/owner}{/repo}', 'subscriptions_url': 'https://api.github.com/users/ezyang/subscriptions', 'organizations_url': 'https://api.github.com/users/ezyang/orgs', 'repos_url': 'https://api.github.com/users/ezyang/repos', 'events_url': 'https://api.github.com/users/ezyang/events{/privacy}', 'received_events_url': 'https://api.github.com/users/ezyang/received_events', 'type': 'User', 'site_admin': False}",referenced,b76dbc5329b9d86c9e686d744bb90099d9db868f,https://api.github.com/repos/pytorch/pytorch/commits/b76dbc5329b9d86c9e686d744bb90099d9db868f,2019-10-03T16:04:49Z,57,38,19
27291,2684826664,"{'login': 'ezyang', 'id': 13564, 'node_id': 'MDQ6VXNlcjEzNTY0', 'avatar_url': 'https://avatars0.githubusercontent.com/u/13564?v=4', 'gravatar_id': '', 'url': 'https://api.github.com/users/ezyang', 'html_url': 'https://github.com/ezyang', 'followers_url': 'https://api.github.com/users/ezyang/followers', 'following_url': 'https://api.github.com/users/ezyang/following{/other_user}', 'gists_url': 'https://api.github.com/users/ezyang/gists{/gist_id}', 'starred_url': 'https://api.github.com/users/ezyang/starred{/owner}{/repo}', 'subscriptions_url': 'https://api.github.com/users/ezyang/subscriptions', 'organizations_url': 'https://api.github.com/users/ezyang/orgs', 'repos_url': 'https://api.github.com/users/ezyang/repos', 'events_url': 'https://api.github.com/users/ezyang/events{/privacy}', 'received_events_url': 'https://api.github.com/users/ezyang/received_events', 'type': 'User', 'site_admin': False}",referenced,f83b0c33c3ef22085126dd79678381a31813826c,https://api.github.com/repos/pytorch/pytorch/commits/f83b0c33c3ef22085126dd79678381a31813826c,2019-10-03T17:17:47Z,1,1,0
27291,2684826982,"{'login': 'ezyang', 'id': 13564, 'node_id': 'MDQ6VXNlcjEzNTY0', 'avatar_url': 'https://avatars0.githubusercontent.com/u/13564?v=4', 'gravatar_id': '', 'url': 'https://api.github.com/users/ezyang', 'html_url': 'https://github.com/ezyang', 'followers_url': 'https://api.github.com/users/ezyang/followers', 'following_url': 'https://api.github.com/users/ezyang/following{/other_user}', 'gists_url': 'https://api.github.com/users/ezyang/gists{/gist_id}', 'starred_url': 'https://api.github.com/users/ezyang/starred{/owner}{/repo}', 'subscriptions_url': 'https://api.github.com/users/ezyang/subscriptions', 'organizations_url': 'https://api.github.com/users/ezyang/orgs', 'repos_url': 'https://api.github.com/users/ezyang/repos', 'events_url': 'https://api.github.com/users/ezyang/events{/privacy}', 'received_events_url': 'https://api.github.com/users/ezyang/received_events', 'type': 'User', 'site_admin': False}",referenced,0e51718a033dd4ab555d0dadaeabf2c16e7a80ab,https://api.github.com/repos/pytorch/pytorch/commits/0e51718a033dd4ab555d0dadaeabf2c16e7a80ab,2019-10-03T17:17:52Z,58,39,19
27291,2684983473,"{'login': 'ezyang', 'id': 13564, 'node_id': 'MDQ6VXNlcjEzNTY0', 'avatar_url': 'https://avatars0.githubusercontent.com/u/13564?v=4', 'gravatar_id': '', 'url': 'https://api.github.com/users/ezyang', 'html_url': 'https://github.com/ezyang', 'followers_url': 'https://api.github.com/users/ezyang/followers', 'following_url': 'https://api.github.com/users/ezyang/following{/other_user}', 'gists_url': 'https://api.github.com/users/ezyang/gists{/gist_id}', 'starred_url': 'https://api.github.com/users/ezyang/starred{/owner}{/repo}', 'subscriptions_url': 'https://api.github.com/users/ezyang/subscriptions', 'organizations_url': 'https://api.github.com/users/ezyang/orgs', 'repos_url': 'https://api.github.com/users/ezyang/repos', 'events_url': 'https://api.github.com/users/ezyang/events{/privacy}', 'received_events_url': 'https://api.github.com/users/ezyang/received_events', 'type': 'User', 'site_admin': False}",referenced,452b07b6e3a9284e59f38ea23b9f6cedf4c48e33,https://api.github.com/repos/pytorch/pytorch/commits/452b07b6e3a9284e59f38ea23b9f6cedf4c48e33,2019-10-03T18:11:05Z,3,2,1
27291,2684983791,"{'login': 'ezyang', 'id': 13564, 'node_id': 'MDQ6VXNlcjEzNTY0', 'avatar_url': 'https://avatars0.githubusercontent.com/u/13564?v=4', 'gravatar_id': '', 'url': 'https://api.github.com/users/ezyang', 'html_url': 'https://github.com/ezyang', 'followers_url': 'https://api.github.com/users/ezyang/followers', 'following_url': 'https://api.github.com/users/ezyang/following{/other_user}', 'gists_url': 'https://api.github.com/users/ezyang/gists{/gist_id}', 'starred_url': 'https://api.github.com/users/ezyang/starred{/owner}{/repo}', 'subscriptions_url': 'https://api.github.com/users/ezyang/subscriptions', 'organizations_url': 'https://api.github.com/users/ezyang/orgs', 'repos_url': 'https://api.github.com/users/ezyang/repos', 'events_url': 'https://api.github.com/users/ezyang/events{/privacy}', 'received_events_url': 'https://api.github.com/users/ezyang/received_events', 'type': 'User', 'site_admin': False}",referenced,69a4c8e4541eee10e37b0835ee0a0126c8cb7cfb,https://api.github.com/repos/pytorch/pytorch/commits/69a4c8e4541eee10e37b0835ee0a0126c8cb7cfb,2019-10-03T18:11:11Z,61,41,20
27291,2685641087,"{'login': 'ezyang', 'id': 13564, 'node_id': 'MDQ6VXNlcjEzNTY0', 'avatar_url': 'https://avatars0.githubusercontent.com/u/13564?v=4', 'gravatar_id': '', 'url': 'https://api.github.com/users/ezyang', 'html_url': 'https://github.com/ezyang', 'followers_url': 'https://api.github.com/users/ezyang/followers', 'following_url': 'https://api.github.com/users/ezyang/following{/other_user}', 'gists_url': 'https://api.github.com/users/ezyang/gists{/gist_id}', 'starred_url': 'https://api.github.com/users/ezyang/starred{/owner}{/repo}', 'subscriptions_url': 'https://api.github.com/users/ezyang/subscriptions', 'organizations_url': 'https://api.github.com/users/ezyang/orgs', 'repos_url': 'https://api.github.com/users/ezyang/repos', 'events_url': 'https://api.github.com/users/ezyang/events{/privacy}', 'received_events_url': 'https://api.github.com/users/ezyang/received_events', 'type': 'User', 'site_admin': False}",referenced,3bc4f57f131b4f1a72905c659041ccb9a5151fd6,https://api.github.com/repos/pytorch/pytorch/commits/3bc4f57f131b4f1a72905c659041ccb9a5151fd6,2019-10-03T22:17:58Z,2,2,0
27291,2685641273,"{'login': 'ezyang', 'id': 13564, 'node_id': 'MDQ6VXNlcjEzNTY0', 'avatar_url': 'https://avatars0.githubusercontent.com/u/13564?v=4', 'gravatar_id': '', 'url': 'https://api.github.com/users/ezyang', 'html_url': 'https://github.com/ezyang', 'followers_url': 'https://api.github.com/users/ezyang/followers', 'following_url': 'https://api.github.com/users/ezyang/following{/other_user}', 'gists_url': 'https://api.github.com/users/ezyang/gists{/gist_id}', 'starred_url': 'https://api.github.com/users/ezyang/starred{/owner}{/repo}', 'subscriptions_url': 'https://api.github.com/users/ezyang/subscriptions', 'organizations_url': 'https://api.github.com/users/ezyang/orgs', 'repos_url': 'https://api.github.com/users/ezyang/repos', 'events_url': 'https://api.github.com/users/ezyang/events{/privacy}', 'received_events_url': 'https://api.github.com/users/ezyang/received_events', 'type': 'User', 'site_admin': False}",referenced,cbe9eb69cbad0b8dd0996306c68301f4e126c281,https://api.github.com/repos/pytorch/pytorch/commits/cbe9eb69cbad0b8dd0996306c68301f4e126c281,2019-10-03T22:18:04Z,63,43,20
27291,2688101149,"{'login': 'ezyang', 'id': 13564, 'node_id': 'MDQ6VXNlcjEzNTY0', 'avatar_url': 'https://avatars0.githubusercontent.com/u/13564?v=4', 'gravatar_id': '', 'url': 'https://api.github.com/users/ezyang', 'html_url': 'https://github.com/ezyang', 'followers_url': 'https://api.github.com/users/ezyang/followers', 'following_url': 'https://api.github.com/users/ezyang/following{/other_user}', 'gists_url': 'https://api.github.com/users/ezyang/gists{/gist_id}', 'starred_url': 'https://api.github.com/users/ezyang/starred{/owner}{/repo}', 'subscriptions_url': 'https://api.github.com/users/ezyang/subscriptions', 'organizations_url': 'https://api.github.com/users/ezyang/orgs', 'repos_url': 'https://api.github.com/users/ezyang/repos', 'events_url': 'https://api.github.com/users/ezyang/events{/privacy}', 'received_events_url': 'https://api.github.com/users/ezyang/received_events', 'type': 'User', 'site_admin': False}",referenced,f1a0787a3740a02cb6005bf4c75e75188b1343dc,https://api.github.com/repos/pytorch/pytorch/commits/f1a0787a3740a02cb6005bf4c75e75188b1343dc,2019-10-04T17:10:54Z,1,1,0
27291,2688101487,"{'login': 'ezyang', 'id': 13564, 'node_id': 'MDQ6VXNlcjEzNTY0', 'avatar_url': 'https://avatars0.githubusercontent.com/u/13564?v=4', 'gravatar_id': '', 'url': 'https://api.github.com/users/ezyang', 'html_url': 'https://github.com/ezyang', 'followers_url': 'https://api.github.com/users/ezyang/followers', 'following_url': 'https://api.github.com/users/ezyang/following{/other_user}', 'gists_url': 'https://api.github.com/users/ezyang/gists{/gist_id}', 'starred_url': 'https://api.github.com/users/ezyang/starred{/owner}{/repo}', 'subscriptions_url': 'https://api.github.com/users/ezyang/subscriptions', 'organizations_url': 'https://api.github.com/users/ezyang/orgs', 'repos_url': 'https://api.github.com/users/ezyang/repos', 'events_url': 'https://api.github.com/users/ezyang/events{/privacy}', 'received_events_url': 'https://api.github.com/users/ezyang/received_events', 'type': 'User', 'site_admin': False}",referenced,383e1ad299e7be093f70b8e4db4c4650ae272628,https://api.github.com/repos/pytorch/pytorch/commits/383e1ad299e7be093f70b8e4db4c4650ae272628,2019-10-04T17:11:02Z,62,43,19
27291,2688644662,"{'login': 'ezyang', 'id': 13564, 'node_id': 'MDQ6VXNlcjEzNTY0', 'avatar_url': 'https://avatars0.githubusercontent.com/u/13564?v=4', 'gravatar_id': '', 'url': 'https://api.github.com/users/ezyang', 'html_url': 'https://github.com/ezyang', 'followers_url': 'https://api.github.com/users/ezyang/followers', 'following_url': 'https://api.github.com/users/ezyang/following{/other_user}', 'gists_url': 'https://api.github.com/users/ezyang/gists{/gist_id}', 'starred_url': 'https://api.github.com/users/ezyang/starred{/owner}{/repo}', 'subscriptions_url': 'https://api.github.com/users/ezyang/subscriptions', 'organizations_url': 'https://api.github.com/users/ezyang/orgs', 'repos_url': 'https://api.github.com/users/ezyang/repos', 'events_url': 'https://api.github.com/users/ezyang/events{/privacy}', 'received_events_url': 'https://api.github.com/users/ezyang/received_events', 'type': 'User', 'site_admin': False}",referenced,a096c609d5e6130a4ebb66a50b3a19fb34502d10,https://api.github.com/repos/pytorch/pytorch/commits/a096c609d5e6130a4ebb66a50b3a19fb34502d10,2019-10-04T20:47:31Z,11159,5960,5199
27291,2688644813,"{'login': 'ezyang', 'id': 13564, 'node_id': 'MDQ6VXNlcjEzNTY0', 'avatar_url': 'https://avatars0.githubusercontent.com/u/13564?v=4', 'gravatar_id': '', 'url': 'https://api.github.com/users/ezyang', 'html_url': 'https://github.com/ezyang', 'followers_url': 'https://api.github.com/users/ezyang/followers', 'following_url': 'https://api.github.com/users/ezyang/following{/other_user}', 'gists_url': 'https://api.github.com/users/ezyang/gists{/gist_id}', 'starred_url': 'https://api.github.com/users/ezyang/starred{/owner}{/repo}', 'subscriptions_url': 'https://api.github.com/users/ezyang/subscriptions', 'organizations_url': 'https://api.github.com/users/ezyang/orgs', 'repos_url': 'https://api.github.com/users/ezyang/repos', 'events_url': 'https://api.github.com/users/ezyang/events{/privacy}', 'received_events_url': 'https://api.github.com/users/ezyang/received_events', 'type': 'User', 'site_admin': False}",referenced,5087b9e9432811c98a5d0310d18b517d79905ee0,https://api.github.com/repos/pytorch/pytorch/commits/5087b9e9432811c98a5d0310d18b517d79905ee0,2019-10-04T20:47:36Z,62,43,19
27291,2695934552,"{'login': 'ezyang', 'id': 13564, 'node_id': 'MDQ6VXNlcjEzNTY0', 'avatar_url': 'https://avatars0.githubusercontent.com/u/13564?v=4', 'gravatar_id': '', 'url': 'https://api.github.com/users/ezyang', 'html_url': 'https://github.com/ezyang', 'followers_url': 'https://api.github.com/users/ezyang/followers', 'following_url': 'https://api.github.com/users/ezyang/following{/other_user}', 'gists_url': 'https://api.github.com/users/ezyang/gists{/gist_id}', 'starred_url': 'https://api.github.com/users/ezyang/starred{/owner}{/repo}', 'subscriptions_url': 'https://api.github.com/users/ezyang/subscriptions', 'organizations_url': 'https://api.github.com/users/ezyang/orgs', 'repos_url': 'https://api.github.com/users/ezyang/repos', 'events_url': 'https://api.github.com/users/ezyang/events{/privacy}', 'received_events_url': 'https://api.github.com/users/ezyang/received_events', 'type': 'User', 'site_admin': False}",referenced,e1059782659e887a1f5d30a917d46931d31a50df,https://api.github.com/repos/pytorch/pytorch/commits/e1059782659e887a1f5d30a917d46931d31a50df,2019-10-08T15:47:48Z,22861,10473,12388
27291,2695934977,"{'login': 'ezyang', 'id': 13564, 'node_id': 'MDQ6VXNlcjEzNTY0', 'avatar_url': 'https://avatars0.githubusercontent.com/u/13564?v=4', 'gravatar_id': '', 'url': 'https://api.github.com/users/ezyang', 'html_url': 'https://github.com/ezyang', 'followers_url': 'https://api.github.com/users/ezyang/followers', 'following_url': 'https://api.github.com/users/ezyang/following{/other_user}', 'gists_url': 'https://api.github.com/users/ezyang/gists{/gist_id}', 'starred_url': 'https://api.github.com/users/ezyang/starred{/owner}{/repo}', 'subscriptions_url': 'https://api.github.com/users/ezyang/subscriptions', 'organizations_url': 'https://api.github.com/users/ezyang/orgs', 'repos_url': 'https://api.github.com/users/ezyang/repos', 'events_url': 'https://api.github.com/users/ezyang/events{/privacy}', 'received_events_url': 'https://api.github.com/users/ezyang/received_events', 'type': 'User', 'site_admin': False}",referenced,1237a40ef1e742ee5046c72e034f5b928bcadd38,https://api.github.com/repos/pytorch/pytorch/commits/1237a40ef1e742ee5046c72e034f5b928bcadd38,2019-10-08T15:47:56Z,46,39,7
27291,2700090058,"{'login': 'facebook-github-bot', 'id': 6422482, 'node_id': 'MDQ6VXNlcjY0MjI0ODI=', 'avatar_url': 'https://avatars3.githubusercontent.com/u/6422482?v=4', 'gravatar_id': '', 'url': 'https://api.github.com/users/facebook-github-bot', 'html_url': 'https://github.com/facebook-github-bot', 'followers_url': 'https://api.github.com/users/facebook-github-bot/followers', 'following_url': 'https://api.github.com/users/facebook-github-bot/following{/other_user}', 'gists_url': 'https://api.github.com/users/facebook-github-bot/gists{/gist_id}', 'starred_url': 'https://api.github.com/users/facebook-github-bot/starred{/owner}{/repo}', 'subscriptions_url': 'https://api.github.com/users/facebook-github-bot/subscriptions', 'organizations_url': 'https://api.github.com/users/facebook-github-bot/orgs', 'repos_url': 'https://api.github.com/users/facebook-github-bot/repos', 'events_url': 'https://api.github.com/users/facebook-github-bot/events{/privacy}', 'received_events_url': 'https://api.github.com/users/facebook-github-bot/received_events', 'type': 'User', 'site_admin': False}",closed,013ca327308cf598dceac106518ff9edd7d4c118,https://api.github.com/repos/pytorch/pytorch/commits/013ca327308cf598dceac106518ff9edd7d4c118,2019-10-09T18:44:01Z,46,39,7
27266,2693866326,"{'login': 'facebook-github-bot', 'id': 6422482, 'node_id': 'MDQ6VXNlcjY0MjI0ODI=', 'avatar_url': 'https://avatars3.githubusercontent.com/u/6422482?v=4', 'gravatar_id': '', 'url': 'https://api.github.com/users/facebook-github-bot', 'html_url': 'https://github.com/facebook-github-bot', 'followers_url': 'https://api.github.com/users/facebook-github-bot/followers', 'following_url': 'https://api.github.com/users/facebook-github-bot/following{/other_user}', 'gists_url': 'https://api.github.com/users/facebook-github-bot/gists{/gist_id}', 'starred_url': 'https://api.github.com/users/facebook-github-bot/starred{/owner}{/repo}', 'subscriptions_url': 'https://api.github.com/users/facebook-github-bot/subscriptions', 'organizations_url': 'https://api.github.com/users/facebook-github-bot/orgs', 'repos_url': 'https://api.github.com/users/facebook-github-bot/repos', 'events_url': 'https://api.github.com/users/facebook-github-bot/events{/privacy}', 'received_events_url': 'https://api.github.com/users/facebook-github-bot/received_events', 'type': 'User', 'site_admin': False}",referenced,23f2fb0aecb1cb2d99fcca307b1748807c432d26,https://api.github.com/repos/pytorch/pytorch/commits/23f2fb0aecb1cb2d99fcca307b1748807c432d26,2019-10-08T02:25:21Z,1,1,0
27255,2725904592,"{'login': 'eellison', 'id': 11477974, 'node_id': 'MDQ6VXNlcjExNDc3OTc0', 'avatar_url': 'https://avatars2.githubusercontent.com/u/11477974?v=4', 'gravatar_id': '', 'url': 'https://api.github.com/users/eellison', 'html_url': 'https://github.com/eellison', 'followers_url': 'https://api.github.com/users/eellison/followers', 'following_url': 'https://api.github.com/users/eellison/following{/other_user}', 'gists_url': 'https://api.github.com/users/eellison/gists{/gist_id}', 'starred_url': 'https://api.github.com/users/eellison/starred{/owner}{/repo}', 'subscriptions_url': 'https://api.github.com/users/eellison/subscriptions', 'organizations_url': 'https://api.github.com/users/eellison/orgs', 'repos_url': 'https://api.github.com/users/eellison/repos', 'events_url': 'https://api.github.com/users/eellison/events{/privacy}', 'received_events_url': 'https://api.github.com/users/eellison/received_events', 'type': 'User', 'site_admin': False}",referenced,90c119280288176eb224fa4124de09ac1299d607,https://api.github.com/repos/pytorch/pytorch/commits/90c119280288176eb224fa4124de09ac1299d607,2019-10-18T18:54:42Z,10,4,6
27255,2769479524,"{'login': 'facebook-github-bot', 'id': 6422482, 'node_id': 'MDQ6VXNlcjY0MjI0ODI=', 'avatar_url': 'https://avatars3.githubusercontent.com/u/6422482?v=4', 'gravatar_id': '', 'url': 'https://api.github.com/users/facebook-github-bot', 'html_url': 'https://github.com/facebook-github-bot', 'followers_url': 'https://api.github.com/users/facebook-github-bot/followers', 'following_url': 'https://api.github.com/users/facebook-github-bot/following{/other_user}', 'gists_url': 'https://api.github.com/users/facebook-github-bot/gists{/gist_id}', 'starred_url': 'https://api.github.com/users/facebook-github-bot/starred{/owner}{/repo}', 'subscriptions_url': 'https://api.github.com/users/facebook-github-bot/subscriptions', 'organizations_url': 'https://api.github.com/users/facebook-github-bot/orgs', 'repos_url': 'https://api.github.com/users/facebook-github-bot/repos', 'events_url': 'https://api.github.com/users/facebook-github-bot/events{/privacy}', 'received_events_url': 'https://api.github.com/users/facebook-github-bot/received_events', 'type': 'User', 'site_admin': False}",referenced,60cb56d128f319505946d77a753fb03311b1a60e,https://api.github.com/repos/pytorch/pytorch/commits/60cb56d128f319505946d77a753fb03311b1a60e,2019-11-04T22:39:34Z,193,98,95
27232,2707666368,"{'login': 'xush6528', 'id': 7608630, 'node_id': 'MDQ6VXNlcjc2MDg2MzA=', 'avatar_url': 'https://avatars2.githubusercontent.com/u/7608630?v=4', 'gravatar_id': '', 'url': 'https://api.github.com/users/xush6528', 'html_url': 'https://github.com/xush6528', 'followers_url': 'https://api.github.com/users/xush6528/followers', 'following_url': 'https://api.github.com/users/xush6528/following{/other_user}', 'gists_url': 'https://api.github.com/users/xush6528/gists{/gist_id}', 'starred_url': 'https://api.github.com/users/xush6528/starred{/owner}{/repo}', 'subscriptions_url': 'https://api.github.com/users/xush6528/subscriptions', 'organizations_url': 'https://api.github.com/users/xush6528/orgs', 'repos_url': 'https://api.github.com/users/xush6528/repos', 'events_url': 'https://api.github.com/users/xush6528/events{/privacy}', 'received_events_url': 'https://api.github.com/users/xush6528/received_events', 'type': 'User', 'site_admin': False}",referenced,75effdc4fa3c586678ab3315cbc45e2ea09ef7d2,https://api.github.com/repos/pytorch/pytorch/commits/75effdc4fa3c586678ab3315cbc45e2ea09ef7d2,2019-10-11T23:35:55Z,2,1,1
27232,2707666882,"{'login': 'xush6528', 'id': 7608630, 'node_id': 'MDQ6VXNlcjc2MDg2MzA=', 'avatar_url': 'https://avatars2.githubusercontent.com/u/7608630?v=4', 'gravatar_id': '', 'url': 'https://api.github.com/users/xush6528', 'html_url': 'https://github.com/xush6528', 'followers_url': 'https://api.github.com/users/xush6528/followers', 'following_url': 'https://api.github.com/users/xush6528/following{/other_user}', 'gists_url': 'https://api.github.com/users/xush6528/gists{/gist_id}', 'starred_url': 'https://api.github.com/users/xush6528/starred{/owner}{/repo}', 'subscriptions_url': 'https://api.github.com/users/xush6528/subscriptions', 'organizations_url': 'https://api.github.com/users/xush6528/orgs', 'repos_url': 'https://api.github.com/users/xush6528/repos', 'events_url': 'https://api.github.com/users/xush6528/events{/privacy}', 'received_events_url': 'https://api.github.com/users/xush6528/received_events', 'type': 'User', 'site_admin': False}",referenced,e761f17f237c1605708c237a353478648bdcac68,https://api.github.com/repos/pytorch/pytorch/commits/e761f17f237c1605708c237a353478648bdcac68,2019-10-11T23:36:27Z,2,1,1
27232,2707667089,"{'login': 'xush6528', 'id': 7608630, 'node_id': 'MDQ6VXNlcjc2MDg2MzA=', 'avatar_url': 'https://avatars2.githubusercontent.com/u/7608630?v=4', 'gravatar_id': '', 'url': 'https://api.github.com/users/xush6528', 'html_url': 'https://github.com/xush6528', 'followers_url': 'https://api.github.com/users/xush6528/followers', 'following_url': 'https://api.github.com/users/xush6528/following{/other_user}', 'gists_url': 'https://api.github.com/users/xush6528/gists{/gist_id}', 'starred_url': 'https://api.github.com/users/xush6528/starred{/owner}{/repo}', 'subscriptions_url': 'https://api.github.com/users/xush6528/subscriptions', 'organizations_url': 'https://api.github.com/users/xush6528/orgs', 'repos_url': 'https://api.github.com/users/xush6528/repos', 'events_url': 'https://api.github.com/users/xush6528/events{/privacy}', 'received_events_url': 'https://api.github.com/users/xush6528/received_events', 'type': 'User', 'site_admin': False}",referenced,ddc16326df8bcdd8e89e41261bbb63d0848b707d,https://api.github.com/repos/pytorch/pytorch/commits/ddc16326df8bcdd8e89e41261bbb63d0848b707d,2019-10-11T23:36:42Z,2,1,1
27232,2707673630,"{'login': 'xush6528', 'id': 7608630, 'node_id': 'MDQ6VXNlcjc2MDg2MzA=', 'avatar_url': 'https://avatars2.githubusercontent.com/u/7608630?v=4', 'gravatar_id': '', 'url': 'https://api.github.com/users/xush6528', 'html_url': 'https://github.com/xush6528', 'followers_url': 'https://api.github.com/users/xush6528/followers', 'following_url': 'https://api.github.com/users/xush6528/following{/other_user}', 'gists_url': 'https://api.github.com/users/xush6528/gists{/gist_id}', 'starred_url': 'https://api.github.com/users/xush6528/starred{/owner}{/repo}', 'subscriptions_url': 'https://api.github.com/users/xush6528/subscriptions', 'organizations_url': 'https://api.github.com/users/xush6528/orgs', 'repos_url': 'https://api.github.com/users/xush6528/repos', 'events_url': 'https://api.github.com/users/xush6528/events{/privacy}', 'received_events_url': 'https://api.github.com/users/xush6528/received_events', 'type': 'User', 'site_admin': False}",referenced,7e20f2abbc4dd37a63694358c644ddc1a8f75315,https://api.github.com/repos/pytorch/pytorch/commits/7e20f2abbc4dd37a63694358c644ddc1a8f75315,2019-10-11T23:43:13Z,12,6,6
27232,2707673717,"{'login': 'xush6528', 'id': 7608630, 'node_id': 'MDQ6VXNlcjc2MDg2MzA=', 'avatar_url': 'https://avatars2.githubusercontent.com/u/7608630?v=4', 'gravatar_id': '', 'url': 'https://api.github.com/users/xush6528', 'html_url': 'https://github.com/xush6528', 'followers_url': 'https://api.github.com/users/xush6528/followers', 'following_url': 'https://api.github.com/users/xush6528/following{/other_user}', 'gists_url': 'https://api.github.com/users/xush6528/gists{/gist_id}', 'starred_url': 'https://api.github.com/users/xush6528/starred{/owner}{/repo}', 'subscriptions_url': 'https://api.github.com/users/xush6528/subscriptions', 'organizations_url': 'https://api.github.com/users/xush6528/orgs', 'repos_url': 'https://api.github.com/users/xush6528/repos', 'events_url': 'https://api.github.com/users/xush6528/events{/privacy}', 'received_events_url': 'https://api.github.com/users/xush6528/received_events', 'type': 'User', 'site_admin': False}",referenced,17892ca080b63d98873c81cf19999718d011aa0d,https://api.github.com/repos/pytorch/pytorch/commits/17892ca080b63d98873c81cf19999718d011aa0d,2019-10-11T23:43:19Z,14,7,7
27232,2707726929,"{'login': 'xush6528', 'id': 7608630, 'node_id': 'MDQ6VXNlcjc2MDg2MzA=', 'avatar_url': 'https://avatars2.githubusercontent.com/u/7608630?v=4', 'gravatar_id': '', 'url': 'https://api.github.com/users/xush6528', 'html_url': 'https://github.com/xush6528', 'followers_url': 'https://api.github.com/users/xush6528/followers', 'following_url': 'https://api.github.com/users/xush6528/following{/other_user}', 'gists_url': 'https://api.github.com/users/xush6528/gists{/gist_id}', 'starred_url': 'https://api.github.com/users/xush6528/starred{/owner}{/repo}', 'subscriptions_url': 'https://api.github.com/users/xush6528/subscriptions', 'organizations_url': 'https://api.github.com/users/xush6528/orgs', 'repos_url': 'https://api.github.com/users/xush6528/repos', 'events_url': 'https://api.github.com/users/xush6528/events{/privacy}', 'received_events_url': 'https://api.github.com/users/xush6528/received_events', 'type': 'User', 'site_admin': False}",referenced,b6759ea21475791996c463be682dc68c78f2fe6f,https://api.github.com/repos/pytorch/pytorch/commits/b6759ea21475791996c463be682dc68c78f2fe6f,2019-10-12T00:50:37Z,2,1,1
27232,2707726970,"{'login': 'xush6528', 'id': 7608630, 'node_id': 'MDQ6VXNlcjc2MDg2MzA=', 'avatar_url': 'https://avatars2.githubusercontent.com/u/7608630?v=4', 'gravatar_id': '', 'url': 'https://api.github.com/users/xush6528', 'html_url': 'https://github.com/xush6528', 'followers_url': 'https://api.github.com/users/xush6528/followers', 'following_url': 'https://api.github.com/users/xush6528/following{/other_user}', 'gists_url': 'https://api.github.com/users/xush6528/gists{/gist_id}', 'starred_url': 'https://api.github.com/users/xush6528/starred{/owner}{/repo}', 'subscriptions_url': 'https://api.github.com/users/xush6528/subscriptions', 'organizations_url': 'https://api.github.com/users/xush6528/orgs', 'repos_url': 'https://api.github.com/users/xush6528/repos', 'events_url': 'https://api.github.com/users/xush6528/events{/privacy}', 'received_events_url': 'https://api.github.com/users/xush6528/received_events', 'type': 'User', 'site_admin': False}",referenced,27744308748fa4d1f1036b74d70b39ef845394dc,https://api.github.com/repos/pytorch/pytorch/commits/27744308748fa4d1f1036b74d70b39ef845394dc,2019-10-12T00:50:43Z,16,8,8
27232,2707789174,"{'login': 'facebook-github-bot', 'id': 6422482, 'node_id': 'MDQ6VXNlcjY0MjI0ODI=', 'avatar_url': 'https://avatars3.githubusercontent.com/u/6422482?v=4', 'gravatar_id': '', 'url': 'https://api.github.com/users/facebook-github-bot', 'html_url': 'https://github.com/facebook-github-bot', 'followers_url': 'https://api.github.com/users/facebook-github-bot/followers', 'following_url': 'https://api.github.com/users/facebook-github-bot/following{/other_user}', 'gists_url': 'https://api.github.com/users/facebook-github-bot/gists{/gist_id}', 'starred_url': 'https://api.github.com/users/facebook-github-bot/starred{/owner}{/repo}', 'subscriptions_url': 'https://api.github.com/users/facebook-github-bot/subscriptions', 'organizations_url': 'https://api.github.com/users/facebook-github-bot/orgs', 'repos_url': 'https://api.github.com/users/facebook-github-bot/repos', 'events_url': 'https://api.github.com/users/facebook-github-bot/events{/privacy}', 'received_events_url': 'https://api.github.com/users/facebook-github-bot/received_events', 'type': 'User', 'site_admin': False}",closed,130127ca5991f1fb342496e2eb0e605a24551280,https://api.github.com/repos/pytorch/pytorch/commits/130127ca5991f1fb342496e2eb0e605a24551280,2019-10-12T02:49:57Z,16,8,8
27231,2704543886,"{'login': 'rohan-varma', 'id': 8039770, 'node_id': 'MDQ6VXNlcjgwMzk3NzA=', 'avatar_url': 'https://avatars2.githubusercontent.com/u/8039770?v=4', 'gravatar_id': '', 'url': 'https://api.github.com/users/rohan-varma', 'html_url': 'https://github.com/rohan-varma', 'followers_url': 'https://api.github.com/users/rohan-varma/followers', 'following_url': 'https://api.github.com/users/rohan-varma/following{/other_user}', 'gists_url': 'https://api.github.com/users/rohan-varma/gists{/gist_id}', 'starred_url': 'https://api.github.com/users/rohan-varma/starred{/owner}{/repo}', 'subscriptions_url': 'https://api.github.com/users/rohan-varma/subscriptions', 'organizations_url': 'https://api.github.com/users/rohan-varma/orgs', 'repos_url': 'https://api.github.com/users/rohan-varma/repos', 'events_url': 'https://api.github.com/users/rohan-varma/events{/privacy}', 'received_events_url': 'https://api.github.com/users/rohan-varma/received_events', 'type': 'User', 'site_admin': False}",referenced,c6f9cc9a50a9c4f9cc71e4fb5db06d3f77326c6a,https://api.github.com/repos/pytorch/pytorch/commits/c6f9cc9a50a9c4f9cc71e4fb5db06d3f77326c6a,2019-10-10T23:55:10Z,5011,3824,1187
27231,2706894907,"{'login': 'rohan-varma', 'id': 8039770, 'node_id': 'MDQ6VXNlcjgwMzk3NzA=', 'avatar_url': 'https://avatars2.githubusercontent.com/u/8039770?v=4', 'gravatar_id': '', 'url': 'https://api.github.com/users/rohan-varma', 'html_url': 'https://github.com/rohan-varma', 'followers_url': 'https://api.github.com/users/rohan-varma/followers', 'following_url': 'https://api.github.com/users/rohan-varma/following{/other_user}', 'gists_url': 'https://api.github.com/users/rohan-varma/gists{/gist_id}', 'starred_url': 'https://api.github.com/users/rohan-varma/starred{/owner}{/repo}', 'subscriptions_url': 'https://api.github.com/users/rohan-varma/subscriptions', 'organizations_url': 'https://api.github.com/users/rohan-varma/orgs', 'repos_url': 'https://api.github.com/users/rohan-varma/repos', 'events_url': 'https://api.github.com/users/rohan-varma/events{/privacy}', 'received_events_url': 'https://api.github.com/users/rohan-varma/received_events', 'type': 'User', 'site_admin': False}",referenced,322f6016b3d17aff9d48f4f42988ba3d29006e74,https://api.github.com/repos/pytorch/pytorch/commits/322f6016b3d17aff9d48f4f42988ba3d29006e74,2019-10-11T17:29:10Z,4655,4468,187
27230,2686816134,"{'login': 'facebook-github-bot', 'id': 6422482, 'node_id': 'MDQ6VXNlcjY0MjI0ODI=', 'avatar_url': 'https://avatars3.githubusercontent.com/u/6422482?v=4', 'gravatar_id': '', 'url': 'https://api.github.com/users/facebook-github-bot', 'html_url': 'https://github.com/facebook-github-bot', 'followers_url': 'https://api.github.com/users/facebook-github-bot/followers', 'following_url': 'https://api.github.com/users/facebook-github-bot/following{/other_user}', 'gists_url': 'https://api.github.com/users/facebook-github-bot/gists{/gist_id}', 'starred_url': 'https://api.github.com/users/facebook-github-bot/starred{/owner}{/repo}', 'subscriptions_url': 'https://api.github.com/users/facebook-github-bot/subscriptions', 'organizations_url': 'https://api.github.com/users/facebook-github-bot/orgs', 'repos_url': 'https://api.github.com/users/facebook-github-bot/repos', 'events_url': 'https://api.github.com/users/facebook-github-bot/events{/privacy}', 'received_events_url': 'https://api.github.com/users/facebook-github-bot/received_events', 'type': 'User', 'site_admin': False}",referenced,a7de545c6374cccd27cb871e284f774bc2395bbe,https://api.github.com/repos/pytorch/pytorch/commits/a7de545c6374cccd27cb871e284f774bc2395bbe,2019-10-04T09:41:14Z,1323,539,784
27215,2769141330,"{'login': 'ezyang', 'id': 13564, 'node_id': 'MDQ6VXNlcjEzNTY0', 'avatar_url': 'https://avatars0.githubusercontent.com/u/13564?v=4', 'gravatar_id': '', 'url': 'https://api.github.com/users/ezyang', 'html_url': 'https://github.com/ezyang', 'followers_url': 'https://api.github.com/users/ezyang/followers', 'following_url': 'https://api.github.com/users/ezyang/following{/other_user}', 'gists_url': 'https://api.github.com/users/ezyang/gists{/gist_id}', 'starred_url': 'https://api.github.com/users/ezyang/starred{/owner}{/repo}', 'subscriptions_url': 'https://api.github.com/users/ezyang/subscriptions', 'organizations_url': 'https://api.github.com/users/ezyang/orgs', 'repos_url': 'https://api.github.com/users/ezyang/repos', 'events_url': 'https://api.github.com/users/ezyang/events{/privacy}', 'received_events_url': 'https://api.github.com/users/ezyang/received_events', 'type': 'User', 'site_admin': False}",referenced,64a892c3a6ceebc0c3c3f1baf145454278995074,https://api.github.com/repos/pytorch/pytorch/commits/64a892c3a6ceebc0c3c3f1baf145454278995074,2019-11-04T20:37:18Z,32,2,30
27215,2769141885,"{'login': 'ezyang', 'id': 13564, 'node_id': 'MDQ6VXNlcjEzNTY0', 'avatar_url': 'https://avatars0.githubusercontent.com/u/13564?v=4', 'gravatar_id': '', 'url': 'https://api.github.com/users/ezyang', 'html_url': 'https://github.com/ezyang', 'followers_url': 'https://api.github.com/users/ezyang/followers', 'following_url': 'https://api.github.com/users/ezyang/following{/other_user}', 'gists_url': 'https://api.github.com/users/ezyang/gists{/gist_id}', 'starred_url': 'https://api.github.com/users/ezyang/starred{/owner}{/repo}', 'subscriptions_url': 'https://api.github.com/users/ezyang/subscriptions', 'organizations_url': 'https://api.github.com/users/ezyang/orgs', 'repos_url': 'https://api.github.com/users/ezyang/repos', 'events_url': 'https://api.github.com/users/ezyang/events{/privacy}', 'received_events_url': 'https://api.github.com/users/ezyang/received_events', 'type': 'User', 'site_admin': False}",referenced,cea54aec5e96f29acaa1647426c1f6bb05575a30,https://api.github.com/repos/pytorch/pytorch/commits/cea54aec5e96f29acaa1647426c1f6bb05575a30,2019-11-04T20:37:29Z,32,2,30
27215,2777192611,"{'login': 'facebook-github-bot', 'id': 6422482, 'node_id': 'MDQ6VXNlcjY0MjI0ODI=', 'avatar_url': 'https://avatars3.githubusercontent.com/u/6422482?v=4', 'gravatar_id': '', 'url': 'https://api.github.com/users/facebook-github-bot', 'html_url': 'https://github.com/facebook-github-bot', 'followers_url': 'https://api.github.com/users/facebook-github-bot/followers', 'following_url': 'https://api.github.com/users/facebook-github-bot/following{/other_user}', 'gists_url': 'https://api.github.com/users/facebook-github-bot/gists{/gist_id}', 'starred_url': 'https://api.github.com/users/facebook-github-bot/starred{/owner}{/repo}', 'subscriptions_url': 'https://api.github.com/users/facebook-github-bot/subscriptions', 'organizations_url': 'https://api.github.com/users/facebook-github-bot/orgs', 'repos_url': 'https://api.github.com/users/facebook-github-bot/repos', 'events_url': 'https://api.github.com/users/facebook-github-bot/events{/privacy}', 'received_events_url': 'https://api.github.com/users/facebook-github-bot/received_events', 'type': 'User', 'site_admin': False}",referenced,a5d356cb39d521c25786c9ef14981f02ca3459be,https://api.github.com/repos/pytorch/pytorch/commits/a5d356cb39d521c25786c9ef14981f02ca3459be,2019-11-06T23:02:19Z,32,2,30
27215,2796040755,"{'login': 'ezyang', 'id': 13564, 'node_id': 'MDQ6VXNlcjEzNTY0', 'avatar_url': 'https://avatars0.githubusercontent.com/u/13564?v=4', 'gravatar_id': '', 'url': 'https://api.github.com/users/ezyang', 'html_url': 'https://github.com/ezyang', 'followers_url': 'https://api.github.com/users/ezyang/followers', 'following_url': 'https://api.github.com/users/ezyang/following{/other_user}', 'gists_url': 'https://api.github.com/users/ezyang/gists{/gist_id}', 'starred_url': 'https://api.github.com/users/ezyang/starred{/owner}{/repo}', 'subscriptions_url': 'https://api.github.com/users/ezyang/subscriptions', 'organizations_url': 'https://api.github.com/users/ezyang/orgs', 'repos_url': 'https://api.github.com/users/ezyang/repos', 'events_url': 'https://api.github.com/users/ezyang/events{/privacy}', 'received_events_url': 'https://api.github.com/users/ezyang/received_events', 'type': 'User', 'site_admin': False}",referenced,699811b0c84e427ab31463e2d891a2069ab58679,https://api.github.com/repos/pytorch/pytorch/commits/699811b0c84e427ab31463e2d891a2069ab58679,2019-11-13T16:51:28Z,174,100,74
27215,2796041110,"{'login': 'ezyang', 'id': 13564, 'node_id': 'MDQ6VXNlcjEzNTY0', 'avatar_url': 'https://avatars0.githubusercontent.com/u/13564?v=4', 'gravatar_id': '', 'url': 'https://api.github.com/users/ezyang', 'html_url': 'https://github.com/ezyang', 'followers_url': 'https://api.github.com/users/ezyang/followers', 'following_url': 'https://api.github.com/users/ezyang/following{/other_user}', 'gists_url': 'https://api.github.com/users/ezyang/gists{/gist_id}', 'starred_url': 'https://api.github.com/users/ezyang/starred{/owner}{/repo}', 'subscriptions_url': 'https://api.github.com/users/ezyang/subscriptions', 'organizations_url': 'https://api.github.com/users/ezyang/orgs', 'repos_url': 'https://api.github.com/users/ezyang/repos', 'events_url': 'https://api.github.com/users/ezyang/events{/privacy}', 'received_events_url': 'https://api.github.com/users/ezyang/received_events', 'type': 'User', 'site_admin': False}",referenced,256c1bcea89f2e214585dc04ebdb6a69f65283d1,https://api.github.com/repos/pytorch/pytorch/commits/256c1bcea89f2e214585dc04ebdb6a69f65283d1,2019-11-13T16:51:35Z,174,100,74
27215,2796775297,"{'login': 'ezyang', 'id': 13564, 'node_id': 'MDQ6VXNlcjEzNTY0', 'avatar_url': 'https://avatars0.githubusercontent.com/u/13564?v=4', 'gravatar_id': '', 'url': 'https://api.github.com/users/ezyang', 'html_url': 'https://github.com/ezyang', 'followers_url': 'https://api.github.com/users/ezyang/followers', 'following_url': 'https://api.github.com/users/ezyang/following{/other_user}', 'gists_url': 'https://api.github.com/users/ezyang/gists{/gist_id}', 'starred_url': 'https://api.github.com/users/ezyang/starred{/owner}{/repo}', 'subscriptions_url': 'https://api.github.com/users/ezyang/subscriptions', 'organizations_url': 'https://api.github.com/users/ezyang/orgs', 'repos_url': 'https://api.github.com/users/ezyang/repos', 'events_url': 'https://api.github.com/users/ezyang/events{/privacy}', 'received_events_url': 'https://api.github.com/users/ezyang/received_events', 'type': 'User', 'site_admin': False}",referenced,9cdde4555be8447f59a42a3318593f968ca4fe4f,https://api.github.com/repos/pytorch/pytorch/commits/9cdde4555be8447f59a42a3318593f968ca4fe4f,2019-11-13T20:50:24Z,42,21,21
27215,2796775483,"{'login': 'ezyang', 'id': 13564, 'node_id': 'MDQ6VXNlcjEzNTY0', 'avatar_url': 'https://avatars0.githubusercontent.com/u/13564?v=4', 'gravatar_id': '', 'url': 'https://api.github.com/users/ezyang', 'html_url': 'https://github.com/ezyang', 'followers_url': 'https://api.github.com/users/ezyang/followers', 'following_url': 'https://api.github.com/users/ezyang/following{/other_user}', 'gists_url': 'https://api.github.com/users/ezyang/gists{/gist_id}', 'starred_url': 'https://api.github.com/users/ezyang/starred{/owner}{/repo}', 'subscriptions_url': 'https://api.github.com/users/ezyang/subscriptions', 'organizations_url': 'https://api.github.com/users/ezyang/orgs', 'repos_url': 'https://api.github.com/users/ezyang/repos', 'events_url': 'https://api.github.com/users/ezyang/events{/privacy}', 'received_events_url': 'https://api.github.com/users/ezyang/received_events', 'type': 'User', 'site_admin': False}",referenced,6ed26eff3925294e8018c97ed0b739711edc15be,https://api.github.com/repos/pytorch/pytorch/commits/6ed26eff3925294e8018c97ed0b739711edc15be,2019-11-13T20:50:28Z,212,119,93
27215,2796962365,"{'login': 'ezyang', 'id': 13564, 'node_id': 'MDQ6VXNlcjEzNTY0', 'avatar_url': 'https://avatars0.githubusercontent.com/u/13564?v=4', 'gravatar_id': '', 'url': 'https://api.github.com/users/ezyang', 'html_url': 'https://github.com/ezyang', 'followers_url': 'https://api.github.com/users/ezyang/followers', 'following_url': 'https://api.github.com/users/ezyang/following{/other_user}', 'gists_url': 'https://api.github.com/users/ezyang/gists{/gist_id}', 'starred_url': 'https://api.github.com/users/ezyang/starred{/owner}{/repo}', 'subscriptions_url': 'https://api.github.com/users/ezyang/subscriptions', 'organizations_url': 'https://api.github.com/users/ezyang/orgs', 'repos_url': 'https://api.github.com/users/ezyang/repos', 'events_url': 'https://api.github.com/users/ezyang/events{/privacy}', 'received_events_url': 'https://api.github.com/users/ezyang/received_events', 'type': 'User', 'site_admin': False}",referenced,b19fd007c20f2dd97ca3ef05f6d287807fc564d3,https://api.github.com/repos/pytorch/pytorch/commits/b19fd007c20f2dd97ca3ef05f6d287807fc564d3,2019-11-13T21:55:26Z,6,3,3
27198,2700610096,"{'login': 'facebook-github-bot', 'id': 6422482, 'node_id': 'MDQ6VXNlcjY0MjI0ODI=', 'avatar_url': 'https://avatars3.githubusercontent.com/u/6422482?v=4', 'gravatar_id': '', 'url': 'https://api.github.com/users/facebook-github-bot', 'html_url': 'https://github.com/facebook-github-bot', 'followers_url': 'https://api.github.com/users/facebook-github-bot/followers', 'following_url': 'https://api.github.com/users/facebook-github-bot/following{/other_user}', 'gists_url': 'https://api.github.com/users/facebook-github-bot/gists{/gist_id}', 'starred_url': 'https://api.github.com/users/facebook-github-bot/starred{/owner}{/repo}', 'subscriptions_url': 'https://api.github.com/users/facebook-github-bot/subscriptions', 'organizations_url': 'https://api.github.com/users/facebook-github-bot/orgs', 'repos_url': 'https://api.github.com/users/facebook-github-bot/repos', 'events_url': 'https://api.github.com/users/facebook-github-bot/events{/privacy}', 'received_events_url': 'https://api.github.com/users/facebook-github-bot/received_events', 'type': 'User', 'site_admin': False}",referenced,3246fddfd63472521786099fd4681ba1223bf1b6,https://api.github.com/repos/pytorch/pytorch/commits/3246fddfd63472521786099fd4681ba1223bf1b6,2019-10-09T21:44:54Z,119,119,0
27196,2701459172,"{'login': 'facebook-github-bot', 'id': 6422482, 'node_id': 'MDQ6VXNlcjY0MjI0ODI=', 'avatar_url': 'https://avatars3.githubusercontent.com/u/6422482?v=4', 'gravatar_id': '', 'url': 'https://api.github.com/users/facebook-github-bot', 'html_url': 'https://github.com/facebook-github-bot', 'followers_url': 'https://api.github.com/users/facebook-github-bot/followers', 'following_url': 'https://api.github.com/users/facebook-github-bot/following{/other_user}', 'gists_url': 'https://api.github.com/users/facebook-github-bot/gists{/gist_id}', 'starred_url': 'https://api.github.com/users/facebook-github-bot/starred{/owner}{/repo}', 'subscriptions_url': 'https://api.github.com/users/facebook-github-bot/subscriptions', 'organizations_url': 'https://api.github.com/users/facebook-github-bot/orgs', 'repos_url': 'https://api.github.com/users/facebook-github-bot/repos', 'events_url': 'https://api.github.com/users/facebook-github-bot/events{/privacy}', 'received_events_url': 'https://api.github.com/users/facebook-github-bot/received_events', 'type': 'User', 'site_admin': False}",referenced,f3df6b8ede4057453486964100e6cba284d9fa36,https://api.github.com/repos/pytorch/pytorch/commits/f3df6b8ede4057453486964100e6cba284d9fa36,2019-10-10T06:18:00Z,153,153,0
27182,2682297143,"{'login': 'zhaojuanmao', 'id': 48731194, 'node_id': 'MDQ6VXNlcjQ4NzMxMTk0', 'avatar_url': 'https://avatars0.githubusercontent.com/u/48731194?v=4', 'gravatar_id': '', 'url': 'https://api.github.com/users/zhaojuanmao', 'html_url': 'https://github.com/zhaojuanmao', 'followers_url': 'https://api.github.com/users/zhaojuanmao/followers', 'following_url': 'https://api.github.com/users/zhaojuanmao/following{/other_user}', 'gists_url': 'https://api.github.com/users/zhaojuanmao/gists{/gist_id}', 'starred_url': 'https://api.github.com/users/zhaojuanmao/starred{/owner}{/repo}', 'subscriptions_url': 'https://api.github.com/users/zhaojuanmao/subscriptions', 'organizations_url': 'https://api.github.com/users/zhaojuanmao/orgs', 'repos_url': 'https://api.github.com/users/zhaojuanmao/repos', 'events_url': 'https://api.github.com/users/zhaojuanmao/events{/privacy}', 'received_events_url': 'https://api.github.com/users/zhaojuanmao/received_events', 'type': 'User', 'site_admin': False}",referenced,9bf80427211d5bb1d915c9dd60069eb7c5e0e167,https://api.github.com/repos/pytorch/pytorch/commits/9bf80427211d5bb1d915c9dd60069eb7c5e0e167,2019-10-02T22:56:41Z,57,50,7
27182,2682297667,"{'login': 'zhaojuanmao', 'id': 48731194, 'node_id': 'MDQ6VXNlcjQ4NzMxMTk0', 'avatar_url': 'https://avatars0.githubusercontent.com/u/48731194?v=4', 'gravatar_id': '', 'url': 'https://api.github.com/users/zhaojuanmao', 'html_url': 'https://github.com/zhaojuanmao', 'followers_url': 'https://api.github.com/users/zhaojuanmao/followers', 'following_url': 'https://api.github.com/users/zhaojuanmao/following{/other_user}', 'gists_url': 'https://api.github.com/users/zhaojuanmao/gists{/gist_id}', 'starred_url': 'https://api.github.com/users/zhaojuanmao/starred{/owner}{/repo}', 'subscriptions_url': 'https://api.github.com/users/zhaojuanmao/subscriptions', 'organizations_url': 'https://api.github.com/users/zhaojuanmao/orgs', 'repos_url': 'https://api.github.com/users/zhaojuanmao/repos', 'events_url': 'https://api.github.com/users/zhaojuanmao/events{/privacy}', 'received_events_url': 'https://api.github.com/users/zhaojuanmao/received_events', 'type': 'User', 'site_admin': False}",referenced,33e5d931837eee23faa71dc875131f81422ad65c,https://api.github.com/repos/pytorch/pytorch/commits/33e5d931837eee23faa71dc875131f81422ad65c,2019-10-02T22:57:01Z,57,50,7
27157,2682893543,"{'login': 'facebook-github-bot', 'id': 6422482, 'node_id': 'MDQ6VXNlcjY0MjI0ODI=', 'avatar_url': 'https://avatars3.githubusercontent.com/u/6422482?v=4', 'gravatar_id': '', 'url': 'https://api.github.com/users/facebook-github-bot', 'html_url': 'https://github.com/facebook-github-bot', 'followers_url': 'https://api.github.com/users/facebook-github-bot/followers', 'following_url': 'https://api.github.com/users/facebook-github-bot/following{/other_user}', 'gists_url': 'https://api.github.com/users/facebook-github-bot/gists{/gist_id}', 'starred_url': 'https://api.github.com/users/facebook-github-bot/starred{/owner}{/repo}', 'subscriptions_url': 'https://api.github.com/users/facebook-github-bot/subscriptions', 'organizations_url': 'https://api.github.com/users/facebook-github-bot/orgs', 'repos_url': 'https://api.github.com/users/facebook-github-bot/repos', 'events_url': 'https://api.github.com/users/facebook-github-bot/events{/privacy}', 'received_events_url': 'https://api.github.com/users/facebook-github-bot/received_events', 'type': 'User', 'site_admin': False}",closed,fc249c79245af10eeb564ab0f1d42b025a8e07f4,https://api.github.com/repos/pytorch/pytorch/commits/fc249c79245af10eeb564ab0f1d42b025a8e07f4,2019-10-03T06:06:11Z,14,10,4
27082,2677175606,"{'login': 'facebook-github-bot', 'id': 6422482, 'node_id': 'MDQ6VXNlcjY0MjI0ODI=', 'avatar_url': 'https://avatars3.githubusercontent.com/u/6422482?v=4', 'gravatar_id': '', 'url': 'https://api.github.com/users/facebook-github-bot', 'html_url': 'https://github.com/facebook-github-bot', 'followers_url': 'https://api.github.com/users/facebook-github-bot/followers', 'following_url': 'https://api.github.com/users/facebook-github-bot/following{/other_user}', 'gists_url': 'https://api.github.com/users/facebook-github-bot/gists{/gist_id}', 'starred_url': 'https://api.github.com/users/facebook-github-bot/starred{/owner}{/repo}', 'subscriptions_url': 'https://api.github.com/users/facebook-github-bot/subscriptions', 'organizations_url': 'https://api.github.com/users/facebook-github-bot/orgs', 'repos_url': 'https://api.github.com/users/facebook-github-bot/repos', 'events_url': 'https://api.github.com/users/facebook-github-bot/events{/privacy}', 'received_events_url': 'https://api.github.com/users/facebook-github-bot/received_events', 'type': 'User', 'site_admin': False}",referenced,18eea8269ae60faef1cba0f9d0f00fbb9dac16f2,https://api.github.com/repos/pytorch/pytorch/commits/18eea8269ae60faef1cba0f9d0f00fbb9dac16f2,2019-10-01T14:05:37Z,23,23,0
27081,2678704315,"{'login': 'bzinodev', 'id': 55170918, 'node_id': 'MDQ6VXNlcjU1MTcwOTE4', 'avatar_url': 'https://avatars2.githubusercontent.com/u/55170918?v=4', 'gravatar_id': '', 'url': 'https://api.github.com/users/bzinodev', 'html_url': 'https://github.com/bzinodev', 'followers_url': 'https://api.github.com/users/bzinodev/followers', 'following_url': 'https://api.github.com/users/bzinodev/following{/other_user}', 'gists_url': 'https://api.github.com/users/bzinodev/gists{/gist_id}', 'starred_url': 'https://api.github.com/users/bzinodev/starred{/owner}{/repo}', 'subscriptions_url': 'https://api.github.com/users/bzinodev/subscriptions', 'organizations_url': 'https://api.github.com/users/bzinodev/orgs', 'repos_url': 'https://api.github.com/users/bzinodev/repos', 'events_url': 'https://api.github.com/users/bzinodev/events{/privacy}', 'received_events_url': 'https://api.github.com/users/bzinodev/received_events', 'type': 'User', 'site_admin': False}",referenced,d1b72f546d5c933a4b4c16027c27a2337bb6f0d0,https://api.github.com/repos/pytorch/pytorch/commits/d1b72f546d5c933a4b4c16027c27a2337bb6f0d0,2019-10-01T22:10:52Z,62,58,4
27081,2678704615,"{'login': 'bzinodev', 'id': 55170918, 'node_id': 'MDQ6VXNlcjU1MTcwOTE4', 'avatar_url': 'https://avatars2.githubusercontent.com/u/55170918?v=4', 'gravatar_id': '', 'url': 'https://api.github.com/users/bzinodev', 'html_url': 'https://github.com/bzinodev', 'followers_url': 'https://api.github.com/users/bzinodev/followers', 'following_url': 'https://api.github.com/users/bzinodev/following{/other_user}', 'gists_url': 'https://api.github.com/users/bzinodev/gists{/gist_id}', 'starred_url': 'https://api.github.com/users/bzinodev/starred{/owner}{/repo}', 'subscriptions_url': 'https://api.github.com/users/bzinodev/subscriptions', 'organizations_url': 'https://api.github.com/users/bzinodev/orgs', 'repos_url': 'https://api.github.com/users/bzinodev/repos', 'events_url': 'https://api.github.com/users/bzinodev/events{/privacy}', 'received_events_url': 'https://api.github.com/users/bzinodev/received_events', 'type': 'User', 'site_admin': False}",referenced,961775b5ad8bf1893e6b2789ccc1cd435af352d6,https://api.github.com/repos/pytorch/pytorch/commits/961775b5ad8bf1893e6b2789ccc1cd435af352d6,2019-10-01T22:11:03Z,62,58,4
27081,2678777612,"{'login': 'bzinodev', 'id': 55170918, 'node_id': 'MDQ6VXNlcjU1MTcwOTE4', 'avatar_url': 'https://avatars2.githubusercontent.com/u/55170918?v=4', 'gravatar_id': '', 'url': 'https://api.github.com/users/bzinodev', 'html_url': 'https://github.com/bzinodev', 'followers_url': 'https://api.github.com/users/bzinodev/followers', 'following_url': 'https://api.github.com/users/bzinodev/following{/other_user}', 'gists_url': 'https://api.github.com/users/bzinodev/gists{/gist_id}', 'starred_url': 'https://api.github.com/users/bzinodev/starred{/owner}{/repo}', 'subscriptions_url': 'https://api.github.com/users/bzinodev/subscriptions', 'organizations_url': 'https://api.github.com/users/bzinodev/orgs', 'repos_url': 'https://api.github.com/users/bzinodev/repos', 'events_url': 'https://api.github.com/users/bzinodev/events{/privacy}', 'received_events_url': 'https://api.github.com/users/bzinodev/received_events', 'type': 'User', 'site_admin': False}",referenced,b65b46c1272f3643c7ec16986bc07edc35d24b94,https://api.github.com/repos/pytorch/pytorch/commits/b65b46c1272f3643c7ec16986bc07edc35d24b94,2019-10-01T22:50:52Z,346,308,38
27081,2678777800,"{'login': 'bzinodev', 'id': 55170918, 'node_id': 'MDQ6VXNlcjU1MTcwOTE4', 'avatar_url': 'https://avatars2.githubusercontent.com/u/55170918?v=4', 'gravatar_id': '', 'url': 'https://api.github.com/users/bzinodev', 'html_url': 'https://github.com/bzinodev', 'followers_url': 'https://api.github.com/users/bzinodev/followers', 'following_url': 'https://api.github.com/users/bzinodev/following{/other_user}', 'gists_url': 'https://api.github.com/users/bzinodev/gists{/gist_id}', 'starred_url': 'https://api.github.com/users/bzinodev/starred{/owner}{/repo}', 'subscriptions_url': 'https://api.github.com/users/bzinodev/subscriptions', 'organizations_url': 'https://api.github.com/users/bzinodev/orgs', 'repos_url': 'https://api.github.com/users/bzinodev/repos', 'events_url': 'https://api.github.com/users/bzinodev/events{/privacy}', 'received_events_url': 'https://api.github.com/users/bzinodev/received_events', 'type': 'User', 'site_admin': False}",referenced,f26597827cc8a95745bf1a51672403c302fdf30d,https://api.github.com/repos/pytorch/pytorch/commits/f26597827cc8a95745bf1a51672403c302fdf30d,2019-10-01T22:50:59Z,62,58,4
27081,2678986326,"{'login': 'bzinodev', 'id': 55170918, 'node_id': 'MDQ6VXNlcjU1MTcwOTE4', 'avatar_url': 'https://avatars2.githubusercontent.com/u/55170918?v=4', 'gravatar_id': '', 'url': 'https://api.github.com/users/bzinodev', 'html_url': 'https://github.com/bzinodev', 'followers_url': 'https://api.github.com/users/bzinodev/followers', 'following_url': 'https://api.github.com/users/bzinodev/following{/other_user}', 'gists_url': 'https://api.github.com/users/bzinodev/gists{/gist_id}', 'starred_url': 'https://api.github.com/users/bzinodev/starred{/owner}{/repo}', 'subscriptions_url': 'https://api.github.com/users/bzinodev/subscriptions', 'organizations_url': 'https://api.github.com/users/bzinodev/orgs', 'repos_url': 'https://api.github.com/users/bzinodev/repos', 'events_url': 'https://api.github.com/users/bzinodev/events{/privacy}', 'received_events_url': 'https://api.github.com/users/bzinodev/received_events', 'type': 'User', 'site_admin': False}",referenced,842cef4773a49a7d698d97b60eb260e37976b0a9,https://api.github.com/repos/pytorch/pytorch/commits/842cef4773a49a7d698d97b60eb260e37976b0a9,2019-10-02T01:08:29Z,436,339,97
27081,2678986507,"{'login': 'bzinodev', 'id': 55170918, 'node_id': 'MDQ6VXNlcjU1MTcwOTE4', 'avatar_url': 'https://avatars2.githubusercontent.com/u/55170918?v=4', 'gravatar_id': '', 'url': 'https://api.github.com/users/bzinodev', 'html_url': 'https://github.com/bzinodev', 'followers_url': 'https://api.github.com/users/bzinodev/followers', 'following_url': 'https://api.github.com/users/bzinodev/following{/other_user}', 'gists_url': 'https://api.github.com/users/bzinodev/gists{/gist_id}', 'starred_url': 'https://api.github.com/users/bzinodev/starred{/owner}{/repo}', 'subscriptions_url': 'https://api.github.com/users/bzinodev/subscriptions', 'organizations_url': 'https://api.github.com/users/bzinodev/orgs', 'repos_url': 'https://api.github.com/users/bzinodev/repos', 'events_url': 'https://api.github.com/users/bzinodev/events{/privacy}', 'received_events_url': 'https://api.github.com/users/bzinodev/received_events', 'type': 'User', 'site_admin': False}",referenced,c5b13ccf3b7d1131634d2d05541805a93dc0b4e1,https://api.github.com/repos/pytorch/pytorch/commits/c5b13ccf3b7d1131634d2d05541805a93dc0b4e1,2019-10-02T01:08:37Z,78,70,8
27081,2681675304,"{'login': 'bzinodev', 'id': 55170918, 'node_id': 'MDQ6VXNlcjU1MTcwOTE4', 'avatar_url': 'https://avatars2.githubusercontent.com/u/55170918?v=4', 'gravatar_id': '', 'url': 'https://api.github.com/users/bzinodev', 'html_url': 'https://github.com/bzinodev', 'followers_url': 'https://api.github.com/users/bzinodev/followers', 'following_url': 'https://api.github.com/users/bzinodev/following{/other_user}', 'gists_url': 'https://api.github.com/users/bzinodev/gists{/gist_id}', 'starred_url': 'https://api.github.com/users/bzinodev/starred{/owner}{/repo}', 'subscriptions_url': 'https://api.github.com/users/bzinodev/subscriptions', 'organizations_url': 'https://api.github.com/users/bzinodev/orgs', 'repos_url': 'https://api.github.com/users/bzinodev/repos', 'events_url': 'https://api.github.com/users/bzinodev/events{/privacy}', 'received_events_url': 'https://api.github.com/users/bzinodev/received_events', 'type': 'User', 'site_admin': False}",referenced,561c6387120051fd7fe538083029458dbb8bc8cc,https://api.github.com/repos/pytorch/pytorch/commits/561c6387120051fd7fe538083029458dbb8bc8cc,2019-10-02T18:51:44Z,2265,1482,783
27081,2681675745,"{'login': 'bzinodev', 'id': 55170918, 'node_id': 'MDQ6VXNlcjU1MTcwOTE4', 'avatar_url': 'https://avatars2.githubusercontent.com/u/55170918?v=4', 'gravatar_id': '', 'url': 'https://api.github.com/users/bzinodev', 'html_url': 'https://github.com/bzinodev', 'followers_url': 'https://api.github.com/users/bzinodev/followers', 'following_url': 'https://api.github.com/users/bzinodev/following{/other_user}', 'gists_url': 'https://api.github.com/users/bzinodev/gists{/gist_id}', 'starred_url': 'https://api.github.com/users/bzinodev/starred{/owner}{/repo}', 'subscriptions_url': 'https://api.github.com/users/bzinodev/subscriptions', 'organizations_url': 'https://api.github.com/users/bzinodev/orgs', 'repos_url': 'https://api.github.com/users/bzinodev/repos', 'events_url': 'https://api.github.com/users/bzinodev/events{/privacy}', 'received_events_url': 'https://api.github.com/users/bzinodev/received_events', 'type': 'User', 'site_admin': False}",referenced,574ad3fe46c6fa56dd4cd00240bd32fb87ed9955,https://api.github.com/repos/pytorch/pytorch/commits/574ad3fe46c6fa56dd4cd00240bd32fb87ed9955,2019-10-02T18:51:52Z,78,70,8
27081,2682432011,"{'login': 'facebook-github-bot', 'id': 6422482, 'node_id': 'MDQ6VXNlcjY0MjI0ODI=', 'avatar_url': 'https://avatars3.githubusercontent.com/u/6422482?v=4', 'gravatar_id': '', 'url': 'https://api.github.com/users/facebook-github-bot', 'html_url': 'https://github.com/facebook-github-bot', 'followers_url': 'https://api.github.com/users/facebook-github-bot/followers', 'following_url': 'https://api.github.com/users/facebook-github-bot/following{/other_user}', 'gists_url': 'https://api.github.com/users/facebook-github-bot/gists{/gist_id}', 'starred_url': 'https://api.github.com/users/facebook-github-bot/starred{/owner}{/repo}', 'subscriptions_url': 'https://api.github.com/users/facebook-github-bot/subscriptions', 'organizations_url': 'https://api.github.com/users/facebook-github-bot/orgs', 'repos_url': 'https://api.github.com/users/facebook-github-bot/repos', 'events_url': 'https://api.github.com/users/facebook-github-bot/events{/privacy}', 'received_events_url': 'https://api.github.com/users/facebook-github-bot/received_events', 'type': 'User', 'site_admin': False}",referenced,803f7bfaacdd3e18788191a5ced483e8b533806b,https://api.github.com/repos/pytorch/pytorch/commits/803f7bfaacdd3e18788191a5ced483e8b533806b,2019-10-03T00:28:50Z,78,70,8
27080,2688236114,"{'login': 'facebook-github-bot', 'id': 6422482, 'node_id': 'MDQ6VXNlcjY0MjI0ODI=', 'avatar_url': 'https://avatars3.githubusercontent.com/u/6422482?v=4', 'gravatar_id': '', 'url': 'https://api.github.com/users/facebook-github-bot', 'html_url': 'https://github.com/facebook-github-bot', 'followers_url': 'https://api.github.com/users/facebook-github-bot/followers', 'following_url': 'https://api.github.com/users/facebook-github-bot/following{/other_user}', 'gists_url': 'https://api.github.com/users/facebook-github-bot/gists{/gist_id}', 'starred_url': 'https://api.github.com/users/facebook-github-bot/starred{/owner}{/repo}', 'subscriptions_url': 'https://api.github.com/users/facebook-github-bot/subscriptions', 'organizations_url': 'https://api.github.com/users/facebook-github-bot/orgs', 'repos_url': 'https://api.github.com/users/facebook-github-bot/repos', 'events_url': 'https://api.github.com/users/facebook-github-bot/events{/privacy}', 'received_events_url': 'https://api.github.com/users/facebook-github-bot/received_events', 'type': 'User', 'site_admin': False}",closed,9f9c6c09992a7654640b44461911277d784803e4,https://api.github.com/repos/pytorch/pytorch/commits/9f9c6c09992a7654640b44461911277d784803e4,2019-10-04T18:02:32Z,4,0,4
27077,2681978559,"{'login': 'facebook-github-bot', 'id': 6422482, 'node_id': 'MDQ6VXNlcjY0MjI0ODI=', 'avatar_url': 'https://avatars3.githubusercontent.com/u/6422482?v=4', 'gravatar_id': '', 'url': 'https://api.github.com/users/facebook-github-bot', 'html_url': 'https://github.com/facebook-github-bot', 'followers_url': 'https://api.github.com/users/facebook-github-bot/followers', 'following_url': 'https://api.github.com/users/facebook-github-bot/following{/other_user}', 'gists_url': 'https://api.github.com/users/facebook-github-bot/gists{/gist_id}', 'starred_url': 'https://api.github.com/users/facebook-github-bot/starred{/owner}{/repo}', 'subscriptions_url': 'https://api.github.com/users/facebook-github-bot/subscriptions', 'organizations_url': 'https://api.github.com/users/facebook-github-bot/orgs', 'repos_url': 'https://api.github.com/users/facebook-github-bot/repos', 'events_url': 'https://api.github.com/users/facebook-github-bot/events{/privacy}', 'received_events_url': 'https://api.github.com/users/facebook-github-bot/received_events', 'type': 'User', 'site_admin': False}",referenced,5e776d8a45249306eddc7156f47f2fe926ab5f89,https://api.github.com/repos/pytorch/pytorch/commits/5e776d8a45249306eddc7156f47f2fe926ab5f89,2019-10-02T20:36:04Z,74,73,1
27077,2682275208,"{'login': 'izdeby', 'id': 47012416, 'node_id': 'MDQ6VXNlcjQ3MDEyNDE2', 'avatar_url': 'https://avatars0.githubusercontent.com/u/47012416?v=4', 'gravatar_id': '', 'url': 'https://api.github.com/users/izdeby', 'html_url': 'https://github.com/izdeby', 'followers_url': 'https://api.github.com/users/izdeby/followers', 'following_url': 'https://api.github.com/users/izdeby/following{/other_user}', 'gists_url': 'https://api.github.com/users/izdeby/gists{/gist_id}', 'starred_url': 'https://api.github.com/users/izdeby/starred{/owner}{/repo}', 'subscriptions_url': 'https://api.github.com/users/izdeby/subscriptions', 'organizations_url': 'https://api.github.com/users/izdeby/orgs', 'repos_url': 'https://api.github.com/users/izdeby/repos', 'events_url': 'https://api.github.com/users/izdeby/events{/privacy}', 'received_events_url': 'https://api.github.com/users/izdeby/received_events', 'type': 'User', 'site_admin': False}",referenced,0bd6f96fbfaa550e09159ead4b691f38f3e44715,https://api.github.com/repos/pytorch/pytorch/commits/0bd6f96fbfaa550e09159ead4b691f38f3e44715,2019-10-02T22:43:32Z,74,73,1
27077,2686200274,"{'login': 'soumith', 'id': 1310570, 'node_id': 'MDQ6VXNlcjEzMTA1NzA=', 'avatar_url': 'https://avatars0.githubusercontent.com/u/1310570?v=4', 'gravatar_id': '', 'url': 'https://api.github.com/users/soumith', 'html_url': 'https://github.com/soumith', 'followers_url': 'https://api.github.com/users/soumith/followers', 'following_url': 'https://api.github.com/users/soumith/following{/other_user}', 'gists_url': 'https://api.github.com/users/soumith/gists{/gist_id}', 'starred_url': 'https://api.github.com/users/soumith/starred{/owner}{/repo}', 'subscriptions_url': 'https://api.github.com/users/soumith/subscriptions', 'organizations_url': 'https://api.github.com/users/soumith/orgs', 'repos_url': 'https://api.github.com/users/soumith/repos', 'events_url': 'https://api.github.com/users/soumith/events{/privacy}', 'received_events_url': 'https://api.github.com/users/soumith/received_events', 'type': 'User', 'site_admin': False}",referenced,6f194f8be568fd28c8e6093f75b3146eaa3ad01f,https://api.github.com/repos/pytorch/pytorch/commits/6f194f8be568fd28c8e6093f75b3146eaa3ad01f,2019-10-04T05:12:29Z,74,73,1
27077,2690395982,"{'login': 'soumith', 'id': 1310570, 'node_id': 'MDQ6VXNlcjEzMTA1NzA=', 'avatar_url': 'https://avatars0.githubusercontent.com/u/1310570?v=4', 'gravatar_id': '', 'url': 'https://api.github.com/users/soumith', 'html_url': 'https://github.com/soumith', 'followers_url': 'https://api.github.com/users/soumith/followers', 'following_url': 'https://api.github.com/users/soumith/following{/other_user}', 'gists_url': 'https://api.github.com/users/soumith/gists{/gist_id}', 'starred_url': 'https://api.github.com/users/soumith/starred{/owner}{/repo}', 'subscriptions_url': 'https://api.github.com/users/soumith/subscriptions', 'organizations_url': 'https://api.github.com/users/soumith/orgs', 'repos_url': 'https://api.github.com/users/soumith/repos', 'events_url': 'https://api.github.com/users/soumith/events{/privacy}', 'received_events_url': 'https://api.github.com/users/soumith/received_events', 'type': 'User', 'site_admin': False}",referenced,d4d4bf5686b090f5cb5ef7172617c24d932c3707,https://api.github.com/repos/pytorch/pytorch/commits/d4d4bf5686b090f5cb5ef7172617c24d932c3707,2019-10-07T03:04:44Z,74,73,1
27074,2682097780,"{'login': 'facebook-github-bot', 'id': 6422482, 'node_id': 'MDQ6VXNlcjY0MjI0ODI=', 'avatar_url': 'https://avatars3.githubusercontent.com/u/6422482?v=4', 'gravatar_id': '', 'url': 'https://api.github.com/users/facebook-github-bot', 'html_url': 'https://github.com/facebook-github-bot', 'followers_url': 'https://api.github.com/users/facebook-github-bot/followers', 'following_url': 'https://api.github.com/users/facebook-github-bot/following{/other_user}', 'gists_url': 'https://api.github.com/users/facebook-github-bot/gists{/gist_id}', 'starred_url': 'https://api.github.com/users/facebook-github-bot/starred{/owner}{/repo}', 'subscriptions_url': 'https://api.github.com/users/facebook-github-bot/subscriptions', 'organizations_url': 'https://api.github.com/users/facebook-github-bot/orgs', 'repos_url': 'https://api.github.com/users/facebook-github-bot/repos', 'events_url': 'https://api.github.com/users/facebook-github-bot/events{/privacy}', 'received_events_url': 'https://api.github.com/users/facebook-github-bot/received_events', 'type': 'User', 'site_admin': False}",referenced,293e35a87cbe440ee9b57e9b3dda7dc2fb67803a,https://api.github.com/repos/pytorch/pytorch/commits/293e35a87cbe440ee9b57e9b3dda7dc2fb67803a,2019-10-02T21:19:50Z,11,5,6
27074,2682261943,"{'login': 'izdeby', 'id': 47012416, 'node_id': 'MDQ6VXNlcjQ3MDEyNDE2', 'avatar_url': 'https://avatars0.githubusercontent.com/u/47012416?v=4', 'gravatar_id': '', 'url': 'https://api.github.com/users/izdeby', 'html_url': 'https://github.com/izdeby', 'followers_url': 'https://api.github.com/users/izdeby/followers', 'following_url': 'https://api.github.com/users/izdeby/following{/other_user}', 'gists_url': 'https://api.github.com/users/izdeby/gists{/gist_id}', 'starred_url': 'https://api.github.com/users/izdeby/starred{/owner}{/repo}', 'subscriptions_url': 'https://api.github.com/users/izdeby/subscriptions', 'organizations_url': 'https://api.github.com/users/izdeby/orgs', 'repos_url': 'https://api.github.com/users/izdeby/repos', 'events_url': 'https://api.github.com/users/izdeby/events{/privacy}', 'received_events_url': 'https://api.github.com/users/izdeby/received_events', 'type': 'User', 'site_admin': False}",referenced,dce0b76a306186bdb5f4c8068cfa66b84311859e,https://api.github.com/repos/pytorch/pytorch/commits/dce0b76a306186bdb5f4c8068cfa66b84311859e,2019-10-02T22:36:05Z,11,5,6
27074,2682280222,"{'login': 'izdeby', 'id': 47012416, 'node_id': 'MDQ6VXNlcjQ3MDEyNDE2', 'avatar_url': 'https://avatars0.githubusercontent.com/u/47012416?v=4', 'gravatar_id': '', 'url': 'https://api.github.com/users/izdeby', 'html_url': 'https://github.com/izdeby', 'followers_url': 'https://api.github.com/users/izdeby/followers', 'following_url': 'https://api.github.com/users/izdeby/following{/other_user}', 'gists_url': 'https://api.github.com/users/izdeby/gists{/gist_id}', 'starred_url': 'https://api.github.com/users/izdeby/starred{/owner}{/repo}', 'subscriptions_url': 'https://api.github.com/users/izdeby/subscriptions', 'organizations_url': 'https://api.github.com/users/izdeby/orgs', 'repos_url': 'https://api.github.com/users/izdeby/repos', 'events_url': 'https://api.github.com/users/izdeby/events{/privacy}', 'received_events_url': 'https://api.github.com/users/izdeby/received_events', 'type': 'User', 'site_admin': False}",referenced,b1d8b3d65177d8444f82fd976b6fadeb1282381c,https://api.github.com/repos/pytorch/pytorch/commits/b1d8b3d65177d8444f82fd976b6fadeb1282381c,2019-10-02T22:46:28Z,11,5,6
27074,2686201278,"{'login': 'soumith', 'id': 1310570, 'node_id': 'MDQ6VXNlcjEzMTA1NzA=', 'avatar_url': 'https://avatars0.githubusercontent.com/u/1310570?v=4', 'gravatar_id': '', 'url': 'https://api.github.com/users/soumith', 'html_url': 'https://github.com/soumith', 'followers_url': 'https://api.github.com/users/soumith/followers', 'following_url': 'https://api.github.com/users/soumith/following{/other_user}', 'gists_url': 'https://api.github.com/users/soumith/gists{/gist_id}', 'starred_url': 'https://api.github.com/users/soumith/starred{/owner}{/repo}', 'subscriptions_url': 'https://api.github.com/users/soumith/subscriptions', 'organizations_url': 'https://api.github.com/users/soumith/orgs', 'repos_url': 'https://api.github.com/users/soumith/repos', 'events_url': 'https://api.github.com/users/soumith/events{/privacy}', 'received_events_url': 'https://api.github.com/users/soumith/received_events', 'type': 'User', 'site_admin': False}",referenced,fb09510f59117852da2982332cdea81d78953efe,https://api.github.com/repos/pytorch/pytorch/commits/fb09510f59117852da2982332cdea81d78953efe,2019-10-04T05:13:19Z,11,5,6
27074,2690396870,"{'login': 'soumith', 'id': 1310570, 'node_id': 'MDQ6VXNlcjEzMTA1NzA=', 'avatar_url': 'https://avatars0.githubusercontent.com/u/1310570?v=4', 'gravatar_id': '', 'url': 'https://api.github.com/users/soumith', 'html_url': 'https://github.com/soumith', 'followers_url': 'https://api.github.com/users/soumith/followers', 'following_url': 'https://api.github.com/users/soumith/following{/other_user}', 'gists_url': 'https://api.github.com/users/soumith/gists{/gist_id}', 'starred_url': 'https://api.github.com/users/soumith/starred{/owner}{/repo}', 'subscriptions_url': 'https://api.github.com/users/soumith/subscriptions', 'organizations_url': 'https://api.github.com/users/soumith/orgs', 'repos_url': 'https://api.github.com/users/soumith/repos', 'events_url': 'https://api.github.com/users/soumith/events{/privacy}', 'received_events_url': 'https://api.github.com/users/soumith/received_events', 'type': 'User', 'site_admin': False}",referenced,1ba6fc4ca6415c64ea7653a02211439801ea4a92,https://api.github.com/repos/pytorch/pytorch/commits/1ba6fc4ca6415c64ea7653a02211439801ea4a92,2019-10-07T03:05:36Z,11,5,6
27073,2682097784,"{'login': 'facebook-github-bot', 'id': 6422482, 'node_id': 'MDQ6VXNlcjY0MjI0ODI=', 'avatar_url': 'https://avatars3.githubusercontent.com/u/6422482?v=4', 'gravatar_id': '', 'url': 'https://api.github.com/users/facebook-github-bot', 'html_url': 'https://github.com/facebook-github-bot', 'followers_url': 'https://api.github.com/users/facebook-github-bot/followers', 'following_url': 'https://api.github.com/users/facebook-github-bot/following{/other_user}', 'gists_url': 'https://api.github.com/users/facebook-github-bot/gists{/gist_id}', 'starred_url': 'https://api.github.com/users/facebook-github-bot/starred{/owner}{/repo}', 'subscriptions_url': 'https://api.github.com/users/facebook-github-bot/subscriptions', 'organizations_url': 'https://api.github.com/users/facebook-github-bot/orgs', 'repos_url': 'https://api.github.com/users/facebook-github-bot/repos', 'events_url': 'https://api.github.com/users/facebook-github-bot/events{/privacy}', 'received_events_url': 'https://api.github.com/users/facebook-github-bot/received_events', 'type': 'User', 'site_admin': False}",referenced,293e35a87cbe440ee9b57e9b3dda7dc2fb67803a,https://api.github.com/repos/pytorch/pytorch/commits/293e35a87cbe440ee9b57e9b3dda7dc2fb67803a,2019-10-02T21:19:50Z,11,5,6
27073,2682261945,"{'login': 'izdeby', 'id': 47012416, 'node_id': 'MDQ6VXNlcjQ3MDEyNDE2', 'avatar_url': 'https://avatars0.githubusercontent.com/u/47012416?v=4', 'gravatar_id': '', 'url': 'https://api.github.com/users/izdeby', 'html_url': 'https://github.com/izdeby', 'followers_url': 'https://api.github.com/users/izdeby/followers', 'following_url': 'https://api.github.com/users/izdeby/following{/other_user}', 'gists_url': 'https://api.github.com/users/izdeby/gists{/gist_id}', 'starred_url': 'https://api.github.com/users/izdeby/starred{/owner}{/repo}', 'subscriptions_url': 'https://api.github.com/users/izdeby/subscriptions', 'organizations_url': 'https://api.github.com/users/izdeby/orgs', 'repos_url': 'https://api.github.com/users/izdeby/repos', 'events_url': 'https://api.github.com/users/izdeby/events{/privacy}', 'received_events_url': 'https://api.github.com/users/izdeby/received_events', 'type': 'User', 'site_admin': False}",referenced,dce0b76a306186bdb5f4c8068cfa66b84311859e,https://api.github.com/repos/pytorch/pytorch/commits/dce0b76a306186bdb5f4c8068cfa66b84311859e,2019-10-02T22:36:05Z,11,5,6
27073,2682280225,"{'login': 'izdeby', 'id': 47012416, 'node_id': 'MDQ6VXNlcjQ3MDEyNDE2', 'avatar_url': 'https://avatars0.githubusercontent.com/u/47012416?v=4', 'gravatar_id': '', 'url': 'https://api.github.com/users/izdeby', 'html_url': 'https://github.com/izdeby', 'followers_url': 'https://api.github.com/users/izdeby/followers', 'following_url': 'https://api.github.com/users/izdeby/following{/other_user}', 'gists_url': 'https://api.github.com/users/izdeby/gists{/gist_id}', 'starred_url': 'https://api.github.com/users/izdeby/starred{/owner}{/repo}', 'subscriptions_url': 'https://api.github.com/users/izdeby/subscriptions', 'organizations_url': 'https://api.github.com/users/izdeby/orgs', 'repos_url': 'https://api.github.com/users/izdeby/repos', 'events_url': 'https://api.github.com/users/izdeby/events{/privacy}', 'received_events_url': 'https://api.github.com/users/izdeby/received_events', 'type': 'User', 'site_admin': False}",referenced,b1d8b3d65177d8444f82fd976b6fadeb1282381c,https://api.github.com/repos/pytorch/pytorch/commits/b1d8b3d65177d8444f82fd976b6fadeb1282381c,2019-10-02T22:46:28Z,11,5,6
27073,2686201281,"{'login': 'soumith', 'id': 1310570, 'node_id': 'MDQ6VXNlcjEzMTA1NzA=', 'avatar_url': 'https://avatars0.githubusercontent.com/u/1310570?v=4', 'gravatar_id': '', 'url': 'https://api.github.com/users/soumith', 'html_url': 'https://github.com/soumith', 'followers_url': 'https://api.github.com/users/soumith/followers', 'following_url': 'https://api.github.com/users/soumith/following{/other_user}', 'gists_url': 'https://api.github.com/users/soumith/gists{/gist_id}', 'starred_url': 'https://api.github.com/users/soumith/starred{/owner}{/repo}', 'subscriptions_url': 'https://api.github.com/users/soumith/subscriptions', 'organizations_url': 'https://api.github.com/users/soumith/orgs', 'repos_url': 'https://api.github.com/users/soumith/repos', 'events_url': 'https://api.github.com/users/soumith/events{/privacy}', 'received_events_url': 'https://api.github.com/users/soumith/received_events', 'type': 'User', 'site_admin': False}",referenced,fb09510f59117852da2982332cdea81d78953efe,https://api.github.com/repos/pytorch/pytorch/commits/fb09510f59117852da2982332cdea81d78953efe,2019-10-04T05:13:19Z,11,5,6
27073,2690396873,"{'login': 'soumith', 'id': 1310570, 'node_id': 'MDQ6VXNlcjEzMTA1NzA=', 'avatar_url': 'https://avatars0.githubusercontent.com/u/1310570?v=4', 'gravatar_id': '', 'url': 'https://api.github.com/users/soumith', 'html_url': 'https://github.com/soumith', 'followers_url': 'https://api.github.com/users/soumith/followers', 'following_url': 'https://api.github.com/users/soumith/following{/other_user}', 'gists_url': 'https://api.github.com/users/soumith/gists{/gist_id}', 'starred_url': 'https://api.github.com/users/soumith/starred{/owner}{/repo}', 'subscriptions_url': 'https://api.github.com/users/soumith/subscriptions', 'organizations_url': 'https://api.github.com/users/soumith/orgs', 'repos_url': 'https://api.github.com/users/soumith/repos', 'events_url': 'https://api.github.com/users/soumith/events{/privacy}', 'received_events_url': 'https://api.github.com/users/soumith/received_events', 'type': 'User', 'site_admin': False}",referenced,1ba6fc4ca6415c64ea7653a02211439801ea4a92,https://api.github.com/repos/pytorch/pytorch/commits/1ba6fc4ca6415c64ea7653a02211439801ea4a92,2019-10-07T03:05:36Z,11,5,6
27048,2710902770,"{'login': 'facebook-github-bot', 'id': 6422482, 'node_id': 'MDQ6VXNlcjY0MjI0ODI=', 'avatar_url': 'https://avatars3.githubusercontent.com/u/6422482?v=4', 'gravatar_id': '', 'url': 'https://api.github.com/users/facebook-github-bot', 'html_url': 'https://github.com/facebook-github-bot', 'followers_url': 'https://api.github.com/users/facebook-github-bot/followers', 'following_url': 'https://api.github.com/users/facebook-github-bot/following{/other_user}', 'gists_url': 'https://api.github.com/users/facebook-github-bot/gists{/gist_id}', 'starred_url': 'https://api.github.com/users/facebook-github-bot/starred{/owner}{/repo}', 'subscriptions_url': 'https://api.github.com/users/facebook-github-bot/subscriptions', 'organizations_url': 'https://api.github.com/users/facebook-github-bot/orgs', 'repos_url': 'https://api.github.com/users/facebook-github-bot/repos', 'events_url': 'https://api.github.com/users/facebook-github-bot/events{/privacy}', 'received_events_url': 'https://api.github.com/users/facebook-github-bot/received_events', 'type': 'User', 'site_admin': False}",referenced,cc5c34a0d0bb353a700dbc41875c1a3c7906462b,https://api.github.com/repos/pytorch/pytorch/commits/cc5c34a0d0bb353a700dbc41875c1a3c7906462b,2019-10-14T15:39:13Z,90,89,1
26999,2673736576,"{'login': 'rohan-varma', 'id': 8039770, 'node_id': 'MDQ6VXNlcjgwMzk3NzA=', 'avatar_url': 'https://avatars2.githubusercontent.com/u/8039770?v=4', 'gravatar_id': '', 'url': 'https://api.github.com/users/rohan-varma', 'html_url': 'https://github.com/rohan-varma', 'followers_url': 'https://api.github.com/users/rohan-varma/followers', 'following_url': 'https://api.github.com/users/rohan-varma/following{/other_user}', 'gists_url': 'https://api.github.com/users/rohan-varma/gists{/gist_id}', 'starred_url': 'https://api.github.com/users/rohan-varma/starred{/owner}{/repo}', 'subscriptions_url': 'https://api.github.com/users/rohan-varma/subscriptions', 'organizations_url': 'https://api.github.com/users/rohan-varma/orgs', 'repos_url': 'https://api.github.com/users/rohan-varma/repos', 'events_url': 'https://api.github.com/users/rohan-varma/events{/privacy}', 'received_events_url': 'https://api.github.com/users/rohan-varma/received_events', 'type': 'User', 'site_admin': False}",referenced,c004c95124279e48c901ef138b1ea549070d1a27,https://api.github.com/repos/pytorch/pytorch/commits/c004c95124279e48c901ef138b1ea549070d1a27,2019-09-30T15:29:29Z,9633,7279,2354
26999,2678503671,"{'login': 'rohan-varma', 'id': 8039770, 'node_id': 'MDQ6VXNlcjgwMzk3NzA=', 'avatar_url': 'https://avatars2.githubusercontent.com/u/8039770?v=4', 'gravatar_id': '', 'url': 'https://api.github.com/users/rohan-varma', 'html_url': 'https://github.com/rohan-varma', 'followers_url': 'https://api.github.com/users/rohan-varma/followers', 'following_url': 'https://api.github.com/users/rohan-varma/following{/other_user}', 'gists_url': 'https://api.github.com/users/rohan-varma/gists{/gist_id}', 'starred_url': 'https://api.github.com/users/rohan-varma/starred{/owner}{/repo}', 'subscriptions_url': 'https://api.github.com/users/rohan-varma/subscriptions', 'organizations_url': 'https://api.github.com/users/rohan-varma/orgs', 'repos_url': 'https://api.github.com/users/rohan-varma/repos', 'events_url': 'https://api.github.com/users/rohan-varma/events{/privacy}', 'received_events_url': 'https://api.github.com/users/rohan-varma/received_events', 'type': 'User', 'site_admin': False}",referenced,233b1371ad905efbaeba7e2fbb6f0d66c13c37bd,https://api.github.com/repos/pytorch/pytorch/commits/233b1371ad905efbaeba7e2fbb6f0d66c13c37bd,2019-10-01T20:49:51Z,2894,2136,758
26999,2678509467,"{'login': 'rohan-varma', 'id': 8039770, 'node_id': 'MDQ6VXNlcjgwMzk3NzA=', 'avatar_url': 'https://avatars2.githubusercontent.com/u/8039770?v=4', 'gravatar_id': '', 'url': 'https://api.github.com/users/rohan-varma', 'html_url': 'https://github.com/rohan-varma', 'followers_url': 'https://api.github.com/users/rohan-varma/followers', 'following_url': 'https://api.github.com/users/rohan-varma/following{/other_user}', 'gists_url': 'https://api.github.com/users/rohan-varma/gists{/gist_id}', 'starred_url': 'https://api.github.com/users/rohan-varma/starred{/owner}{/repo}', 'subscriptions_url': 'https://api.github.com/users/rohan-varma/subscriptions', 'organizations_url': 'https://api.github.com/users/rohan-varma/orgs', 'repos_url': 'https://api.github.com/users/rohan-varma/repos', 'events_url': 'https://api.github.com/users/rohan-varma/events{/privacy}', 'received_events_url': 'https://api.github.com/users/rohan-varma/received_events', 'type': 'User', 'site_admin': False}",referenced,f318ee709cff1cb30c297b5689fb32dbfa616104,https://api.github.com/repos/pytorch/pytorch/commits/f318ee709cff1cb30c297b5689fb32dbfa616104,2019-10-01T20:51:57Z,441,285,156
26998,2673591300,"{'login': 'facebook-github-bot', 'id': 6422482, 'node_id': 'MDQ6VXNlcjY0MjI0ODI=', 'avatar_url': 'https://avatars3.githubusercontent.com/u/6422482?v=4', 'gravatar_id': '', 'url': 'https://api.github.com/users/facebook-github-bot', 'html_url': 'https://github.com/facebook-github-bot', 'followers_url': 'https://api.github.com/users/facebook-github-bot/followers', 'following_url': 'https://api.github.com/users/facebook-github-bot/following{/other_user}', 'gists_url': 'https://api.github.com/users/facebook-github-bot/gists{/gist_id}', 'starred_url': 'https://api.github.com/users/facebook-github-bot/starred{/owner}{/repo}', 'subscriptions_url': 'https://api.github.com/users/facebook-github-bot/subscriptions', 'organizations_url': 'https://api.github.com/users/facebook-github-bot/orgs', 'repos_url': 'https://api.github.com/users/facebook-github-bot/repos', 'events_url': 'https://api.github.com/users/facebook-github-bot/events{/privacy}', 'received_events_url': 'https://api.github.com/users/facebook-github-bot/received_events', 'type': 'User', 'site_admin': False}",closed,1afe3fc01eb194a3e7ce58240462de2121646233,https://api.github.com/repos/pytorch/pytorch/commits/1afe3fc01eb194a3e7ce58240462de2121646233,2019-09-30T14:52:28Z,8,5,3
26998,2677585810,"{'login': 'facebook-github-bot', 'id': 6422482, 'node_id': 'MDQ6VXNlcjY0MjI0ODI=', 'avatar_url': 'https://avatars3.githubusercontent.com/u/6422482?v=4', 'gravatar_id': '', 'url': 'https://api.github.com/users/facebook-github-bot', 'html_url': 'https://github.com/facebook-github-bot', 'followers_url': 'https://api.github.com/users/facebook-github-bot/followers', 'following_url': 'https://api.github.com/users/facebook-github-bot/following{/other_user}', 'gists_url': 'https://api.github.com/users/facebook-github-bot/gists{/gist_id}', 'starred_url': 'https://api.github.com/users/facebook-github-bot/starred{/owner}{/repo}', 'subscriptions_url': 'https://api.github.com/users/facebook-github-bot/subscriptions', 'organizations_url': 'https://api.github.com/users/facebook-github-bot/orgs', 'repos_url': 'https://api.github.com/users/facebook-github-bot/repos', 'events_url': 'https://api.github.com/users/facebook-github-bot/events{/privacy}', 'received_events_url': 'https://api.github.com/users/facebook-github-bot/received_events', 'type': 'User', 'site_admin': False}",closed,ec07d144baa20de9bbdd102ccbe24e5b139c6dbc,https://api.github.com/repos/pytorch/pytorch/commits/ec07d144baa20de9bbdd102ccbe24e5b139c6dbc,2019-10-01T15:50:43Z,22,15,7
26998,2686189270,"{'login': 'soumith', 'id': 1310570, 'node_id': 'MDQ6VXNlcjEzMTA1NzA=', 'avatar_url': 'https://avatars0.githubusercontent.com/u/1310570?v=4', 'gravatar_id': '', 'url': 'https://api.github.com/users/soumith', 'html_url': 'https://github.com/soumith', 'followers_url': 'https://api.github.com/users/soumith/followers', 'following_url': 'https://api.github.com/users/soumith/following{/other_user}', 'gists_url': 'https://api.github.com/users/soumith/gists{/gist_id}', 'starred_url': 'https://api.github.com/users/soumith/starred{/owner}{/repo}', 'subscriptions_url': 'https://api.github.com/users/soumith/subscriptions', 'organizations_url': 'https://api.github.com/users/soumith/orgs', 'repos_url': 'https://api.github.com/users/soumith/repos', 'events_url': 'https://api.github.com/users/soumith/events{/privacy}', 'received_events_url': 'https://api.github.com/users/soumith/received_events', 'type': 'User', 'site_admin': False}",referenced,831566ec90aeef8e22a7e28ca98442b11c718e33,https://api.github.com/repos/pytorch/pytorch/commits/831566ec90aeef8e22a7e28ca98442b11c718e33,2019-10-04T05:04:01Z,22,15,7
26899,2825470376,"{'login': 'facebook-github-bot', 'id': 6422482, 'node_id': 'MDQ6VXNlcjY0MjI0ODI=', 'avatar_url': 'https://avatars3.githubusercontent.com/u/6422482?v=4', 'gravatar_id': '', 'url': 'https://api.github.com/users/facebook-github-bot', 'html_url': 'https://github.com/facebook-github-bot', 'followers_url': 'https://api.github.com/users/facebook-github-bot/followers', 'following_url': 'https://api.github.com/users/facebook-github-bot/following{/other_user}', 'gists_url': 'https://api.github.com/users/facebook-github-bot/gists{/gist_id}', 'starred_url': 'https://api.github.com/users/facebook-github-bot/starred{/owner}{/repo}', 'subscriptions_url': 'https://api.github.com/users/facebook-github-bot/subscriptions', 'organizations_url': 'https://api.github.com/users/facebook-github-bot/orgs', 'repos_url': 'https://api.github.com/users/facebook-github-bot/repos', 'events_url': 'https://api.github.com/users/facebook-github-bot/events{/privacy}', 'received_events_url': 'https://api.github.com/users/facebook-github-bot/received_events', 'type': 'User', 'site_admin': False}",referenced,7c4b9042ababa32dcd49e8d35114c81c53027431,https://api.github.com/repos/pytorch/pytorch/commits/7c4b9042ababa32dcd49e8d35114c81c53027431,2019-11-23T17:29:43Z,79,67,12
26899,2899122631,"{'login': 'mingbowan', 'id': 2181364, 'node_id': 'MDQ6VXNlcjIxODEzNjQ=', 'avatar_url': 'https://avatars2.githubusercontent.com/u/2181364?v=4', 'gravatar_id': '', 'url': 'https://api.github.com/users/mingbowan', 'html_url': 'https://github.com/mingbowan', 'followers_url': 'https://api.github.com/users/mingbowan/followers', 'following_url': 'https://api.github.com/users/mingbowan/following{/other_user}', 'gists_url': 'https://api.github.com/users/mingbowan/gists{/gist_id}', 'starred_url': 'https://api.github.com/users/mingbowan/starred{/owner}{/repo}', 'subscriptions_url': 'https://api.github.com/users/mingbowan/subscriptions', 'organizations_url': 'https://api.github.com/users/mingbowan/orgs', 'repos_url': 'https://api.github.com/users/mingbowan/repos', 'events_url': 'https://api.github.com/users/mingbowan/events{/privacy}', 'received_events_url': 'https://api.github.com/users/mingbowan/received_events', 'type': 'User', 'site_admin': False}",referenced,9e7dc37f902af78b26739410766e79e63f53e27f,https://api.github.com/repos/pytorch/pytorch/commits/9e7dc37f902af78b26739410766e79e63f53e27f,2019-12-20T00:01:12Z,79,67,12
26892,2674267026,"{'login': 'facebook-github-bot', 'id': 6422482, 'node_id': 'MDQ6VXNlcjY0MjI0ODI=', 'avatar_url': 'https://avatars3.githubusercontent.com/u/6422482?v=4', 'gravatar_id': '', 'url': 'https://api.github.com/users/facebook-github-bot', 'html_url': 'https://github.com/facebook-github-bot', 'followers_url': 'https://api.github.com/users/facebook-github-bot/followers', 'following_url': 'https://api.github.com/users/facebook-github-bot/following{/other_user}', 'gists_url': 'https://api.github.com/users/facebook-github-bot/gists{/gist_id}', 'starred_url': 'https://api.github.com/users/facebook-github-bot/starred{/owner}{/repo}', 'subscriptions_url': 'https://api.github.com/users/facebook-github-bot/subscriptions', 'organizations_url': 'https://api.github.com/users/facebook-github-bot/orgs', 'repos_url': 'https://api.github.com/users/facebook-github-bot/repos', 'events_url': 'https://api.github.com/users/facebook-github-bot/events{/privacy}', 'received_events_url': 'https://api.github.com/users/facebook-github-bot/received_events', 'type': 'User', 'site_admin': False}",closed,73347e0ae558428078c3e842e3a27634c34bccf1,https://api.github.com/repos/pytorch/pytorch/commits/73347e0ae558428078c3e842e3a27634c34bccf1,2019-09-30T18:11:02Z,15,14,1
26892,2686192284,"{'login': 'soumith', 'id': 1310570, 'node_id': 'MDQ6VXNlcjEzMTA1NzA=', 'avatar_url': 'https://avatars0.githubusercontent.com/u/1310570?v=4', 'gravatar_id': '', 'url': 'https://api.github.com/users/soumith', 'html_url': 'https://github.com/soumith', 'followers_url': 'https://api.github.com/users/soumith/followers', 'following_url': 'https://api.github.com/users/soumith/following{/other_user}', 'gists_url': 'https://api.github.com/users/soumith/gists{/gist_id}', 'starred_url': 'https://api.github.com/users/soumith/starred{/owner}{/repo}', 'subscriptions_url': 'https://api.github.com/users/soumith/subscriptions', 'organizations_url': 'https://api.github.com/users/soumith/orgs', 'repos_url': 'https://api.github.com/users/soumith/repos', 'events_url': 'https://api.github.com/users/soumith/events{/privacy}', 'received_events_url': 'https://api.github.com/users/soumith/received_events', 'type': 'User', 'site_admin': False}",referenced,b6e976ae2dde7b18d58930fe3233396ca65f8b27,https://api.github.com/repos/pytorch/pytorch/commits/b6e976ae2dde7b18d58930fe3233396ca65f8b27,2019-10-04T05:06:14Z,15,14,1
26884,2693276958,"{'login': 'facebook-github-bot', 'id': 6422482, 'node_id': 'MDQ6VXNlcjY0MjI0ODI=', 'avatar_url': 'https://avatars3.githubusercontent.com/u/6422482?v=4', 'gravatar_id': '', 'url': 'https://api.github.com/users/facebook-github-bot', 'html_url': 'https://github.com/facebook-github-bot', 'followers_url': 'https://api.github.com/users/facebook-github-bot/followers', 'following_url': 'https://api.github.com/users/facebook-github-bot/following{/other_user}', 'gists_url': 'https://api.github.com/users/facebook-github-bot/gists{/gist_id}', 'starred_url': 'https://api.github.com/users/facebook-github-bot/starred{/owner}{/repo}', 'subscriptions_url': 'https://api.github.com/users/facebook-github-bot/subscriptions', 'organizations_url': 'https://api.github.com/users/facebook-github-bot/orgs', 'repos_url': 'https://api.github.com/users/facebook-github-bot/repos', 'events_url': 'https://api.github.com/users/facebook-github-bot/events{/privacy}', 'received_events_url': 'https://api.github.com/users/facebook-github-bot/received_events', 'type': 'User', 'site_admin': False}",closed,0046092178c67422d9e34b55d76c8545116fe19f,https://api.github.com/repos/pytorch/pytorch/commits/0046092178c67422d9e34b55d76c8545116fe19f,2019-10-07T20:53:12Z,170,112,58
26838,2803273390,"{'login': 'ezyang', 'id': 13564, 'node_id': 'MDQ6VXNlcjEzNTY0', 'avatar_url': 'https://avatars0.githubusercontent.com/u/13564?v=4', 'gravatar_id': '', 'url': 'https://api.github.com/users/ezyang', 'html_url': 'https://github.com/ezyang', 'followers_url': 'https://api.github.com/users/ezyang/followers', 'following_url': 'https://api.github.com/users/ezyang/following{/other_user}', 'gists_url': 'https://api.github.com/users/ezyang/gists{/gist_id}', 'starred_url': 'https://api.github.com/users/ezyang/starred{/owner}{/repo}', 'subscriptions_url': 'https://api.github.com/users/ezyang/subscriptions', 'organizations_url': 'https://api.github.com/users/ezyang/orgs', 'repos_url': 'https://api.github.com/users/ezyang/repos', 'events_url': 'https://api.github.com/users/ezyang/events{/privacy}', 'received_events_url': 'https://api.github.com/users/ezyang/received_events', 'type': 'User', 'site_admin': False}",referenced,7234f631a5c97289cdbb2ce8616338e77d39f744,https://api.github.com/repos/pytorch/pytorch/commits/7234f631a5c97289cdbb2ce8616338e77d39f744,2019-11-15T16:39:11Z,2,2,0
26838,2803273961,"{'login': 'ezyang', 'id': 13564, 'node_id': 'MDQ6VXNlcjEzNTY0', 'avatar_url': 'https://avatars0.githubusercontent.com/u/13564?v=4', 'gravatar_id': '', 'url': 'https://api.github.com/users/ezyang', 'html_url': 'https://github.com/ezyang', 'followers_url': 'https://api.github.com/users/ezyang/followers', 'following_url': 'https://api.github.com/users/ezyang/following{/other_user}', 'gists_url': 'https://api.github.com/users/ezyang/gists{/gist_id}', 'starred_url': 'https://api.github.com/users/ezyang/starred{/owner}{/repo}', 'subscriptions_url': 'https://api.github.com/users/ezyang/subscriptions', 'organizations_url': 'https://api.github.com/users/ezyang/orgs', 'repos_url': 'https://api.github.com/users/ezyang/repos', 'events_url': 'https://api.github.com/users/ezyang/events{/privacy}', 'received_events_url': 'https://api.github.com/users/ezyang/received_events', 'type': 'User', 'site_admin': False}",referenced,21442413501abbcba59f014b5f1adcf1712b1d4f,https://api.github.com/repos/pytorch/pytorch/commits/21442413501abbcba59f014b5f1adcf1712b1d4f,2019-11-15T16:39:23Z,2,2,0
26838,2807718611,"{'login': 'ezyang', 'id': 13564, 'node_id': 'MDQ6VXNlcjEzNTY0', 'avatar_url': 'https://avatars0.githubusercontent.com/u/13564?v=4', 'gravatar_id': '', 'url': 'https://api.github.com/users/ezyang', 'html_url': 'https://github.com/ezyang', 'followers_url': 'https://api.github.com/users/ezyang/followers', 'following_url': 'https://api.github.com/users/ezyang/following{/other_user}', 'gists_url': 'https://api.github.com/users/ezyang/gists{/gist_id}', 'starred_url': 'https://api.github.com/users/ezyang/starred{/owner}{/repo}', 'subscriptions_url': 'https://api.github.com/users/ezyang/subscriptions', 'organizations_url': 'https://api.github.com/users/ezyang/orgs', 'repos_url': 'https://api.github.com/users/ezyang/repos', 'events_url': 'https://api.github.com/users/ezyang/events{/privacy}', 'received_events_url': 'https://api.github.com/users/ezyang/received_events', 'type': 'User', 'site_admin': False}",referenced,4736ce39cd1c8a80e5a514549bda17f1a01fbf70,https://api.github.com/repos/pytorch/pytorch/commits/4736ce39cd1c8a80e5a514549bda17f1a01fbf70,2019-11-18T14:28:49Z,2,1,1
26838,2807718945,"{'login': 'ezyang', 'id': 13564, 'node_id': 'MDQ6VXNlcjEzNTY0', 'avatar_url': 'https://avatars0.githubusercontent.com/u/13564?v=4', 'gravatar_id': '', 'url': 'https://api.github.com/users/ezyang', 'html_url': 'https://github.com/ezyang', 'followers_url': 'https://api.github.com/users/ezyang/followers', 'following_url': 'https://api.github.com/users/ezyang/following{/other_user}', 'gists_url': 'https://api.github.com/users/ezyang/gists{/gist_id}', 'starred_url': 'https://api.github.com/users/ezyang/starred{/owner}{/repo}', 'subscriptions_url': 'https://api.github.com/users/ezyang/subscriptions', 'organizations_url': 'https://api.github.com/users/ezyang/orgs', 'repos_url': 'https://api.github.com/users/ezyang/repos', 'events_url': 'https://api.github.com/users/ezyang/events{/privacy}', 'received_events_url': 'https://api.github.com/users/ezyang/received_events', 'type': 'User', 'site_admin': False}",referenced,8c3b75c00d311dd7abb3d8ba90beb2347587ab18,https://api.github.com/repos/pytorch/pytorch/commits/8c3b75c00d311dd7abb3d8ba90beb2347587ab18,2019-11-18T14:28:55Z,2,2,0
26838,2807996548,"{'login': 'facebook-github-bot', 'id': 6422482, 'node_id': 'MDQ6VXNlcjY0MjI0ODI=', 'avatar_url': 'https://avatars3.githubusercontent.com/u/6422482?v=4', 'gravatar_id': '', 'url': 'https://api.github.com/users/facebook-github-bot', 'html_url': 'https://github.com/facebook-github-bot', 'followers_url': 'https://api.github.com/users/facebook-github-bot/followers', 'following_url': 'https://api.github.com/users/facebook-github-bot/following{/other_user}', 'gists_url': 'https://api.github.com/users/facebook-github-bot/gists{/gist_id}', 'starred_url': 'https://api.github.com/users/facebook-github-bot/starred{/owner}{/repo}', 'subscriptions_url': 'https://api.github.com/users/facebook-github-bot/subscriptions', 'organizations_url': 'https://api.github.com/users/facebook-github-bot/orgs', 'repos_url': 'https://api.github.com/users/facebook-github-bot/repos', 'events_url': 'https://api.github.com/users/facebook-github-bot/events{/privacy}', 'received_events_url': 'https://api.github.com/users/facebook-github-bot/received_events', 'type': 'User', 'site_admin': False}",referenced,a573f8f7d7ca807ef14feb924c4853df79762131,https://api.github.com/repos/pytorch/pytorch/commits/a573f8f7d7ca807ef14feb924c4853df79762131,2019-11-18T15:38:46Z,2,2,0
26817,2662757233,"{'login': 'ezyang', 'id': 13564, 'node_id': 'MDQ6VXNlcjEzNTY0', 'avatar_url': 'https://avatars0.githubusercontent.com/u/13564?v=4', 'gravatar_id': '', 'url': 'https://api.github.com/users/ezyang', 'html_url': 'https://github.com/ezyang', 'followers_url': 'https://api.github.com/users/ezyang/followers', 'following_url': 'https://api.github.com/users/ezyang/following{/other_user}', 'gists_url': 'https://api.github.com/users/ezyang/gists{/gist_id}', 'starred_url': 'https://api.github.com/users/ezyang/starred{/owner}{/repo}', 'subscriptions_url': 'https://api.github.com/users/ezyang/subscriptions', 'organizations_url': 'https://api.github.com/users/ezyang/orgs', 'repos_url': 'https://api.github.com/users/ezyang/repos', 'events_url': 'https://api.github.com/users/ezyang/events{/privacy}', 'received_events_url': 'https://api.github.com/users/ezyang/received_events', 'type': 'User', 'site_admin': False}",referenced,39e9ca388d3b08777e2cb6a13f5d4bdbbed738a5,https://api.github.com/repos/pytorch/pytorch/commits/39e9ca388d3b08777e2cb6a13f5d4bdbbed738a5,2019-09-25T18:46:48Z,813,772,41
26817,2662757554,"{'login': 'ezyang', 'id': 13564, 'node_id': 'MDQ6VXNlcjEzNTY0', 'avatar_url': 'https://avatars0.githubusercontent.com/u/13564?v=4', 'gravatar_id': '', 'url': 'https://api.github.com/users/ezyang', 'html_url': 'https://github.com/ezyang', 'followers_url': 'https://api.github.com/users/ezyang/followers', 'following_url': 'https://api.github.com/users/ezyang/following{/other_user}', 'gists_url': 'https://api.github.com/users/ezyang/gists{/gist_id}', 'starred_url': 'https://api.github.com/users/ezyang/starred{/owner}{/repo}', 'subscriptions_url': 'https://api.github.com/users/ezyang/subscriptions', 'organizations_url': 'https://api.github.com/users/ezyang/orgs', 'repos_url': 'https://api.github.com/users/ezyang/repos', 'events_url': 'https://api.github.com/users/ezyang/events{/privacy}', 'received_events_url': 'https://api.github.com/users/ezyang/received_events', 'type': 'User', 'site_admin': False}",referenced,e6cd38c34e46efca01d67c1d61c5464d01cabf22,https://api.github.com/repos/pytorch/pytorch/commits/e6cd38c34e46efca01d67c1d61c5464d01cabf22,2019-09-25T18:46:54Z,813,772,41
26817,2666724430,"{'login': 'ezyang', 'id': 13564, 'node_id': 'MDQ6VXNlcjEzNTY0', 'avatar_url': 'https://avatars0.githubusercontent.com/u/13564?v=4', 'gravatar_id': '', 'url': 'https://api.github.com/users/ezyang', 'html_url': 'https://github.com/ezyang', 'followers_url': 'https://api.github.com/users/ezyang/followers', 'following_url': 'https://api.github.com/users/ezyang/following{/other_user}', 'gists_url': 'https://api.github.com/users/ezyang/gists{/gist_id}', 'starred_url': 'https://api.github.com/users/ezyang/starred{/owner}{/repo}', 'subscriptions_url': 'https://api.github.com/users/ezyang/subscriptions', 'organizations_url': 'https://api.github.com/users/ezyang/orgs', 'repos_url': 'https://api.github.com/users/ezyang/repos', 'events_url': 'https://api.github.com/users/ezyang/events{/privacy}', 'received_events_url': 'https://api.github.com/users/ezyang/received_events', 'type': 'User', 'site_admin': False}",referenced,fd9b92af526c1cb1b970e6b7e584de2eea0bae17,https://api.github.com/repos/pytorch/pytorch/commits/fd9b92af526c1cb1b970e6b7e584de2eea0bae17,2019-09-26T21:14:59Z,7666,5571,2095
26817,2666724546,"{'login': 'ezyang', 'id': 13564, 'node_id': 'MDQ6VXNlcjEzNTY0', 'avatar_url': 'https://avatars0.githubusercontent.com/u/13564?v=4', 'gravatar_id': '', 'url': 'https://api.github.com/users/ezyang', 'html_url': 'https://github.com/ezyang', 'followers_url': 'https://api.github.com/users/ezyang/followers', 'following_url': 'https://api.github.com/users/ezyang/following{/other_user}', 'gists_url': 'https://api.github.com/users/ezyang/gists{/gist_id}', 'starred_url': 'https://api.github.com/users/ezyang/starred{/owner}{/repo}', 'subscriptions_url': 'https://api.github.com/users/ezyang/subscriptions', 'organizations_url': 'https://api.github.com/users/ezyang/orgs', 'repos_url': 'https://api.github.com/users/ezyang/repos', 'events_url': 'https://api.github.com/users/ezyang/events{/privacy}', 'received_events_url': 'https://api.github.com/users/ezyang/received_events', 'type': 'User', 'site_admin': False}",referenced,3991a07fc844b020ad2e230807848dc59a282c80,https://api.github.com/repos/pytorch/pytorch/commits/3991a07fc844b020ad2e230807848dc59a282c80,2019-09-26T21:15:02Z,1017,976,41
26817,2668839382,"{'login': 'facebook-github-bot', 'id': 6422482, 'node_id': 'MDQ6VXNlcjY0MjI0ODI=', 'avatar_url': 'https://avatars3.githubusercontent.com/u/6422482?v=4', 'gravatar_id': '', 'url': 'https://api.github.com/users/facebook-github-bot', 'html_url': 'https://github.com/facebook-github-bot', 'followers_url': 'https://api.github.com/users/facebook-github-bot/followers', 'following_url': 'https://api.github.com/users/facebook-github-bot/following{/other_user}', 'gists_url': 'https://api.github.com/users/facebook-github-bot/gists{/gist_id}', 'starred_url': 'https://api.github.com/users/facebook-github-bot/starred{/owner}{/repo}', 'subscriptions_url': 'https://api.github.com/users/facebook-github-bot/subscriptions', 'organizations_url': 'https://api.github.com/users/facebook-github-bot/orgs', 'repos_url': 'https://api.github.com/users/facebook-github-bot/repos', 'events_url': 'https://api.github.com/users/facebook-github-bot/events{/privacy}', 'received_events_url': 'https://api.github.com/users/facebook-github-bot/received_events', 'type': 'User', 'site_admin': False}",closed,76a76a6cb95ef63c073838a11418681b289878e6,https://api.github.com/repos/pytorch/pytorch/commits/76a76a6cb95ef63c073838a11418681b289878e6,2019-09-27T14:25:32Z,1017,976,41
26807,2666724946,"{'login': 'facebook-github-bot', 'id': 6422482, 'node_id': 'MDQ6VXNlcjY0MjI0ODI=', 'avatar_url': 'https://avatars3.githubusercontent.com/u/6422482?v=4', 'gravatar_id': '', 'url': 'https://api.github.com/users/facebook-github-bot', 'html_url': 'https://github.com/facebook-github-bot', 'followers_url': 'https://api.github.com/users/facebook-github-bot/followers', 'following_url': 'https://api.github.com/users/facebook-github-bot/following{/other_user}', 'gists_url': 'https://api.github.com/users/facebook-github-bot/gists{/gist_id}', 'starred_url': 'https://api.github.com/users/facebook-github-bot/starred{/owner}{/repo}', 'subscriptions_url': 'https://api.github.com/users/facebook-github-bot/subscriptions', 'organizations_url': 'https://api.github.com/users/facebook-github-bot/orgs', 'repos_url': 'https://api.github.com/users/facebook-github-bot/repos', 'events_url': 'https://api.github.com/users/facebook-github-bot/events{/privacy}', 'received_events_url': 'https://api.github.com/users/facebook-github-bot/received_events', 'type': 'User', 'site_admin': False}",referenced,bf1d957dc8f64fb6dd006ce523cf844c722afa7f,https://api.github.com/repos/pytorch/pytorch/commits/bf1d957dc8f64fb6dd006ce523cf844c722afa7f,2019-09-26T21:15:11Z,12,11,1
26797,2715027655,"{'login': 'facebook-github-bot', 'id': 6422482, 'node_id': 'MDQ6VXNlcjY0MjI0ODI=', 'avatar_url': 'https://avatars3.githubusercontent.com/u/6422482?v=4', 'gravatar_id': '', 'url': 'https://api.github.com/users/facebook-github-bot', 'html_url': 'https://github.com/facebook-github-bot', 'followers_url': 'https://api.github.com/users/facebook-github-bot/followers', 'following_url': 'https://api.github.com/users/facebook-github-bot/following{/other_user}', 'gists_url': 'https://api.github.com/users/facebook-github-bot/gists{/gist_id}', 'starred_url': 'https://api.github.com/users/facebook-github-bot/starred{/owner}{/repo}', 'subscriptions_url': 'https://api.github.com/users/facebook-github-bot/subscriptions', 'organizations_url': 'https://api.github.com/users/facebook-github-bot/orgs', 'repos_url': 'https://api.github.com/users/facebook-github-bot/repos', 'events_url': 'https://api.github.com/users/facebook-github-bot/events{/privacy}', 'received_events_url': 'https://api.github.com/users/facebook-github-bot/received_events', 'type': 'User', 'site_admin': False}",closed,f461184505149560803855f3a40d9e0e54c64826,https://api.github.com/repos/pytorch/pytorch/commits/f461184505149560803855f3a40d9e0e54c64826,2019-10-15T18:36:48Z,185,138,47
26792,2678438083,"{'login': 'driazati', 'id': 9407960, 'node_id': 'MDQ6VXNlcjk0MDc5NjA=', 'avatar_url': 'https://avatars3.githubusercontent.com/u/9407960?v=4', 'gravatar_id': '', 'url': 'https://api.github.com/users/driazati', 'html_url': 'https://github.com/driazati', 'followers_url': 'https://api.github.com/users/driazati/followers', 'following_url': 'https://api.github.com/users/driazati/following{/other_user}', 'gists_url': 'https://api.github.com/users/driazati/gists{/gist_id}', 'starred_url': 'https://api.github.com/users/driazati/starred{/owner}{/repo}', 'subscriptions_url': 'https://api.github.com/users/driazati/subscriptions', 'organizations_url': 'https://api.github.com/users/driazati/orgs', 'repos_url': 'https://api.github.com/users/driazati/repos', 'events_url': 'https://api.github.com/users/driazati/events{/privacy}', 'received_events_url': 'https://api.github.com/users/driazati/received_events', 'type': 'User', 'site_admin': False}",referenced,5ce4896211574bc3e76d7534f0782274d1dc74f4,https://api.github.com/repos/pytorch/pytorch/commits/5ce4896211574bc3e76d7534f0782274d1dc74f4,2019-10-01T20:28:15Z,62,57,5
26792,2718512162,"{'login': 'facebook-github-bot', 'id': 6422482, 'node_id': 'MDQ6VXNlcjY0MjI0ODI=', 'avatar_url': 'https://avatars3.githubusercontent.com/u/6422482?v=4', 'gravatar_id': '', 'url': 'https://api.github.com/users/facebook-github-bot', 'html_url': 'https://github.com/facebook-github-bot', 'followers_url': 'https://api.github.com/users/facebook-github-bot/followers', 'following_url': 'https://api.github.com/users/facebook-github-bot/following{/other_user}', 'gists_url': 'https://api.github.com/users/facebook-github-bot/gists{/gist_id}', 'starred_url': 'https://api.github.com/users/facebook-github-bot/starred{/owner}{/repo}', 'subscriptions_url': 'https://api.github.com/users/facebook-github-bot/subscriptions', 'organizations_url': 'https://api.github.com/users/facebook-github-bot/orgs', 'repos_url': 'https://api.github.com/users/facebook-github-bot/repos', 'events_url': 'https://api.github.com/users/facebook-github-bot/events{/privacy}', 'received_events_url': 'https://api.github.com/users/facebook-github-bot/received_events', 'type': 'User', 'site_admin': False}",closed,8cdc262063d9c5e3381f0e383f89f1f07c2b083b,https://api.github.com/repos/pytorch/pytorch/commits/8cdc262063d9c5e3381f0e383f89f1f07c2b083b,2019-10-16T17:36:49Z,89,84,5
26764,2662174796,"{'login': 'ezyang', 'id': 13564, 'node_id': 'MDQ6VXNlcjEzNTY0', 'avatar_url': 'https://avatars0.githubusercontent.com/u/13564?v=4', 'gravatar_id': '', 'url': 'https://api.github.com/users/ezyang', 'html_url': 'https://github.com/ezyang', 'followers_url': 'https://api.github.com/users/ezyang/followers', 'following_url': 'https://api.github.com/users/ezyang/following{/other_user}', 'gists_url': 'https://api.github.com/users/ezyang/gists{/gist_id}', 'starred_url': 'https://api.github.com/users/ezyang/starred{/owner}{/repo}', 'subscriptions_url': 'https://api.github.com/users/ezyang/subscriptions', 'organizations_url': 'https://api.github.com/users/ezyang/orgs', 'repos_url': 'https://api.github.com/users/ezyang/repos', 'events_url': 'https://api.github.com/users/ezyang/events{/privacy}', 'received_events_url': 'https://api.github.com/users/ezyang/received_events', 'type': 'User', 'site_admin': False}",referenced,87632e4966bf5463d92472fd74fa17dcf82cdcc7,https://api.github.com/repos/pytorch/pytorch/commits/87632e4966bf5463d92472fd74fa17dcf82cdcc7,2019-09-25T15:36:37Z,428,214,214
26764,2662175263,"{'login': 'ezyang', 'id': 13564, 'node_id': 'MDQ6VXNlcjEzNTY0', 'avatar_url': 'https://avatars0.githubusercontent.com/u/13564?v=4', 'gravatar_id': '', 'url': 'https://api.github.com/users/ezyang', 'html_url': 'https://github.com/ezyang', 'followers_url': 'https://api.github.com/users/ezyang/followers', 'following_url': 'https://api.github.com/users/ezyang/following{/other_user}', 'gists_url': 'https://api.github.com/users/ezyang/gists{/gist_id}', 'starred_url': 'https://api.github.com/users/ezyang/starred{/owner}{/repo}', 'subscriptions_url': 'https://api.github.com/users/ezyang/subscriptions', 'organizations_url': 'https://api.github.com/users/ezyang/orgs', 'repos_url': 'https://api.github.com/users/ezyang/repos', 'events_url': 'https://api.github.com/users/ezyang/events{/privacy}', 'received_events_url': 'https://api.github.com/users/ezyang/received_events', 'type': 'User', 'site_admin': False}",referenced,706c3419b9d6948004c2183591f74451f2a8add6,https://api.github.com/repos/pytorch/pytorch/commits/706c3419b9d6948004c2183591f74451f2a8add6,2019-09-25T15:36:45Z,428,214,214
26764,2663892042,"{'login': 'ljk53', 'id': 48700641, 'node_id': 'MDQ6VXNlcjQ4NzAwNjQx', 'avatar_url': 'https://avatars3.githubusercontent.com/u/48700641?v=4', 'gravatar_id': '', 'url': 'https://api.github.com/users/ljk53', 'html_url': 'https://github.com/ljk53', 'followers_url': 'https://api.github.com/users/ljk53/followers', 'following_url': 'https://api.github.com/users/ljk53/following{/other_user}', 'gists_url': 'https://api.github.com/users/ljk53/gists{/gist_id}', 'starred_url': 'https://api.github.com/users/ljk53/starred{/owner}{/repo}', 'subscriptions_url': 'https://api.github.com/users/ljk53/subscriptions', 'organizations_url': 'https://api.github.com/users/ljk53/orgs', 'repos_url': 'https://api.github.com/users/ljk53/repos', 'events_url': 'https://api.github.com/users/ljk53/events{/privacy}', 'received_events_url': 'https://api.github.com/users/ljk53/received_events', 'type': 'User', 'site_admin': False}",referenced,4c2e16e9f7dfe49a33ecaa9a41323cf3481b763f,https://api.github.com/repos/pytorch/pytorch/commits/4c2e16e9f7dfe49a33ecaa9a41323cf3481b763f,2019-09-26T04:50:53Z,39,37,2
26764,2663892218,"{'login': 'ljk53', 'id': 48700641, 'node_id': 'MDQ6VXNlcjQ4NzAwNjQx', 'avatar_url': 'https://avatars3.githubusercontent.com/u/48700641?v=4', 'gravatar_id': '', 'url': 'https://api.github.com/users/ljk53', 'html_url': 'https://github.com/ljk53', 'followers_url': 'https://api.github.com/users/ljk53/followers', 'following_url': 'https://api.github.com/users/ljk53/following{/other_user}', 'gists_url': 'https://api.github.com/users/ljk53/gists{/gist_id}', 'starred_url': 'https://api.github.com/users/ljk53/starred{/owner}{/repo}', 'subscriptions_url': 'https://api.github.com/users/ljk53/subscriptions', 'organizations_url': 'https://api.github.com/users/ljk53/orgs', 'repos_url': 'https://api.github.com/users/ljk53/repos', 'events_url': 'https://api.github.com/users/ljk53/events{/privacy}', 'received_events_url': 'https://api.github.com/users/ljk53/received_events', 'type': 'User', 'site_admin': False}",referenced,9bdfe544b3af55fbe3b8b9a4feecb408c6d6862c,https://api.github.com/repos/pytorch/pytorch/commits/9bdfe544b3af55fbe3b8b9a4feecb408c6d6862c,2019-09-26T04:51:00Z,39,37,2
26764,2666313496,"{'login': 'ezyang', 'id': 13564, 'node_id': 'MDQ6VXNlcjEzNTY0', 'avatar_url': 'https://avatars0.githubusercontent.com/u/13564?v=4', 'gravatar_id': '', 'url': 'https://api.github.com/users/ezyang', 'html_url': 'https://github.com/ezyang', 'followers_url': 'https://api.github.com/users/ezyang/followers', 'following_url': 'https://api.github.com/users/ezyang/following{/other_user}', 'gists_url': 'https://api.github.com/users/ezyang/gists{/gist_id}', 'starred_url': 'https://api.github.com/users/ezyang/starred{/owner}{/repo}', 'subscriptions_url': 'https://api.github.com/users/ezyang/subscriptions', 'organizations_url': 'https://api.github.com/users/ezyang/orgs', 'repos_url': 'https://api.github.com/users/ezyang/repos', 'events_url': 'https://api.github.com/users/ezyang/events{/privacy}', 'received_events_url': 'https://api.github.com/users/ezyang/received_events', 'type': 'User', 'site_admin': False}",referenced,1a08c0a4e06733067c7945552ffe256a07b2dd1b,https://api.github.com/repos/pytorch/pytorch/commits/1a08c0a4e06733067c7945552ffe256a07b2dd1b,2019-09-26T18:42:15Z,211,211,0
26764,2666313659,"{'login': 'ezyang', 'id': 13564, 'node_id': 'MDQ6VXNlcjEzNTY0', 'avatar_url': 'https://avatars0.githubusercontent.com/u/13564?v=4', 'gravatar_id': '', 'url': 'https://api.github.com/users/ezyang', 'html_url': 'https://github.com/ezyang', 'followers_url': 'https://api.github.com/users/ezyang/followers', 'following_url': 'https://api.github.com/users/ezyang/following{/other_user}', 'gists_url': 'https://api.github.com/users/ezyang/gists{/gist_id}', 'starred_url': 'https://api.github.com/users/ezyang/starred{/owner}{/repo}', 'subscriptions_url': 'https://api.github.com/users/ezyang/subscriptions', 'organizations_url': 'https://api.github.com/users/ezyang/orgs', 'repos_url': 'https://api.github.com/users/ezyang/repos', 'events_url': 'https://api.github.com/users/ezyang/events{/privacy}', 'received_events_url': 'https://api.github.com/users/ezyang/received_events', 'type': 'User', 'site_admin': False}",referenced,6577f606ec819d8c72b5e7a88b598e1b0c1a7036,https://api.github.com/repos/pytorch/pytorch/commits/6577f606ec819d8c72b5e7a88b598e1b0c1a7036,2019-09-26T18:42:19Z,211,211,0
26764,2666402350,"{'login': 'ezyang', 'id': 13564, 'node_id': 'MDQ6VXNlcjEzNTY0', 'avatar_url': 'https://avatars0.githubusercontent.com/u/13564?v=4', 'gravatar_id': '', 'url': 'https://api.github.com/users/ezyang', 'html_url': 'https://github.com/ezyang', 'followers_url': 'https://api.github.com/users/ezyang/followers', 'following_url': 'https://api.github.com/users/ezyang/following{/other_user}', 'gists_url': 'https://api.github.com/users/ezyang/gists{/gist_id}', 'starred_url': 'https://api.github.com/users/ezyang/starred{/owner}{/repo}', 'subscriptions_url': 'https://api.github.com/users/ezyang/subscriptions', 'organizations_url': 'https://api.github.com/users/ezyang/orgs', 'repos_url': 'https://api.github.com/users/ezyang/repos', 'events_url': 'https://api.github.com/users/ezyang/events{/privacy}', 'received_events_url': 'https://api.github.com/users/ezyang/received_events', 'type': 'User', 'site_admin': False}",referenced,f09ca35ef1d22b03f298edf085c6f71493b3dc31,https://api.github.com/repos/pytorch/pytorch/commits/f09ca35ef1d22b03f298edf085c6f71493b3dc31,2019-09-26T19:13:45Z,2,2,0
26764,2666402547,"{'login': 'ezyang', 'id': 13564, 'node_id': 'MDQ6VXNlcjEzNTY0', 'avatar_url': 'https://avatars0.githubusercontent.com/u/13564?v=4', 'gravatar_id': '', 'url': 'https://api.github.com/users/ezyang', 'html_url': 'https://github.com/ezyang', 'followers_url': 'https://api.github.com/users/ezyang/followers', 'following_url': 'https://api.github.com/users/ezyang/following{/other_user}', 'gists_url': 'https://api.github.com/users/ezyang/gists{/gist_id}', 'starred_url': 'https://api.github.com/users/ezyang/starred{/owner}{/repo}', 'subscriptions_url': 'https://api.github.com/users/ezyang/subscriptions', 'organizations_url': 'https://api.github.com/users/ezyang/orgs', 'repos_url': 'https://api.github.com/users/ezyang/repos', 'events_url': 'https://api.github.com/users/ezyang/events{/privacy}', 'received_events_url': 'https://api.github.com/users/ezyang/received_events', 'type': 'User', 'site_admin': False}",referenced,f5539a19063a2bf0e5ee78cbbe6cad5644eb02c7,https://api.github.com/repos/pytorch/pytorch/commits/f5539a19063a2bf0e5ee78cbbe6cad5644eb02c7,2019-09-26T19:13:50Z,213,213,0
26764,2668773491,"{'login': 'ezyang', 'id': 13564, 'node_id': 'MDQ6VXNlcjEzNTY0', 'avatar_url': 'https://avatars0.githubusercontent.com/u/13564?v=4', 'gravatar_id': '', 'url': 'https://api.github.com/users/ezyang', 'html_url': 'https://github.com/ezyang', 'followers_url': 'https://api.github.com/users/ezyang/followers', 'following_url': 'https://api.github.com/users/ezyang/following{/other_user}', 'gists_url': 'https://api.github.com/users/ezyang/gists{/gist_id}', 'starred_url': 'https://api.github.com/users/ezyang/starred{/owner}{/repo}', 'subscriptions_url': 'https://api.github.com/users/ezyang/subscriptions', 'organizations_url': 'https://api.github.com/users/ezyang/orgs', 'repos_url': 'https://api.github.com/users/ezyang/repos', 'events_url': 'https://api.github.com/users/ezyang/events{/privacy}', 'received_events_url': 'https://api.github.com/users/ezyang/received_events', 'type': 'User', 'site_admin': False}",referenced,7736f1797e6940842b753181e6c743d28496f0d7,https://api.github.com/repos/pytorch/pytorch/commits/7736f1797e6940842b753181e6c743d28496f0d7,2019-09-27T14:06:08Z,267,267,0
26764,2668773750,"{'login': 'ezyang', 'id': 13564, 'node_id': 'MDQ6VXNlcjEzNTY0', 'avatar_url': 'https://avatars0.githubusercontent.com/u/13564?v=4', 'gravatar_id': '', 'url': 'https://api.github.com/users/ezyang', 'html_url': 'https://github.com/ezyang', 'followers_url': 'https://api.github.com/users/ezyang/followers', 'following_url': 'https://api.github.com/users/ezyang/following{/other_user}', 'gists_url': 'https://api.github.com/users/ezyang/gists{/gist_id}', 'starred_url': 'https://api.github.com/users/ezyang/starred{/owner}{/repo}', 'subscriptions_url': 'https://api.github.com/users/ezyang/subscriptions', 'organizations_url': 'https://api.github.com/users/ezyang/orgs', 'repos_url': 'https://api.github.com/users/ezyang/repos', 'events_url': 'https://api.github.com/users/ezyang/events{/privacy}', 'received_events_url': 'https://api.github.com/users/ezyang/received_events', 'type': 'User', 'site_admin': False}",referenced,021c59d460cc98dc0d6ad1116cfe56461d3cab80,https://api.github.com/repos/pytorch/pytorch/commits/021c59d460cc98dc0d6ad1116cfe56461d3cab80,2019-09-27T14:06:14Z,480,480,0
26764,2669664702,"{'login': 'ezyang', 'id': 13564, 'node_id': 'MDQ6VXNlcjEzNTY0', 'avatar_url': 'https://avatars0.githubusercontent.com/u/13564?v=4', 'gravatar_id': '', 'url': 'https://api.github.com/users/ezyang', 'html_url': 'https://github.com/ezyang', 'followers_url': 'https://api.github.com/users/ezyang/followers', 'following_url': 'https://api.github.com/users/ezyang/following{/other_user}', 'gists_url': 'https://api.github.com/users/ezyang/gists{/gist_id}', 'starred_url': 'https://api.github.com/users/ezyang/starred{/owner}{/repo}', 'subscriptions_url': 'https://api.github.com/users/ezyang/subscriptions', 'organizations_url': 'https://api.github.com/users/ezyang/orgs', 'repos_url': 'https://api.github.com/users/ezyang/repos', 'events_url': 'https://api.github.com/users/ezyang/events{/privacy}', 'received_events_url': 'https://api.github.com/users/ezyang/received_events', 'type': 'User', 'site_admin': False}",referenced,c25a8f76db85e1c0bbfe6da0628b6d50b50e2852,https://api.github.com/repos/pytorch/pytorch/commits/c25a8f76db85e1c0bbfe6da0628b6d50b50e2852,2019-09-27T19:25:18Z,4319,3181,1138
26764,2669664802,"{'login': 'ezyang', 'id': 13564, 'node_id': 'MDQ6VXNlcjEzNTY0', 'avatar_url': 'https://avatars0.githubusercontent.com/u/13564?v=4', 'gravatar_id': '', 'url': 'https://api.github.com/users/ezyang', 'html_url': 'https://github.com/ezyang', 'followers_url': 'https://api.github.com/users/ezyang/followers', 'following_url': 'https://api.github.com/users/ezyang/following{/other_user}', 'gists_url': 'https://api.github.com/users/ezyang/gists{/gist_id}', 'starred_url': 'https://api.github.com/users/ezyang/starred{/owner}{/repo}', 'subscriptions_url': 'https://api.github.com/users/ezyang/subscriptions', 'organizations_url': 'https://api.github.com/users/ezyang/orgs', 'repos_url': 'https://api.github.com/users/ezyang/repos', 'events_url': 'https://api.github.com/users/ezyang/events{/privacy}', 'received_events_url': 'https://api.github.com/users/ezyang/received_events', 'type': 'User', 'site_admin': False}",referenced,d44011adc8c4323adb56fd3fede169cd9a83a63c,https://api.github.com/repos/pytorch/pytorch/commits/d44011adc8c4323adb56fd3fede169cd9a83a63c,2019-09-27T19:25:21Z,480,480,0
26764,2669858723,"{'login': 'ezyang', 'id': 13564, 'node_id': 'MDQ6VXNlcjEzNTY0', 'avatar_url': 'https://avatars0.githubusercontent.com/u/13564?v=4', 'gravatar_id': '', 'url': 'https://api.github.com/users/ezyang', 'html_url': 'https://github.com/ezyang', 'followers_url': 'https://api.github.com/users/ezyang/followers', 'following_url': 'https://api.github.com/users/ezyang/following{/other_user}', 'gists_url': 'https://api.github.com/users/ezyang/gists{/gist_id}', 'starred_url': 'https://api.github.com/users/ezyang/starred{/owner}{/repo}', 'subscriptions_url': 'https://api.github.com/users/ezyang/subscriptions', 'organizations_url': 'https://api.github.com/users/ezyang/orgs', 'repos_url': 'https://api.github.com/users/ezyang/repos', 'events_url': 'https://api.github.com/users/ezyang/events{/privacy}', 'received_events_url': 'https://api.github.com/users/ezyang/received_events', 'type': 'User', 'site_admin': False}",referenced,79723306fd01c19527db3a16d8c182d6db180720,https://api.github.com/repos/pytorch/pytorch/commits/79723306fd01c19527db3a16d8c182d6db180720,2019-09-27T20:49:05Z,4137,3983,154
26764,2669858906,"{'login': 'ezyang', 'id': 13564, 'node_id': 'MDQ6VXNlcjEzNTY0', 'avatar_url': 'https://avatars0.githubusercontent.com/u/13564?v=4', 'gravatar_id': '', 'url': 'https://api.github.com/users/ezyang', 'html_url': 'https://github.com/ezyang', 'followers_url': 'https://api.github.com/users/ezyang/followers', 'following_url': 'https://api.github.com/users/ezyang/following{/other_user}', 'gists_url': 'https://api.github.com/users/ezyang/gists{/gist_id}', 'starred_url': 'https://api.github.com/users/ezyang/starred{/owner}{/repo}', 'subscriptions_url': 'https://api.github.com/users/ezyang/subscriptions', 'organizations_url': 'https://api.github.com/users/ezyang/orgs', 'repos_url': 'https://api.github.com/users/ezyang/repos', 'events_url': 'https://api.github.com/users/ezyang/events{/privacy}', 'received_events_url': 'https://api.github.com/users/ezyang/received_events', 'type': 'User', 'site_admin': False}",referenced,70ff43d7fe179de700e7ab16e8590b8b52ba7b25,https://api.github.com/repos/pytorch/pytorch/commits/70ff43d7fe179de700e7ab16e8590b8b52ba7b25,2019-09-27T20:49:10Z,482,482,0
26764,2669966587,"{'login': 'ljk53', 'id': 48700641, 'node_id': 'MDQ6VXNlcjQ4NzAwNjQx', 'avatar_url': 'https://avatars3.githubusercontent.com/u/48700641?v=4', 'gravatar_id': '', 'url': 'https://api.github.com/users/ljk53', 'html_url': 'https://github.com/ljk53', 'followers_url': 'https://api.github.com/users/ljk53/followers', 'following_url': 'https://api.github.com/users/ljk53/following{/other_user}', 'gists_url': 'https://api.github.com/users/ljk53/gists{/gist_id}', 'starred_url': 'https://api.github.com/users/ljk53/starred{/owner}{/repo}', 'subscriptions_url': 'https://api.github.com/users/ljk53/subscriptions', 'organizations_url': 'https://api.github.com/users/ljk53/orgs', 'repos_url': 'https://api.github.com/users/ljk53/repos', 'events_url': 'https://api.github.com/users/ljk53/events{/privacy}', 'received_events_url': 'https://api.github.com/users/ljk53/received_events', 'type': 'User', 'site_admin': False}",referenced,21d664952d82f0f9502e55dd03b91c0a7e0da29a,https://api.github.com/repos/pytorch/pytorch/commits/21d664952d82f0f9502e55dd03b91c0a7e0da29a,2019-09-27T21:37:39Z,11706,9023,2683
26764,2669966677,"{'login': 'ljk53', 'id': 48700641, 'node_id': 'MDQ6VXNlcjQ4NzAwNjQx', 'avatar_url': 'https://avatars3.githubusercontent.com/u/48700641?v=4', 'gravatar_id': '', 'url': 'https://api.github.com/users/ljk53', 'html_url': 'https://github.com/ljk53', 'followers_url': 'https://api.github.com/users/ljk53/followers', 'following_url': 'https://api.github.com/users/ljk53/following{/other_user}', 'gists_url': 'https://api.github.com/users/ljk53/gists{/gist_id}', 'starred_url': 'https://api.github.com/users/ljk53/starred{/owner}{/repo}', 'subscriptions_url': 'https://api.github.com/users/ljk53/subscriptions', 'organizations_url': 'https://api.github.com/users/ljk53/orgs', 'repos_url': 'https://api.github.com/users/ljk53/repos', 'events_url': 'https://api.github.com/users/ljk53/events{/privacy}', 'received_events_url': 'https://api.github.com/users/ljk53/received_events', 'type': 'User', 'site_admin': False}",referenced,05ac4be502515bc2e2d55cd9f70235d281b8db6b,https://api.github.com/repos/pytorch/pytorch/commits/05ac4be502515bc2e2d55cd9f70235d281b8db6b,2019-09-27T21:37:43Z,7,7,0
26764,2670039019,"{'login': 'facebook-github-bot', 'id': 6422482, 'node_id': 'MDQ6VXNlcjY0MjI0ODI=', 'avatar_url': 'https://avatars3.githubusercontent.com/u/6422482?v=4', 'gravatar_id': '', 'url': 'https://api.github.com/users/facebook-github-bot', 'html_url': 'https://github.com/facebook-github-bot', 'followers_url': 'https://api.github.com/users/facebook-github-bot/followers', 'following_url': 'https://api.github.com/users/facebook-github-bot/following{/other_user}', 'gists_url': 'https://api.github.com/users/facebook-github-bot/gists{/gist_id}', 'starred_url': 'https://api.github.com/users/facebook-github-bot/starred{/owner}{/repo}', 'subscriptions_url': 'https://api.github.com/users/facebook-github-bot/subscriptions', 'organizations_url': 'https://api.github.com/users/facebook-github-bot/orgs', 'repos_url': 'https://api.github.com/users/facebook-github-bot/repos', 'events_url': 'https://api.github.com/users/facebook-github-bot/events{/privacy}', 'received_events_url': 'https://api.github.com/users/facebook-github-bot/received_events', 'type': 'User', 'site_admin': False}",referenced,38f7a51cf25a8b781ac1119a6feab457c0aae70d,https://api.github.com/repos/pytorch/pytorch/commits/38f7a51cf25a8b781ac1119a6feab457c0aae70d,2019-09-27T22:17:38Z,7,7,0
26764,2674177198,"{'login': 'ezyang', 'id': 13564, 'node_id': 'MDQ6VXNlcjEzNTY0', 'avatar_url': 'https://avatars0.githubusercontent.com/u/13564?v=4', 'gravatar_id': '', 'url': 'https://api.github.com/users/ezyang', 'html_url': 'https://github.com/ezyang', 'followers_url': 'https://api.github.com/users/ezyang/followers', 'following_url': 'https://api.github.com/users/ezyang/following{/other_user}', 'gists_url': 'https://api.github.com/users/ezyang/gists{/gist_id}', 'starred_url': 'https://api.github.com/users/ezyang/starred{/owner}{/repo}', 'subscriptions_url': 'https://api.github.com/users/ezyang/subscriptions', 'organizations_url': 'https://api.github.com/users/ezyang/orgs', 'repos_url': 'https://api.github.com/users/ezyang/repos', 'events_url': 'https://api.github.com/users/ezyang/events{/privacy}', 'received_events_url': 'https://api.github.com/users/ezyang/received_events', 'type': 'User', 'site_admin': False}",referenced,a80ab7fcd9566e0f99860549145676b2ef594846,https://api.github.com/repos/pytorch/pytorch/commits/a80ab7fcd9566e0f99860549145676b2ef594846,2019-09-30T17:42:42Z,6059,3791,2268
26764,2674177342,"{'login': 'ezyang', 'id': 13564, 'node_id': 'MDQ6VXNlcjEzNTY0', 'avatar_url': 'https://avatars0.githubusercontent.com/u/13564?v=4', 'gravatar_id': '', 'url': 'https://api.github.com/users/ezyang', 'html_url': 'https://github.com/ezyang', 'followers_url': 'https://api.github.com/users/ezyang/followers', 'following_url': 'https://api.github.com/users/ezyang/following{/other_user}', 'gists_url': 'https://api.github.com/users/ezyang/gists{/gist_id}', 'starred_url': 'https://api.github.com/users/ezyang/starred{/owner}{/repo}', 'subscriptions_url': 'https://api.github.com/users/ezyang/subscriptions', 'organizations_url': 'https://api.github.com/users/ezyang/orgs', 'repos_url': 'https://api.github.com/users/ezyang/repos', 'events_url': 'https://api.github.com/users/ezyang/events{/privacy}', 'received_events_url': 'https://api.github.com/users/ezyang/received_events', 'type': 'User', 'site_admin': False}",referenced,aaa492515484a17a3ef7499995560b2b0026da6d,https://api.github.com/repos/pytorch/pytorch/commits/aaa492515484a17a3ef7499995560b2b0026da6d,2019-09-30T17:42:45Z,482,482,0
26764,2674512256,"{'login': 'facebook-github-bot', 'id': 6422482, 'node_id': 'MDQ6VXNlcjY0MjI0ODI=', 'avatar_url': 'https://avatars3.githubusercontent.com/u/6422482?v=4', 'gravatar_id': '', 'url': 'https://api.github.com/users/facebook-github-bot', 'html_url': 'https://github.com/facebook-github-bot', 'followers_url': 'https://api.github.com/users/facebook-github-bot/followers', 'following_url': 'https://api.github.com/users/facebook-github-bot/following{/other_user}', 'gists_url': 'https://api.github.com/users/facebook-github-bot/gists{/gist_id}', 'starred_url': 'https://api.github.com/users/facebook-github-bot/starred{/owner}{/repo}', 'subscriptions_url': 'https://api.github.com/users/facebook-github-bot/subscriptions', 'organizations_url': 'https://api.github.com/users/facebook-github-bot/orgs', 'repos_url': 'https://api.github.com/users/facebook-github-bot/repos', 'events_url': 'https://api.github.com/users/facebook-github-bot/events{/privacy}', 'received_events_url': 'https://api.github.com/users/facebook-github-bot/received_events', 'type': 'User', 'site_admin': False}",closed,9159a601ca4953ecf0d3dc568cd0b966de2d4686,https://api.github.com/repos/pytorch/pytorch/commits/9159a601ca4953ecf0d3dc568cd0b966de2d4686,2019-09-30T19:28:32Z,482,482,0
26725,2675196903,"{'login': 'facebook-github-bot', 'id': 6422482, 'node_id': 'MDQ6VXNlcjY0MjI0ODI=', 'avatar_url': 'https://avatars3.githubusercontent.com/u/6422482?v=4', 'gravatar_id': '', 'url': 'https://api.github.com/users/facebook-github-bot', 'html_url': 'https://github.com/facebook-github-bot', 'followers_url': 'https://api.github.com/users/facebook-github-bot/followers', 'following_url': 'https://api.github.com/users/facebook-github-bot/following{/other_user}', 'gists_url': 'https://api.github.com/users/facebook-github-bot/gists{/gist_id}', 'starred_url': 'https://api.github.com/users/facebook-github-bot/starred{/owner}{/repo}', 'subscriptions_url': 'https://api.github.com/users/facebook-github-bot/subscriptions', 'organizations_url': 'https://api.github.com/users/facebook-github-bot/orgs', 'repos_url': 'https://api.github.com/users/facebook-github-bot/repos', 'events_url': 'https://api.github.com/users/facebook-github-bot/events{/privacy}', 'received_events_url': 'https://api.github.com/users/facebook-github-bot/received_events', 'type': 'User', 'site_admin': False}",referenced,990f4ca76d5bd627a295ce3aa847834d0c33af6a,https://api.github.com/repos/pytorch/pytorch/commits/990f4ca76d5bd627a295ce3aa847834d0c33af6a,2019-10-01T00:25:46Z,79,39,40
26725,2681614599,"{'login': 'eellison', 'id': 11477974, 'node_id': 'MDQ6VXNlcjExNDc3OTc0', 'avatar_url': 'https://avatars2.githubusercontent.com/u/11477974?v=4', 'gravatar_id': '', 'url': 'https://api.github.com/users/eellison', 'html_url': 'https://github.com/eellison', 'followers_url': 'https://api.github.com/users/eellison/followers', 'following_url': 'https://api.github.com/users/eellison/following{/other_user}', 'gists_url': 'https://api.github.com/users/eellison/gists{/gist_id}', 'starred_url': 'https://api.github.com/users/eellison/starred{/owner}{/repo}', 'subscriptions_url': 'https://api.github.com/users/eellison/subscriptions', 'organizations_url': 'https://api.github.com/users/eellison/orgs', 'repos_url': 'https://api.github.com/users/eellison/repos', 'events_url': 'https://api.github.com/users/eellison/events{/privacy}', 'received_events_url': 'https://api.github.com/users/eellison/received_events', 'type': 'User', 'site_admin': False}",referenced,506ec0581db6ae837de2207d26537f7fb8b2815f,https://api.github.com/repos/pytorch/pytorch/commits/506ec0581db6ae837de2207d26537f7fb8b2815f,2019-10-02T18:31:29Z,79,39,40
26725,2686197731,"{'login': 'soumith', 'id': 1310570, 'node_id': 'MDQ6VXNlcjEzMTA1NzA=', 'avatar_url': 'https://avatars0.githubusercontent.com/u/1310570?v=4', 'gravatar_id': '', 'url': 'https://api.github.com/users/soumith', 'html_url': 'https://github.com/soumith', 'followers_url': 'https://api.github.com/users/soumith/followers', 'following_url': 'https://api.github.com/users/soumith/following{/other_user}', 'gists_url': 'https://api.github.com/users/soumith/gists{/gist_id}', 'starred_url': 'https://api.github.com/users/soumith/starred{/owner}{/repo}', 'subscriptions_url': 'https://api.github.com/users/soumith/subscriptions', 'organizations_url': 'https://api.github.com/users/soumith/orgs', 'repos_url': 'https://api.github.com/users/soumith/repos', 'events_url': 'https://api.github.com/users/soumith/events{/privacy}', 'received_events_url': 'https://api.github.com/users/soumith/received_events', 'type': 'User', 'site_admin': False}",referenced,464f595f4a5fbec551390d88d67e47fe3d446888,https://api.github.com/repos/pytorch/pytorch/commits/464f595f4a5fbec551390d88d67e47fe3d446888,2019-10-04T05:10:31Z,79,39,40
26725,2690393205,"{'login': 'soumith', 'id': 1310570, 'node_id': 'MDQ6VXNlcjEzMTA1NzA=', 'avatar_url': 'https://avatars0.githubusercontent.com/u/1310570?v=4', 'gravatar_id': '', 'url': 'https://api.github.com/users/soumith', 'html_url': 'https://github.com/soumith', 'followers_url': 'https://api.github.com/users/soumith/followers', 'following_url': 'https://api.github.com/users/soumith/following{/other_user}', 'gists_url': 'https://api.github.com/users/soumith/gists{/gist_id}', 'starred_url': 'https://api.github.com/users/soumith/starred{/owner}{/repo}', 'subscriptions_url': 'https://api.github.com/users/soumith/subscriptions', 'organizations_url': 'https://api.github.com/users/soumith/orgs', 'repos_url': 'https://api.github.com/users/soumith/repos', 'events_url': 'https://api.github.com/users/soumith/events{/privacy}', 'received_events_url': 'https://api.github.com/users/soumith/received_events', 'type': 'User', 'site_admin': False}",referenced,544c16cdbfe3ecbcea2d048ac9a39ba06f223368,https://api.github.com/repos/pytorch/pytorch/commits/544c16cdbfe3ecbcea2d048ac9a39ba06f223368,2019-10-07T03:01:55Z,79,39,40
26721,2663789063,"{'login': 'facebook-github-bot', 'id': 6422482, 'node_id': 'MDQ6VXNlcjY0MjI0ODI=', 'avatar_url': 'https://avatars3.githubusercontent.com/u/6422482?v=4', 'gravatar_id': '', 'url': 'https://api.github.com/users/facebook-github-bot', 'html_url': 'https://github.com/facebook-github-bot', 'followers_url': 'https://api.github.com/users/facebook-github-bot/followers', 'following_url': 'https://api.github.com/users/facebook-github-bot/following{/other_user}', 'gists_url': 'https://api.github.com/users/facebook-github-bot/gists{/gist_id}', 'starred_url': 'https://api.github.com/users/facebook-github-bot/starred{/owner}{/repo}', 'subscriptions_url': 'https://api.github.com/users/facebook-github-bot/subscriptions', 'organizations_url': 'https://api.github.com/users/facebook-github-bot/orgs', 'repos_url': 'https://api.github.com/users/facebook-github-bot/repos', 'events_url': 'https://api.github.com/users/facebook-github-bot/events{/privacy}', 'received_events_url': 'https://api.github.com/users/facebook-github-bot/received_events', 'type': 'User', 'site_admin': False}",referenced,8f359a48a6843702e61eeefc8294f73c1a13cac1,https://api.github.com/repos/pytorch/pytorch/commits/8f359a48a6843702e61eeefc8294f73c1a13cac1,2019-09-26T03:37:37Z,2,1,1
26698,2696563327,"{'login': 'facebook-github-bot', 'id': 6422482, 'node_id': 'MDQ6VXNlcjY0MjI0ODI=', 'avatar_url': 'https://avatars3.githubusercontent.com/u/6422482?v=4', 'gravatar_id': '', 'url': 'https://api.github.com/users/facebook-github-bot', 'html_url': 'https://github.com/facebook-github-bot', 'followers_url': 'https://api.github.com/users/facebook-github-bot/followers', 'following_url': 'https://api.github.com/users/facebook-github-bot/following{/other_user}', 'gists_url': 'https://api.github.com/users/facebook-github-bot/gists{/gist_id}', 'starred_url': 'https://api.github.com/users/facebook-github-bot/starred{/owner}{/repo}', 'subscriptions_url': 'https://api.github.com/users/facebook-github-bot/subscriptions', 'organizations_url': 'https://api.github.com/users/facebook-github-bot/orgs', 'repos_url': 'https://api.github.com/users/facebook-github-bot/repos', 'events_url': 'https://api.github.com/users/facebook-github-bot/events{/privacy}', 'received_events_url': 'https://api.github.com/users/facebook-github-bot/received_events', 'type': 'User', 'site_admin': False}",referenced,eb9320032113bbb551c2f74163ca8285ce8a2cbb,https://api.github.com/repos/pytorch/pytorch/commits/eb9320032113bbb551c2f74163ca8285ce8a2cbb,2019-10-08T19:13:47Z,18,9,9
26693,2663364123,"{'login': 'facebook-github-bot', 'id': 6422482, 'node_id': 'MDQ6VXNlcjY0MjI0ODI=', 'avatar_url': 'https://avatars3.githubusercontent.com/u/6422482?v=4', 'gravatar_id': '', 'url': 'https://api.github.com/users/facebook-github-bot', 'html_url': 'https://github.com/facebook-github-bot', 'followers_url': 'https://api.github.com/users/facebook-github-bot/followers', 'following_url': 'https://api.github.com/users/facebook-github-bot/following{/other_user}', 'gists_url': 'https://api.github.com/users/facebook-github-bot/gists{/gist_id}', 'starred_url': 'https://api.github.com/users/facebook-github-bot/starred{/owner}{/repo}', 'subscriptions_url': 'https://api.github.com/users/facebook-github-bot/subscriptions', 'organizations_url': 'https://api.github.com/users/facebook-github-bot/orgs', 'repos_url': 'https://api.github.com/users/facebook-github-bot/repos', 'events_url': 'https://api.github.com/users/facebook-github-bot/events{/privacy}', 'received_events_url': 'https://api.github.com/users/facebook-github-bot/received_events', 'type': 'User', 'site_admin': False}",closed,d43480d6d16f1a9009ac0d39d394e61c5e831d27,https://api.github.com/repos/pytorch/pytorch/commits/d43480d6d16f1a9009ac0d39d394e61c5e831d27,2019-09-25T22:41:44Z,95,74,21
26673,2696550907,"{'login': 'facebook-github-bot', 'id': 6422482, 'node_id': 'MDQ6VXNlcjY0MjI0ODI=', 'avatar_url': 'https://avatars3.githubusercontent.com/u/6422482?v=4', 'gravatar_id': '', 'url': 'https://api.github.com/users/facebook-github-bot', 'html_url': 'https://github.com/facebook-github-bot', 'followers_url': 'https://api.github.com/users/facebook-github-bot/followers', 'following_url': 'https://api.github.com/users/facebook-github-bot/following{/other_user}', 'gists_url': 'https://api.github.com/users/facebook-github-bot/gists{/gist_id}', 'starred_url': 'https://api.github.com/users/facebook-github-bot/starred{/owner}{/repo}', 'subscriptions_url': 'https://api.github.com/users/facebook-github-bot/subscriptions', 'organizations_url': 'https://api.github.com/users/facebook-github-bot/orgs', 'repos_url': 'https://api.github.com/users/facebook-github-bot/repos', 'events_url': 'https://api.github.com/users/facebook-github-bot/events{/privacy}', 'received_events_url': 'https://api.github.com/users/facebook-github-bot/received_events', 'type': 'User', 'site_admin': False}",referenced,f522bde1213fcc46f2857f79be7b1b01ddf302a6,https://api.github.com/repos/pytorch/pytorch/commits/f522bde1213fcc46f2857f79be7b1b01ddf302a6,2019-10-08T19:09:14Z,30,16,14
26671,2711667942,"{'login': 'facebook-github-bot', 'id': 6422482, 'node_id': 'MDQ6VXNlcjY0MjI0ODI=', 'avatar_url': 'https://avatars3.githubusercontent.com/u/6422482?v=4', 'gravatar_id': '', 'url': 'https://api.github.com/users/facebook-github-bot', 'html_url': 'https://github.com/facebook-github-bot', 'followers_url': 'https://api.github.com/users/facebook-github-bot/followers', 'following_url': 'https://api.github.com/users/facebook-github-bot/following{/other_user}', 'gists_url': 'https://api.github.com/users/facebook-github-bot/gists{/gist_id}', 'starred_url': 'https://api.github.com/users/facebook-github-bot/starred{/owner}{/repo}', 'subscriptions_url': 'https://api.github.com/users/facebook-github-bot/subscriptions', 'organizations_url': 'https://api.github.com/users/facebook-github-bot/orgs', 'repos_url': 'https://api.github.com/users/facebook-github-bot/repos', 'events_url': 'https://api.github.com/users/facebook-github-bot/events{/privacy}', 'received_events_url': 'https://api.github.com/users/facebook-github-bot/received_events', 'type': 'User', 'site_admin': False}",referenced,cd6b37afa7168eb34e1d098e50fc730ab097c722,https://api.github.com/repos/pytorch/pytorch/commits/cd6b37afa7168eb34e1d098e50fc730ab097c722,2019-10-14T20:08:23Z,68,68,0
26606,2714935861,"{'login': 'facebook-github-bot', 'id': 6422482, 'node_id': 'MDQ6VXNlcjY0MjI0ODI=', 'avatar_url': 'https://avatars3.githubusercontent.com/u/6422482?v=4', 'gravatar_id': '', 'url': 'https://api.github.com/users/facebook-github-bot', 'html_url': 'https://github.com/facebook-github-bot', 'followers_url': 'https://api.github.com/users/facebook-github-bot/followers', 'following_url': 'https://api.github.com/users/facebook-github-bot/following{/other_user}', 'gists_url': 'https://api.github.com/users/facebook-github-bot/gists{/gist_id}', 'starred_url': 'https://api.github.com/users/facebook-github-bot/starred{/owner}{/repo}', 'subscriptions_url': 'https://api.github.com/users/facebook-github-bot/subscriptions', 'organizations_url': 'https://api.github.com/users/facebook-github-bot/orgs', 'repos_url': 'https://api.github.com/users/facebook-github-bot/repos', 'events_url': 'https://api.github.com/users/facebook-github-bot/events{/privacy}', 'received_events_url': 'https://api.github.com/users/facebook-github-bot/received_events', 'type': 'User', 'site_admin': False}",referenced,3397d41b8af2824495faaefc649c3c7e47f03bfb,https://api.github.com/repos/pytorch/pytorch/commits/3397d41b8af2824495faaefc649c3c7e47f03bfb,2019-10-15T18:05:51Z,274,138,136
26513,2653451027,"{'login': 'rohan-varma', 'id': 8039770, 'node_id': 'MDQ6VXNlcjgwMzk3NzA=', 'avatar_url': 'https://avatars2.githubusercontent.com/u/8039770?v=4', 'gravatar_id': '', 'url': 'https://api.github.com/users/rohan-varma', 'html_url': 'https://github.com/rohan-varma', 'followers_url': 'https://api.github.com/users/rohan-varma/followers', 'following_url': 'https://api.github.com/users/rohan-varma/following{/other_user}', 'gists_url': 'https://api.github.com/users/rohan-varma/gists{/gist_id}', 'starred_url': 'https://api.github.com/users/rohan-varma/starred{/owner}{/repo}', 'subscriptions_url': 'https://api.github.com/users/rohan-varma/subscriptions', 'organizations_url': 'https://api.github.com/users/rohan-varma/orgs', 'repos_url': 'https://api.github.com/users/rohan-varma/repos', 'events_url': 'https://api.github.com/users/rohan-varma/events{/privacy}', 'received_events_url': 'https://api.github.com/users/rohan-varma/received_events', 'type': 'User', 'site_admin': False}",referenced,fde45665f1148c1ed3f72948fd32efcdad0386d5,https://api.github.com/repos/pytorch/pytorch/commits/fde45665f1148c1ed3f72948fd32efcdad0386d5,2019-09-23T07:29:29Z,8,6,2
26513,2655564660,"{'login': 'rohan-varma', 'id': 8039770, 'node_id': 'MDQ6VXNlcjgwMzk3NzA=', 'avatar_url': 'https://avatars2.githubusercontent.com/u/8039770?v=4', 'gravatar_id': '', 'url': 'https://api.github.com/users/rohan-varma', 'html_url': 'https://github.com/rohan-varma', 'followers_url': 'https://api.github.com/users/rohan-varma/followers', 'following_url': 'https://api.github.com/users/rohan-varma/following{/other_user}', 'gists_url': 'https://api.github.com/users/rohan-varma/gists{/gist_id}', 'starred_url': 'https://api.github.com/users/rohan-varma/starred{/owner}{/repo}', 'subscriptions_url': 'https://api.github.com/users/rohan-varma/subscriptions', 'organizations_url': 'https://api.github.com/users/rohan-varma/orgs', 'repos_url': 'https://api.github.com/users/rohan-varma/repos', 'events_url': 'https://api.github.com/users/rohan-varma/events{/privacy}', 'received_events_url': 'https://api.github.com/users/rohan-varma/received_events', 'type': 'User', 'site_admin': False}",referenced,c8eeadc168de0d76b37355e798e0dda15561e141,https://api.github.com/repos/pytorch/pytorch/commits/c8eeadc168de0d76b37355e798e0dda15561e141,2019-09-23T19:05:19Z,10,6,4
26513,2655599638,"{'login': 'rohan-varma', 'id': 8039770, 'node_id': 'MDQ6VXNlcjgwMzk3NzA=', 'avatar_url': 'https://avatars2.githubusercontent.com/u/8039770?v=4', 'gravatar_id': '', 'url': 'https://api.github.com/users/rohan-varma', 'html_url': 'https://github.com/rohan-varma', 'followers_url': 'https://api.github.com/users/rohan-varma/followers', 'following_url': 'https://api.github.com/users/rohan-varma/following{/other_user}', 'gists_url': 'https://api.github.com/users/rohan-varma/gists{/gist_id}', 'starred_url': 'https://api.github.com/users/rohan-varma/starred{/owner}{/repo}', 'subscriptions_url': 'https://api.github.com/users/rohan-varma/subscriptions', 'organizations_url': 'https://api.github.com/users/rohan-varma/orgs', 'repos_url': 'https://api.github.com/users/rohan-varma/repos', 'events_url': 'https://api.github.com/users/rohan-varma/events{/privacy}', 'received_events_url': 'https://api.github.com/users/rohan-varma/received_events', 'type': 'User', 'site_admin': False}",referenced,1b5ba302274231574f1b91fe5b6cadf10894c0ec,https://api.github.com/repos/pytorch/pytorch/commits/1b5ba302274231574f1b91fe5b6cadf10894c0ec,2019-09-23T19:17:59Z,3,2,1
26513,2656083006,"{'login': 'rohan-varma', 'id': 8039770, 'node_id': 'MDQ6VXNlcjgwMzk3NzA=', 'avatar_url': 'https://avatars2.githubusercontent.com/u/8039770?v=4', 'gravatar_id': '', 'url': 'https://api.github.com/users/rohan-varma', 'html_url': 'https://github.com/rohan-varma', 'followers_url': 'https://api.github.com/users/rohan-varma/followers', 'following_url': 'https://api.github.com/users/rohan-varma/following{/other_user}', 'gists_url': 'https://api.github.com/users/rohan-varma/gists{/gist_id}', 'starred_url': 'https://api.github.com/users/rohan-varma/starred{/owner}{/repo}', 'subscriptions_url': 'https://api.github.com/users/rohan-varma/subscriptions', 'organizations_url': 'https://api.github.com/users/rohan-varma/orgs', 'repos_url': 'https://api.github.com/users/rohan-varma/repos', 'events_url': 'https://api.github.com/users/rohan-varma/events{/privacy}', 'received_events_url': 'https://api.github.com/users/rohan-varma/received_events', 'type': 'User', 'site_admin': False}",referenced,412dca09b03365e5692a77c4c570d22cb8ae3f1f,https://api.github.com/repos/pytorch/pytorch/commits/412dca09b03365e5692a77c4c570d22cb8ae3f1f,2019-09-23T22:22:24Z,11489,6798,4691
26513,2656903250,"{'login': 'rohan-varma', 'id': 8039770, 'node_id': 'MDQ6VXNlcjgwMzk3NzA=', 'avatar_url': 'https://avatars2.githubusercontent.com/u/8039770?v=4', 'gravatar_id': '', 'url': 'https://api.github.com/users/rohan-varma', 'html_url': 'https://github.com/rohan-varma', 'followers_url': 'https://api.github.com/users/rohan-varma/followers', 'following_url': 'https://api.github.com/users/rohan-varma/following{/other_user}', 'gists_url': 'https://api.github.com/users/rohan-varma/gists{/gist_id}', 'starred_url': 'https://api.github.com/users/rohan-varma/starred{/owner}{/repo}', 'subscriptions_url': 'https://api.github.com/users/rohan-varma/subscriptions', 'organizations_url': 'https://api.github.com/users/rohan-varma/orgs', 'repos_url': 'https://api.github.com/users/rohan-varma/repos', 'events_url': 'https://api.github.com/users/rohan-varma/events{/privacy}', 'received_events_url': 'https://api.github.com/users/rohan-varma/received_events', 'type': 'User', 'site_admin': False}",referenced,2e29ed9ebf330b8fe57d7e7e5d0f722c76e790a1,https://api.github.com/repos/pytorch/pytorch/commits/2e29ed9ebf330b8fe57d7e7e5d0f722c76e790a1,2019-09-24T07:03:52Z,3972,2589,1383
26495,2648482744,"{'login': 'zou3519', 'id': 5652049, 'node_id': 'MDQ6VXNlcjU2NTIwNDk=', 'avatar_url': 'https://avatars3.githubusercontent.com/u/5652049?v=4', 'gravatar_id': '', 'url': 'https://api.github.com/users/zou3519', 'html_url': 'https://github.com/zou3519', 'followers_url': 'https://api.github.com/users/zou3519/followers', 'following_url': 'https://api.github.com/users/zou3519/following{/other_user}', 'gists_url': 'https://api.github.com/users/zou3519/gists{/gist_id}', 'starred_url': 'https://api.github.com/users/zou3519/starred{/owner}{/repo}', 'subscriptions_url': 'https://api.github.com/users/zou3519/subscriptions', 'organizations_url': 'https://api.github.com/users/zou3519/orgs', 'repos_url': 'https://api.github.com/users/zou3519/repos', 'events_url': 'https://api.github.com/users/zou3519/events{/privacy}', 'received_events_url': 'https://api.github.com/users/zou3519/received_events', 'type': 'User', 'site_admin': False}",referenced,bacbf0f319fada7e3e5e1ab25725591e17e0ead7,https://api.github.com/repos/pytorch/pytorch/commits/bacbf0f319fada7e3e5e1ab25725591e17e0ead7,2019-09-19T21:34:46Z,12,9,3
26495,2648483027,"{'login': 'zou3519', 'id': 5652049, 'node_id': 'MDQ6VXNlcjU2NTIwNDk=', 'avatar_url': 'https://avatars3.githubusercontent.com/u/5652049?v=4', 'gravatar_id': '', 'url': 'https://api.github.com/users/zou3519', 'html_url': 'https://github.com/zou3519', 'followers_url': 'https://api.github.com/users/zou3519/followers', 'following_url': 'https://api.github.com/users/zou3519/following{/other_user}', 'gists_url': 'https://api.github.com/users/zou3519/gists{/gist_id}', 'starred_url': 'https://api.github.com/users/zou3519/starred{/owner}{/repo}', 'subscriptions_url': 'https://api.github.com/users/zou3519/subscriptions', 'organizations_url': 'https://api.github.com/users/zou3519/orgs', 'repos_url': 'https://api.github.com/users/zou3519/repos', 'events_url': 'https://api.github.com/users/zou3519/events{/privacy}', 'received_events_url': 'https://api.github.com/users/zou3519/received_events', 'type': 'User', 'site_admin': False}",referenced,2a8a1a02ca5051063da492ba9c9cde274d70611d,https://api.github.com/repos/pytorch/pytorch/commits/2a8a1a02ca5051063da492ba9c9cde274d70611d,2019-09-19T21:34:54Z,12,9,3
26495,2650545924,"{'login': 'facebook-github-bot', 'id': 6422482, 'node_id': 'MDQ6VXNlcjY0MjI0ODI=', 'avatar_url': 'https://avatars3.githubusercontent.com/u/6422482?v=4', 'gravatar_id': '', 'url': 'https://api.github.com/users/facebook-github-bot', 'html_url': 'https://github.com/facebook-github-bot', 'followers_url': 'https://api.github.com/users/facebook-github-bot/followers', 'following_url': 'https://api.github.com/users/facebook-github-bot/following{/other_user}', 'gists_url': 'https://api.github.com/users/facebook-github-bot/gists{/gist_id}', 'starred_url': 'https://api.github.com/users/facebook-github-bot/starred{/owner}{/repo}', 'subscriptions_url': 'https://api.github.com/users/facebook-github-bot/subscriptions', 'organizations_url': 'https://api.github.com/users/facebook-github-bot/orgs', 'repos_url': 'https://api.github.com/users/facebook-github-bot/repos', 'events_url': 'https://api.github.com/users/facebook-github-bot/events{/privacy}', 'received_events_url': 'https://api.github.com/users/facebook-github-bot/received_events', 'type': 'User', 'site_admin': False}",closed,e2515a4d6dc1895f1bc2c8b4d7950ca03ee9cc3d,https://api.github.com/repos/pytorch/pytorch/commits/e2515a4d6dc1895f1bc2c8b4d7950ca03ee9cc3d,2019-09-20T14:38:19Z,12,9,3
26437,2651089521,"{'login': 'facebook-github-bot', 'id': 6422482, 'node_id': 'MDQ6VXNlcjY0MjI0ODI=', 'avatar_url': 'https://avatars3.githubusercontent.com/u/6422482?v=4', 'gravatar_id': '', 'url': 'https://api.github.com/users/facebook-github-bot', 'html_url': 'https://github.com/facebook-github-bot', 'followers_url': 'https://api.github.com/users/facebook-github-bot/followers', 'following_url': 'https://api.github.com/users/facebook-github-bot/following{/other_user}', 'gists_url': 'https://api.github.com/users/facebook-github-bot/gists{/gist_id}', 'starred_url': 'https://api.github.com/users/facebook-github-bot/starred{/owner}{/repo}', 'subscriptions_url': 'https://api.github.com/users/facebook-github-bot/subscriptions', 'organizations_url': 'https://api.github.com/users/facebook-github-bot/orgs', 'repos_url': 'https://api.github.com/users/facebook-github-bot/repos', 'events_url': 'https://api.github.com/users/facebook-github-bot/events{/privacy}', 'received_events_url': 'https://api.github.com/users/facebook-github-bot/received_events', 'type': 'User', 'site_admin': False}",closed,4c40dbcb755bc9c7391ca373db542094f3439add,https://api.github.com/repos/pytorch/pytorch/commits/4c40dbcb755bc9c7391ca373db542094f3439add,2019-09-20T17:53:36Z,80,67,13
26433,2693683425,"{'login': 'facebook-github-bot', 'id': 6422482, 'node_id': 'MDQ6VXNlcjY0MjI0ODI=', 'avatar_url': 'https://avatars3.githubusercontent.com/u/6422482?v=4', 'gravatar_id': '', 'url': 'https://api.github.com/users/facebook-github-bot', 'html_url': 'https://github.com/facebook-github-bot', 'followers_url': 'https://api.github.com/users/facebook-github-bot/followers', 'following_url': 'https://api.github.com/users/facebook-github-bot/following{/other_user}', 'gists_url': 'https://api.github.com/users/facebook-github-bot/gists{/gist_id}', 'starred_url': 'https://api.github.com/users/facebook-github-bot/starred{/owner}{/repo}', 'subscriptions_url': 'https://api.github.com/users/facebook-github-bot/subscriptions', 'organizations_url': 'https://api.github.com/users/facebook-github-bot/orgs', 'repos_url': 'https://api.github.com/users/facebook-github-bot/repos', 'events_url': 'https://api.github.com/users/facebook-github-bot/events{/privacy}', 'received_events_url': 'https://api.github.com/users/facebook-github-bot/received_events', 'type': 'User', 'site_admin': False}",referenced,ce16d689b362a1d675942d1ab016e5112db913bf,https://api.github.com/repos/pytorch/pytorch/commits/ce16d689b362a1d675942d1ab016e5112db913bf,2019-10-08T00:14:41Z,3,3,0
26408,2652399230,"{'login': 'albanD', 'id': 6359743, 'node_id': 'MDQ6VXNlcjYzNTk3NDM=', 'avatar_url': 'https://avatars3.githubusercontent.com/u/6359743?v=4', 'gravatar_id': '', 'url': 'https://api.github.com/users/albanD', 'html_url': 'https://github.com/albanD', 'followers_url': 'https://api.github.com/users/albanD/followers', 'following_url': 'https://api.github.com/users/albanD/following{/other_user}', 'gists_url': 'https://api.github.com/users/albanD/gists{/gist_id}', 'starred_url': 'https://api.github.com/users/albanD/starred{/owner}{/repo}', 'subscriptions_url': 'https://api.github.com/users/albanD/subscriptions', 'organizations_url': 'https://api.github.com/users/albanD/orgs', 'repos_url': 'https://api.github.com/users/albanD/repos', 'events_url': 'https://api.github.com/users/albanD/events{/privacy}', 'received_events_url': 'https://api.github.com/users/albanD/received_events', 'type': 'User', 'site_admin': False}",referenced,a1eaee33349c4b8e8345ddb151a05cca8c2194fe,https://api.github.com/repos/pytorch/pytorch/commits/a1eaee33349c4b8e8345ddb151a05cca8c2194fe,2019-09-22T01:09:29Z,4,4,0
26408,2652399286,"{'login': 'albanD', 'id': 6359743, 'node_id': 'MDQ6VXNlcjYzNTk3NDM=', 'avatar_url': 'https://avatars3.githubusercontent.com/u/6359743?v=4', 'gravatar_id': '', 'url': 'https://api.github.com/users/albanD', 'html_url': 'https://github.com/albanD', 'followers_url': 'https://api.github.com/users/albanD/followers', 'following_url': 'https://api.github.com/users/albanD/following{/other_user}', 'gists_url': 'https://api.github.com/users/albanD/gists{/gist_id}', 'starred_url': 'https://api.github.com/users/albanD/starred{/owner}{/repo}', 'subscriptions_url': 'https://api.github.com/users/albanD/subscriptions', 'organizations_url': 'https://api.github.com/users/albanD/orgs', 'repos_url': 'https://api.github.com/users/albanD/repos', 'events_url': 'https://api.github.com/users/albanD/events{/privacy}', 'received_events_url': 'https://api.github.com/users/albanD/received_events', 'type': 'User', 'site_admin': False}",referenced,49f520899c65244d19b10c13f13a93baae97db05,https://api.github.com/repos/pytorch/pytorch/commits/49f520899c65244d19b10c13f13a93baae97db05,2019-09-22T01:09:35Z,4,4,0
26408,2658286548,"{'login': 'facebook-github-bot', 'id': 6422482, 'node_id': 'MDQ6VXNlcjY0MjI0ODI=', 'avatar_url': 'https://avatars3.githubusercontent.com/u/6422482?v=4', 'gravatar_id': '', 'url': 'https://api.github.com/users/facebook-github-bot', 'html_url': 'https://github.com/facebook-github-bot', 'followers_url': 'https://api.github.com/users/facebook-github-bot/followers', 'following_url': 'https://api.github.com/users/facebook-github-bot/following{/other_user}', 'gists_url': 'https://api.github.com/users/facebook-github-bot/gists{/gist_id}', 'starred_url': 'https://api.github.com/users/facebook-github-bot/starred{/owner}{/repo}', 'subscriptions_url': 'https://api.github.com/users/facebook-github-bot/subscriptions', 'organizations_url': 'https://api.github.com/users/facebook-github-bot/orgs', 'repos_url': 'https://api.github.com/users/facebook-github-bot/repos', 'events_url': 'https://api.github.com/users/facebook-github-bot/events{/privacy}', 'received_events_url': 'https://api.github.com/users/facebook-github-bot/received_events', 'type': 'User', 'site_admin': False}",closed,9f3351de81517533ef0f86a9086e99795e936e97,https://api.github.com/repos/pytorch/pytorch/commits/9f3351de81517533ef0f86a9086e99795e936e97,2019-09-24T14:27:53Z,4,4,0
26401,2727430151,"{'login': 'zasdfgbnm', 'id': 1032377, 'node_id': 'MDQ6VXNlcjEwMzIzNzc=', 'avatar_url': 'https://avatars2.githubusercontent.com/u/1032377?v=4', 'gravatar_id': '', 'url': 'https://api.github.com/users/zasdfgbnm', 'html_url': 'https://github.com/zasdfgbnm', 'followers_url': 'https://api.github.com/users/zasdfgbnm/followers', 'following_url': 'https://api.github.com/users/zasdfgbnm/following{/other_user}', 'gists_url': 'https://api.github.com/users/zasdfgbnm/gists{/gist_id}', 'starred_url': 'https://api.github.com/users/zasdfgbnm/starred{/owner}{/repo}', 'subscriptions_url': 'https://api.github.com/users/zasdfgbnm/subscriptions', 'organizations_url': 'https://api.github.com/users/zasdfgbnm/orgs', 'repos_url': 'https://api.github.com/users/zasdfgbnm/repos', 'events_url': 'https://api.github.com/users/zasdfgbnm/events{/privacy}', 'received_events_url': 'https://api.github.com/users/zasdfgbnm/received_events', 'type': 'User', 'site_admin': False}",referenced,a3a32ff695fc4eabae7aef57406395832ee0bed4,https://api.github.com/repos/pytorch/pytorch/commits/a3a32ff695fc4eabae7aef57406395832ee0bed4,2019-10-20T03:15:26Z,323,205,118
26401,2727430180,"{'login': 'zasdfgbnm', 'id': 1032377, 'node_id': 'MDQ6VXNlcjEwMzIzNzc=', 'avatar_url': 'https://avatars2.githubusercontent.com/u/1032377?v=4', 'gravatar_id': '', 'url': 'https://api.github.com/users/zasdfgbnm', 'html_url': 'https://github.com/zasdfgbnm', 'followers_url': 'https://api.github.com/users/zasdfgbnm/followers', 'following_url': 'https://api.github.com/users/zasdfgbnm/following{/other_user}', 'gists_url': 'https://api.github.com/users/zasdfgbnm/gists{/gist_id}', 'starred_url': 'https://api.github.com/users/zasdfgbnm/starred{/owner}{/repo}', 'subscriptions_url': 'https://api.github.com/users/zasdfgbnm/subscriptions', 'organizations_url': 'https://api.github.com/users/zasdfgbnm/orgs', 'repos_url': 'https://api.github.com/users/zasdfgbnm/repos', 'events_url': 'https://api.github.com/users/zasdfgbnm/events{/privacy}', 'received_events_url': 'https://api.github.com/users/zasdfgbnm/received_events', 'type': 'User', 'site_admin': False}",referenced,dd74026ff4df08bea69d19adf18ca330c7862d33,https://api.github.com/repos/pytorch/pytorch/commits/dd74026ff4df08bea69d19adf18ca330c7862d33,2019-10-20T03:15:33Z,323,205,118
26401,2734130631,"{'login': 'zasdfgbnm', 'id': 1032377, 'node_id': 'MDQ6VXNlcjEwMzIzNzc=', 'avatar_url': 'https://avatars2.githubusercontent.com/u/1032377?v=4', 'gravatar_id': '', 'url': 'https://api.github.com/users/zasdfgbnm', 'html_url': 'https://github.com/zasdfgbnm', 'followers_url': 'https://api.github.com/users/zasdfgbnm/followers', 'following_url': 'https://api.github.com/users/zasdfgbnm/following{/other_user}', 'gists_url': 'https://api.github.com/users/zasdfgbnm/gists{/gist_id}', 'starred_url': 'https://api.github.com/users/zasdfgbnm/starred{/owner}{/repo}', 'subscriptions_url': 'https://api.github.com/users/zasdfgbnm/subscriptions', 'organizations_url': 'https://api.github.com/users/zasdfgbnm/orgs', 'repos_url': 'https://api.github.com/users/zasdfgbnm/repos', 'events_url': 'https://api.github.com/users/zasdfgbnm/events{/privacy}', 'received_events_url': 'https://api.github.com/users/zasdfgbnm/received_events', 'type': 'User', 'site_admin': False}",referenced,2ad882f1e84474311b988ed1dd1203baa479c70a,https://api.github.com/repos/pytorch/pytorch/commits/2ad882f1e84474311b988ed1dd1203baa479c70a,2019-10-22T17:16:27Z,46,46,0
26401,2734140892,"{'login': 'zasdfgbnm', 'id': 1032377, 'node_id': 'MDQ6VXNlcjEwMzIzNzc=', 'avatar_url': 'https://avatars2.githubusercontent.com/u/1032377?v=4', 'gravatar_id': '', 'url': 'https://api.github.com/users/zasdfgbnm', 'html_url': 'https://github.com/zasdfgbnm', 'followers_url': 'https://api.github.com/users/zasdfgbnm/followers', 'following_url': 'https://api.github.com/users/zasdfgbnm/following{/other_user}', 'gists_url': 'https://api.github.com/users/zasdfgbnm/gists{/gist_id}', 'starred_url': 'https://api.github.com/users/zasdfgbnm/starred{/owner}{/repo}', 'subscriptions_url': 'https://api.github.com/users/zasdfgbnm/subscriptions', 'organizations_url': 'https://api.github.com/users/zasdfgbnm/orgs', 'repos_url': 'https://api.github.com/users/zasdfgbnm/repos', 'events_url': 'https://api.github.com/users/zasdfgbnm/events{/privacy}', 'received_events_url': 'https://api.github.com/users/zasdfgbnm/received_events', 'type': 'User', 'site_admin': False}",referenced,c294de9e6b2eefb641cefc12c862496764d0933c,https://api.github.com/repos/pytorch/pytorch/commits/c294de9e6b2eefb641cefc12c862496764d0933c,2019-10-22T17:19:49Z,0,0,0
26401,2734196275,"{'login': 'zasdfgbnm', 'id': 1032377, 'node_id': 'MDQ6VXNlcjEwMzIzNzc=', 'avatar_url': 'https://avatars2.githubusercontent.com/u/1032377?v=4', 'gravatar_id': '', 'url': 'https://api.github.com/users/zasdfgbnm', 'html_url': 'https://github.com/zasdfgbnm', 'followers_url': 'https://api.github.com/users/zasdfgbnm/followers', 'following_url': 'https://api.github.com/users/zasdfgbnm/following{/other_user}', 'gists_url': 'https://api.github.com/users/zasdfgbnm/gists{/gist_id}', 'starred_url': 'https://api.github.com/users/zasdfgbnm/starred{/owner}{/repo}', 'subscriptions_url': 'https://api.github.com/users/zasdfgbnm/subscriptions', 'organizations_url': 'https://api.github.com/users/zasdfgbnm/orgs', 'repos_url': 'https://api.github.com/users/zasdfgbnm/repos', 'events_url': 'https://api.github.com/users/zasdfgbnm/events{/privacy}', 'received_events_url': 'https://api.github.com/users/zasdfgbnm/received_events', 'type': 'User', 'site_admin': False}",referenced,be0acf2f5c04652263f188367911b202be564ee8,https://api.github.com/repos/pytorch/pytorch/commits/be0acf2f5c04652263f188367911b202be564ee8,2019-10-22T17:37:45Z,323,205,118
26401,2734597062,"{'login': 'zasdfgbnm', 'id': 1032377, 'node_id': 'MDQ6VXNlcjEwMzIzNzc=', 'avatar_url': 'https://avatars2.githubusercontent.com/u/1032377?v=4', 'gravatar_id': '', 'url': 'https://api.github.com/users/zasdfgbnm', 'html_url': 'https://github.com/zasdfgbnm', 'followers_url': 'https://api.github.com/users/zasdfgbnm/followers', 'following_url': 'https://api.github.com/users/zasdfgbnm/following{/other_user}', 'gists_url': 'https://api.github.com/users/zasdfgbnm/gists{/gist_id}', 'starred_url': 'https://api.github.com/users/zasdfgbnm/starred{/owner}{/repo}', 'subscriptions_url': 'https://api.github.com/users/zasdfgbnm/subscriptions', 'organizations_url': 'https://api.github.com/users/zasdfgbnm/orgs', 'repos_url': 'https://api.github.com/users/zasdfgbnm/repos', 'events_url': 'https://api.github.com/users/zasdfgbnm/events{/privacy}', 'received_events_url': 'https://api.github.com/users/zasdfgbnm/received_events', 'type': 'User', 'site_admin': False}",referenced,4c301a118630d53d97304da418032a8925c1ba8d,https://api.github.com/repos/pytorch/pytorch/commits/4c301a118630d53d97304da418032a8925c1ba8d,2019-10-22T19:52:28Z,86,58,28
26401,2738638262,"{'login': 'zasdfgbnm', 'id': 1032377, 'node_id': 'MDQ6VXNlcjEwMzIzNzc=', 'avatar_url': 'https://avatars2.githubusercontent.com/u/1032377?v=4', 'gravatar_id': '', 'url': 'https://api.github.com/users/zasdfgbnm', 'html_url': 'https://github.com/zasdfgbnm', 'followers_url': 'https://api.github.com/users/zasdfgbnm/followers', 'following_url': 'https://api.github.com/users/zasdfgbnm/following{/other_user}', 'gists_url': 'https://api.github.com/users/zasdfgbnm/gists{/gist_id}', 'starred_url': 'https://api.github.com/users/zasdfgbnm/starred{/owner}{/repo}', 'subscriptions_url': 'https://api.github.com/users/zasdfgbnm/subscriptions', 'organizations_url': 'https://api.github.com/users/zasdfgbnm/orgs', 'repos_url': 'https://api.github.com/users/zasdfgbnm/repos', 'events_url': 'https://api.github.com/users/zasdfgbnm/events{/privacy}', 'received_events_url': 'https://api.github.com/users/zasdfgbnm/received_events', 'type': 'User', 'site_admin': False}",referenced,66826d1c5a724b2eb8929091b477b4d0076d9a98,https://api.github.com/repos/pytorch/pytorch/commits/66826d1c5a724b2eb8929091b477b4d0076d9a98,2019-10-23T21:31:47Z,2914,1736,1178
26401,2741850303,"{'login': 'zasdfgbnm', 'id': 1032377, 'node_id': 'MDQ6VXNlcjEwMzIzNzc=', 'avatar_url': 'https://avatars2.githubusercontent.com/u/1032377?v=4', 'gravatar_id': '', 'url': 'https://api.github.com/users/zasdfgbnm', 'html_url': 'https://github.com/zasdfgbnm', 'followers_url': 'https://api.github.com/users/zasdfgbnm/followers', 'following_url': 'https://api.github.com/users/zasdfgbnm/following{/other_user}', 'gists_url': 'https://api.github.com/users/zasdfgbnm/gists{/gist_id}', 'starred_url': 'https://api.github.com/users/zasdfgbnm/starred{/owner}{/repo}', 'subscriptions_url': 'https://api.github.com/users/zasdfgbnm/subscriptions', 'organizations_url': 'https://api.github.com/users/zasdfgbnm/orgs', 'repos_url': 'https://api.github.com/users/zasdfgbnm/repos', 'events_url': 'https://api.github.com/users/zasdfgbnm/events{/privacy}', 'received_events_url': 'https://api.github.com/users/zasdfgbnm/received_events', 'type': 'User', 'site_admin': False}",referenced,6a60d08483fe32b033b11ab867284f12624c661c,https://api.github.com/repos/pytorch/pytorch/commits/6a60d08483fe32b033b11ab867284f12624c661c,2019-10-24T18:51:45Z,2436,1571,865
26401,2745633895,"{'login': 'zasdfgbnm', 'id': 1032377, 'node_id': 'MDQ6VXNlcjEwMzIzNzc=', 'avatar_url': 'https://avatars2.githubusercontent.com/u/1032377?v=4', 'gravatar_id': '', 'url': 'https://api.github.com/users/zasdfgbnm', 'html_url': 'https://github.com/zasdfgbnm', 'followers_url': 'https://api.github.com/users/zasdfgbnm/followers', 'following_url': 'https://api.github.com/users/zasdfgbnm/following{/other_user}', 'gists_url': 'https://api.github.com/users/zasdfgbnm/gists{/gist_id}', 'starred_url': 'https://api.github.com/users/zasdfgbnm/starred{/owner}{/repo}', 'subscriptions_url': 'https://api.github.com/users/zasdfgbnm/subscriptions', 'organizations_url': 'https://api.github.com/users/zasdfgbnm/orgs', 'repos_url': 'https://api.github.com/users/zasdfgbnm/repos', 'events_url': 'https://api.github.com/users/zasdfgbnm/events{/privacy}', 'received_events_url': 'https://api.github.com/users/zasdfgbnm/received_events', 'type': 'User', 'site_admin': False}",referenced,37e5536efc124aa3dc95fc5ef887b3efccca2148,https://api.github.com/repos/pytorch/pytorch/commits/37e5536efc124aa3dc95fc5ef887b3efccca2148,2019-10-25T22:34:22Z,5047,3088,1959
26401,2745946424,"{'login': 'zasdfgbnm', 'id': 1032377, 'node_id': 'MDQ6VXNlcjEwMzIzNzc=', 'avatar_url': 'https://avatars2.githubusercontent.com/u/1032377?v=4', 'gravatar_id': '', 'url': 'https://api.github.com/users/zasdfgbnm', 'html_url': 'https://github.com/zasdfgbnm', 'followers_url': 'https://api.github.com/users/zasdfgbnm/followers', 'following_url': 'https://api.github.com/users/zasdfgbnm/following{/other_user}', 'gists_url': 'https://api.github.com/users/zasdfgbnm/gists{/gist_id}', 'starred_url': 'https://api.github.com/users/zasdfgbnm/starred{/owner}{/repo}', 'subscriptions_url': 'https://api.github.com/users/zasdfgbnm/subscriptions', 'organizations_url': 'https://api.github.com/users/zasdfgbnm/orgs', 'repos_url': 'https://api.github.com/users/zasdfgbnm/repos', 'events_url': 'https://api.github.com/users/zasdfgbnm/events{/privacy}', 'received_events_url': 'https://api.github.com/users/zasdfgbnm/received_events', 'type': 'User', 'site_admin': False}",referenced,5d60bd518c4b062f3a31cdfcd51df40bf0ca00e4,https://api.github.com/repos/pytorch/pytorch/commits/5d60bd518c4b062f3a31cdfcd51df40bf0ca00e4,2019-10-26T08:14:51Z,16,11,5
26401,2746185665,"{'login': 'zasdfgbnm', 'id': 1032377, 'node_id': 'MDQ6VXNlcjEwMzIzNzc=', 'avatar_url': 'https://avatars2.githubusercontent.com/u/1032377?v=4', 'gravatar_id': '', 'url': 'https://api.github.com/users/zasdfgbnm', 'html_url': 'https://github.com/zasdfgbnm', 'followers_url': 'https://api.github.com/users/zasdfgbnm/followers', 'following_url': 'https://api.github.com/users/zasdfgbnm/following{/other_user}', 'gists_url': 'https://api.github.com/users/zasdfgbnm/gists{/gist_id}', 'starred_url': 'https://api.github.com/users/zasdfgbnm/starred{/owner}{/repo}', 'subscriptions_url': 'https://api.github.com/users/zasdfgbnm/subscriptions', 'organizations_url': 'https://api.github.com/users/zasdfgbnm/orgs', 'repos_url': 'https://api.github.com/users/zasdfgbnm/repos', 'events_url': 'https://api.github.com/users/zasdfgbnm/events{/privacy}', 'received_events_url': 'https://api.github.com/users/zasdfgbnm/received_events', 'type': 'User', 'site_admin': False}",referenced,bb3ad0c1f0998a4f7776cfca8b1b6d95af1d728e,https://api.github.com/repos/pytorch/pytorch/commits/bb3ad0c1f0998a4f7776cfca8b1b6d95af1d728e,2019-10-26T17:11:32Z,16,7,9
26401,2750179475,"{'login': 'facebook-github-bot', 'id': 6422482, 'node_id': 'MDQ6VXNlcjY0MjI0ODI=', 'avatar_url': 'https://avatars3.githubusercontent.com/u/6422482?v=4', 'gravatar_id': '', 'url': 'https://api.github.com/users/facebook-github-bot', 'html_url': 'https://github.com/facebook-github-bot', 'followers_url': 'https://api.github.com/users/facebook-github-bot/followers', 'following_url': 'https://api.github.com/users/facebook-github-bot/following{/other_user}', 'gists_url': 'https://api.github.com/users/facebook-github-bot/gists{/gist_id}', 'starred_url': 'https://api.github.com/users/facebook-github-bot/starred{/owner}{/repo}', 'subscriptions_url': 'https://api.github.com/users/facebook-github-bot/subscriptions', 'organizations_url': 'https://api.github.com/users/facebook-github-bot/orgs', 'repos_url': 'https://api.github.com/users/facebook-github-bot/repos', 'events_url': 'https://api.github.com/users/facebook-github-bot/events{/privacy}', 'received_events_url': 'https://api.github.com/users/facebook-github-bot/received_events', 'type': 'User', 'site_admin': False}",closed,b9f099ed936a116ffd1c0ebb0d065b50fa753332,https://api.github.com/repos/pytorch/pytorch/commits/b9f099ed936a116ffd1c0ebb0d065b50fa753332,2019-10-28T21:49:20Z,137,93,44
26333,2674292398,"{'login': 'facebook-github-bot', 'id': 6422482, 'node_id': 'MDQ6VXNlcjY0MjI0ODI=', 'avatar_url': 'https://avatars3.githubusercontent.com/u/6422482?v=4', 'gravatar_id': '', 'url': 'https://api.github.com/users/facebook-github-bot', 'html_url': 'https://github.com/facebook-github-bot', 'followers_url': 'https://api.github.com/users/facebook-github-bot/followers', 'following_url': 'https://api.github.com/users/facebook-github-bot/following{/other_user}', 'gists_url': 'https://api.github.com/users/facebook-github-bot/gists{/gist_id}', 'starred_url': 'https://api.github.com/users/facebook-github-bot/starred{/owner}{/repo}', 'subscriptions_url': 'https://api.github.com/users/facebook-github-bot/subscriptions', 'organizations_url': 'https://api.github.com/users/facebook-github-bot/orgs', 'repos_url': 'https://api.github.com/users/facebook-github-bot/repos', 'events_url': 'https://api.github.com/users/facebook-github-bot/events{/privacy}', 'received_events_url': 'https://api.github.com/users/facebook-github-bot/received_events', 'type': 'User', 'site_admin': False}",closed,585a5975fb962fea5f10b563c39f15af4ad7b7f1,https://api.github.com/repos/pytorch/pytorch/commits/585a5975fb962fea5f10b563c39f15af4ad7b7f1,2019-09-30T18:18:32Z,39,26,13
26333,2750130121,"{'login': 'facebook-github-bot', 'id': 6422482, 'node_id': 'MDQ6VXNlcjY0MjI0ODI=', 'avatar_url': 'https://avatars3.githubusercontent.com/u/6422482?v=4', 'gravatar_id': '', 'url': 'https://api.github.com/users/facebook-github-bot', 'html_url': 'https://github.com/facebook-github-bot', 'followers_url': 'https://api.github.com/users/facebook-github-bot/followers', 'following_url': 'https://api.github.com/users/facebook-github-bot/following{/other_user}', 'gists_url': 'https://api.github.com/users/facebook-github-bot/gists{/gist_id}', 'starred_url': 'https://api.github.com/users/facebook-github-bot/starred{/owner}{/repo}', 'subscriptions_url': 'https://api.github.com/users/facebook-github-bot/subscriptions', 'organizations_url': 'https://api.github.com/users/facebook-github-bot/orgs', 'repos_url': 'https://api.github.com/users/facebook-github-bot/repos', 'events_url': 'https://api.github.com/users/facebook-github-bot/events{/privacy}', 'received_events_url': 'https://api.github.com/users/facebook-github-bot/received_events', 'type': 'User', 'site_admin': False}",closed,f33813d5890396ac241d7a7dbbc3f0e9a304ee3c,https://api.github.com/repos/pytorch/pytorch/commits/f33813d5890396ac241d7a7dbbc3f0e9a304ee3c,2019-10-28T21:28:47Z,164,136,28
26328,2651463450,"{'login': 'facebook-github-bot', 'id': 6422482, 'node_id': 'MDQ6VXNlcjY0MjI0ODI=', 'avatar_url': 'https://avatars3.githubusercontent.com/u/6422482?v=4', 'gravatar_id': '', 'url': 'https://api.github.com/users/facebook-github-bot', 'html_url': 'https://github.com/facebook-github-bot', 'followers_url': 'https://api.github.com/users/facebook-github-bot/followers', 'following_url': 'https://api.github.com/users/facebook-github-bot/following{/other_user}', 'gists_url': 'https://api.github.com/users/facebook-github-bot/gists{/gist_id}', 'starred_url': 'https://api.github.com/users/facebook-github-bot/starred{/owner}{/repo}', 'subscriptions_url': 'https://api.github.com/users/facebook-github-bot/subscriptions', 'organizations_url': 'https://api.github.com/users/facebook-github-bot/orgs', 'repos_url': 'https://api.github.com/users/facebook-github-bot/repos', 'events_url': 'https://api.github.com/users/facebook-github-bot/events{/privacy}', 'received_events_url': 'https://api.github.com/users/facebook-github-bot/received_events', 'type': 'User', 'site_admin': False}",closed,1a114948ce1cebab7a8b0fad35f284ccb1e4e012,https://api.github.com/repos/pytorch/pytorch/commits/1a114948ce1cebab7a8b0fad35f284ccb1e4e012,2019-09-20T20:32:21Z,37,30,7
26305,2825470374,"{'login': 'facebook-github-bot', 'id': 6422482, 'node_id': 'MDQ6VXNlcjY0MjI0ODI=', 'avatar_url': 'https://avatars3.githubusercontent.com/u/6422482?v=4', 'gravatar_id': '', 'url': 'https://api.github.com/users/facebook-github-bot', 'html_url': 'https://github.com/facebook-github-bot', 'followers_url': 'https://api.github.com/users/facebook-github-bot/followers', 'following_url': 'https://api.github.com/users/facebook-github-bot/following{/other_user}', 'gists_url': 'https://api.github.com/users/facebook-github-bot/gists{/gist_id}', 'starred_url': 'https://api.github.com/users/facebook-github-bot/starred{/owner}{/repo}', 'subscriptions_url': 'https://api.github.com/users/facebook-github-bot/subscriptions', 'organizations_url': 'https://api.github.com/users/facebook-github-bot/orgs', 'repos_url': 'https://api.github.com/users/facebook-github-bot/repos', 'events_url': 'https://api.github.com/users/facebook-github-bot/events{/privacy}', 'received_events_url': 'https://api.github.com/users/facebook-github-bot/received_events', 'type': 'User', 'site_admin': False}",referenced,7c4b9042ababa32dcd49e8d35114c81c53027431,https://api.github.com/repos/pytorch/pytorch/commits/7c4b9042ababa32dcd49e8d35114c81c53027431,2019-11-23T17:29:43Z,79,67,12
26305,2899122638,"{'login': 'mingbowan', 'id': 2181364, 'node_id': 'MDQ6VXNlcjIxODEzNjQ=', 'avatar_url': 'https://avatars2.githubusercontent.com/u/2181364?v=4', 'gravatar_id': '', 'url': 'https://api.github.com/users/mingbowan', 'html_url': 'https://github.com/mingbowan', 'followers_url': 'https://api.github.com/users/mingbowan/followers', 'following_url': 'https://api.github.com/users/mingbowan/following{/other_user}', 'gists_url': 'https://api.github.com/users/mingbowan/gists{/gist_id}', 'starred_url': 'https://api.github.com/users/mingbowan/starred{/owner}{/repo}', 'subscriptions_url': 'https://api.github.com/users/mingbowan/subscriptions', 'organizations_url': 'https://api.github.com/users/mingbowan/orgs', 'repos_url': 'https://api.github.com/users/mingbowan/repos', 'events_url': 'https://api.github.com/users/mingbowan/events{/privacy}', 'received_events_url': 'https://api.github.com/users/mingbowan/received_events', 'type': 'User', 'site_admin': False}",referenced,9e7dc37f902af78b26739410766e79e63f53e27f,https://api.github.com/repos/pytorch/pytorch/commits/9e7dc37f902af78b26739410766e79e63f53e27f,2019-12-20T00:01:12Z,79,67,12
26206,2636952186,"{'login': 'ezyang', 'id': 13564, 'node_id': 'MDQ6VXNlcjEzNTY0', 'avatar_url': 'https://avatars0.githubusercontent.com/u/13564?v=4', 'gravatar_id': '', 'url': 'https://api.github.com/users/ezyang', 'html_url': 'https://github.com/ezyang', 'followers_url': 'https://api.github.com/users/ezyang/followers', 'following_url': 'https://api.github.com/users/ezyang/following{/other_user}', 'gists_url': 'https://api.github.com/users/ezyang/gists{/gist_id}', 'starred_url': 'https://api.github.com/users/ezyang/starred{/owner}{/repo}', 'subscriptions_url': 'https://api.github.com/users/ezyang/subscriptions', 'organizations_url': 'https://api.github.com/users/ezyang/orgs', 'repos_url': 'https://api.github.com/users/ezyang/repos', 'events_url': 'https://api.github.com/users/ezyang/events{/privacy}', 'received_events_url': 'https://api.github.com/users/ezyang/received_events', 'type': 'User', 'site_admin': False}",referenced,924a3a864c2784068ca52f6ca40cc0259c3bcbab,https://api.github.com/repos/pytorch/pytorch/commits/924a3a864c2784068ca52f6ca40cc0259c3bcbab,2019-09-16T16:01:43Z,44,19,25
26206,2636953700,"{'login': 'ezyang', 'id': 13564, 'node_id': 'MDQ6VXNlcjEzNTY0', 'avatar_url': 'https://avatars0.githubusercontent.com/u/13564?v=4', 'gravatar_id': '', 'url': 'https://api.github.com/users/ezyang', 'html_url': 'https://github.com/ezyang', 'followers_url': 'https://api.github.com/users/ezyang/followers', 'following_url': 'https://api.github.com/users/ezyang/following{/other_user}', 'gists_url': 'https://api.github.com/users/ezyang/gists{/gist_id}', 'starred_url': 'https://api.github.com/users/ezyang/starred{/owner}{/repo}', 'subscriptions_url': 'https://api.github.com/users/ezyang/subscriptions', 'organizations_url': 'https://api.github.com/users/ezyang/orgs', 'repos_url': 'https://api.github.com/users/ezyang/repos', 'events_url': 'https://api.github.com/users/ezyang/events{/privacy}', 'received_events_url': 'https://api.github.com/users/ezyang/received_events', 'type': 'User', 'site_admin': False}",referenced,e217f33a501640e030b04053404a97dda9736bd9,https://api.github.com/repos/pytorch/pytorch/commits/e217f33a501640e030b04053404a97dda9736bd9,2019-09-16T16:02:11Z,44,19,25
26206,2637341567,"{'login': 'ezyang', 'id': 13564, 'node_id': 'MDQ6VXNlcjEzNTY0', 'avatar_url': 'https://avatars0.githubusercontent.com/u/13564?v=4', 'gravatar_id': '', 'url': 'https://api.github.com/users/ezyang', 'html_url': 'https://github.com/ezyang', 'followers_url': 'https://api.github.com/users/ezyang/followers', 'following_url': 'https://api.github.com/users/ezyang/following{/other_user}', 'gists_url': 'https://api.github.com/users/ezyang/gists{/gist_id}', 'starred_url': 'https://api.github.com/users/ezyang/starred{/owner}{/repo}', 'subscriptions_url': 'https://api.github.com/users/ezyang/subscriptions', 'organizations_url': 'https://api.github.com/users/ezyang/orgs', 'repos_url': 'https://api.github.com/users/ezyang/repos', 'events_url': 'https://api.github.com/users/ezyang/events{/privacy}', 'received_events_url': 'https://api.github.com/users/ezyang/received_events', 'type': 'User', 'site_admin': False}",referenced,3bd7bc7b9c85e0d81c38a5c02f482a4eebbeb4b2,https://api.github.com/repos/pytorch/pytorch/commits/3bd7bc7b9c85e0d81c38a5c02f482a4eebbeb4b2,2019-09-16T18:14:56Z,642,321,321
26206,2637341801,"{'login': 'ezyang', 'id': 13564, 'node_id': 'MDQ6VXNlcjEzNTY0', 'avatar_url': 'https://avatars0.githubusercontent.com/u/13564?v=4', 'gravatar_id': '', 'url': 'https://api.github.com/users/ezyang', 'html_url': 'https://github.com/ezyang', 'followers_url': 'https://api.github.com/users/ezyang/followers', 'following_url': 'https://api.github.com/users/ezyang/following{/other_user}', 'gists_url': 'https://api.github.com/users/ezyang/gists{/gist_id}', 'starred_url': 'https://api.github.com/users/ezyang/starred{/owner}{/repo}', 'subscriptions_url': 'https://api.github.com/users/ezyang/subscriptions', 'organizations_url': 'https://api.github.com/users/ezyang/orgs', 'repos_url': 'https://api.github.com/users/ezyang/repos', 'events_url': 'https://api.github.com/users/ezyang/events{/privacy}', 'received_events_url': 'https://api.github.com/users/ezyang/received_events', 'type': 'User', 'site_admin': False}",referenced,6a163a59f8e7c5e5b3b844c69538f67723c0eb44,https://api.github.com/repos/pytorch/pytorch/commits/6a163a59f8e7c5e5b3b844c69538f67723c0eb44,2019-09-16T18:15:01Z,44,19,25
26206,2637878267,"{'login': 'ezyang', 'id': 13564, 'node_id': 'MDQ6VXNlcjEzNTY0', 'avatar_url': 'https://avatars0.githubusercontent.com/u/13564?v=4', 'gravatar_id': '', 'url': 'https://api.github.com/users/ezyang', 'html_url': 'https://github.com/ezyang', 'followers_url': 'https://api.github.com/users/ezyang/followers', 'following_url': 'https://api.github.com/users/ezyang/following{/other_user}', 'gists_url': 'https://api.github.com/users/ezyang/gists{/gist_id}', 'starred_url': 'https://api.github.com/users/ezyang/starred{/owner}{/repo}', 'subscriptions_url': 'https://api.github.com/users/ezyang/subscriptions', 'organizations_url': 'https://api.github.com/users/ezyang/orgs', 'repos_url': 'https://api.github.com/users/ezyang/repos', 'events_url': 'https://api.github.com/users/ezyang/events{/privacy}', 'received_events_url': 'https://api.github.com/users/ezyang/received_events', 'type': 'User', 'site_admin': False}",referenced,58e4a9eadf73a5b15523a57c7b4aa755d9eee0ed,https://api.github.com/repos/pytorch/pytorch/commits/58e4a9eadf73a5b15523a57c7b4aa755d9eee0ed,2019-09-16T21:31:45Z,29,21,8
26206,2637878513,"{'login': 'ezyang', 'id': 13564, 'node_id': 'MDQ6VXNlcjEzNTY0', 'avatar_url': 'https://avatars0.githubusercontent.com/u/13564?v=4', 'gravatar_id': '', 'url': 'https://api.github.com/users/ezyang', 'html_url': 'https://github.com/ezyang', 'followers_url': 'https://api.github.com/users/ezyang/followers', 'following_url': 'https://api.github.com/users/ezyang/following{/other_user}', 'gists_url': 'https://api.github.com/users/ezyang/gists{/gist_id}', 'starred_url': 'https://api.github.com/users/ezyang/starred{/owner}{/repo}', 'subscriptions_url': 'https://api.github.com/users/ezyang/subscriptions', 'organizations_url': 'https://api.github.com/users/ezyang/orgs', 'repos_url': 'https://api.github.com/users/ezyang/repos', 'events_url': 'https://api.github.com/users/ezyang/events{/privacy}', 'received_events_url': 'https://api.github.com/users/ezyang/received_events', 'type': 'User', 'site_admin': False}",referenced,50a20a9b0222301181d1523a760852c2d4375335,https://api.github.com/repos/pytorch/pytorch/commits/50a20a9b0222301181d1523a760852c2d4375335,2019-09-16T21:31:51Z,44,19,25
26206,2637881676,"{'login': 'ezyang', 'id': 13564, 'node_id': 'MDQ6VXNlcjEzNTY0', 'avatar_url': 'https://avatars0.githubusercontent.com/u/13564?v=4', 'gravatar_id': '', 'url': 'https://api.github.com/users/ezyang', 'html_url': 'https://github.com/ezyang', 'followers_url': 'https://api.github.com/users/ezyang/followers', 'following_url': 'https://api.github.com/users/ezyang/following{/other_user}', 'gists_url': 'https://api.github.com/users/ezyang/gists{/gist_id}', 'starred_url': 'https://api.github.com/users/ezyang/starred{/owner}{/repo}', 'subscriptions_url': 'https://api.github.com/users/ezyang/subscriptions', 'organizations_url': 'https://api.github.com/users/ezyang/orgs', 'repos_url': 'https://api.github.com/users/ezyang/repos', 'events_url': 'https://api.github.com/users/ezyang/events{/privacy}', 'received_events_url': 'https://api.github.com/users/ezyang/received_events', 'type': 'User', 'site_admin': False}",referenced,f9c4874ac345bf9ced421a2192a416dc2ecbf9ff,https://api.github.com/repos/pytorch/pytorch/commits/f9c4874ac345bf9ced421a2192a416dc2ecbf9ff,2019-09-16T21:32:56Z,756,484,272
26206,2637881971,"{'login': 'ezyang', 'id': 13564, 'node_id': 'MDQ6VXNlcjEzNTY0', 'avatar_url': 'https://avatars0.githubusercontent.com/u/13564?v=4', 'gravatar_id': '', 'url': 'https://api.github.com/users/ezyang', 'html_url': 'https://github.com/ezyang', 'followers_url': 'https://api.github.com/users/ezyang/followers', 'following_url': 'https://api.github.com/users/ezyang/following{/other_user}', 'gists_url': 'https://api.github.com/users/ezyang/gists{/gist_id}', 'starred_url': 'https://api.github.com/users/ezyang/starred{/owner}{/repo}', 'subscriptions_url': 'https://api.github.com/users/ezyang/subscriptions', 'organizations_url': 'https://api.github.com/users/ezyang/orgs', 'repos_url': 'https://api.github.com/users/ezyang/repos', 'events_url': 'https://api.github.com/users/ezyang/events{/privacy}', 'received_events_url': 'https://api.github.com/users/ezyang/received_events', 'type': 'User', 'site_admin': False}",referenced,51022026ddae1c8c50c94917c12c59f10eed80b7,https://api.github.com/repos/pytorch/pytorch/commits/51022026ddae1c8c50c94917c12c59f10eed80b7,2019-09-16T21:33:04Z,44,19,25
26206,2640154767,"{'login': 'ezyang', 'id': 13564, 'node_id': 'MDQ6VXNlcjEzNTY0', 'avatar_url': 'https://avatars0.githubusercontent.com/u/13564?v=4', 'gravatar_id': '', 'url': 'https://api.github.com/users/ezyang', 'html_url': 'https://github.com/ezyang', 'followers_url': 'https://api.github.com/users/ezyang/followers', 'following_url': 'https://api.github.com/users/ezyang/following{/other_user}', 'gists_url': 'https://api.github.com/users/ezyang/gists{/gist_id}', 'starred_url': 'https://api.github.com/users/ezyang/starred{/owner}{/repo}', 'subscriptions_url': 'https://api.github.com/users/ezyang/subscriptions', 'organizations_url': 'https://api.github.com/users/ezyang/orgs', 'repos_url': 'https://api.github.com/users/ezyang/repos', 'events_url': 'https://api.github.com/users/ezyang/events{/privacy}', 'received_events_url': 'https://api.github.com/users/ezyang/received_events', 'type': 'User', 'site_admin': False}",referenced,0f191afa9122f141ca95d1cdb133a9bcf0e7e8f0,https://api.github.com/repos/pytorch/pytorch/commits/0f191afa9122f141ca95d1cdb133a9bcf0e7e8f0,2019-09-17T14:38:49Z,7175,4053,3122
26206,2640155014,"{'login': 'ezyang', 'id': 13564, 'node_id': 'MDQ6VXNlcjEzNTY0', 'avatar_url': 'https://avatars0.githubusercontent.com/u/13564?v=4', 'gravatar_id': '', 'url': 'https://api.github.com/users/ezyang', 'html_url': 'https://github.com/ezyang', 'followers_url': 'https://api.github.com/users/ezyang/followers', 'following_url': 'https://api.github.com/users/ezyang/following{/other_user}', 'gists_url': 'https://api.github.com/users/ezyang/gists{/gist_id}', 'starred_url': 'https://api.github.com/users/ezyang/starred{/owner}{/repo}', 'subscriptions_url': 'https://api.github.com/users/ezyang/subscriptions', 'organizations_url': 'https://api.github.com/users/ezyang/orgs', 'repos_url': 'https://api.github.com/users/ezyang/repos', 'events_url': 'https://api.github.com/users/ezyang/events{/privacy}', 'received_events_url': 'https://api.github.com/users/ezyang/received_events', 'type': 'User', 'site_admin': False}",referenced,5dd49e183d195a5c5a6c01bfe3f8d5c8b84811cd,https://api.github.com/repos/pytorch/pytorch/commits/5dd49e183d195a5c5a6c01bfe3f8d5c8b84811cd,2019-09-17T14:38:53Z,7175,4053,3122
26206,2640155413,"{'login': 'ezyang', 'id': 13564, 'node_id': 'MDQ6VXNlcjEzNTY0', 'avatar_url': 'https://avatars0.githubusercontent.com/u/13564?v=4', 'gravatar_id': '', 'url': 'https://api.github.com/users/ezyang', 'html_url': 'https://github.com/ezyang', 'followers_url': 'https://api.github.com/users/ezyang/followers', 'following_url': 'https://api.github.com/users/ezyang/following{/other_user}', 'gists_url': 'https://api.github.com/users/ezyang/gists{/gist_id}', 'starred_url': 'https://api.github.com/users/ezyang/starred{/owner}{/repo}', 'subscriptions_url': 'https://api.github.com/users/ezyang/subscriptions', 'organizations_url': 'https://api.github.com/users/ezyang/orgs', 'repos_url': 'https://api.github.com/users/ezyang/repos', 'events_url': 'https://api.github.com/users/ezyang/events{/privacy}', 'received_events_url': 'https://api.github.com/users/ezyang/received_events', 'type': 'User', 'site_admin': False}",referenced,99f17af39b0ed691e8e3ba066fec08712424dde1,https://api.github.com/repos/pytorch/pytorch/commits/99f17af39b0ed691e8e3ba066fec08712424dde1,2019-09-17T14:39:00Z,44,19,25
26206,2647290487,"{'login': 'ezyang', 'id': 13564, 'node_id': 'MDQ6VXNlcjEzNTY0', 'avatar_url': 'https://avatars0.githubusercontent.com/u/13564?v=4', 'gravatar_id': '', 'url': 'https://api.github.com/users/ezyang', 'html_url': 'https://github.com/ezyang', 'followers_url': 'https://api.github.com/users/ezyang/followers', 'following_url': 'https://api.github.com/users/ezyang/following{/other_user}', 'gists_url': 'https://api.github.com/users/ezyang/gists{/gist_id}', 'starred_url': 'https://api.github.com/users/ezyang/starred{/owner}{/repo}', 'subscriptions_url': 'https://api.github.com/users/ezyang/subscriptions', 'organizations_url': 'https://api.github.com/users/ezyang/orgs', 'repos_url': 'https://api.github.com/users/ezyang/repos', 'events_url': 'https://api.github.com/users/ezyang/events{/privacy}', 'received_events_url': 'https://api.github.com/users/ezyang/received_events', 'type': 'User', 'site_admin': False}",referenced,53c7826911acde080ba7808a2d5c0c804bbee222,https://api.github.com/repos/pytorch/pytorch/commits/53c7826911acde080ba7808a2d5c0c804bbee222,2019-09-19T14:49:29Z,0,0,0
26206,2647291137,"{'login': 'ezyang', 'id': 13564, 'node_id': 'MDQ6VXNlcjEzNTY0', 'avatar_url': 'https://avatars0.githubusercontent.com/u/13564?v=4', 'gravatar_id': '', 'url': 'https://api.github.com/users/ezyang', 'html_url': 'https://github.com/ezyang', 'followers_url': 'https://api.github.com/users/ezyang/followers', 'following_url': 'https://api.github.com/users/ezyang/following{/other_user}', 'gists_url': 'https://api.github.com/users/ezyang/gists{/gist_id}', 'starred_url': 'https://api.github.com/users/ezyang/starred{/owner}{/repo}', 'subscriptions_url': 'https://api.github.com/users/ezyang/subscriptions', 'organizations_url': 'https://api.github.com/users/ezyang/orgs', 'repos_url': 'https://api.github.com/users/ezyang/repos', 'events_url': 'https://api.github.com/users/ezyang/events{/privacy}', 'received_events_url': 'https://api.github.com/users/ezyang/received_events', 'type': 'User', 'site_admin': False}",referenced,36c08daf262658880542e803be7f5402abbf2930,https://api.github.com/repos/pytorch/pytorch/commits/36c08daf262658880542e803be7f5402abbf2930,2019-09-19T14:49:40Z,4,2,2
26206,2647292164,"{'login': 'ezyang', 'id': 13564, 'node_id': 'MDQ6VXNlcjEzNTY0', 'avatar_url': 'https://avatars0.githubusercontent.com/u/13564?v=4', 'gravatar_id': '', 'url': 'https://api.github.com/users/ezyang', 'html_url': 'https://github.com/ezyang', 'followers_url': 'https://api.github.com/users/ezyang/followers', 'following_url': 'https://api.github.com/users/ezyang/following{/other_user}', 'gists_url': 'https://api.github.com/users/ezyang/gists{/gist_id}', 'starred_url': 'https://api.github.com/users/ezyang/starred{/owner}{/repo}', 'subscriptions_url': 'https://api.github.com/users/ezyang/subscriptions', 'organizations_url': 'https://api.github.com/users/ezyang/orgs', 'repos_url': 'https://api.github.com/users/ezyang/repos', 'events_url': 'https://api.github.com/users/ezyang/events{/privacy}', 'received_events_url': 'https://api.github.com/users/ezyang/received_events', 'type': 'User', 'site_admin': False}",referenced,2e8a5ec18f13edf676e4cea7457d81e67fdcabc2,https://api.github.com/repos/pytorch/pytorch/commits/2e8a5ec18f13edf676e4cea7457d81e67fdcabc2,2019-09-19T14:49:55Z,46,20,26
26206,2658280796,"{'login': 'ezyang', 'id': 13564, 'node_id': 'MDQ6VXNlcjEzNTY0', 'avatar_url': 'https://avatars0.githubusercontent.com/u/13564?v=4', 'gravatar_id': '', 'url': 'https://api.github.com/users/ezyang', 'html_url': 'https://github.com/ezyang', 'followers_url': 'https://api.github.com/users/ezyang/followers', 'following_url': 'https://api.github.com/users/ezyang/following{/other_user}', 'gists_url': 'https://api.github.com/users/ezyang/gists{/gist_id}', 'starred_url': 'https://api.github.com/users/ezyang/starred{/owner}{/repo}', 'subscriptions_url': 'https://api.github.com/users/ezyang/subscriptions', 'organizations_url': 'https://api.github.com/users/ezyang/orgs', 'repos_url': 'https://api.github.com/users/ezyang/repos', 'events_url': 'https://api.github.com/users/ezyang/events{/privacy}', 'received_events_url': 'https://api.github.com/users/ezyang/received_events', 'type': 'User', 'site_admin': False}",referenced,4065246237e29af8a3d599545b8bdd434ac8ec1f,https://api.github.com/repos/pytorch/pytorch/commits/4065246237e29af8a3d599545b8bdd434ac8ec1f,2019-09-24T14:26:33Z,46,20,26
26206,2658280852,"{'login': 'ezyang', 'id': 13564, 'node_id': 'MDQ6VXNlcjEzNTY0', 'avatar_url': 'https://avatars0.githubusercontent.com/u/13564?v=4', 'gravatar_id': '', 'url': 'https://api.github.com/users/ezyang', 'html_url': 'https://github.com/ezyang', 'followers_url': 'https://api.github.com/users/ezyang/followers', 'following_url': 'https://api.github.com/users/ezyang/following{/other_user}', 'gists_url': 'https://api.github.com/users/ezyang/gists{/gist_id}', 'starred_url': 'https://api.github.com/users/ezyang/starred{/owner}{/repo}', 'subscriptions_url': 'https://api.github.com/users/ezyang/subscriptions', 'organizations_url': 'https://api.github.com/users/ezyang/orgs', 'repos_url': 'https://api.github.com/users/ezyang/repos', 'events_url': 'https://api.github.com/users/ezyang/events{/privacy}', 'received_events_url': 'https://api.github.com/users/ezyang/received_events', 'type': 'User', 'site_admin': False}",referenced,a7225fec99651720ad0d05e2e731f61eed414066,https://api.github.com/repos/pytorch/pytorch/commits/a7225fec99651720ad0d05e2e731f61eed414066,2019-09-24T14:26:34Z,36786,23762,13024
26206,2658280860,"{'login': 'ezyang', 'id': 13564, 'node_id': 'MDQ6VXNlcjEzNTY0', 'avatar_url': 'https://avatars0.githubusercontent.com/u/13564?v=4', 'gravatar_id': '', 'url': 'https://api.github.com/users/ezyang', 'html_url': 'https://github.com/ezyang', 'followers_url': 'https://api.github.com/users/ezyang/followers', 'following_url': 'https://api.github.com/users/ezyang/following{/other_user}', 'gists_url': 'https://api.github.com/users/ezyang/gists{/gist_id}', 'starred_url': 'https://api.github.com/users/ezyang/starred{/owner}{/repo}', 'subscriptions_url': 'https://api.github.com/users/ezyang/subscriptions', 'organizations_url': 'https://api.github.com/users/ezyang/orgs', 'repos_url': 'https://api.github.com/users/ezyang/repos', 'events_url': 'https://api.github.com/users/ezyang/events{/privacy}', 'received_events_url': 'https://api.github.com/users/ezyang/received_events', 'type': 'User', 'site_admin': False}",referenced,03fd60813f7654bb8cc876596e9258d78c2d4f19,https://api.github.com/repos/pytorch/pytorch/commits/03fd60813f7654bb8cc876596e9258d78c2d4f19,2019-09-24T14:26:34Z,36786,23762,13024
26206,2662614811,"{'login': 'facebook-github-bot', 'id': 6422482, 'node_id': 'MDQ6VXNlcjY0MjI0ODI=', 'avatar_url': 'https://avatars3.githubusercontent.com/u/6422482?v=4', 'gravatar_id': '', 'url': 'https://api.github.com/users/facebook-github-bot', 'html_url': 'https://github.com/facebook-github-bot', 'followers_url': 'https://api.github.com/users/facebook-github-bot/followers', 'following_url': 'https://api.github.com/users/facebook-github-bot/following{/other_user}', 'gists_url': 'https://api.github.com/users/facebook-github-bot/gists{/gist_id}', 'starred_url': 'https://api.github.com/users/facebook-github-bot/starred{/owner}{/repo}', 'subscriptions_url': 'https://api.github.com/users/facebook-github-bot/subscriptions', 'organizations_url': 'https://api.github.com/users/facebook-github-bot/orgs', 'repos_url': 'https://api.github.com/users/facebook-github-bot/repos', 'events_url': 'https://api.github.com/users/facebook-github-bot/events{/privacy}', 'received_events_url': 'https://api.github.com/users/facebook-github-bot/received_events', 'type': 'User', 'site_admin': False}",closed,1cae5195a658aa361e0a0e9ec1c27804698ce55a,https://api.github.com/repos/pytorch/pytorch/commits/1cae5195a658aa361e0a0e9ec1c27804698ce55a,2019-09-25T17:59:18Z,46,20,26
26199,2634427223,"{'login': 'facebook-github-bot', 'id': 6422482, 'node_id': 'MDQ6VXNlcjY0MjI0ODI=', 'avatar_url': 'https://avatars3.githubusercontent.com/u/6422482?v=4', 'gravatar_id': '', 'url': 'https://api.github.com/users/facebook-github-bot', 'html_url': 'https://github.com/facebook-github-bot', 'followers_url': 'https://api.github.com/users/facebook-github-bot/followers', 'following_url': 'https://api.github.com/users/facebook-github-bot/following{/other_user}', 'gists_url': 'https://api.github.com/users/facebook-github-bot/gists{/gist_id}', 'starred_url': 'https://api.github.com/users/facebook-github-bot/starred{/owner}{/repo}', 'subscriptions_url': 'https://api.github.com/users/facebook-github-bot/subscriptions', 'organizations_url': 'https://api.github.com/users/facebook-github-bot/orgs', 'repos_url': 'https://api.github.com/users/facebook-github-bot/repos', 'events_url': 'https://api.github.com/users/facebook-github-bot/events{/privacy}', 'received_events_url': 'https://api.github.com/users/facebook-github-bot/received_events', 'type': 'User', 'site_admin': False}",closed,7f3c423541647b4018fbee807b7875e2b37babc9,https://api.github.com/repos/pytorch/pytorch/commits/7f3c423541647b4018fbee807b7875e2b37babc9,2019-09-15T02:29:54Z,2,2,0
26076,2648589406,"{'login': 'facebook-github-bot', 'id': 6422482, 'node_id': 'MDQ6VXNlcjY0MjI0ODI=', 'avatar_url': 'https://avatars3.githubusercontent.com/u/6422482?v=4', 'gravatar_id': '', 'url': 'https://api.github.com/users/facebook-github-bot', 'html_url': 'https://github.com/facebook-github-bot', 'followers_url': 'https://api.github.com/users/facebook-github-bot/followers', 'following_url': 'https://api.github.com/users/facebook-github-bot/following{/other_user}', 'gists_url': 'https://api.github.com/users/facebook-github-bot/gists{/gist_id}', 'starred_url': 'https://api.github.com/users/facebook-github-bot/starred{/owner}{/repo}', 'subscriptions_url': 'https://api.github.com/users/facebook-github-bot/subscriptions', 'organizations_url': 'https://api.github.com/users/facebook-github-bot/orgs', 'repos_url': 'https://api.github.com/users/facebook-github-bot/repos', 'events_url': 'https://api.github.com/users/facebook-github-bot/events{/privacy}', 'received_events_url': 'https://api.github.com/users/facebook-github-bot/received_events', 'type': 'User', 'site_admin': False}",closed,e72b0be2e1c6f63d410cb176fe2380b9990c8f2b,https://api.github.com/repos/pytorch/pytorch/commits/e72b0be2e1c6f63d410cb176fe2380b9990c8f2b,2019-09-19T22:29:00Z,126,70,56
26067,2627472010,"{'login': 'driazati', 'id': 9407960, 'node_id': 'MDQ6VXNlcjk0MDc5NjA=', 'avatar_url': 'https://avatars3.githubusercontent.com/u/9407960?v=4', 'gravatar_id': '', 'url': 'https://api.github.com/users/driazati', 'html_url': 'https://github.com/driazati', 'followers_url': 'https://api.github.com/users/driazati/followers', 'following_url': 'https://api.github.com/users/driazati/following{/other_user}', 'gists_url': 'https://api.github.com/users/driazati/gists{/gist_id}', 'starred_url': 'https://api.github.com/users/driazati/starred{/owner}{/repo}', 'subscriptions_url': 'https://api.github.com/users/driazati/subscriptions', 'organizations_url': 'https://api.github.com/users/driazati/orgs', 'repos_url': 'https://api.github.com/users/driazati/repos', 'events_url': 'https://api.github.com/users/driazati/events{/privacy}', 'received_events_url': 'https://api.github.com/users/driazati/received_events', 'type': 'User', 'site_admin': False}",referenced,6979adfe44000395164b41b0031e743e6a37d103,https://api.github.com/repos/pytorch/pytorch/commits/6979adfe44000395164b41b0031e743e6a37d103,2019-09-11T23:54:19Z,45,33,12
26052,2753441634,"{'login': 'facebook-github-bot', 'id': 6422482, 'node_id': 'MDQ6VXNlcjY0MjI0ODI=', 'avatar_url': 'https://avatars3.githubusercontent.com/u/6422482?v=4', 'gravatar_id': '', 'url': 'https://api.github.com/users/facebook-github-bot', 'html_url': 'https://github.com/facebook-github-bot', 'followers_url': 'https://api.github.com/users/facebook-github-bot/followers', 'following_url': 'https://api.github.com/users/facebook-github-bot/following{/other_user}', 'gists_url': 'https://api.github.com/users/facebook-github-bot/gists{/gist_id}', 'starred_url': 'https://api.github.com/users/facebook-github-bot/starred{/owner}{/repo}', 'subscriptions_url': 'https://api.github.com/users/facebook-github-bot/subscriptions', 'organizations_url': 'https://api.github.com/users/facebook-github-bot/orgs', 'repos_url': 'https://api.github.com/users/facebook-github-bot/repos', 'events_url': 'https://api.github.com/users/facebook-github-bot/events{/privacy}', 'received_events_url': 'https://api.github.com/users/facebook-github-bot/received_events', 'type': 'User', 'site_admin': False}",referenced,f42768f8c0f4f74efa55530af8230c1a2e5753f4,https://api.github.com/repos/pytorch/pytorch/commits/f42768f8c0f4f74efa55530af8230c1a2e5753f4,2019-10-29T19:05:48Z,221,221,0
26049,2632608320,"{'login': 'pietern', 'id': 9845, 'node_id': 'MDQ6VXNlcjk4NDU=', 'avatar_url': 'https://avatars3.githubusercontent.com/u/9845?v=4', 'gravatar_id': '', 'url': 'https://api.github.com/users/pietern', 'html_url': 'https://github.com/pietern', 'followers_url': 'https://api.github.com/users/pietern/followers', 'following_url': 'https://api.github.com/users/pietern/following{/other_user}', 'gists_url': 'https://api.github.com/users/pietern/gists{/gist_id}', 'starred_url': 'https://api.github.com/users/pietern/starred{/owner}{/repo}', 'subscriptions_url': 'https://api.github.com/users/pietern/subscriptions', 'organizations_url': 'https://api.github.com/users/pietern/orgs', 'repos_url': 'https://api.github.com/users/pietern/repos', 'events_url': 'https://api.github.com/users/pietern/events{/privacy}', 'received_events_url': 'https://api.github.com/users/pietern/received_events', 'type': 'User', 'site_admin': False}",referenced,399dddd5c5e3782105de895b05d5025a8760a884,https://api.github.com/repos/pytorch/pytorch/commits/399dddd5c5e3782105de895b05d5025a8760a884,2019-09-13T14:51:58Z,139,108,31
26049,2632608754,"{'login': 'pietern', 'id': 9845, 'node_id': 'MDQ6VXNlcjk4NDU=', 'avatar_url': 'https://avatars3.githubusercontent.com/u/9845?v=4', 'gravatar_id': '', 'url': 'https://api.github.com/users/pietern', 'html_url': 'https://github.com/pietern', 'followers_url': 'https://api.github.com/users/pietern/followers', 'following_url': 'https://api.github.com/users/pietern/following{/other_user}', 'gists_url': 'https://api.github.com/users/pietern/gists{/gist_id}', 'starred_url': 'https://api.github.com/users/pietern/starred{/owner}{/repo}', 'subscriptions_url': 'https://api.github.com/users/pietern/subscriptions', 'organizations_url': 'https://api.github.com/users/pietern/orgs', 'repos_url': 'https://api.github.com/users/pietern/repos', 'events_url': 'https://api.github.com/users/pietern/events{/privacy}', 'received_events_url': 'https://api.github.com/users/pietern/received_events', 'type': 'User', 'site_admin': False}",referenced,79ed2591c85a7fc7630fa5f6c89a2d03a666d97e,https://api.github.com/repos/pytorch/pytorch/commits/79ed2591c85a7fc7630fa5f6c89a2d03a666d97e,2019-09-13T14:52:05Z,139,108,31
26049,2632613615,"{'login': 'pietern', 'id': 9845, 'node_id': 'MDQ6VXNlcjk4NDU=', 'avatar_url': 'https://avatars3.githubusercontent.com/u/9845?v=4', 'gravatar_id': '', 'url': 'https://api.github.com/users/pietern', 'html_url': 'https://github.com/pietern', 'followers_url': 'https://api.github.com/users/pietern/followers', 'following_url': 'https://api.github.com/users/pietern/following{/other_user}', 'gists_url': 'https://api.github.com/users/pietern/gists{/gist_id}', 'starred_url': 'https://api.github.com/users/pietern/starred{/owner}{/repo}', 'subscriptions_url': 'https://api.github.com/users/pietern/subscriptions', 'organizations_url': 'https://api.github.com/users/pietern/orgs', 'repos_url': 'https://api.github.com/users/pietern/repos', 'events_url': 'https://api.github.com/users/pietern/events{/privacy}', 'received_events_url': 'https://api.github.com/users/pietern/received_events', 'type': 'User', 'site_admin': False}",referenced,e6d7777cf55f4bb58b1536fe7939e29bb480117f,https://api.github.com/repos/pytorch/pytorch/commits/e6d7777cf55f4bb58b1536fe7939e29bb480117f,2019-09-13T14:53:26Z,574,477,97
26049,2632613926,"{'login': 'pietern', 'id': 9845, 'node_id': 'MDQ6VXNlcjk4NDU=', 'avatar_url': 'https://avatars3.githubusercontent.com/u/9845?v=4', 'gravatar_id': '', 'url': 'https://api.github.com/users/pietern', 'html_url': 'https://github.com/pietern', 'followers_url': 'https://api.github.com/users/pietern/followers', 'following_url': 'https://api.github.com/users/pietern/following{/other_user}', 'gists_url': 'https://api.github.com/users/pietern/gists{/gist_id}', 'starred_url': 'https://api.github.com/users/pietern/starred{/owner}{/repo}', 'subscriptions_url': 'https://api.github.com/users/pietern/subscriptions', 'organizations_url': 'https://api.github.com/users/pietern/orgs', 'repos_url': 'https://api.github.com/users/pietern/repos', 'events_url': 'https://api.github.com/users/pietern/events{/privacy}', 'received_events_url': 'https://api.github.com/users/pietern/received_events', 'type': 'User', 'site_admin': False}",referenced,78a510c0773b8b5e5b44d6872b52c19c86d06ba9,https://api.github.com/repos/pytorch/pytorch/commits/78a510c0773b8b5e5b44d6872b52c19c86d06ba9,2019-09-13T14:53:32Z,139,108,31
26049,2636937483,"{'login': 'pietern', 'id': 9845, 'node_id': 'MDQ6VXNlcjk4NDU=', 'avatar_url': 'https://avatars3.githubusercontent.com/u/9845?v=4', 'gravatar_id': '', 'url': 'https://api.github.com/users/pietern', 'html_url': 'https://github.com/pietern', 'followers_url': 'https://api.github.com/users/pietern/followers', 'following_url': 'https://api.github.com/users/pietern/following{/other_user}', 'gists_url': 'https://api.github.com/users/pietern/gists{/gist_id}', 'starred_url': 'https://api.github.com/users/pietern/starred{/owner}{/repo}', 'subscriptions_url': 'https://api.github.com/users/pietern/subscriptions', 'organizations_url': 'https://api.github.com/users/pietern/orgs', 'repos_url': 'https://api.github.com/users/pietern/repos', 'events_url': 'https://api.github.com/users/pietern/events{/privacy}', 'received_events_url': 'https://api.github.com/users/pietern/received_events', 'type': 'User', 'site_admin': False}",referenced,7fa9d6e6b090308e5b05e44c3021b7613c839965,https://api.github.com/repos/pytorch/pytorch/commits/7fa9d6e6b090308e5b05e44c3021b7613c839965,2019-09-16T15:57:37Z,21,15,6
26049,2636937874,"{'login': 'pietern', 'id': 9845, 'node_id': 'MDQ6VXNlcjk4NDU=', 'avatar_url': 'https://avatars3.githubusercontent.com/u/9845?v=4', 'gravatar_id': '', 'url': 'https://api.github.com/users/pietern', 'html_url': 'https://github.com/pietern', 'followers_url': 'https://api.github.com/users/pietern/followers', 'following_url': 'https://api.github.com/users/pietern/following{/other_user}', 'gists_url': 'https://api.github.com/users/pietern/gists{/gist_id}', 'starred_url': 'https://api.github.com/users/pietern/starred{/owner}{/repo}', 'subscriptions_url': 'https://api.github.com/users/pietern/subscriptions', 'organizations_url': 'https://api.github.com/users/pietern/orgs', 'repos_url': 'https://api.github.com/users/pietern/repos', 'events_url': 'https://api.github.com/users/pietern/events{/privacy}', 'received_events_url': 'https://api.github.com/users/pietern/received_events', 'type': 'User', 'site_admin': False}",referenced,1b3eafe1d04415f01d21419ef1d44ea3dc355d85,https://api.github.com/repos/pytorch/pytorch/commits/1b3eafe1d04415f01d21419ef1d44ea3dc355d85,2019-09-16T15:57:42Z,148,117,31
26049,2637471306,"{'login': 'facebook-github-bot', 'id': 6422482, 'node_id': 'MDQ6VXNlcjY0MjI0ODI=', 'avatar_url': 'https://avatars3.githubusercontent.com/u/6422482?v=4', 'gravatar_id': '', 'url': 'https://api.github.com/users/facebook-github-bot', 'html_url': 'https://github.com/facebook-github-bot', 'followers_url': 'https://api.github.com/users/facebook-github-bot/followers', 'following_url': 'https://api.github.com/users/facebook-github-bot/following{/other_user}', 'gists_url': 'https://api.github.com/users/facebook-github-bot/gists{/gist_id}', 'starred_url': 'https://api.github.com/users/facebook-github-bot/starred{/owner}{/repo}', 'subscriptions_url': 'https://api.github.com/users/facebook-github-bot/subscriptions', 'organizations_url': 'https://api.github.com/users/facebook-github-bot/orgs', 'repos_url': 'https://api.github.com/users/facebook-github-bot/repos', 'events_url': 'https://api.github.com/users/facebook-github-bot/events{/privacy}', 'received_events_url': 'https://api.github.com/users/facebook-github-bot/received_events', 'type': 'User', 'site_admin': False}",closed,f43a2c9c2fe6353afdd87d9b32f4d284f4347ec5,https://api.github.com/repos/pytorch/pytorch/commits/f43a2c9c2fe6353afdd87d9b32f4d284f4347ec5,2019-09-16T19:00:55Z,148,117,31
26038,2673519047,"{'login': 'facebook-github-bot', 'id': 6422482, 'node_id': 'MDQ6VXNlcjY0MjI0ODI=', 'avatar_url': 'https://avatars3.githubusercontent.com/u/6422482?v=4', 'gravatar_id': '', 'url': 'https://api.github.com/users/facebook-github-bot', 'html_url': 'https://github.com/facebook-github-bot', 'followers_url': 'https://api.github.com/users/facebook-github-bot/followers', 'following_url': 'https://api.github.com/users/facebook-github-bot/following{/other_user}', 'gists_url': 'https://api.github.com/users/facebook-github-bot/gists{/gist_id}', 'starred_url': 'https://api.github.com/users/facebook-github-bot/starred{/owner}{/repo}', 'subscriptions_url': 'https://api.github.com/users/facebook-github-bot/subscriptions', 'organizations_url': 'https://api.github.com/users/facebook-github-bot/orgs', 'repos_url': 'https://api.github.com/users/facebook-github-bot/repos', 'events_url': 'https://api.github.com/users/facebook-github-bot/events{/privacy}', 'received_events_url': 'https://api.github.com/users/facebook-github-bot/received_events', 'type': 'User', 'site_admin': False}",closed,275e0c1c8f01e4bc24e7be54814849806577e237,https://api.github.com/repos/pytorch/pytorch/commits/275e0c1c8f01e4bc24e7be54814849806577e237,2019-09-30T14:34:14Z,8,8,0
26038,2688230156,"{'login': 'soumith', 'id': 1310570, 'node_id': 'MDQ6VXNlcjEzMTA1NzA=', 'avatar_url': 'https://avatars0.githubusercontent.com/u/1310570?v=4', 'gravatar_id': '', 'url': 'https://api.github.com/users/soumith', 'html_url': 'https://github.com/soumith', 'followers_url': 'https://api.github.com/users/soumith/followers', 'following_url': 'https://api.github.com/users/soumith/following{/other_user}', 'gists_url': 'https://api.github.com/users/soumith/gists{/gist_id}', 'starred_url': 'https://api.github.com/users/soumith/starred{/owner}{/repo}', 'subscriptions_url': 'https://api.github.com/users/soumith/subscriptions', 'organizations_url': 'https://api.github.com/users/soumith/orgs', 'repos_url': 'https://api.github.com/users/soumith/repos', 'events_url': 'https://api.github.com/users/soumith/events{/privacy}', 'received_events_url': 'https://api.github.com/users/soumith/received_events', 'type': 'User', 'site_admin': False}",referenced,3c8ce2a57e8be913a6d3209fc8b0a8225d7234df,https://api.github.com/repos/pytorch/pytorch/commits/3c8ce2a57e8be913a6d3209fc8b0a8225d7234df,2019-10-04T18:00:15Z,8,8,0
26036,2641440342,"{'login': 'facebook-github-bot', 'id': 6422482, 'node_id': 'MDQ6VXNlcjY0MjI0ODI=', 'avatar_url': 'https://avatars3.githubusercontent.com/u/6422482?v=4', 'gravatar_id': '', 'url': 'https://api.github.com/users/facebook-github-bot', 'html_url': 'https://github.com/facebook-github-bot', 'followers_url': 'https://api.github.com/users/facebook-github-bot/followers', 'following_url': 'https://api.github.com/users/facebook-github-bot/following{/other_user}', 'gists_url': 'https://api.github.com/users/facebook-github-bot/gists{/gist_id}', 'starred_url': 'https://api.github.com/users/facebook-github-bot/starred{/owner}{/repo}', 'subscriptions_url': 'https://api.github.com/users/facebook-github-bot/subscriptions', 'organizations_url': 'https://api.github.com/users/facebook-github-bot/orgs', 'repos_url': 'https://api.github.com/users/facebook-github-bot/repos', 'events_url': 'https://api.github.com/users/facebook-github-bot/events{/privacy}', 'received_events_url': 'https://api.github.com/users/facebook-github-bot/received_events', 'type': 'User', 'site_admin': False}",closed,a06e1c3af7b2e0059248fe87046576f783587186,https://api.github.com/repos/pytorch/pytorch/commits/a06e1c3af7b2e0059248fe87046576f783587186,2019-09-17T21:50:45Z,108,92,16
26032,2658861734,"{'login': 'facebook-github-bot', 'id': 6422482, 'node_id': 'MDQ6VXNlcjY0MjI0ODI=', 'avatar_url': 'https://avatars3.githubusercontent.com/u/6422482?v=4', 'gravatar_id': '', 'url': 'https://api.github.com/users/facebook-github-bot', 'html_url': 'https://github.com/facebook-github-bot', 'followers_url': 'https://api.github.com/users/facebook-github-bot/followers', 'following_url': 'https://api.github.com/users/facebook-github-bot/following{/other_user}', 'gists_url': 'https://api.github.com/users/facebook-github-bot/gists{/gist_id}', 'starred_url': 'https://api.github.com/users/facebook-github-bot/starred{/owner}{/repo}', 'subscriptions_url': 'https://api.github.com/users/facebook-github-bot/subscriptions', 'organizations_url': 'https://api.github.com/users/facebook-github-bot/orgs', 'repos_url': 'https://api.github.com/users/facebook-github-bot/repos', 'events_url': 'https://api.github.com/users/facebook-github-bot/events{/privacy}', 'received_events_url': 'https://api.github.com/users/facebook-github-bot/received_events', 'type': 'User', 'site_admin': False}",closed,9f1da984ef8eba63b874377b5c71610ad14a574b,https://api.github.com/repos/pytorch/pytorch/commits/9f1da984ef8eba63b874377b5c71610ad14a574b,2019-09-24T17:11:10Z,3,1,2
25917,2658685532,"{'login': 'facebook-github-bot', 'id': 6422482, 'node_id': 'MDQ6VXNlcjY0MjI0ODI=', 'avatar_url': 'https://avatars3.githubusercontent.com/u/6422482?v=4', 'gravatar_id': '', 'url': 'https://api.github.com/users/facebook-github-bot', 'html_url': 'https://github.com/facebook-github-bot', 'followers_url': 'https://api.github.com/users/facebook-github-bot/followers', 'following_url': 'https://api.github.com/users/facebook-github-bot/following{/other_user}', 'gists_url': 'https://api.github.com/users/facebook-github-bot/gists{/gist_id}', 'starred_url': 'https://api.github.com/users/facebook-github-bot/starred{/owner}{/repo}', 'subscriptions_url': 'https://api.github.com/users/facebook-github-bot/subscriptions', 'organizations_url': 'https://api.github.com/users/facebook-github-bot/orgs', 'repos_url': 'https://api.github.com/users/facebook-github-bot/repos', 'events_url': 'https://api.github.com/users/facebook-github-bot/events{/privacy}', 'received_events_url': 'https://api.github.com/users/facebook-github-bot/received_events', 'type': 'User', 'site_admin': False}",referenced,66d27504e3feddfc731457fc0cea7b1c1dff7dbe,https://api.github.com/repos/pytorch/pytorch/commits/66d27504e3feddfc731457fc0cea7b1c1dff7dbe,2019-09-24T16:13:09Z,5,3,2
25886,2980691747,"{'login': 'suo', 'id': 1617424, 'node_id': 'MDQ6VXNlcjE2MTc0MjQ=', 'avatar_url': 'https://avatars2.githubusercontent.com/u/1617424?v=4', 'gravatar_id': '', 'url': 'https://api.github.com/users/suo', 'html_url': 'https://github.com/suo', 'followers_url': 'https://api.github.com/users/suo/followers', 'following_url': 'https://api.github.com/users/suo/following{/other_user}', 'gists_url': 'https://api.github.com/users/suo/gists{/gist_id}', 'starred_url': 'https://api.github.com/users/suo/starred{/owner}{/repo}', 'subscriptions_url': 'https://api.github.com/users/suo/subscriptions', 'organizations_url': 'https://api.github.com/users/suo/orgs', 'repos_url': 'https://api.github.com/users/suo/repos', 'events_url': 'https://api.github.com/users/suo/events{/privacy}', 'received_events_url': 'https://api.github.com/users/suo/received_events', 'type': 'User', 'site_admin': False}",referenced,c05ae4a80bf742c50f5ce7fc62db6d50bc9454ce,https://api.github.com/repos/pytorch/pytorch/commits/c05ae4a80bf742c50f5ce7fc62db6d50bc9454ce,2020-01-27T07:03:22Z,39,32,7
25886,2980691752,"{'login': 'suo', 'id': 1617424, 'node_id': 'MDQ6VXNlcjE2MTc0MjQ=', 'avatar_url': 'https://avatars2.githubusercontent.com/u/1617424?v=4', 'gravatar_id': '', 'url': 'https://api.github.com/users/suo', 'html_url': 'https://github.com/suo', 'followers_url': 'https://api.github.com/users/suo/followers', 'following_url': 'https://api.github.com/users/suo/following{/other_user}', 'gists_url': 'https://api.github.com/users/suo/gists{/gist_id}', 'starred_url': 'https://api.github.com/users/suo/starred{/owner}{/repo}', 'subscriptions_url': 'https://api.github.com/users/suo/subscriptions', 'organizations_url': 'https://api.github.com/users/suo/orgs', 'repos_url': 'https://api.github.com/users/suo/repos', 'events_url': 'https://api.github.com/users/suo/events{/privacy}', 'received_events_url': 'https://api.github.com/users/suo/received_events', 'type': 'User', 'site_admin': False}",referenced,b7f27f9bb12880c69308c805d8a11bebbfe37d14,https://api.github.com/repos/pytorch/pytorch/commits/b7f27f9bb12880c69308c805d8a11bebbfe37d14,2020-01-27T07:03:22Z,39,32,7
25886,2984857261,"{'login': 'facebook-github-bot', 'id': 6422482, 'node_id': 'MDQ6VXNlcjY0MjI0ODI=', 'avatar_url': 'https://avatars3.githubusercontent.com/u/6422482?v=4', 'gravatar_id': '', 'url': 'https://api.github.com/users/facebook-github-bot', 'html_url': 'https://github.com/facebook-github-bot', 'followers_url': 'https://api.github.com/users/facebook-github-bot/followers', 'following_url': 'https://api.github.com/users/facebook-github-bot/following{/other_user}', 'gists_url': 'https://api.github.com/users/facebook-github-bot/gists{/gist_id}', 'starred_url': 'https://api.github.com/users/facebook-github-bot/starred{/owner}{/repo}', 'subscriptions_url': 'https://api.github.com/users/facebook-github-bot/subscriptions', 'organizations_url': 'https://api.github.com/users/facebook-github-bot/orgs', 'repos_url': 'https://api.github.com/users/facebook-github-bot/repos', 'events_url': 'https://api.github.com/users/facebook-github-bot/events{/privacy}', 'received_events_url': 'https://api.github.com/users/facebook-github-bot/received_events', 'type': 'User', 'site_admin': False}",closed,63170431f975e6ec1d5f612b9cafafeefb45ac2a,https://api.github.com/repos/pytorch/pytorch/commits/63170431f975e6ec1d5f612b9cafafeefb45ac2a,2020-01-28T09:27:02Z,39,32,7
25871,2656098050,"{'login': 'suo', 'id': 1617424, 'node_id': 'MDQ6VXNlcjE2MTc0MjQ=', 'avatar_url': 'https://avatars2.githubusercontent.com/u/1617424?v=4', 'gravatar_id': '', 'url': 'https://api.github.com/users/suo', 'html_url': 'https://github.com/suo', 'followers_url': 'https://api.github.com/users/suo/followers', 'following_url': 'https://api.github.com/users/suo/following{/other_user}', 'gists_url': 'https://api.github.com/users/suo/gists{/gist_id}', 'starred_url': 'https://api.github.com/users/suo/starred{/owner}{/repo}', 'subscriptions_url': 'https://api.github.com/users/suo/subscriptions', 'organizations_url': 'https://api.github.com/users/suo/orgs', 'repos_url': 'https://api.github.com/users/suo/repos', 'events_url': 'https://api.github.com/users/suo/events{/privacy}', 'received_events_url': 'https://api.github.com/users/suo/received_events', 'type': 'User', 'site_admin': False}",referenced,5e527c0389b533cc622f67462989c10ca7cb9f54,https://api.github.com/repos/pytorch/pytorch/commits/5e527c0389b533cc622f67462989c10ca7cb9f54,2019-09-23T22:30:04Z,41,41,0
25871,2656098219,"{'login': 'suo', 'id': 1617424, 'node_id': 'MDQ6VXNlcjE2MTc0MjQ=', 'avatar_url': 'https://avatars2.githubusercontent.com/u/1617424?v=4', 'gravatar_id': '', 'url': 'https://api.github.com/users/suo', 'html_url': 'https://github.com/suo', 'followers_url': 'https://api.github.com/users/suo/followers', 'following_url': 'https://api.github.com/users/suo/following{/other_user}', 'gists_url': 'https://api.github.com/users/suo/gists{/gist_id}', 'starred_url': 'https://api.github.com/users/suo/starred{/owner}{/repo}', 'subscriptions_url': 'https://api.github.com/users/suo/subscriptions', 'organizations_url': 'https://api.github.com/users/suo/orgs', 'repos_url': 'https://api.github.com/users/suo/repos', 'events_url': 'https://api.github.com/users/suo/events{/privacy}', 'received_events_url': 'https://api.github.com/users/suo/received_events', 'type': 'User', 'site_admin': False}",referenced,6f17363200398fd40ba081495fc6453a0ceddec4,https://api.github.com/repos/pytorch/pytorch/commits/6f17363200398fd40ba081495fc6453a0ceddec4,2019-09-23T22:30:10Z,41,41,0
25865,2656284832,"{'login': 'facebook-github-bot', 'id': 6422482, 'node_id': 'MDQ6VXNlcjY0MjI0ODI=', 'avatar_url': 'https://avatars3.githubusercontent.com/u/6422482?v=4', 'gravatar_id': '', 'url': 'https://api.github.com/users/facebook-github-bot', 'html_url': 'https://github.com/facebook-github-bot', 'followers_url': 'https://api.github.com/users/facebook-github-bot/followers', 'following_url': 'https://api.github.com/users/facebook-github-bot/following{/other_user}', 'gists_url': 'https://api.github.com/users/facebook-github-bot/gists{/gist_id}', 'starred_url': 'https://api.github.com/users/facebook-github-bot/starred{/owner}{/repo}', 'subscriptions_url': 'https://api.github.com/users/facebook-github-bot/subscriptions', 'organizations_url': 'https://api.github.com/users/facebook-github-bot/orgs', 'repos_url': 'https://api.github.com/users/facebook-github-bot/repos', 'events_url': 'https://api.github.com/users/facebook-github-bot/events{/privacy}', 'received_events_url': 'https://api.github.com/users/facebook-github-bot/received_events', 'type': 'User', 'site_admin': False}",closed,1eaaf8b68bd0c3490f1be37c6f8c89ab315e83e2,https://api.github.com/repos/pytorch/pytorch/commits/1eaaf8b68bd0c3490f1be37c6f8c89ab315e83e2,2019-09-24T00:24:32Z,203,134,69
25859,2681248977,"{'login': 'albanD', 'id': 6359743, 'node_id': 'MDQ6VXNlcjYzNTk3NDM=', 'avatar_url': 'https://avatars3.githubusercontent.com/u/6359743?v=4', 'gravatar_id': '', 'url': 'https://api.github.com/users/albanD', 'html_url': 'https://github.com/albanD', 'followers_url': 'https://api.github.com/users/albanD/followers', 'following_url': 'https://api.github.com/users/albanD/following{/other_user}', 'gists_url': 'https://api.github.com/users/albanD/gists{/gist_id}', 'starred_url': 'https://api.github.com/users/albanD/starred{/owner}{/repo}', 'subscriptions_url': 'https://api.github.com/users/albanD/subscriptions', 'organizations_url': 'https://api.github.com/users/albanD/orgs', 'repos_url': 'https://api.github.com/users/albanD/repos', 'events_url': 'https://api.github.com/users/albanD/events{/privacy}', 'received_events_url': 'https://api.github.com/users/albanD/received_events', 'type': 'User', 'site_admin': False}",referenced,922b808c65cc0cb42ed9407ee8ecd85075b9d7f6,https://api.github.com/repos/pytorch/pytorch/commits/922b808c65cc0cb42ed9407ee8ecd85075b9d7f6,2019-10-02T16:30:11Z,74962,50795,24167
25859,2682223467,"{'login': 'albanD', 'id': 6359743, 'node_id': 'MDQ6VXNlcjYzNTk3NDM=', 'avatar_url': 'https://avatars3.githubusercontent.com/u/6359743?v=4', 'gravatar_id': '', 'url': 'https://api.github.com/users/albanD', 'html_url': 'https://github.com/albanD', 'followers_url': 'https://api.github.com/users/albanD/followers', 'following_url': 'https://api.github.com/users/albanD/following{/other_user}', 'gists_url': 'https://api.github.com/users/albanD/gists{/gist_id}', 'starred_url': 'https://api.github.com/users/albanD/starred{/owner}{/repo}', 'subscriptions_url': 'https://api.github.com/users/albanD/subscriptions', 'organizations_url': 'https://api.github.com/users/albanD/orgs', 'repos_url': 'https://api.github.com/users/albanD/repos', 'events_url': 'https://api.github.com/users/albanD/events{/privacy}', 'received_events_url': 'https://api.github.com/users/albanD/received_events', 'type': 'User', 'site_admin': False}",referenced,2e91fc4462fae98c12fb2391944bfa7d534e7e2c,https://api.github.com/repos/pytorch/pytorch/commits/2e91fc4462fae98c12fb2391944bfa7d534e7e2c,2019-10-02T22:15:12Z,13,13,0
25859,2722875284,"{'login': 'albanD', 'id': 6359743, 'node_id': 'MDQ6VXNlcjYzNTk3NDM=', 'avatar_url': 'https://avatars3.githubusercontent.com/u/6359743?v=4', 'gravatar_id': '', 'url': 'https://api.github.com/users/albanD', 'html_url': 'https://github.com/albanD', 'followers_url': 'https://api.github.com/users/albanD/followers', 'following_url': 'https://api.github.com/users/albanD/following{/other_user}', 'gists_url': 'https://api.github.com/users/albanD/gists{/gist_id}', 'starred_url': 'https://api.github.com/users/albanD/starred{/owner}{/repo}', 'subscriptions_url': 'https://api.github.com/users/albanD/subscriptions', 'organizations_url': 'https://api.github.com/users/albanD/orgs', 'repos_url': 'https://api.github.com/users/albanD/repos', 'events_url': 'https://api.github.com/users/albanD/events{/privacy}', 'received_events_url': 'https://api.github.com/users/albanD/received_events', 'type': 'User', 'site_admin': False}",referenced,0eb77cbe418bc4b341071aa7f1bfd79b7327328f,https://api.github.com/repos/pytorch/pytorch/commits/0eb77cbe418bc4b341071aa7f1bfd79b7327328f,2019-10-17T21:51:08Z,99567,56556,43011
25859,2723050002,"{'login': 'albanD', 'id': 6359743, 'node_id': 'MDQ6VXNlcjYzNTk3NDM=', 'avatar_url': 'https://avatars3.githubusercontent.com/u/6359743?v=4', 'gravatar_id': '', 'url': 'https://api.github.com/users/albanD', 'html_url': 'https://github.com/albanD', 'followers_url': 'https://api.github.com/users/albanD/followers', 'following_url': 'https://api.github.com/users/albanD/following{/other_user}', 'gists_url': 'https://api.github.com/users/albanD/gists{/gist_id}', 'starred_url': 'https://api.github.com/users/albanD/starred{/owner}{/repo}', 'subscriptions_url': 'https://api.github.com/users/albanD/subscriptions', 'organizations_url': 'https://api.github.com/users/albanD/orgs', 'repos_url': 'https://api.github.com/users/albanD/repos', 'events_url': 'https://api.github.com/users/albanD/events{/privacy}', 'received_events_url': 'https://api.github.com/users/albanD/received_events', 'type': 'User', 'site_admin': False}",referenced,2636123d598fe10f41676f06358cc7a805f458b8,https://api.github.com/repos/pytorch/pytorch/commits/2636123d598fe10f41676f06358cc7a805f458b8,2019-10-17T23:22:32Z,3,2,1
25859,2723050135,"{'login': 'albanD', 'id': 6359743, 'node_id': 'MDQ6VXNlcjYzNTk3NDM=', 'avatar_url': 'https://avatars3.githubusercontent.com/u/6359743?v=4', 'gravatar_id': '', 'url': 'https://api.github.com/users/albanD', 'html_url': 'https://github.com/albanD', 'followers_url': 'https://api.github.com/users/albanD/followers', 'following_url': 'https://api.github.com/users/albanD/following{/other_user}', 'gists_url': 'https://api.github.com/users/albanD/gists{/gist_id}', 'starred_url': 'https://api.github.com/users/albanD/starred{/owner}{/repo}', 'subscriptions_url': 'https://api.github.com/users/albanD/subscriptions', 'organizations_url': 'https://api.github.com/users/albanD/orgs', 'repos_url': 'https://api.github.com/users/albanD/repos', 'events_url': 'https://api.github.com/users/albanD/events{/privacy}', 'received_events_url': 'https://api.github.com/users/albanD/received_events', 'type': 'User', 'site_admin': False}",referenced,f8520d3726f7210769e54209f4b9e6b4d49df1a7,https://api.github.com/repos/pytorch/pytorch/commits/f8520d3726f7210769e54209f4b9e6b4d49df1a7,2019-10-17T23:22:37Z,3,2,1
25859,2725177071,"{'login': 'albanD', 'id': 6359743, 'node_id': 'MDQ6VXNlcjYzNTk3NDM=', 'avatar_url': 'https://avatars3.githubusercontent.com/u/6359743?v=4', 'gravatar_id': '', 'url': 'https://api.github.com/users/albanD', 'html_url': 'https://github.com/albanD', 'followers_url': 'https://api.github.com/users/albanD/followers', 'following_url': 'https://api.github.com/users/albanD/following{/other_user}', 'gists_url': 'https://api.github.com/users/albanD/gists{/gist_id}', 'starred_url': 'https://api.github.com/users/albanD/starred{/owner}{/repo}', 'subscriptions_url': 'https://api.github.com/users/albanD/subscriptions', 'organizations_url': 'https://api.github.com/users/albanD/orgs', 'repos_url': 'https://api.github.com/users/albanD/repos', 'events_url': 'https://api.github.com/users/albanD/events{/privacy}', 'received_events_url': 'https://api.github.com/users/albanD/received_events', 'type': 'User', 'site_admin': False}",referenced,818a01307c373c526357af71f79b99d27b84f992,https://api.github.com/repos/pytorch/pytorch/commits/818a01307c373c526357af71f79b99d27b84f992,2019-10-18T14:51:38Z,4862,3326,1536
25859,2725177732,"{'login': 'albanD', 'id': 6359743, 'node_id': 'MDQ6VXNlcjYzNTk3NDM=', 'avatar_url': 'https://avatars3.githubusercontent.com/u/6359743?v=4', 'gravatar_id': '', 'url': 'https://api.github.com/users/albanD', 'html_url': 'https://github.com/albanD', 'followers_url': 'https://api.github.com/users/albanD/followers', 'following_url': 'https://api.github.com/users/albanD/following{/other_user}', 'gists_url': 'https://api.github.com/users/albanD/gists{/gist_id}', 'starred_url': 'https://api.github.com/users/albanD/starred{/owner}{/repo}', 'subscriptions_url': 'https://api.github.com/users/albanD/subscriptions', 'organizations_url': 'https://api.github.com/users/albanD/orgs', 'repos_url': 'https://api.github.com/users/albanD/repos', 'events_url': 'https://api.github.com/users/albanD/events{/privacy}', 'received_events_url': 'https://api.github.com/users/albanD/received_events', 'type': 'User', 'site_admin': False}",referenced,477af0258e9accafb5a46267217d1deb4515936b,https://api.github.com/repos/pytorch/pytorch/commits/477af0258e9accafb5a46267217d1deb4515936b,2019-10-18T14:51:49Z,4862,3326,1536
25859,2725275104,"{'login': 'albanD', 'id': 6359743, 'node_id': 'MDQ6VXNlcjYzNTk3NDM=', 'avatar_url': 'https://avatars3.githubusercontent.com/u/6359743?v=4', 'gravatar_id': '', 'url': 'https://api.github.com/users/albanD', 'html_url': 'https://github.com/albanD', 'followers_url': 'https://api.github.com/users/albanD/followers', 'following_url': 'https://api.github.com/users/albanD/following{/other_user}', 'gists_url': 'https://api.github.com/users/albanD/gists{/gist_id}', 'starred_url': 'https://api.github.com/users/albanD/starred{/owner}{/repo}', 'subscriptions_url': 'https://api.github.com/users/albanD/subscriptions', 'organizations_url': 'https://api.github.com/users/albanD/orgs', 'repos_url': 'https://api.github.com/users/albanD/repos', 'events_url': 'https://api.github.com/users/albanD/events{/privacy}', 'received_events_url': 'https://api.github.com/users/albanD/received_events', 'type': 'User', 'site_admin': False}",referenced,16884327b0ba0b4dd0a774bd71fb88d6ff1b2f24,https://api.github.com/repos/pytorch/pytorch/commits/16884327b0ba0b4dd0a774bd71fb88d6ff1b2f24,2019-10-18T15:20:17Z,24,19,5
25859,2725275386,"{'login': 'albanD', 'id': 6359743, 'node_id': 'MDQ6VXNlcjYzNTk3NDM=', 'avatar_url': 'https://avatars3.githubusercontent.com/u/6359743?v=4', 'gravatar_id': '', 'url': 'https://api.github.com/users/albanD', 'html_url': 'https://github.com/albanD', 'followers_url': 'https://api.github.com/users/albanD/followers', 'following_url': 'https://api.github.com/users/albanD/following{/other_user}', 'gists_url': 'https://api.github.com/users/albanD/gists{/gist_id}', 'starred_url': 'https://api.github.com/users/albanD/starred{/owner}{/repo}', 'subscriptions_url': 'https://api.github.com/users/albanD/subscriptions', 'organizations_url': 'https://api.github.com/users/albanD/orgs', 'repos_url': 'https://api.github.com/users/albanD/repos', 'events_url': 'https://api.github.com/users/albanD/events{/privacy}', 'received_events_url': 'https://api.github.com/users/albanD/received_events', 'type': 'User', 'site_admin': False}",referenced,0156581fc850f91f7557255e13dad7418571f557,https://api.github.com/repos/pytorch/pytorch/commits/0156581fc850f91f7557255e13dad7418571f557,2019-10-18T15:20:23Z,24,19,5
25859,2725324767,"{'login': 'albanD', 'id': 6359743, 'node_id': 'MDQ6VXNlcjYzNTk3NDM=', 'avatar_url': 'https://avatars3.githubusercontent.com/u/6359743?v=4', 'gravatar_id': '', 'url': 'https://api.github.com/users/albanD', 'html_url': 'https://github.com/albanD', 'followers_url': 'https://api.github.com/users/albanD/followers', 'following_url': 'https://api.github.com/users/albanD/following{/other_user}', 'gists_url': 'https://api.github.com/users/albanD/gists{/gist_id}', 'starred_url': 'https://api.github.com/users/albanD/starred{/owner}{/repo}', 'subscriptions_url': 'https://api.github.com/users/albanD/subscriptions', 'organizations_url': 'https://api.github.com/users/albanD/orgs', 'repos_url': 'https://api.github.com/users/albanD/repos', 'events_url': 'https://api.github.com/users/albanD/events{/privacy}', 'received_events_url': 'https://api.github.com/users/albanD/received_events', 'type': 'User', 'site_admin': False}",referenced,b75ee79011a5538835c0b73d06e4c9526b5ed05c,https://api.github.com/repos/pytorch/pytorch/commits/b75ee79011a5538835c0b73d06e4c9526b5ed05c,2019-10-18T15:35:05Z,4,2,2
25859,2725325222,"{'login': 'albanD', 'id': 6359743, 'node_id': 'MDQ6VXNlcjYzNTk3NDM=', 'avatar_url': 'https://avatars3.githubusercontent.com/u/6359743?v=4', 'gravatar_id': '', 'url': 'https://api.github.com/users/albanD', 'html_url': 'https://github.com/albanD', 'followers_url': 'https://api.github.com/users/albanD/followers', 'following_url': 'https://api.github.com/users/albanD/following{/other_user}', 'gists_url': 'https://api.github.com/users/albanD/gists{/gist_id}', 'starred_url': 'https://api.github.com/users/albanD/starred{/owner}{/repo}', 'subscriptions_url': 'https://api.github.com/users/albanD/subscriptions', 'organizations_url': 'https://api.github.com/users/albanD/orgs', 'repos_url': 'https://api.github.com/users/albanD/repos', 'events_url': 'https://api.github.com/users/albanD/events{/privacy}', 'received_events_url': 'https://api.github.com/users/albanD/received_events', 'type': 'User', 'site_admin': False}",referenced,0ecd55c9cf96c728c5d3cfb5a61c8f1ec63ddc07,https://api.github.com/repos/pytorch/pytorch/commits/0ecd55c9cf96c728c5d3cfb5a61c8f1ec63ddc07,2019-10-18T15:35:13Z,4,2,2
25859,2725989716,"{'login': 'albanD', 'id': 6359743, 'node_id': 'MDQ6VXNlcjYzNTk3NDM=', 'avatar_url': 'https://avatars3.githubusercontent.com/u/6359743?v=4', 'gravatar_id': '', 'url': 'https://api.github.com/users/albanD', 'html_url': 'https://github.com/albanD', 'followers_url': 'https://api.github.com/users/albanD/followers', 'following_url': 'https://api.github.com/users/albanD/following{/other_user}', 'gists_url': 'https://api.github.com/users/albanD/gists{/gist_id}', 'starred_url': 'https://api.github.com/users/albanD/starred{/owner}{/repo}', 'subscriptions_url': 'https://api.github.com/users/albanD/subscriptions', 'organizations_url': 'https://api.github.com/users/albanD/orgs', 'repos_url': 'https://api.github.com/users/albanD/repos', 'events_url': 'https://api.github.com/users/albanD/events{/privacy}', 'received_events_url': 'https://api.github.com/users/albanD/received_events', 'type': 'User', 'site_admin': False}",referenced,30b772a3aac384ab395fcecfb86c7fea16a2e45c,https://api.github.com/repos/pytorch/pytorch/commits/30b772a3aac384ab395fcecfb86c7fea16a2e45c,2019-10-18T19:26:59Z,2,0,2
25859,2725989952,"{'login': 'albanD', 'id': 6359743, 'node_id': 'MDQ6VXNlcjYzNTk3NDM=', 'avatar_url': 'https://avatars3.githubusercontent.com/u/6359743?v=4', 'gravatar_id': '', 'url': 'https://api.github.com/users/albanD', 'html_url': 'https://github.com/albanD', 'followers_url': 'https://api.github.com/users/albanD/followers', 'following_url': 'https://api.github.com/users/albanD/following{/other_user}', 'gists_url': 'https://api.github.com/users/albanD/gists{/gist_id}', 'starred_url': 'https://api.github.com/users/albanD/starred{/owner}{/repo}', 'subscriptions_url': 'https://api.github.com/users/albanD/subscriptions', 'organizations_url': 'https://api.github.com/users/albanD/orgs', 'repos_url': 'https://api.github.com/users/albanD/repos', 'events_url': 'https://api.github.com/users/albanD/events{/privacy}', 'received_events_url': 'https://api.github.com/users/albanD/received_events', 'type': 'User', 'site_admin': False}",referenced,e34357a0dc70a52d42e5adeff29f0968c0c38fff,https://api.github.com/repos/pytorch/pytorch/commits/e34357a0dc70a52d42e5adeff29f0968c0c38fff,2019-10-18T19:27:03Z,2,0,2
25859,2734704732,"{'login': 'albanD', 'id': 6359743, 'node_id': 'MDQ6VXNlcjYzNTk3NDM=', 'avatar_url': 'https://avatars3.githubusercontent.com/u/6359743?v=4', 'gravatar_id': '', 'url': 'https://api.github.com/users/albanD', 'html_url': 'https://github.com/albanD', 'followers_url': 'https://api.github.com/users/albanD/followers', 'following_url': 'https://api.github.com/users/albanD/following{/other_user}', 'gists_url': 'https://api.github.com/users/albanD/gists{/gist_id}', 'starred_url': 'https://api.github.com/users/albanD/starred{/owner}{/repo}', 'subscriptions_url': 'https://api.github.com/users/albanD/subscriptions', 'organizations_url': 'https://api.github.com/users/albanD/orgs', 'repos_url': 'https://api.github.com/users/albanD/repos', 'events_url': 'https://api.github.com/users/albanD/events{/privacy}', 'received_events_url': 'https://api.github.com/users/albanD/received_events', 'type': 'User', 'site_admin': False}",referenced,cb549c5d28202849d2ebb07cb2bdc9a11339b1de,https://api.github.com/repos/pytorch/pytorch/commits/cb549c5d28202849d2ebb07cb2bdc9a11339b1de,2019-10-22T20:28:54Z,136,81,55
25859,2734705077,"{'login': 'albanD', 'id': 6359743, 'node_id': 'MDQ6VXNlcjYzNTk3NDM=', 'avatar_url': 'https://avatars3.githubusercontent.com/u/6359743?v=4', 'gravatar_id': '', 'url': 'https://api.github.com/users/albanD', 'html_url': 'https://github.com/albanD', 'followers_url': 'https://api.github.com/users/albanD/followers', 'following_url': 'https://api.github.com/users/albanD/following{/other_user}', 'gists_url': 'https://api.github.com/users/albanD/gists{/gist_id}', 'starred_url': 'https://api.github.com/users/albanD/starred{/owner}{/repo}', 'subscriptions_url': 'https://api.github.com/users/albanD/subscriptions', 'organizations_url': 'https://api.github.com/users/albanD/orgs', 'repos_url': 'https://api.github.com/users/albanD/repos', 'events_url': 'https://api.github.com/users/albanD/events{/privacy}', 'received_events_url': 'https://api.github.com/users/albanD/received_events', 'type': 'User', 'site_admin': False}",referenced,4d2018a310e01febc1ab06ab086a8bff33aecad0,https://api.github.com/repos/pytorch/pytorch/commits/4d2018a310e01febc1ab06ab086a8bff33aecad0,2019-10-22T20:29:01Z,136,81,55
25859,2735051061,"{'login': 'albanD', 'id': 6359743, 'node_id': 'MDQ6VXNlcjYzNTk3NDM=', 'avatar_url': 'https://avatars3.githubusercontent.com/u/6359743?v=4', 'gravatar_id': '', 'url': 'https://api.github.com/users/albanD', 'html_url': 'https://github.com/albanD', 'followers_url': 'https://api.github.com/users/albanD/followers', 'following_url': 'https://api.github.com/users/albanD/following{/other_user}', 'gists_url': 'https://api.github.com/users/albanD/gists{/gist_id}', 'starred_url': 'https://api.github.com/users/albanD/starred{/owner}{/repo}', 'subscriptions_url': 'https://api.github.com/users/albanD/subscriptions', 'organizations_url': 'https://api.github.com/users/albanD/orgs', 'repos_url': 'https://api.github.com/users/albanD/repos', 'events_url': 'https://api.github.com/users/albanD/events{/privacy}', 'received_events_url': 'https://api.github.com/users/albanD/received_events', 'type': 'User', 'site_admin': False}",referenced,96446b5f1270f316336dd9bf1a0d4e99888841d6,https://api.github.com/repos/pytorch/pytorch/commits/96446b5f1270f316336dd9bf1a0d4e99888841d6,2019-10-22T22:34:45Z,58,52,6
25859,2735051182,"{'login': 'albanD', 'id': 6359743, 'node_id': 'MDQ6VXNlcjYzNTk3NDM=', 'avatar_url': 'https://avatars3.githubusercontent.com/u/6359743?v=4', 'gravatar_id': '', 'url': 'https://api.github.com/users/albanD', 'html_url': 'https://github.com/albanD', 'followers_url': 'https://api.github.com/users/albanD/followers', 'following_url': 'https://api.github.com/users/albanD/following{/other_user}', 'gists_url': 'https://api.github.com/users/albanD/gists{/gist_id}', 'starred_url': 'https://api.github.com/users/albanD/starred{/owner}{/repo}', 'subscriptions_url': 'https://api.github.com/users/albanD/subscriptions', 'organizations_url': 'https://api.github.com/users/albanD/orgs', 'repos_url': 'https://api.github.com/users/albanD/repos', 'events_url': 'https://api.github.com/users/albanD/events{/privacy}', 'received_events_url': 'https://api.github.com/users/albanD/received_events', 'type': 'User', 'site_admin': False}",referenced,fb0572f027e3a1ad405d4fa31fb3f72fcc54d940,https://api.github.com/repos/pytorch/pytorch/commits/fb0572f027e3a1ad405d4fa31fb3f72fcc54d940,2019-10-22T22:34:49Z,58,52,6
25859,2735170349,"{'login': 'albanD', 'id': 6359743, 'node_id': 'MDQ6VXNlcjYzNTk3NDM=', 'avatar_url': 'https://avatars3.githubusercontent.com/u/6359743?v=4', 'gravatar_id': '', 'url': 'https://api.github.com/users/albanD', 'html_url': 'https://github.com/albanD', 'followers_url': 'https://api.github.com/users/albanD/followers', 'following_url': 'https://api.github.com/users/albanD/following{/other_user}', 'gists_url': 'https://api.github.com/users/albanD/gists{/gist_id}', 'starred_url': 'https://api.github.com/users/albanD/starred{/owner}{/repo}', 'subscriptions_url': 'https://api.github.com/users/albanD/subscriptions', 'organizations_url': 'https://api.github.com/users/albanD/orgs', 'repos_url': 'https://api.github.com/users/albanD/repos', 'events_url': 'https://api.github.com/users/albanD/events{/privacy}', 'received_events_url': 'https://api.github.com/users/albanD/received_events', 'type': 'User', 'site_admin': False}",referenced,bcb2b7491cab2fe87a96266c060469a409bf182b,https://api.github.com/repos/pytorch/pytorch/commits/bcb2b7491cab2fe87a96266c060469a409bf182b,2019-10-22T23:43:44Z,1,1,0
25859,2735170423,"{'login': 'albanD', 'id': 6359743, 'node_id': 'MDQ6VXNlcjYzNTk3NDM=', 'avatar_url': 'https://avatars3.githubusercontent.com/u/6359743?v=4', 'gravatar_id': '', 'url': 'https://api.github.com/users/albanD', 'html_url': 'https://github.com/albanD', 'followers_url': 'https://api.github.com/users/albanD/followers', 'following_url': 'https://api.github.com/users/albanD/following{/other_user}', 'gists_url': 'https://api.github.com/users/albanD/gists{/gist_id}', 'starred_url': 'https://api.github.com/users/albanD/starred{/owner}{/repo}', 'subscriptions_url': 'https://api.github.com/users/albanD/subscriptions', 'organizations_url': 'https://api.github.com/users/albanD/orgs', 'repos_url': 'https://api.github.com/users/albanD/repos', 'events_url': 'https://api.github.com/users/albanD/events{/privacy}', 'received_events_url': 'https://api.github.com/users/albanD/received_events', 'type': 'User', 'site_admin': False}",referenced,e3ccae832804fcc3b79e90c12910d0fe0c6fcca5,https://api.github.com/repos/pytorch/pytorch/commits/e3ccae832804fcc3b79e90c12910d0fe0c6fcca5,2019-10-22T23:43:48Z,1,1,0
25859,2753962141,"{'login': 'albanD', 'id': 6359743, 'node_id': 'MDQ6VXNlcjYzNTk3NDM=', 'avatar_url': 'https://avatars3.githubusercontent.com/u/6359743?v=4', 'gravatar_id': '', 'url': 'https://api.github.com/users/albanD', 'html_url': 'https://github.com/albanD', 'followers_url': 'https://api.github.com/users/albanD/followers', 'following_url': 'https://api.github.com/users/albanD/following{/other_user}', 'gists_url': 'https://api.github.com/users/albanD/gists{/gist_id}', 'starred_url': 'https://api.github.com/users/albanD/starred{/owner}{/repo}', 'subscriptions_url': 'https://api.github.com/users/albanD/subscriptions', 'organizations_url': 'https://api.github.com/users/albanD/orgs', 'repos_url': 'https://api.github.com/users/albanD/repos', 'events_url': 'https://api.github.com/users/albanD/events{/privacy}', 'received_events_url': 'https://api.github.com/users/albanD/received_events', 'type': 'User', 'site_admin': False}",referenced,c65485715fae4d251bc2ac6fcf0abe5dfd3cad7d,https://api.github.com/repos/pytorch/pytorch/commits/c65485715fae4d251bc2ac6fcf0abe5dfd3cad7d,2019-10-29T22:01:08Z,96,21,75
25859,2753962345,"{'login': 'albanD', 'id': 6359743, 'node_id': 'MDQ6VXNlcjYzNTk3NDM=', 'avatar_url': 'https://avatars3.githubusercontent.com/u/6359743?v=4', 'gravatar_id': '', 'url': 'https://api.github.com/users/albanD', 'html_url': 'https://github.com/albanD', 'followers_url': 'https://api.github.com/users/albanD/followers', 'following_url': 'https://api.github.com/users/albanD/following{/other_user}', 'gists_url': 'https://api.github.com/users/albanD/gists{/gist_id}', 'starred_url': 'https://api.github.com/users/albanD/starred{/owner}{/repo}', 'subscriptions_url': 'https://api.github.com/users/albanD/subscriptions', 'organizations_url': 'https://api.github.com/users/albanD/orgs', 'repos_url': 'https://api.github.com/users/albanD/repos', 'events_url': 'https://api.github.com/users/albanD/events{/privacy}', 'received_events_url': 'https://api.github.com/users/albanD/received_events', 'type': 'User', 'site_admin': False}",referenced,166958ee3d4ab91fcdf05b16113f08a24910d8fb,https://api.github.com/repos/pytorch/pytorch/commits/166958ee3d4ab91fcdf05b16113f08a24910d8fb,2019-10-29T22:01:13Z,96,21,75
25859,2754036403,"{'login': 'albanD', 'id': 6359743, 'node_id': 'MDQ6VXNlcjYzNTk3NDM=', 'avatar_url': 'https://avatars3.githubusercontent.com/u/6359743?v=4', 'gravatar_id': '', 'url': 'https://api.github.com/users/albanD', 'html_url': 'https://github.com/albanD', 'followers_url': 'https://api.github.com/users/albanD/followers', 'following_url': 'https://api.github.com/users/albanD/following{/other_user}', 'gists_url': 'https://api.github.com/users/albanD/gists{/gist_id}', 'starred_url': 'https://api.github.com/users/albanD/starred{/owner}{/repo}', 'subscriptions_url': 'https://api.github.com/users/albanD/subscriptions', 'organizations_url': 'https://api.github.com/users/albanD/orgs', 'repos_url': 'https://api.github.com/users/albanD/repos', 'events_url': 'https://api.github.com/users/albanD/events{/privacy}', 'received_events_url': 'https://api.github.com/users/albanD/received_events', 'type': 'User', 'site_admin': False}",referenced,d933c216db57062b029a4e80ca23ce05652a3344,https://api.github.com/repos/pytorch/pytorch/commits/d933c216db57062b029a4e80ca23ce05652a3344,2019-10-29T22:33:34Z,29157,20360,8797
25859,2754036521,"{'login': 'albanD', 'id': 6359743, 'node_id': 'MDQ6VXNlcjYzNTk3NDM=', 'avatar_url': 'https://avatars3.githubusercontent.com/u/6359743?v=4', 'gravatar_id': '', 'url': 'https://api.github.com/users/albanD', 'html_url': 'https://github.com/albanD', 'followers_url': 'https://api.github.com/users/albanD/followers', 'following_url': 'https://api.github.com/users/albanD/following{/other_user}', 'gists_url': 'https://api.github.com/users/albanD/gists{/gist_id}', 'starred_url': 'https://api.github.com/users/albanD/starred{/owner}{/repo}', 'subscriptions_url': 'https://api.github.com/users/albanD/subscriptions', 'organizations_url': 'https://api.github.com/users/albanD/orgs', 'repos_url': 'https://api.github.com/users/albanD/repos', 'events_url': 'https://api.github.com/users/albanD/events{/privacy}', 'received_events_url': 'https://api.github.com/users/albanD/received_events', 'type': 'User', 'site_admin': False}",referenced,893a36565539c03e11425272af0886f45e6fe44f,https://api.github.com/repos/pytorch/pytorch/commits/893a36565539c03e11425272af0886f45e6fe44f,2019-10-29T22:33:38Z,29157,20360,8797
25859,2757468424,"{'login': 'albanD', 'id': 6359743, 'node_id': 'MDQ6VXNlcjYzNTk3NDM=', 'avatar_url': 'https://avatars3.githubusercontent.com/u/6359743?v=4', 'gravatar_id': '', 'url': 'https://api.github.com/users/albanD', 'html_url': 'https://github.com/albanD', 'followers_url': 'https://api.github.com/users/albanD/followers', 'following_url': 'https://api.github.com/users/albanD/following{/other_user}', 'gists_url': 'https://api.github.com/users/albanD/gists{/gist_id}', 'starred_url': 'https://api.github.com/users/albanD/starred{/owner}{/repo}', 'subscriptions_url': 'https://api.github.com/users/albanD/subscriptions', 'organizations_url': 'https://api.github.com/users/albanD/orgs', 'repos_url': 'https://api.github.com/users/albanD/repos', 'events_url': 'https://api.github.com/users/albanD/events{/privacy}', 'received_events_url': 'https://api.github.com/users/albanD/received_events', 'type': 'User', 'site_admin': False}",referenced,6f160fbce8b665d6dc55424c576b75963ce0fb1f,https://api.github.com/repos/pytorch/pytorch/commits/6f160fbce8b665d6dc55424c576b75963ce0fb1f,2019-10-30T20:04:37Z,8,4,4
25859,2757468738,"{'login': 'albanD', 'id': 6359743, 'node_id': 'MDQ6VXNlcjYzNTk3NDM=', 'avatar_url': 'https://avatars3.githubusercontent.com/u/6359743?v=4', 'gravatar_id': '', 'url': 'https://api.github.com/users/albanD', 'html_url': 'https://github.com/albanD', 'followers_url': 'https://api.github.com/users/albanD/followers', 'following_url': 'https://api.github.com/users/albanD/following{/other_user}', 'gists_url': 'https://api.github.com/users/albanD/gists{/gist_id}', 'starred_url': 'https://api.github.com/users/albanD/starred{/owner}{/repo}', 'subscriptions_url': 'https://api.github.com/users/albanD/subscriptions', 'organizations_url': 'https://api.github.com/users/albanD/orgs', 'repos_url': 'https://api.github.com/users/albanD/repos', 'events_url': 'https://api.github.com/users/albanD/events{/privacy}', 'received_events_url': 'https://api.github.com/users/albanD/received_events', 'type': 'User', 'site_admin': False}",referenced,f9b7f4d76075ce6236e5f2d80346f1915a2ca5fa,https://api.github.com/repos/pytorch/pytorch/commits/f9b7f4d76075ce6236e5f2d80346f1915a2ca5fa,2019-10-30T20:04:43Z,8,4,4
25854,2624384409,"{'login': 'facebook-github-bot', 'id': 6422482, 'node_id': 'MDQ6VXNlcjY0MjI0ODI=', 'avatar_url': 'https://avatars3.githubusercontent.com/u/6422482?v=4', 'gravatar_id': '', 'url': 'https://api.github.com/users/facebook-github-bot', 'html_url': 'https://github.com/facebook-github-bot', 'followers_url': 'https://api.github.com/users/facebook-github-bot/followers', 'following_url': 'https://api.github.com/users/facebook-github-bot/following{/other_user}', 'gists_url': 'https://api.github.com/users/facebook-github-bot/gists{/gist_id}', 'starred_url': 'https://api.github.com/users/facebook-github-bot/starred{/owner}{/repo}', 'subscriptions_url': 'https://api.github.com/users/facebook-github-bot/subscriptions', 'organizations_url': 'https://api.github.com/users/facebook-github-bot/orgs', 'repos_url': 'https://api.github.com/users/facebook-github-bot/repos', 'events_url': 'https://api.github.com/users/facebook-github-bot/events{/privacy}', 'received_events_url': 'https://api.github.com/users/facebook-github-bot/received_events', 'type': 'User', 'site_admin': False}",closed,9815739d83c7daf9723135046b1fc30b56844c7c,https://api.github.com/repos/pytorch/pytorch/commits/9815739d83c7daf9723135046b1fc30b56844c7c,2019-09-11T04:42:04Z,4,2,2
25836,2623296089,"{'login': 'facebook-github-bot', 'id': 6422482, 'node_id': 'MDQ6VXNlcjY0MjI0ODI=', 'avatar_url': 'https://avatars3.githubusercontent.com/u/6422482?v=4', 'gravatar_id': '', 'url': 'https://api.github.com/users/facebook-github-bot', 'html_url': 'https://github.com/facebook-github-bot', 'followers_url': 'https://api.github.com/users/facebook-github-bot/followers', 'following_url': 'https://api.github.com/users/facebook-github-bot/following{/other_user}', 'gists_url': 'https://api.github.com/users/facebook-github-bot/gists{/gist_id}', 'starred_url': 'https://api.github.com/users/facebook-github-bot/starred{/owner}{/repo}', 'subscriptions_url': 'https://api.github.com/users/facebook-github-bot/subscriptions', 'organizations_url': 'https://api.github.com/users/facebook-github-bot/orgs', 'repos_url': 'https://api.github.com/users/facebook-github-bot/repos', 'events_url': 'https://api.github.com/users/facebook-github-bot/events{/privacy}', 'received_events_url': 'https://api.github.com/users/facebook-github-bot/received_events', 'type': 'User', 'site_admin': False}",closed,26f67e7aa755cc29a161b08f8e92ab595cf9daa4,https://api.github.com/repos/pytorch/pytorch/commits/26f67e7aa755cc29a161b08f8e92ab595cf9daa4,2019-09-10T18:41:54Z,42,32,10
25834,2620686615,"{'login': 'facebook-github-bot', 'id': 6422482, 'node_id': 'MDQ6VXNlcjY0MjI0ODI=', 'avatar_url': 'https://avatars3.githubusercontent.com/u/6422482?v=4', 'gravatar_id': '', 'url': 'https://api.github.com/users/facebook-github-bot', 'html_url': 'https://github.com/facebook-github-bot', 'followers_url': 'https://api.github.com/users/facebook-github-bot/followers', 'following_url': 'https://api.github.com/users/facebook-github-bot/following{/other_user}', 'gists_url': 'https://api.github.com/users/facebook-github-bot/gists{/gist_id}', 'starred_url': 'https://api.github.com/users/facebook-github-bot/starred{/owner}{/repo}', 'subscriptions_url': 'https://api.github.com/users/facebook-github-bot/subscriptions', 'organizations_url': 'https://api.github.com/users/facebook-github-bot/orgs', 'repos_url': 'https://api.github.com/users/facebook-github-bot/repos', 'events_url': 'https://api.github.com/users/facebook-github-bot/events{/privacy}', 'received_events_url': 'https://api.github.com/users/facebook-github-bot/received_events', 'type': 'User', 'site_admin': False}",closed,b27bcda851fb754ab8d1e64277ea4c2ab0bfb8ef,https://api.github.com/repos/pytorch/pytorch/commits/b27bcda851fb754ab8d1e64277ea4c2ab0bfb8ef,2019-09-10T02:21:12Z,2,1,1
25833,2715027664,"{'login': 'facebook-github-bot', 'id': 6422482, 'node_id': 'MDQ6VXNlcjY0MjI0ODI=', 'avatar_url': 'https://avatars3.githubusercontent.com/u/6422482?v=4', 'gravatar_id': '', 'url': 'https://api.github.com/users/facebook-github-bot', 'html_url': 'https://github.com/facebook-github-bot', 'followers_url': 'https://api.github.com/users/facebook-github-bot/followers', 'following_url': 'https://api.github.com/users/facebook-github-bot/following{/other_user}', 'gists_url': 'https://api.github.com/users/facebook-github-bot/gists{/gist_id}', 'starred_url': 'https://api.github.com/users/facebook-github-bot/starred{/owner}{/repo}', 'subscriptions_url': 'https://api.github.com/users/facebook-github-bot/subscriptions', 'organizations_url': 'https://api.github.com/users/facebook-github-bot/orgs', 'repos_url': 'https://api.github.com/users/facebook-github-bot/repos', 'events_url': 'https://api.github.com/users/facebook-github-bot/events{/privacy}', 'received_events_url': 'https://api.github.com/users/facebook-github-bot/received_events', 'type': 'User', 'site_admin': False}",referenced,f461184505149560803855f3a40d9e0e54c64826,https://api.github.com/repos/pytorch/pytorch/commits/f461184505149560803855f3a40d9e0e54c64826,2019-10-15T18:36:48Z,185,138,47
25831,2687798758,"{'login': 'facebook-github-bot', 'id': 6422482, 'node_id': 'MDQ6VXNlcjY0MjI0ODI=', 'avatar_url': 'https://avatars3.githubusercontent.com/u/6422482?v=4', 'gravatar_id': '', 'url': 'https://api.github.com/users/facebook-github-bot', 'html_url': 'https://github.com/facebook-github-bot', 'followers_url': 'https://api.github.com/users/facebook-github-bot/followers', 'following_url': 'https://api.github.com/users/facebook-github-bot/following{/other_user}', 'gists_url': 'https://api.github.com/users/facebook-github-bot/gists{/gist_id}', 'starred_url': 'https://api.github.com/users/facebook-github-bot/starred{/owner}{/repo}', 'subscriptions_url': 'https://api.github.com/users/facebook-github-bot/subscriptions', 'organizations_url': 'https://api.github.com/users/facebook-github-bot/orgs', 'repos_url': 'https://api.github.com/users/facebook-github-bot/repos', 'events_url': 'https://api.github.com/users/facebook-github-bot/events{/privacy}', 'received_events_url': 'https://api.github.com/users/facebook-github-bot/received_events', 'type': 'User', 'site_admin': False}",referenced,c389156fc4872ad4400046bf146abb6b9ec9e075,https://api.github.com/repos/pytorch/pytorch/commits/c389156fc4872ad4400046bf146abb6b9ec9e075,2019-10-04T15:23:46Z,50,22,28
25810,2731073649,"{'login': 'facebook-github-bot', 'id': 6422482, 'node_id': 'MDQ6VXNlcjY0MjI0ODI=', 'avatar_url': 'https://avatars3.githubusercontent.com/u/6422482?v=4', 'gravatar_id': '', 'url': 'https://api.github.com/users/facebook-github-bot', 'html_url': 'https://github.com/facebook-github-bot', 'followers_url': 'https://api.github.com/users/facebook-github-bot/followers', 'following_url': 'https://api.github.com/users/facebook-github-bot/following{/other_user}', 'gists_url': 'https://api.github.com/users/facebook-github-bot/gists{/gist_id}', 'starred_url': 'https://api.github.com/users/facebook-github-bot/starred{/owner}{/repo}', 'subscriptions_url': 'https://api.github.com/users/facebook-github-bot/subscriptions', 'organizations_url': 'https://api.github.com/users/facebook-github-bot/orgs', 'repos_url': 'https://api.github.com/users/facebook-github-bot/repos', 'events_url': 'https://api.github.com/users/facebook-github-bot/events{/privacy}', 'received_events_url': 'https://api.github.com/users/facebook-github-bot/received_events', 'type': 'User', 'site_admin': False}",referenced,ba59d720cd5c5c81601b53d2c3397c46c1f87883,https://api.github.com/repos/pytorch/pytorch/commits/ba59d720cd5c5c81601b53d2c3397c46c1f87883,2019-10-21T20:03:14Z,1,1,0
25807,2718652483,"{'login': 'facebook-github-bot', 'id': 6422482, 'node_id': 'MDQ6VXNlcjY0MjI0ODI=', 'avatar_url': 'https://avatars3.githubusercontent.com/u/6422482?v=4', 'gravatar_id': '', 'url': 'https://api.github.com/users/facebook-github-bot', 'html_url': 'https://github.com/facebook-github-bot', 'followers_url': 'https://api.github.com/users/facebook-github-bot/followers', 'following_url': 'https://api.github.com/users/facebook-github-bot/following{/other_user}', 'gists_url': 'https://api.github.com/users/facebook-github-bot/gists{/gist_id}', 'starred_url': 'https://api.github.com/users/facebook-github-bot/starred{/owner}{/repo}', 'subscriptions_url': 'https://api.github.com/users/facebook-github-bot/subscriptions', 'organizations_url': 'https://api.github.com/users/facebook-github-bot/orgs', 'repos_url': 'https://api.github.com/users/facebook-github-bot/repos', 'events_url': 'https://api.github.com/users/facebook-github-bot/events{/privacy}', 'received_events_url': 'https://api.github.com/users/facebook-github-bot/received_events', 'type': 'User', 'site_admin': False}",referenced,735463f210584d44ca3460d7319f5eaa213842c4,https://api.github.com/repos/pytorch/pytorch/commits/735463f210584d44ca3460d7319f5eaa213842c4,2019-10-16T18:22:37Z,195,171,24
25805,3007993709,"{'login': 'facebook-github-bot', 'id': 6422482, 'node_id': 'MDQ6VXNlcjY0MjI0ODI=', 'avatar_url': 'https://avatars3.githubusercontent.com/u/6422482?v=4', 'gravatar_id': '', 'url': 'https://api.github.com/users/facebook-github-bot', 'html_url': 'https://github.com/facebook-github-bot', 'followers_url': 'https://api.github.com/users/facebook-github-bot/followers', 'following_url': 'https://api.github.com/users/facebook-github-bot/following{/other_user}', 'gists_url': 'https://api.github.com/users/facebook-github-bot/gists{/gist_id}', 'starred_url': 'https://api.github.com/users/facebook-github-bot/starred{/owner}{/repo}', 'subscriptions_url': 'https://api.github.com/users/facebook-github-bot/subscriptions', 'organizations_url': 'https://api.github.com/users/facebook-github-bot/orgs', 'repos_url': 'https://api.github.com/users/facebook-github-bot/repos', 'events_url': 'https://api.github.com/users/facebook-github-bot/events{/privacy}', 'received_events_url': 'https://api.github.com/users/facebook-github-bot/received_events', 'type': 'User', 'site_admin': False}",closed,58e8d5588acc2ab0840380c3a89848292a73af3e,https://api.github.com/repos/pytorch/pytorch/commits/58e8d5588acc2ab0840380c3a89848292a73af3e,2020-02-04T22:46:11Z,6,6,0
25804,2681617895,"{'login': 'facebook-github-bot', 'id': 6422482, 'node_id': 'MDQ6VXNlcjY0MjI0ODI=', 'avatar_url': 'https://avatars3.githubusercontent.com/u/6422482?v=4', 'gravatar_id': '', 'url': 'https://api.github.com/users/facebook-github-bot', 'html_url': 'https://github.com/facebook-github-bot', 'followers_url': 'https://api.github.com/users/facebook-github-bot/followers', 'following_url': 'https://api.github.com/users/facebook-github-bot/following{/other_user}', 'gists_url': 'https://api.github.com/users/facebook-github-bot/gists{/gist_id}', 'starred_url': 'https://api.github.com/users/facebook-github-bot/starred{/owner}{/repo}', 'subscriptions_url': 'https://api.github.com/users/facebook-github-bot/subscriptions', 'organizations_url': 'https://api.github.com/users/facebook-github-bot/orgs', 'repos_url': 'https://api.github.com/users/facebook-github-bot/repos', 'events_url': 'https://api.github.com/users/facebook-github-bot/events{/privacy}', 'received_events_url': 'https://api.github.com/users/facebook-github-bot/received_events', 'type': 'User', 'site_admin': False}",referenced,bb51980766182b42f631e3f156233d0fdcc881bc,https://api.github.com/repos/pytorch/pytorch/commits/bb51980766182b42f631e3f156233d0fdcc881bc,2019-10-02T18:32:36Z,162,83,79
25801,2718521062,"{'login': 'facebook-github-bot', 'id': 6422482, 'node_id': 'MDQ6VXNlcjY0MjI0ODI=', 'avatar_url': 'https://avatars3.githubusercontent.com/u/6422482?v=4', 'gravatar_id': '', 'url': 'https://api.github.com/users/facebook-github-bot', 'html_url': 'https://github.com/facebook-github-bot', 'followers_url': 'https://api.github.com/users/facebook-github-bot/followers', 'following_url': 'https://api.github.com/users/facebook-github-bot/following{/other_user}', 'gists_url': 'https://api.github.com/users/facebook-github-bot/gists{/gist_id}', 'starred_url': 'https://api.github.com/users/facebook-github-bot/starred{/owner}{/repo}', 'subscriptions_url': 'https://api.github.com/users/facebook-github-bot/subscriptions', 'organizations_url': 'https://api.github.com/users/facebook-github-bot/orgs', 'repos_url': 'https://api.github.com/users/facebook-github-bot/repos', 'events_url': 'https://api.github.com/users/facebook-github-bot/events{/privacy}', 'received_events_url': 'https://api.github.com/users/facebook-github-bot/received_events', 'type': 'User', 'site_admin': False}",closed,97b39a296f83cc8afa1281abff7acdb292eadd67,https://api.github.com/repos/pytorch/pytorch/commits/97b39a296f83cc8afa1281abff7acdb292eadd67,2019-10-16T17:39:48Z,44,42,2
25706,2620610512,"{'login': 'facebook-github-bot', 'id': 6422482, 'node_id': 'MDQ6VXNlcjY0MjI0ODI=', 'avatar_url': 'https://avatars3.githubusercontent.com/u/6422482?v=4', 'gravatar_id': '', 'url': 'https://api.github.com/users/facebook-github-bot', 'html_url': 'https://github.com/facebook-github-bot', 'followers_url': 'https://api.github.com/users/facebook-github-bot/followers', 'following_url': 'https://api.github.com/users/facebook-github-bot/following{/other_user}', 'gists_url': 'https://api.github.com/users/facebook-github-bot/gists{/gist_id}', 'starred_url': 'https://api.github.com/users/facebook-github-bot/starred{/owner}{/repo}', 'subscriptions_url': 'https://api.github.com/users/facebook-github-bot/subscriptions', 'organizations_url': 'https://api.github.com/users/facebook-github-bot/orgs', 'repos_url': 'https://api.github.com/users/facebook-github-bot/repos', 'events_url': 'https://api.github.com/users/facebook-github-bot/events{/privacy}', 'received_events_url': 'https://api.github.com/users/facebook-github-bot/received_events', 'type': 'User', 'site_admin': False}",referenced,1777eb2ed92554ef5ff009bf38f03d52ec089889,https://api.github.com/repos/pytorch/pytorch/commits/1777eb2ed92554ef5ff009bf38f03d52ec089889,2019-09-10T01:27:14Z,2,1,1
25694,2614917163,"{'login': 'facebook-github-bot', 'id': 6422482, 'node_id': 'MDQ6VXNlcjY0MjI0ODI=', 'avatar_url': 'https://avatars3.githubusercontent.com/u/6422482?v=4', 'gravatar_id': '', 'url': 'https://api.github.com/users/facebook-github-bot', 'html_url': 'https://github.com/facebook-github-bot', 'followers_url': 'https://api.github.com/users/facebook-github-bot/followers', 'following_url': 'https://api.github.com/users/facebook-github-bot/following{/other_user}', 'gists_url': 'https://api.github.com/users/facebook-github-bot/gists{/gist_id}', 'starred_url': 'https://api.github.com/users/facebook-github-bot/starred{/owner}{/repo}', 'subscriptions_url': 'https://api.github.com/users/facebook-github-bot/subscriptions', 'organizations_url': 'https://api.github.com/users/facebook-github-bot/orgs', 'repos_url': 'https://api.github.com/users/facebook-github-bot/repos', 'events_url': 'https://api.github.com/users/facebook-github-bot/events{/privacy}', 'received_events_url': 'https://api.github.com/users/facebook-github-bot/received_events', 'type': 'User', 'site_admin': False}",closed,511d1875c5c00e5186abf7f092d0ae611dbc569d,https://api.github.com/repos/pytorch/pytorch/commits/511d1875c5c00e5186abf7f092d0ae611dbc569d,2019-09-06T16:28:01Z,2,1,1
25637,2612792138,"{'login': 'facebook-github-bot', 'id': 6422482, 'node_id': 'MDQ6VXNlcjY0MjI0ODI=', 'avatar_url': 'https://avatars3.githubusercontent.com/u/6422482?v=4', 'gravatar_id': '', 'url': 'https://api.github.com/users/facebook-github-bot', 'html_url': 'https://github.com/facebook-github-bot', 'followers_url': 'https://api.github.com/users/facebook-github-bot/followers', 'following_url': 'https://api.github.com/users/facebook-github-bot/following{/other_user}', 'gists_url': 'https://api.github.com/users/facebook-github-bot/gists{/gist_id}', 'starred_url': 'https://api.github.com/users/facebook-github-bot/starred{/owner}{/repo}', 'subscriptions_url': 'https://api.github.com/users/facebook-github-bot/subscriptions', 'organizations_url': 'https://api.github.com/users/facebook-github-bot/orgs', 'repos_url': 'https://api.github.com/users/facebook-github-bot/repos', 'events_url': 'https://api.github.com/users/facebook-github-bot/events{/privacy}', 'received_events_url': 'https://api.github.com/users/facebook-github-bot/received_events', 'type': 'User', 'site_admin': False}",referenced,82c8949a9d16886086ea3d7b24bb2fc9c9437894,https://api.github.com/repos/pytorch/pytorch/commits/82c8949a9d16886086ea3d7b24bb2fc9c9437894,2019-09-06T00:19:31Z,70,47,23
25605,2643446261,"{'login': 'facebook-github-bot', 'id': 6422482, 'node_id': 'MDQ6VXNlcjY0MjI0ODI=', 'avatar_url': 'https://avatars3.githubusercontent.com/u/6422482?v=4', 'gravatar_id': '', 'url': 'https://api.github.com/users/facebook-github-bot', 'html_url': 'https://github.com/facebook-github-bot', 'followers_url': 'https://api.github.com/users/facebook-github-bot/followers', 'following_url': 'https://api.github.com/users/facebook-github-bot/following{/other_user}', 'gists_url': 'https://api.github.com/users/facebook-github-bot/gists{/gist_id}', 'starred_url': 'https://api.github.com/users/facebook-github-bot/starred{/owner}{/repo}', 'subscriptions_url': 'https://api.github.com/users/facebook-github-bot/subscriptions', 'organizations_url': 'https://api.github.com/users/facebook-github-bot/orgs', 'repos_url': 'https://api.github.com/users/facebook-github-bot/repos', 'events_url': 'https://api.github.com/users/facebook-github-bot/events{/privacy}', 'received_events_url': 'https://api.github.com/users/facebook-github-bot/received_events', 'type': 'User', 'site_admin': False}",closed,b8ae4d0f1cdf1bed61ddfaeea68a7b69251dcea0,https://api.github.com/repos/pytorch/pytorch/commits/b8ae4d0f1cdf1bed61ddfaeea68a7b69251dcea0,2019-09-18T13:08:47Z,77,61,16
25549,2738607925,"{'login': 'facebook-github-bot', 'id': 6422482, 'node_id': 'MDQ6VXNlcjY0MjI0ODI=', 'avatar_url': 'https://avatars3.githubusercontent.com/u/6422482?v=4', 'gravatar_id': '', 'url': 'https://api.github.com/users/facebook-github-bot', 'html_url': 'https://github.com/facebook-github-bot', 'followers_url': 'https://api.github.com/users/facebook-github-bot/followers', 'following_url': 'https://api.github.com/users/facebook-github-bot/following{/other_user}', 'gists_url': 'https://api.github.com/users/facebook-github-bot/gists{/gist_id}', 'starred_url': 'https://api.github.com/users/facebook-github-bot/starred{/owner}{/repo}', 'subscriptions_url': 'https://api.github.com/users/facebook-github-bot/subscriptions', 'organizations_url': 'https://api.github.com/users/facebook-github-bot/orgs', 'repos_url': 'https://api.github.com/users/facebook-github-bot/repos', 'events_url': 'https://api.github.com/users/facebook-github-bot/events{/privacy}', 'received_events_url': 'https://api.github.com/users/facebook-github-bot/received_events', 'type': 'User', 'site_admin': False}",referenced,d081de67cf6d89ec53f30f0b60d914f86b3f655c,https://api.github.com/repos/pytorch/pytorch/commits/d081de67cf6d89ec53f30f0b60d914f86b3f655c,2019-10-23T21:19:50Z,12,6,6
25525,2711282348,"{'login': 'facebook-github-bot', 'id': 6422482, 'node_id': 'MDQ6VXNlcjY0MjI0ODI=', 'avatar_url': 'https://avatars3.githubusercontent.com/u/6422482?v=4', 'gravatar_id': '', 'url': 'https://api.github.com/users/facebook-github-bot', 'html_url': 'https://github.com/facebook-github-bot', 'followers_url': 'https://api.github.com/users/facebook-github-bot/followers', 'following_url': 'https://api.github.com/users/facebook-github-bot/following{/other_user}', 'gists_url': 'https://api.github.com/users/facebook-github-bot/gists{/gist_id}', 'starred_url': 'https://api.github.com/users/facebook-github-bot/starred{/owner}{/repo}', 'subscriptions_url': 'https://api.github.com/users/facebook-github-bot/subscriptions', 'organizations_url': 'https://api.github.com/users/facebook-github-bot/orgs', 'repos_url': 'https://api.github.com/users/facebook-github-bot/repos', 'events_url': 'https://api.github.com/users/facebook-github-bot/events{/privacy}', 'received_events_url': 'https://api.github.com/users/facebook-github-bot/received_events', 'type': 'User', 'site_admin': False}",referenced,b5e0fd4c5619a7b2786360a228dacc236ce238ef,https://api.github.com/repos/pytorch/pytorch/commits/b5e0fd4c5619a7b2786360a228dacc236ce238ef,2019-10-14T17:43:21Z,132,118,14
25525,2712203305,"{'login': 'rohan-varma', 'id': 8039770, 'node_id': 'MDQ6VXNlcjgwMzk3NzA=', 'avatar_url': 'https://avatars2.githubusercontent.com/u/8039770?v=4', 'gravatar_id': '', 'url': 'https://api.github.com/users/rohan-varma', 'html_url': 'https://github.com/rohan-varma', 'followers_url': 'https://api.github.com/users/rohan-varma/followers', 'following_url': 'https://api.github.com/users/rohan-varma/following{/other_user}', 'gists_url': 'https://api.github.com/users/rohan-varma/gists{/gist_id}', 'starred_url': 'https://api.github.com/users/rohan-varma/starred{/owner}{/repo}', 'subscriptions_url': 'https://api.github.com/users/rohan-varma/subscriptions', 'organizations_url': 'https://api.github.com/users/rohan-varma/orgs', 'repos_url': 'https://api.github.com/users/rohan-varma/repos', 'events_url': 'https://api.github.com/users/rohan-varma/events{/privacy}', 'received_events_url': 'https://api.github.com/users/rohan-varma/received_events', 'type': 'User', 'site_admin': False}",referenced,37920e3c98e07ca1c008a373f0c088a38daebec1,https://api.github.com/repos/pytorch/pytorch/commits/37920e3c98e07ca1c008a373f0c088a38daebec1,2019-10-15T00:46:13Z,17,15,2
25525,2712562188,"{'login': 'rohan-varma', 'id': 8039770, 'node_id': 'MDQ6VXNlcjgwMzk3NzA=', 'avatar_url': 'https://avatars2.githubusercontent.com/u/8039770?v=4', 'gravatar_id': '', 'url': 'https://api.github.com/users/rohan-varma', 'html_url': 'https://github.com/rohan-varma', 'followers_url': 'https://api.github.com/users/rohan-varma/followers', 'following_url': 'https://api.github.com/users/rohan-varma/following{/other_user}', 'gists_url': 'https://api.github.com/users/rohan-varma/gists{/gist_id}', 'starred_url': 'https://api.github.com/users/rohan-varma/starred{/owner}{/repo}', 'subscriptions_url': 'https://api.github.com/users/rohan-varma/subscriptions', 'organizations_url': 'https://api.github.com/users/rohan-varma/orgs', 'repos_url': 'https://api.github.com/users/rohan-varma/repos', 'events_url': 'https://api.github.com/users/rohan-varma/events{/privacy}', 'received_events_url': 'https://api.github.com/users/rohan-varma/received_events', 'type': 'User', 'site_admin': False}",referenced,cef903be5db02ecee3a7cdc28a76bf78f19f643c,https://api.github.com/repos/pytorch/pytorch/commits/cef903be5db02ecee3a7cdc28a76bf78f19f643c,2019-10-15T05:07:44Z,118,82,36
25525,2712573074,"{'login': 'rohan-varma', 'id': 8039770, 'node_id': 'MDQ6VXNlcjgwMzk3NzA=', 'avatar_url': 'https://avatars2.githubusercontent.com/u/8039770?v=4', 'gravatar_id': '', 'url': 'https://api.github.com/users/rohan-varma', 'html_url': 'https://github.com/rohan-varma', 'followers_url': 'https://api.github.com/users/rohan-varma/followers', 'following_url': 'https://api.github.com/users/rohan-varma/following{/other_user}', 'gists_url': 'https://api.github.com/users/rohan-varma/gists{/gist_id}', 'starred_url': 'https://api.github.com/users/rohan-varma/starred{/owner}{/repo}', 'subscriptions_url': 'https://api.github.com/users/rohan-varma/subscriptions', 'organizations_url': 'https://api.github.com/users/rohan-varma/orgs', 'repos_url': 'https://api.github.com/users/rohan-varma/repos', 'events_url': 'https://api.github.com/users/rohan-varma/events{/privacy}', 'received_events_url': 'https://api.github.com/users/rohan-varma/received_events', 'type': 'User', 'site_admin': False}",referenced,fc38f28259d779117ab5272fb1f6ca22fd7af36f,https://api.github.com/repos/pytorch/pytorch/commits/fc38f28259d779117ab5272fb1f6ca22fd7af36f,2019-10-15T05:15:22Z,4,0,4
25525,2712606365,"{'login': 'rohan-varma', 'id': 8039770, 'node_id': 'MDQ6VXNlcjgwMzk3NzA=', 'avatar_url': 'https://avatars2.githubusercontent.com/u/8039770?v=4', 'gravatar_id': '', 'url': 'https://api.github.com/users/rohan-varma', 'html_url': 'https://github.com/rohan-varma', 'followers_url': 'https://api.github.com/users/rohan-varma/followers', 'following_url': 'https://api.github.com/users/rohan-varma/following{/other_user}', 'gists_url': 'https://api.github.com/users/rohan-varma/gists{/gist_id}', 'starred_url': 'https://api.github.com/users/rohan-varma/starred{/owner}{/repo}', 'subscriptions_url': 'https://api.github.com/users/rohan-varma/subscriptions', 'organizations_url': 'https://api.github.com/users/rohan-varma/orgs', 'repos_url': 'https://api.github.com/users/rohan-varma/repos', 'events_url': 'https://api.github.com/users/rohan-varma/events{/privacy}', 'received_events_url': 'https://api.github.com/users/rohan-varma/received_events', 'type': 'User', 'site_admin': False}",referenced,3459db74f8f1d452d39f4507345d14a133555c85,https://api.github.com/repos/pytorch/pytorch/commits/3459db74f8f1d452d39f4507345d14a133555c85,2019-10-15T05:37:04Z,20,6,14
25525,2712612142,"{'login': 'rohan-varma', 'id': 8039770, 'node_id': 'MDQ6VXNlcjgwMzk3NzA=', 'avatar_url': 'https://avatars2.githubusercontent.com/u/8039770?v=4', 'gravatar_id': '', 'url': 'https://api.github.com/users/rohan-varma', 'html_url': 'https://github.com/rohan-varma', 'followers_url': 'https://api.github.com/users/rohan-varma/followers', 'following_url': 'https://api.github.com/users/rohan-varma/following{/other_user}', 'gists_url': 'https://api.github.com/users/rohan-varma/gists{/gist_id}', 'starred_url': 'https://api.github.com/users/rohan-varma/starred{/owner}{/repo}', 'subscriptions_url': 'https://api.github.com/users/rohan-varma/subscriptions', 'organizations_url': 'https://api.github.com/users/rohan-varma/orgs', 'repos_url': 'https://api.github.com/users/rohan-varma/repos', 'events_url': 'https://api.github.com/users/rohan-varma/events{/privacy}', 'received_events_url': 'https://api.github.com/users/rohan-varma/received_events', 'type': 'User', 'site_admin': False}",referenced,cbf4b8885681e8952b5118b371b73e10a00a5335,https://api.github.com/repos/pytorch/pytorch/commits/cbf4b8885681e8952b5118b371b73e10a00a5335,2019-10-15T05:40:24Z,1,0,1
25525,2712640947,"{'login': 'rohan-varma', 'id': 8039770, 'node_id': 'MDQ6VXNlcjgwMzk3NzA=', 'avatar_url': 'https://avatars2.githubusercontent.com/u/8039770?v=4', 'gravatar_id': '', 'url': 'https://api.github.com/users/rohan-varma', 'html_url': 'https://github.com/rohan-varma', 'followers_url': 'https://api.github.com/users/rohan-varma/followers', 'following_url': 'https://api.github.com/users/rohan-varma/following{/other_user}', 'gists_url': 'https://api.github.com/users/rohan-varma/gists{/gist_id}', 'starred_url': 'https://api.github.com/users/rohan-varma/starred{/owner}{/repo}', 'subscriptions_url': 'https://api.github.com/users/rohan-varma/subscriptions', 'organizations_url': 'https://api.github.com/users/rohan-varma/orgs', 'repos_url': 'https://api.github.com/users/rohan-varma/repos', 'events_url': 'https://api.github.com/users/rohan-varma/events{/privacy}', 'received_events_url': 'https://api.github.com/users/rohan-varma/received_events', 'type': 'User', 'site_admin': False}",referenced,8747c725082b22b27acf0f94ad2e5fce7db6100d,https://api.github.com/repos/pytorch/pytorch/commits/8747c725082b22b27acf0f94ad2e5fce7db6100d,2019-10-15T05:57:31Z,11,5,6
25525,2715375362,"{'login': 'rohan-varma', 'id': 8039770, 'node_id': 'MDQ6VXNlcjgwMzk3NzA=', 'avatar_url': 'https://avatars2.githubusercontent.com/u/8039770?v=4', 'gravatar_id': '', 'url': 'https://api.github.com/users/rohan-varma', 'html_url': 'https://github.com/rohan-varma', 'followers_url': 'https://api.github.com/users/rohan-varma/followers', 'following_url': 'https://api.github.com/users/rohan-varma/following{/other_user}', 'gists_url': 'https://api.github.com/users/rohan-varma/gists{/gist_id}', 'starred_url': 'https://api.github.com/users/rohan-varma/starred{/owner}{/repo}', 'subscriptions_url': 'https://api.github.com/users/rohan-varma/subscriptions', 'organizations_url': 'https://api.github.com/users/rohan-varma/orgs', 'repos_url': 'https://api.github.com/users/rohan-varma/repos', 'events_url': 'https://api.github.com/users/rohan-varma/events{/privacy}', 'received_events_url': 'https://api.github.com/users/rohan-varma/received_events', 'type': 'User', 'site_admin': False}",referenced,bfbb1e347d059b56c923ac383b30ff8797321a8b,https://api.github.com/repos/pytorch/pytorch/commits/bfbb1e347d059b56c923ac383b30ff8797321a8b,2019-10-15T20:36:17Z,6,2,4
25525,2715584298,"{'login': 'rohan-varma', 'id': 8039770, 'node_id': 'MDQ6VXNlcjgwMzk3NzA=', 'avatar_url': 'https://avatars2.githubusercontent.com/u/8039770?v=4', 'gravatar_id': '', 'url': 'https://api.github.com/users/rohan-varma', 'html_url': 'https://github.com/rohan-varma', 'followers_url': 'https://api.github.com/users/rohan-varma/followers', 'following_url': 'https://api.github.com/users/rohan-varma/following{/other_user}', 'gists_url': 'https://api.github.com/users/rohan-varma/gists{/gist_id}', 'starred_url': 'https://api.github.com/users/rohan-varma/starred{/owner}{/repo}', 'subscriptions_url': 'https://api.github.com/users/rohan-varma/subscriptions', 'organizations_url': 'https://api.github.com/users/rohan-varma/orgs', 'repos_url': 'https://api.github.com/users/rohan-varma/repos', 'events_url': 'https://api.github.com/users/rohan-varma/events{/privacy}', 'received_events_url': 'https://api.github.com/users/rohan-varma/received_events', 'type': 'User', 'site_admin': False}",referenced,638c68b6e117102a00f0c22e34be02abfc2163de,https://api.github.com/repos/pytorch/pytorch/commits/638c68b6e117102a00f0c22e34be02abfc2163de,2019-10-15T21:56:10Z,11,5,6
25525,2719277902,"{'login': 'rohan-varma', 'id': 8039770, 'node_id': 'MDQ6VXNlcjgwMzk3NzA=', 'avatar_url': 'https://avatars2.githubusercontent.com/u/8039770?v=4', 'gravatar_id': '', 'url': 'https://api.github.com/users/rohan-varma', 'html_url': 'https://github.com/rohan-varma', 'followers_url': 'https://api.github.com/users/rohan-varma/followers', 'following_url': 'https://api.github.com/users/rohan-varma/following{/other_user}', 'gists_url': 'https://api.github.com/users/rohan-varma/gists{/gist_id}', 'starred_url': 'https://api.github.com/users/rohan-varma/starred{/owner}{/repo}', 'subscriptions_url': 'https://api.github.com/users/rohan-varma/subscriptions', 'organizations_url': 'https://api.github.com/users/rohan-varma/orgs', 'repos_url': 'https://api.github.com/users/rohan-varma/repos', 'events_url': 'https://api.github.com/users/rohan-varma/events{/privacy}', 'received_events_url': 'https://api.github.com/users/rohan-varma/received_events', 'type': 'User', 'site_admin': False}",referenced,8e787018d52e66b29e69b920313f3f25d73cec92,https://api.github.com/repos/pytorch/pytorch/commits/8e787018d52e66b29e69b920313f3f25d73cec92,2019-10-16T22:06:07Z,83,59,24
25525,2719334597,"{'login': 'rohan-varma', 'id': 8039770, 'node_id': 'MDQ6VXNlcjgwMzk3NzA=', 'avatar_url': 'https://avatars2.githubusercontent.com/u/8039770?v=4', 'gravatar_id': '', 'url': 'https://api.github.com/users/rohan-varma', 'html_url': 'https://github.com/rohan-varma', 'followers_url': 'https://api.github.com/users/rohan-varma/followers', 'following_url': 'https://api.github.com/users/rohan-varma/following{/other_user}', 'gists_url': 'https://api.github.com/users/rohan-varma/gists{/gist_id}', 'starred_url': 'https://api.github.com/users/rohan-varma/starred{/owner}{/repo}', 'subscriptions_url': 'https://api.github.com/users/rohan-varma/subscriptions', 'organizations_url': 'https://api.github.com/users/rohan-varma/orgs', 'repos_url': 'https://api.github.com/users/rohan-varma/repos', 'events_url': 'https://api.github.com/users/rohan-varma/events{/privacy}', 'received_events_url': 'https://api.github.com/users/rohan-varma/received_events', 'type': 'User', 'site_admin': False}",referenced,3e052cac17e151bc5f75f323de7359eb89470d7e,https://api.github.com/repos/pytorch/pytorch/commits/3e052cac17e151bc5f75f323de7359eb89470d7e,2019-10-16T22:34:23Z,16,5,11
25525,2719344740,"{'login': 'rohan-varma', 'id': 8039770, 'node_id': 'MDQ6VXNlcjgwMzk3NzA=', 'avatar_url': 'https://avatars2.githubusercontent.com/u/8039770?v=4', 'gravatar_id': '', 'url': 'https://api.github.com/users/rohan-varma', 'html_url': 'https://github.com/rohan-varma', 'followers_url': 'https://api.github.com/users/rohan-varma/followers', 'following_url': 'https://api.github.com/users/rohan-varma/following{/other_user}', 'gists_url': 'https://api.github.com/users/rohan-varma/gists{/gist_id}', 'starred_url': 'https://api.github.com/users/rohan-varma/starred{/owner}{/repo}', 'subscriptions_url': 'https://api.github.com/users/rohan-varma/subscriptions', 'organizations_url': 'https://api.github.com/users/rohan-varma/orgs', 'repos_url': 'https://api.github.com/users/rohan-varma/repos', 'events_url': 'https://api.github.com/users/rohan-varma/events{/privacy}', 'received_events_url': 'https://api.github.com/users/rohan-varma/received_events', 'type': 'User', 'site_admin': False}",referenced,ddbf1cb0dfed82112a9c7a1e9f57201cb02d6cc6,https://api.github.com/repos/pytorch/pytorch/commits/ddbf1cb0dfed82112a9c7a1e9f57201cb02d6cc6,2019-10-16T22:39:50Z,2,1,1
25525,2719358501,"{'login': 'rohan-varma', 'id': 8039770, 'node_id': 'MDQ6VXNlcjgwMzk3NzA=', 'avatar_url': 'https://avatars2.githubusercontent.com/u/8039770?v=4', 'gravatar_id': '', 'url': 'https://api.github.com/users/rohan-varma', 'html_url': 'https://github.com/rohan-varma', 'followers_url': 'https://api.github.com/users/rohan-varma/followers', 'following_url': 'https://api.github.com/users/rohan-varma/following{/other_user}', 'gists_url': 'https://api.github.com/users/rohan-varma/gists{/gist_id}', 'starred_url': 'https://api.github.com/users/rohan-varma/starred{/owner}{/repo}', 'subscriptions_url': 'https://api.github.com/users/rohan-varma/subscriptions', 'organizations_url': 'https://api.github.com/users/rohan-varma/orgs', 'repos_url': 'https://api.github.com/users/rohan-varma/repos', 'events_url': 'https://api.github.com/users/rohan-varma/events{/privacy}', 'received_events_url': 'https://api.github.com/users/rohan-varma/received_events', 'type': 'User', 'site_admin': False}",referenced,2a3e8f5bd4436149ef1f4b16e1b0823a79e77ada,https://api.github.com/repos/pytorch/pytorch/commits/2a3e8f5bd4436149ef1f4b16e1b0823a79e77ada,2019-10-16T22:47:06Z,39,14,25
25525,2722605720,"{'login': 'rohan-varma', 'id': 8039770, 'node_id': 'MDQ6VXNlcjgwMzk3NzA=', 'avatar_url': 'https://avatars2.githubusercontent.com/u/8039770?v=4', 'gravatar_id': '', 'url': 'https://api.github.com/users/rohan-varma', 'html_url': 'https://github.com/rohan-varma', 'followers_url': 'https://api.github.com/users/rohan-varma/followers', 'following_url': 'https://api.github.com/users/rohan-varma/following{/other_user}', 'gists_url': 'https://api.github.com/users/rohan-varma/gists{/gist_id}', 'starred_url': 'https://api.github.com/users/rohan-varma/starred{/owner}{/repo}', 'subscriptions_url': 'https://api.github.com/users/rohan-varma/subscriptions', 'organizations_url': 'https://api.github.com/users/rohan-varma/orgs', 'repos_url': 'https://api.github.com/users/rohan-varma/repos', 'events_url': 'https://api.github.com/users/rohan-varma/events{/privacy}', 'received_events_url': 'https://api.github.com/users/rohan-varma/received_events', 'type': 'User', 'site_admin': False}",referenced,9671566d0256152b49106e05a90c88e174cd2502,https://api.github.com/repos/pytorch/pytorch/commits/9671566d0256152b49106e05a90c88e174cd2502,2019-10-17T20:09:32Z,32,22,10
25472,2669088538,"{'login': 'facebook-github-bot', 'id': 6422482, 'node_id': 'MDQ6VXNlcjY0MjI0ODI=', 'avatar_url': 'https://avatars3.githubusercontent.com/u/6422482?v=4', 'gravatar_id': '', 'url': 'https://api.github.com/users/facebook-github-bot', 'html_url': 'https://github.com/facebook-github-bot', 'followers_url': 'https://api.github.com/users/facebook-github-bot/followers', 'following_url': 'https://api.github.com/users/facebook-github-bot/following{/other_user}', 'gists_url': 'https://api.github.com/users/facebook-github-bot/gists{/gist_id}', 'starred_url': 'https://api.github.com/users/facebook-github-bot/starred{/owner}{/repo}', 'subscriptions_url': 'https://api.github.com/users/facebook-github-bot/subscriptions', 'organizations_url': 'https://api.github.com/users/facebook-github-bot/orgs', 'repos_url': 'https://api.github.com/users/facebook-github-bot/repos', 'events_url': 'https://api.github.com/users/facebook-github-bot/events{/privacy}', 'received_events_url': 'https://api.github.com/users/facebook-github-bot/received_events', 'type': 'User', 'site_admin': False}",referenced,2a43b741968430ff81a3fc3cb98b0651b92f196b,https://api.github.com/repos/pytorch/pytorch/commits/2a43b741968430ff81a3fc3cb98b0651b92f196b,2019-09-27T15:40:48Z,31,31,0
25463,2602561707,"{'login': 'pietern', 'id': 9845, 'node_id': 'MDQ6VXNlcjk4NDU=', 'avatar_url': 'https://avatars3.githubusercontent.com/u/9845?v=4', 'gravatar_id': '', 'url': 'https://api.github.com/users/pietern', 'html_url': 'https://github.com/pietern', 'followers_url': 'https://api.github.com/users/pietern/followers', 'following_url': 'https://api.github.com/users/pietern/following{/other_user}', 'gists_url': 'https://api.github.com/users/pietern/gists{/gist_id}', 'starred_url': 'https://api.github.com/users/pietern/starred{/owner}{/repo}', 'subscriptions_url': 'https://api.github.com/users/pietern/subscriptions', 'organizations_url': 'https://api.github.com/users/pietern/orgs', 'repos_url': 'https://api.github.com/users/pietern/repos', 'events_url': 'https://api.github.com/users/pietern/events{/privacy}', 'received_events_url': 'https://api.github.com/users/pietern/received_events', 'type': 'User', 'site_admin': False}",referenced,201b936811332f809b65609e5a98f54982887f61,https://api.github.com/repos/pytorch/pytorch/commits/201b936811332f809b65609e5a98f54982887f61,2019-09-03T07:41:55Z,105,81,24
25463,2602561964,"{'login': 'pietern', 'id': 9845, 'node_id': 'MDQ6VXNlcjk4NDU=', 'avatar_url': 'https://avatars3.githubusercontent.com/u/9845?v=4', 'gravatar_id': '', 'url': 'https://api.github.com/users/pietern', 'html_url': 'https://github.com/pietern', 'followers_url': 'https://api.github.com/users/pietern/followers', 'following_url': 'https://api.github.com/users/pietern/following{/other_user}', 'gists_url': 'https://api.github.com/users/pietern/gists{/gist_id}', 'starred_url': 'https://api.github.com/users/pietern/starred{/owner}{/repo}', 'subscriptions_url': 'https://api.github.com/users/pietern/subscriptions', 'organizations_url': 'https://api.github.com/users/pietern/orgs', 'repos_url': 'https://api.github.com/users/pietern/repos', 'events_url': 'https://api.github.com/users/pietern/events{/privacy}', 'received_events_url': 'https://api.github.com/users/pietern/received_events', 'type': 'User', 'site_admin': False}",referenced,fafb80fab42ab2efbaa64ea499f3c9e737a9d6b6,https://api.github.com/repos/pytorch/pytorch/commits/fafb80fab42ab2efbaa64ea499f3c9e737a9d6b6,2019-09-03T07:42:01Z,105,81,24
25463,2604725010,"{'login': 'facebook-github-bot', 'id': 6422482, 'node_id': 'MDQ6VXNlcjY0MjI0ODI=', 'avatar_url': 'https://avatars3.githubusercontent.com/u/6422482?v=4', 'gravatar_id': '', 'url': 'https://api.github.com/users/facebook-github-bot', 'html_url': 'https://github.com/facebook-github-bot', 'followers_url': 'https://api.github.com/users/facebook-github-bot/followers', 'following_url': 'https://api.github.com/users/facebook-github-bot/following{/other_user}', 'gists_url': 'https://api.github.com/users/facebook-github-bot/gists{/gist_id}', 'starred_url': 'https://api.github.com/users/facebook-github-bot/starred{/owner}{/repo}', 'subscriptions_url': 'https://api.github.com/users/facebook-github-bot/subscriptions', 'organizations_url': 'https://api.github.com/users/facebook-github-bot/orgs', 'repos_url': 'https://api.github.com/users/facebook-github-bot/repos', 'events_url': 'https://api.github.com/users/facebook-github-bot/events{/privacy}', 'received_events_url': 'https://api.github.com/users/facebook-github-bot/received_events', 'type': 'User', 'site_admin': False}",referenced,500e72aaa5eece39bf7cfc533f74077234f578de,https://api.github.com/repos/pytorch/pytorch/commits/500e72aaa5eece39bf7cfc533f74077234f578de,2019-09-03T19:27:17Z,105,81,24
25454,2597464778,"{'login': 'facebook-github-bot', 'id': 6422482, 'node_id': 'MDQ6VXNlcjY0MjI0ODI=', 'avatar_url': 'https://avatars3.githubusercontent.com/u/6422482?v=4', 'gravatar_id': '', 'url': 'https://api.github.com/users/facebook-github-bot', 'html_url': 'https://github.com/facebook-github-bot', 'followers_url': 'https://api.github.com/users/facebook-github-bot/followers', 'following_url': 'https://api.github.com/users/facebook-github-bot/following{/other_user}', 'gists_url': 'https://api.github.com/users/facebook-github-bot/gists{/gist_id}', 'starred_url': 'https://api.github.com/users/facebook-github-bot/starred{/owner}{/repo}', 'subscriptions_url': 'https://api.github.com/users/facebook-github-bot/subscriptions', 'organizations_url': 'https://api.github.com/users/facebook-github-bot/orgs', 'repos_url': 'https://api.github.com/users/facebook-github-bot/repos', 'events_url': 'https://api.github.com/users/facebook-github-bot/events{/privacy}', 'received_events_url': 'https://api.github.com/users/facebook-github-bot/received_events', 'type': 'User', 'site_admin': False}",closed,4fb28e5df913e742d60b120e0e31c4d6b4a2d595,https://api.github.com/repos/pytorch/pytorch/commits/4fb28e5df913e742d60b120e0e31c4d6b4a2d595,2019-08-30T14:59:39Z,1,1,0
25427,2602597812,"{'login': 'facebook-github-bot', 'id': 6422482, 'node_id': 'MDQ6VXNlcjY0MjI0ODI=', 'avatar_url': 'https://avatars3.githubusercontent.com/u/6422482?v=4', 'gravatar_id': '', 'url': 'https://api.github.com/users/facebook-github-bot', 'html_url': 'https://github.com/facebook-github-bot', 'followers_url': 'https://api.github.com/users/facebook-github-bot/followers', 'following_url': 'https://api.github.com/users/facebook-github-bot/following{/other_user}', 'gists_url': 'https://api.github.com/users/facebook-github-bot/gists{/gist_id}', 'starred_url': 'https://api.github.com/users/facebook-github-bot/starred{/owner}{/repo}', 'subscriptions_url': 'https://api.github.com/users/facebook-github-bot/subscriptions', 'organizations_url': 'https://api.github.com/users/facebook-github-bot/orgs', 'repos_url': 'https://api.github.com/users/facebook-github-bot/repos', 'events_url': 'https://api.github.com/users/facebook-github-bot/events{/privacy}', 'received_events_url': 'https://api.github.com/users/facebook-github-bot/received_events', 'type': 'User', 'site_admin': False}",referenced,53cacb6a591f1e6515acee4116ca0732afca6ed7,https://api.github.com/repos/pytorch/pytorch/commits/53cacb6a591f1e6515acee4116ca0732afca6ed7,2019-09-03T07:54:22Z,3,1,2
25399,2619013644,"{'login': 'facebook-github-bot', 'id': 6422482, 'node_id': 'MDQ6VXNlcjY0MjI0ODI=', 'avatar_url': 'https://avatars3.githubusercontent.com/u/6422482?v=4', 'gravatar_id': '', 'url': 'https://api.github.com/users/facebook-github-bot', 'html_url': 'https://github.com/facebook-github-bot', 'followers_url': 'https://api.github.com/users/facebook-github-bot/followers', 'following_url': 'https://api.github.com/users/facebook-github-bot/following{/other_user}', 'gists_url': 'https://api.github.com/users/facebook-github-bot/gists{/gist_id}', 'starred_url': 'https://api.github.com/users/facebook-github-bot/starred{/owner}{/repo}', 'subscriptions_url': 'https://api.github.com/users/facebook-github-bot/subscriptions', 'organizations_url': 'https://api.github.com/users/facebook-github-bot/orgs', 'repos_url': 'https://api.github.com/users/facebook-github-bot/repos', 'events_url': 'https://api.github.com/users/facebook-github-bot/events{/privacy}', 'received_events_url': 'https://api.github.com/users/facebook-github-bot/received_events', 'type': 'User', 'site_admin': False}",closed,4fac61a886c94456a2a9c49fe6e0a6eec502455d,https://api.github.com/repos/pytorch/pytorch/commits/4fac61a886c94456a2a9c49fe6e0a6eec502455d,2019-09-09T14:54:39Z,3,3,0
25360,2604535693,"{'login': 'facebook-github-bot', 'id': 6422482, 'node_id': 'MDQ6VXNlcjY0MjI0ODI=', 'avatar_url': 'https://avatars3.githubusercontent.com/u/6422482?v=4', 'gravatar_id': '', 'url': 'https://api.github.com/users/facebook-github-bot', 'html_url': 'https://github.com/facebook-github-bot', 'followers_url': 'https://api.github.com/users/facebook-github-bot/followers', 'following_url': 'https://api.github.com/users/facebook-github-bot/following{/other_user}', 'gists_url': 'https://api.github.com/users/facebook-github-bot/gists{/gist_id}', 'starred_url': 'https://api.github.com/users/facebook-github-bot/starred{/owner}{/repo}', 'subscriptions_url': 'https://api.github.com/users/facebook-github-bot/subscriptions', 'organizations_url': 'https://api.github.com/users/facebook-github-bot/orgs', 'repos_url': 'https://api.github.com/users/facebook-github-bot/repos', 'events_url': 'https://api.github.com/users/facebook-github-bot/events{/privacy}', 'received_events_url': 'https://api.github.com/users/facebook-github-bot/received_events', 'type': 'User', 'site_admin': False}",closed,f3f83ccb2370b12150797e85b70435306e7002a6,https://api.github.com/repos/pytorch/pytorch/commits/f3f83ccb2370b12150797e85b70435306e7002a6,2019-09-03T18:16:41Z,40,28,12
25320,2598369612,"{'login': 'facebook-github-bot', 'id': 6422482, 'node_id': 'MDQ6VXNlcjY0MjI0ODI=', 'avatar_url': 'https://avatars3.githubusercontent.com/u/6422482?v=4', 'gravatar_id': '', 'url': 'https://api.github.com/users/facebook-github-bot', 'html_url': 'https://github.com/facebook-github-bot', 'followers_url': 'https://api.github.com/users/facebook-github-bot/followers', 'following_url': 'https://api.github.com/users/facebook-github-bot/following{/other_user}', 'gists_url': 'https://api.github.com/users/facebook-github-bot/gists{/gist_id}', 'starred_url': 'https://api.github.com/users/facebook-github-bot/starred{/owner}{/repo}', 'subscriptions_url': 'https://api.github.com/users/facebook-github-bot/subscriptions', 'organizations_url': 'https://api.github.com/users/facebook-github-bot/orgs', 'repos_url': 'https://api.github.com/users/facebook-github-bot/repos', 'events_url': 'https://api.github.com/users/facebook-github-bot/events{/privacy}', 'received_events_url': 'https://api.github.com/users/facebook-github-bot/received_events', 'type': 'User', 'site_admin': False}",closed,861194e3f8fe59b6877f62722fa1cd28b69ba45b,https://api.github.com/repos/pytorch/pytorch/commits/861194e3f8fe59b6877f62722fa1cd28b69ba45b,2019-08-30T21:35:08Z,3,3,0
25315,2663539781,"{'login': 'facebook-github-bot', 'id': 6422482, 'node_id': 'MDQ6VXNlcjY0MjI0ODI=', 'avatar_url': 'https://avatars3.githubusercontent.com/u/6422482?v=4', 'gravatar_id': '', 'url': 'https://api.github.com/users/facebook-github-bot', 'html_url': 'https://github.com/facebook-github-bot', 'followers_url': 'https://api.github.com/users/facebook-github-bot/followers', 'following_url': 'https://api.github.com/users/facebook-github-bot/following{/other_user}', 'gists_url': 'https://api.github.com/users/facebook-github-bot/gists{/gist_id}', 'starred_url': 'https://api.github.com/users/facebook-github-bot/starred{/owner}{/repo}', 'subscriptions_url': 'https://api.github.com/users/facebook-github-bot/subscriptions', 'organizations_url': 'https://api.github.com/users/facebook-github-bot/orgs', 'repos_url': 'https://api.github.com/users/facebook-github-bot/repos', 'events_url': 'https://api.github.com/users/facebook-github-bot/events{/privacy}', 'received_events_url': 'https://api.github.com/users/facebook-github-bot/received_events', 'type': 'User', 'site_admin': False}",referenced,90ffab6e3713a40f47f4c9d3d3b16d56e83f97c4,https://api.github.com/repos/pytorch/pytorch/commits/90ffab6e3713a40f47f4c9d3d3b16d56e83f97c4,2019-09-26T00:38:28Z,121,119,2
25304,2590572625,"{'login': 'ezyang', 'id': 13564, 'node_id': 'MDQ6VXNlcjEzNTY0', 'avatar_url': 'https://avatars0.githubusercontent.com/u/13564?v=4', 'gravatar_id': '', 'url': 'https://api.github.com/users/ezyang', 'html_url': 'https://github.com/ezyang', 'followers_url': 'https://api.github.com/users/ezyang/followers', 'following_url': 'https://api.github.com/users/ezyang/following{/other_user}', 'gists_url': 'https://api.github.com/users/ezyang/gists{/gist_id}', 'starred_url': 'https://api.github.com/users/ezyang/starred{/owner}{/repo}', 'subscriptions_url': 'https://api.github.com/users/ezyang/subscriptions', 'organizations_url': 'https://api.github.com/users/ezyang/orgs', 'repos_url': 'https://api.github.com/users/ezyang/repos', 'events_url': 'https://api.github.com/users/ezyang/events{/privacy}', 'received_events_url': 'https://api.github.com/users/ezyang/received_events', 'type': 'User', 'site_admin': False}",referenced,78881f77f716c84593c8d4827e91867b7e651d1d,https://api.github.com/repos/pytorch/pytorch/commits/78881f77f716c84593c8d4827e91867b7e651d1d,2019-08-28T13:38:33Z,9,7,2
25304,2590572881,"{'login': 'ezyang', 'id': 13564, 'node_id': 'MDQ6VXNlcjEzNTY0', 'avatar_url': 'https://avatars0.githubusercontent.com/u/13564?v=4', 'gravatar_id': '', 'url': 'https://api.github.com/users/ezyang', 'html_url': 'https://github.com/ezyang', 'followers_url': 'https://api.github.com/users/ezyang/followers', 'following_url': 'https://api.github.com/users/ezyang/following{/other_user}', 'gists_url': 'https://api.github.com/users/ezyang/gists{/gist_id}', 'starred_url': 'https://api.github.com/users/ezyang/starred{/owner}{/repo}', 'subscriptions_url': 'https://api.github.com/users/ezyang/subscriptions', 'organizations_url': 'https://api.github.com/users/ezyang/orgs', 'repos_url': 'https://api.github.com/users/ezyang/repos', 'events_url': 'https://api.github.com/users/ezyang/events{/privacy}', 'received_events_url': 'https://api.github.com/users/ezyang/received_events', 'type': 'User', 'site_admin': False}",referenced,527e9ec43197380c31040b9c544b4baf83e0ffbe,https://api.github.com/repos/pytorch/pytorch/commits/527e9ec43197380c31040b9c544b4baf83e0ffbe,2019-08-28T13:38:37Z,9,7,2
25304,2590868966,"{'login': 'ezyang', 'id': 13564, 'node_id': 'MDQ6VXNlcjEzNTY0', 'avatar_url': 'https://avatars0.githubusercontent.com/u/13564?v=4', 'gravatar_id': '', 'url': 'https://api.github.com/users/ezyang', 'html_url': 'https://github.com/ezyang', 'followers_url': 'https://api.github.com/users/ezyang/followers', 'following_url': 'https://api.github.com/users/ezyang/following{/other_user}', 'gists_url': 'https://api.github.com/users/ezyang/gists{/gist_id}', 'starred_url': 'https://api.github.com/users/ezyang/starred{/owner}{/repo}', 'subscriptions_url': 'https://api.github.com/users/ezyang/subscriptions', 'organizations_url': 'https://api.github.com/users/ezyang/orgs', 'repos_url': 'https://api.github.com/users/ezyang/repos', 'events_url': 'https://api.github.com/users/ezyang/events{/privacy}', 'received_events_url': 'https://api.github.com/users/ezyang/received_events', 'type': 'User', 'site_admin': False}",referenced,87ef63cbb200e1067d87c1b18afef489629848f2,https://api.github.com/repos/pytorch/pytorch/commits/87ef63cbb200e1067d87c1b18afef489629848f2,2019-08-28T14:59:29Z,34,17,17
25304,2590869241,"{'login': 'ezyang', 'id': 13564, 'node_id': 'MDQ6VXNlcjEzNTY0', 'avatar_url': 'https://avatars0.githubusercontent.com/u/13564?v=4', 'gravatar_id': '', 'url': 'https://api.github.com/users/ezyang', 'html_url': 'https://github.com/ezyang', 'followers_url': 'https://api.github.com/users/ezyang/followers', 'following_url': 'https://api.github.com/users/ezyang/following{/other_user}', 'gists_url': 'https://api.github.com/users/ezyang/gists{/gist_id}', 'starred_url': 'https://api.github.com/users/ezyang/starred{/owner}{/repo}', 'subscriptions_url': 'https://api.github.com/users/ezyang/subscriptions', 'organizations_url': 'https://api.github.com/users/ezyang/orgs', 'repos_url': 'https://api.github.com/users/ezyang/repos', 'events_url': 'https://api.github.com/users/ezyang/events{/privacy}', 'received_events_url': 'https://api.github.com/users/ezyang/received_events', 'type': 'User', 'site_admin': False}",referenced,a5265967f8dde5d39c07cd3929c0a2754389788e,https://api.github.com/repos/pytorch/pytorch/commits/a5265967f8dde5d39c07cd3929c0a2754389788e,2019-08-28T14:59:34Z,29,17,12
25304,2591457130,"{'login': 'facebook-github-bot', 'id': 6422482, 'node_id': 'MDQ6VXNlcjY0MjI0ODI=', 'avatar_url': 'https://avatars3.githubusercontent.com/u/6422482?v=4', 'gravatar_id': '', 'url': 'https://api.github.com/users/facebook-github-bot', 'html_url': 'https://github.com/facebook-github-bot', 'followers_url': 'https://api.github.com/users/facebook-github-bot/followers', 'following_url': 'https://api.github.com/users/facebook-github-bot/following{/other_user}', 'gists_url': 'https://api.github.com/users/facebook-github-bot/gists{/gist_id}', 'starred_url': 'https://api.github.com/users/facebook-github-bot/starred{/owner}{/repo}', 'subscriptions_url': 'https://api.github.com/users/facebook-github-bot/subscriptions', 'organizations_url': 'https://api.github.com/users/facebook-github-bot/orgs', 'repos_url': 'https://api.github.com/users/facebook-github-bot/repos', 'events_url': 'https://api.github.com/users/facebook-github-bot/events{/privacy}', 'received_events_url': 'https://api.github.com/users/facebook-github-bot/received_events', 'type': 'User', 'site_admin': False}",referenced,53ac931af233cb9043b896d5a4988d4d4556b95c,https://api.github.com/repos/pytorch/pytorch/commits/53ac931af233cb9043b896d5a4988d4d4556b95c,2019-08-28T18:06:23Z,29,17,12
25293,2594829875,"{'login': 'facebook-github-bot', 'id': 6422482, 'node_id': 'MDQ6VXNlcjY0MjI0ODI=', 'avatar_url': 'https://avatars3.githubusercontent.com/u/6422482?v=4', 'gravatar_id': '', 'url': 'https://api.github.com/users/facebook-github-bot', 'html_url': 'https://github.com/facebook-github-bot', 'followers_url': 'https://api.github.com/users/facebook-github-bot/followers', 'following_url': 'https://api.github.com/users/facebook-github-bot/following{/other_user}', 'gists_url': 'https://api.github.com/users/facebook-github-bot/gists{/gist_id}', 'starred_url': 'https://api.github.com/users/facebook-github-bot/starred{/owner}{/repo}', 'subscriptions_url': 'https://api.github.com/users/facebook-github-bot/subscriptions', 'organizations_url': 'https://api.github.com/users/facebook-github-bot/orgs', 'repos_url': 'https://api.github.com/users/facebook-github-bot/repos', 'events_url': 'https://api.github.com/users/facebook-github-bot/events{/privacy}', 'received_events_url': 'https://api.github.com/users/facebook-github-bot/received_events', 'type': 'User', 'site_admin': False}",closed,cad3abb0366075bd84d2865735dce634c308ea1d,https://api.github.com/repos/pytorch/pytorch/commits/cad3abb0366075bd84d2865735dce634c308ea1d,2019-08-29T17:49:34Z,11,2,9
25242,2636953455,"{'login': 'facebook-github-bot', 'id': 6422482, 'node_id': 'MDQ6VXNlcjY0MjI0ODI=', 'avatar_url': 'https://avatars3.githubusercontent.com/u/6422482?v=4', 'gravatar_id': '', 'url': 'https://api.github.com/users/facebook-github-bot', 'html_url': 'https://github.com/facebook-github-bot', 'followers_url': 'https://api.github.com/users/facebook-github-bot/followers', 'following_url': 'https://api.github.com/users/facebook-github-bot/following{/other_user}', 'gists_url': 'https://api.github.com/users/facebook-github-bot/gists{/gist_id}', 'starred_url': 'https://api.github.com/users/facebook-github-bot/starred{/owner}{/repo}', 'subscriptions_url': 'https://api.github.com/users/facebook-github-bot/subscriptions', 'organizations_url': 'https://api.github.com/users/facebook-github-bot/orgs', 'repos_url': 'https://api.github.com/users/facebook-github-bot/repos', 'events_url': 'https://api.github.com/users/facebook-github-bot/events{/privacy}', 'received_events_url': 'https://api.github.com/users/facebook-github-bot/received_events', 'type': 'User', 'site_admin': False}",referenced,38b2bc14519bffe5389b492b0e65427edbb78480,https://api.github.com/repos/pytorch/pytorch/commits/38b2bc14519bffe5389b492b0e65427edbb78480,2019-09-16T16:02:07Z,2,1,1
25214,2588774659,"{'login': 'driazati', 'id': 9407960, 'node_id': 'MDQ6VXNlcjk0MDc5NjA=', 'avatar_url': 'https://avatars3.githubusercontent.com/u/9407960?v=4', 'gravatar_id': '', 'url': 'https://api.github.com/users/driazati', 'html_url': 'https://github.com/driazati', 'followers_url': 'https://api.github.com/users/driazati/followers', 'following_url': 'https://api.github.com/users/driazati/following{/other_user}', 'gists_url': 'https://api.github.com/users/driazati/gists{/gist_id}', 'starred_url': 'https://api.github.com/users/driazati/starred{/owner}{/repo}', 'subscriptions_url': 'https://api.github.com/users/driazati/subscriptions', 'organizations_url': 'https://api.github.com/users/driazati/orgs', 'repos_url': 'https://api.github.com/users/driazati/repos', 'events_url': 'https://api.github.com/users/driazati/events{/privacy}', 'received_events_url': 'https://api.github.com/users/driazati/received_events', 'type': 'User', 'site_admin': False}",referenced,cf8ac8fc955f8a6461a642dc516e539277c697f5,https://api.github.com/repos/pytorch/pytorch/commits/cf8ac8fc955f8a6461a642dc516e539277c697f5,2019-08-27T23:25:23Z,39,38,1
25214,2598529243,"{'login': 'facebook-github-bot', 'id': 6422482, 'node_id': 'MDQ6VXNlcjY0MjI0ODI=', 'avatar_url': 'https://avatars3.githubusercontent.com/u/6422482?v=4', 'gravatar_id': '', 'url': 'https://api.github.com/users/facebook-github-bot', 'html_url': 'https://github.com/facebook-github-bot', 'followers_url': 'https://api.github.com/users/facebook-github-bot/followers', 'following_url': 'https://api.github.com/users/facebook-github-bot/following{/other_user}', 'gists_url': 'https://api.github.com/users/facebook-github-bot/gists{/gist_id}', 'starred_url': 'https://api.github.com/users/facebook-github-bot/starred{/owner}{/repo}', 'subscriptions_url': 'https://api.github.com/users/facebook-github-bot/subscriptions', 'organizations_url': 'https://api.github.com/users/facebook-github-bot/orgs', 'repos_url': 'https://api.github.com/users/facebook-github-bot/repos', 'events_url': 'https://api.github.com/users/facebook-github-bot/events{/privacy}', 'received_events_url': 'https://api.github.com/users/facebook-github-bot/received_events', 'type': 'User', 'site_admin': False}",closed,7a921ba17d799cbc2553195e221747f75e9f7dd8,https://api.github.com/repos/pytorch/pytorch/commits/7a921ba17d799cbc2553195e221747f75e9f7dd8,2019-08-30T23:48:05Z,77,73,4
25172,2620690401,"{'login': 'facebook-github-bot', 'id': 6422482, 'node_id': 'MDQ6VXNlcjY0MjI0ODI=', 'avatar_url': 'https://avatars3.githubusercontent.com/u/6422482?v=4', 'gravatar_id': '', 'url': 'https://api.github.com/users/facebook-github-bot', 'html_url': 'https://github.com/facebook-github-bot', 'followers_url': 'https://api.github.com/users/facebook-github-bot/followers', 'following_url': 'https://api.github.com/users/facebook-github-bot/following{/other_user}', 'gists_url': 'https://api.github.com/users/facebook-github-bot/gists{/gist_id}', 'starred_url': 'https://api.github.com/users/facebook-github-bot/starred{/owner}{/repo}', 'subscriptions_url': 'https://api.github.com/users/facebook-github-bot/subscriptions', 'organizations_url': 'https://api.github.com/users/facebook-github-bot/orgs', 'repos_url': 'https://api.github.com/users/facebook-github-bot/repos', 'events_url': 'https://api.github.com/users/facebook-github-bot/events{/privacy}', 'received_events_url': 'https://api.github.com/users/facebook-github-bot/received_events', 'type': 'User', 'site_admin': False}",closed,36bdde255e09c26ce5de417fd3a50c44a73e1815,https://api.github.com/repos/pytorch/pytorch/commits/36bdde255e09c26ce5de417fd3a50c44a73e1815,2019-09-10T02:23:53Z,11,8,3
25097,2587660582,"{'login': 'facebook-github-bot', 'id': 6422482, 'node_id': 'MDQ6VXNlcjY0MjI0ODI=', 'avatar_url': 'https://avatars3.githubusercontent.com/u/6422482?v=4', 'gravatar_id': '', 'url': 'https://api.github.com/users/facebook-github-bot', 'html_url': 'https://github.com/facebook-github-bot', 'followers_url': 'https://api.github.com/users/facebook-github-bot/followers', 'following_url': 'https://api.github.com/users/facebook-github-bot/following{/other_user}', 'gists_url': 'https://api.github.com/users/facebook-github-bot/gists{/gist_id}', 'starred_url': 'https://api.github.com/users/facebook-github-bot/starred{/owner}{/repo}', 'subscriptions_url': 'https://api.github.com/users/facebook-github-bot/subscriptions', 'organizations_url': 'https://api.github.com/users/facebook-github-bot/orgs', 'repos_url': 'https://api.github.com/users/facebook-github-bot/repos', 'events_url': 'https://api.github.com/users/facebook-github-bot/events{/privacy}', 'received_events_url': 'https://api.github.com/users/facebook-github-bot/received_events', 'type': 'User', 'site_admin': False}",referenced,44a7879b6efbea28e5a9d4ba841c5763cd4674cb,https://api.github.com/repos/pytorch/pytorch/commits/44a7879b6efbea28e5a9d4ba841c5763cd4674cb,2019-08-27T16:09:37Z,1,1,0
25086,2580738827,"{'login': 'facebook-github-bot', 'id': 6422482, 'node_id': 'MDQ6VXNlcjY0MjI0ODI=', 'avatar_url': 'https://avatars3.githubusercontent.com/u/6422482?v=4', 'gravatar_id': '', 'url': 'https://api.github.com/users/facebook-github-bot', 'html_url': 'https://github.com/facebook-github-bot', 'followers_url': 'https://api.github.com/users/facebook-github-bot/followers', 'following_url': 'https://api.github.com/users/facebook-github-bot/following{/other_user}', 'gists_url': 'https://api.github.com/users/facebook-github-bot/gists{/gist_id}', 'starred_url': 'https://api.github.com/users/facebook-github-bot/starred{/owner}{/repo}', 'subscriptions_url': 'https://api.github.com/users/facebook-github-bot/subscriptions', 'organizations_url': 'https://api.github.com/users/facebook-github-bot/orgs', 'repos_url': 'https://api.github.com/users/facebook-github-bot/repos', 'events_url': 'https://api.github.com/users/facebook-github-bot/events{/privacy}', 'received_events_url': 'https://api.github.com/users/facebook-github-bot/received_events', 'type': 'User', 'site_admin': False}",referenced,ab38059bc7174e08fd08a021a61a13dfa71ef5f4,https://api.github.com/repos/pytorch/pytorch/commits/ab38059bc7174e08fd08a021a61a13dfa71ef5f4,2019-08-23T20:14:50Z,9,7,2
25072,2591675624,"{'login': 'facebook-github-bot', 'id': 6422482, 'node_id': 'MDQ6VXNlcjY0MjI0ODI=', 'avatar_url': 'https://avatars3.githubusercontent.com/u/6422482?v=4', 'gravatar_id': '', 'url': 'https://api.github.com/users/facebook-github-bot', 'html_url': 'https://github.com/facebook-github-bot', 'followers_url': 'https://api.github.com/users/facebook-github-bot/followers', 'following_url': 'https://api.github.com/users/facebook-github-bot/following{/other_user}', 'gists_url': 'https://api.github.com/users/facebook-github-bot/gists{/gist_id}', 'starred_url': 'https://api.github.com/users/facebook-github-bot/starred{/owner}{/repo}', 'subscriptions_url': 'https://api.github.com/users/facebook-github-bot/subscriptions', 'organizations_url': 'https://api.github.com/users/facebook-github-bot/orgs', 'repos_url': 'https://api.github.com/users/facebook-github-bot/repos', 'events_url': 'https://api.github.com/users/facebook-github-bot/events{/privacy}', 'received_events_url': 'https://api.github.com/users/facebook-github-bot/received_events', 'type': 'User', 'site_admin': False}",closed,6100de9b1b911ca5ab4ef9628c588249c72fc758,https://api.github.com/repos/pytorch/pytorch/commits/6100de9b1b911ca5ab4ef9628c588249c72fc758,2019-08-28T19:25:39Z,24,15,9
25067,2592570202,"{'login': 'facebook-github-bot', 'id': 6422482, 'node_id': 'MDQ6VXNlcjY0MjI0ODI=', 'avatar_url': 'https://avatars3.githubusercontent.com/u/6422482?v=4', 'gravatar_id': '', 'url': 'https://api.github.com/users/facebook-github-bot', 'html_url': 'https://github.com/facebook-github-bot', 'followers_url': 'https://api.github.com/users/facebook-github-bot/followers', 'following_url': 'https://api.github.com/users/facebook-github-bot/following{/other_user}', 'gists_url': 'https://api.github.com/users/facebook-github-bot/gists{/gist_id}', 'starred_url': 'https://api.github.com/users/facebook-github-bot/starred{/owner}{/repo}', 'subscriptions_url': 'https://api.github.com/users/facebook-github-bot/subscriptions', 'organizations_url': 'https://api.github.com/users/facebook-github-bot/orgs', 'repos_url': 'https://api.github.com/users/facebook-github-bot/repos', 'events_url': 'https://api.github.com/users/facebook-github-bot/events{/privacy}', 'received_events_url': 'https://api.github.com/users/facebook-github-bot/received_events', 'type': 'User', 'site_admin': False}",closed,efe808b326b9d1c2a6979bc7831cf06a9c05ec20,https://api.github.com/repos/pytorch/pytorch/commits/efe808b326b9d1c2a6979bc7831cf06a9c05ec20,2019-08-29T03:50:36Z,25,13,12
25016,2679340913,"{'login': 'xuhdev', 'id': 325476, 'node_id': 'MDQ6VXNlcjMyNTQ3Ng==', 'avatar_url': 'https://avatars1.githubusercontent.com/u/325476?v=4', 'gravatar_id': '', 'url': 'https://api.github.com/users/xuhdev', 'html_url': 'https://github.com/xuhdev', 'followers_url': 'https://api.github.com/users/xuhdev/followers', 'following_url': 'https://api.github.com/users/xuhdev/following{/other_user}', 'gists_url': 'https://api.github.com/users/xuhdev/gists{/gist_id}', 'starred_url': 'https://api.github.com/users/xuhdev/starred{/owner}{/repo}', 'subscriptions_url': 'https://api.github.com/users/xuhdev/subscriptions', 'organizations_url': 'https://api.github.com/users/xuhdev/orgs', 'repos_url': 'https://api.github.com/users/xuhdev/repos', 'events_url': 'https://api.github.com/users/xuhdev/events{/privacy}', 'received_events_url': 'https://api.github.com/users/xuhdev/received_events', 'type': 'User', 'site_admin': False}",referenced,71f674d5c947f208f7adee6f6c8436ee41886874,https://api.github.com/repos/pytorch/pytorch/commits/71f674d5c947f208f7adee6f6c8436ee41886874,2019-10-02T05:24:42Z,1421,766,655
25016,2679341059,"{'login': 'xuhdev', 'id': 325476, 'node_id': 'MDQ6VXNlcjMyNTQ3Ng==', 'avatar_url': 'https://avatars1.githubusercontent.com/u/325476?v=4', 'gravatar_id': '', 'url': 'https://api.github.com/users/xuhdev', 'html_url': 'https://github.com/xuhdev', 'followers_url': 'https://api.github.com/users/xuhdev/followers', 'following_url': 'https://api.github.com/users/xuhdev/following{/other_user}', 'gists_url': 'https://api.github.com/users/xuhdev/gists{/gist_id}', 'starred_url': 'https://api.github.com/users/xuhdev/starred{/owner}{/repo}', 'subscriptions_url': 'https://api.github.com/users/xuhdev/subscriptions', 'organizations_url': 'https://api.github.com/users/xuhdev/orgs', 'repos_url': 'https://api.github.com/users/xuhdev/repos', 'events_url': 'https://api.github.com/users/xuhdev/events{/privacy}', 'received_events_url': 'https://api.github.com/users/xuhdev/received_events', 'type': 'User', 'site_admin': False}",referenced,2844683216a098b31f39192936dbb6f15390ed8d,https://api.github.com/repos/pytorch/pytorch/commits/2844683216a098b31f39192936dbb6f15390ed8d,2019-10-02T05:24:47Z,186,178,8
25016,2681863178,"{'login': 'xuhdev', 'id': 325476, 'node_id': 'MDQ6VXNlcjMyNTQ3Ng==', 'avatar_url': 'https://avatars1.githubusercontent.com/u/325476?v=4', 'gravatar_id': '', 'url': 'https://api.github.com/users/xuhdev', 'html_url': 'https://github.com/xuhdev', 'followers_url': 'https://api.github.com/users/xuhdev/followers', 'following_url': 'https://api.github.com/users/xuhdev/following{/other_user}', 'gists_url': 'https://api.github.com/users/xuhdev/gists{/gist_id}', 'starred_url': 'https://api.github.com/users/xuhdev/starred{/owner}{/repo}', 'subscriptions_url': 'https://api.github.com/users/xuhdev/subscriptions', 'organizations_url': 'https://api.github.com/users/xuhdev/orgs', 'repos_url': 'https://api.github.com/users/xuhdev/repos', 'events_url': 'https://api.github.com/users/xuhdev/events{/privacy}', 'received_events_url': 'https://api.github.com/users/xuhdev/received_events', 'type': 'User', 'site_admin': False}",referenced,3eb87883b0aba1ca5882c08284a97c9ad11bf79f,https://api.github.com/repos/pytorch/pytorch/commits/3eb87883b0aba1ca5882c08284a97c9ad11bf79f,2019-10-02T19:56:55Z,3657,2196,1461
25016,2681863316,"{'login': 'xuhdev', 'id': 325476, 'node_id': 'MDQ6VXNlcjMyNTQ3Ng==', 'avatar_url': 'https://avatars1.githubusercontent.com/u/325476?v=4', 'gravatar_id': '', 'url': 'https://api.github.com/users/xuhdev', 'html_url': 'https://github.com/xuhdev', 'followers_url': 'https://api.github.com/users/xuhdev/followers', 'following_url': 'https://api.github.com/users/xuhdev/following{/other_user}', 'gists_url': 'https://api.github.com/users/xuhdev/gists{/gist_id}', 'starred_url': 'https://api.github.com/users/xuhdev/starred{/owner}{/repo}', 'subscriptions_url': 'https://api.github.com/users/xuhdev/subscriptions', 'organizations_url': 'https://api.github.com/users/xuhdev/orgs', 'repos_url': 'https://api.github.com/users/xuhdev/repos', 'events_url': 'https://api.github.com/users/xuhdev/events{/privacy}', 'received_events_url': 'https://api.github.com/users/xuhdev/received_events', 'type': 'User', 'site_admin': False}",referenced,f7af52bbce307ca77adbe58633a0f45383234e55,https://api.github.com/repos/pytorch/pytorch/commits/f7af52bbce307ca77adbe58633a0f45383234e55,2019-10-02T19:56:58Z,188,180,8
25016,2685013070,"{'login': 'xuhdev', 'id': 325476, 'node_id': 'MDQ6VXNlcjMyNTQ3Ng==', 'avatar_url': 'https://avatars1.githubusercontent.com/u/325476?v=4', 'gravatar_id': '', 'url': 'https://api.github.com/users/xuhdev', 'html_url': 'https://github.com/xuhdev', 'followers_url': 'https://api.github.com/users/xuhdev/followers', 'following_url': 'https://api.github.com/users/xuhdev/following{/other_user}', 'gists_url': 'https://api.github.com/users/xuhdev/gists{/gist_id}', 'starred_url': 'https://api.github.com/users/xuhdev/starred{/owner}{/repo}', 'subscriptions_url': 'https://api.github.com/users/xuhdev/subscriptions', 'organizations_url': 'https://api.github.com/users/xuhdev/orgs', 'repos_url': 'https://api.github.com/users/xuhdev/repos', 'events_url': 'https://api.github.com/users/xuhdev/events{/privacy}', 'received_events_url': 'https://api.github.com/users/xuhdev/received_events', 'type': 'User', 'site_admin': False}",referenced,4765cb977ab978f6630836a17cccf289e827e426,https://api.github.com/repos/pytorch/pytorch/commits/4765cb977ab978f6630836a17cccf289e827e426,2019-10-03T18:20:58Z,5835,2248,3587
25016,2685013199,"{'login': 'xuhdev', 'id': 325476, 'node_id': 'MDQ6VXNlcjMyNTQ3Ng==', 'avatar_url': 'https://avatars1.githubusercontent.com/u/325476?v=4', 'gravatar_id': '', 'url': 'https://api.github.com/users/xuhdev', 'html_url': 'https://github.com/xuhdev', 'followers_url': 'https://api.github.com/users/xuhdev/followers', 'following_url': 'https://api.github.com/users/xuhdev/following{/other_user}', 'gists_url': 'https://api.github.com/users/xuhdev/gists{/gist_id}', 'starred_url': 'https://api.github.com/users/xuhdev/starred{/owner}{/repo}', 'subscriptions_url': 'https://api.github.com/users/xuhdev/subscriptions', 'organizations_url': 'https://api.github.com/users/xuhdev/orgs', 'repos_url': 'https://api.github.com/users/xuhdev/repos', 'events_url': 'https://api.github.com/users/xuhdev/events{/privacy}', 'received_events_url': 'https://api.github.com/users/xuhdev/received_events', 'type': 'User', 'site_admin': False}",referenced,2a523b18e1015838862751b9c2493b491d4eb5c8,https://api.github.com/repos/pytorch/pytorch/commits/2a523b18e1015838862751b9c2493b491d4eb5c8,2019-10-03T18:21:01Z,192,184,8
25016,2719285688,"{'login': 'xuhdev', 'id': 325476, 'node_id': 'MDQ6VXNlcjMyNTQ3Ng==', 'avatar_url': 'https://avatars1.githubusercontent.com/u/325476?v=4', 'gravatar_id': '', 'url': 'https://api.github.com/users/xuhdev', 'html_url': 'https://github.com/xuhdev', 'followers_url': 'https://api.github.com/users/xuhdev/followers', 'following_url': 'https://api.github.com/users/xuhdev/following{/other_user}', 'gists_url': 'https://api.github.com/users/xuhdev/gists{/gist_id}', 'starred_url': 'https://api.github.com/users/xuhdev/starred{/owner}{/repo}', 'subscriptions_url': 'https://api.github.com/users/xuhdev/subscriptions', 'organizations_url': 'https://api.github.com/users/xuhdev/orgs', 'repos_url': 'https://api.github.com/users/xuhdev/repos', 'events_url': 'https://api.github.com/users/xuhdev/events{/privacy}', 'received_events_url': 'https://api.github.com/users/xuhdev/received_events', 'type': 'User', 'site_admin': False}",referenced,a323130ea34d78a6d6615f2393c6b360e5842e64,https://api.github.com/repos/pytorch/pytorch/commits/a323130ea34d78a6d6615f2393c6b360e5842e64,2019-10-16T22:09:56Z,192,184,8
25016,2719285899,"{'login': 'xuhdev', 'id': 325476, 'node_id': 'MDQ6VXNlcjMyNTQ3Ng==', 'avatar_url': 'https://avatars1.githubusercontent.com/u/325476?v=4', 'gravatar_id': '', 'url': 'https://api.github.com/users/xuhdev', 'html_url': 'https://github.com/xuhdev', 'followers_url': 'https://api.github.com/users/xuhdev/followers', 'following_url': 'https://api.github.com/users/xuhdev/following{/other_user}', 'gists_url': 'https://api.github.com/users/xuhdev/gists{/gist_id}', 'starred_url': 'https://api.github.com/users/xuhdev/starred{/owner}{/repo}', 'subscriptions_url': 'https://api.github.com/users/xuhdev/subscriptions', 'organizations_url': 'https://api.github.com/users/xuhdev/orgs', 'repos_url': 'https://api.github.com/users/xuhdev/repos', 'events_url': 'https://api.github.com/users/xuhdev/events{/privacy}', 'received_events_url': 'https://api.github.com/users/xuhdev/received_events', 'type': 'User', 'site_admin': False}",referenced,8b7bd6eeafcb40b8d7bc5c147a917e81dcf26170,https://api.github.com/repos/pytorch/pytorch/commits/8b7bd6eeafcb40b8d7bc5c147a917e81dcf26170,2019-10-16T22:10:02Z,84491,49647,34844
25016,2722744096,"{'login': 'xuhdev', 'id': 325476, 'node_id': 'MDQ6VXNlcjMyNTQ3Ng==', 'avatar_url': 'https://avatars1.githubusercontent.com/u/325476?v=4', 'gravatar_id': '', 'url': 'https://api.github.com/users/xuhdev', 'html_url': 'https://github.com/xuhdev', 'followers_url': 'https://api.github.com/users/xuhdev/followers', 'following_url': 'https://api.github.com/users/xuhdev/following{/other_user}', 'gists_url': 'https://api.github.com/users/xuhdev/gists{/gist_id}', 'starred_url': 'https://api.github.com/users/xuhdev/starred{/owner}{/repo}', 'subscriptions_url': 'https://api.github.com/users/xuhdev/subscriptions', 'organizations_url': 'https://api.github.com/users/xuhdev/orgs', 'repos_url': 'https://api.github.com/users/xuhdev/repos', 'events_url': 'https://api.github.com/users/xuhdev/events{/privacy}', 'received_events_url': 'https://api.github.com/users/xuhdev/received_events', 'type': 'User', 'site_admin': False}",referenced,50f974b930ccc919cc5a297784f0190961620291,https://api.github.com/repos/pytorch/pytorch/commits/50f974b930ccc919cc5a297784f0190961620291,2019-10-17T20:58:48Z,3573,2274,1299
25016,2722744252,"{'login': 'xuhdev', 'id': 325476, 'node_id': 'MDQ6VXNlcjMyNTQ3Ng==', 'avatar_url': 'https://avatars1.githubusercontent.com/u/325476?v=4', 'gravatar_id': '', 'url': 'https://api.github.com/users/xuhdev', 'html_url': 'https://github.com/xuhdev', 'followers_url': 'https://api.github.com/users/xuhdev/followers', 'following_url': 'https://api.github.com/users/xuhdev/following{/other_user}', 'gists_url': 'https://api.github.com/users/xuhdev/gists{/gist_id}', 'starred_url': 'https://api.github.com/users/xuhdev/starred{/owner}{/repo}', 'subscriptions_url': 'https://api.github.com/users/xuhdev/subscriptions', 'organizations_url': 'https://api.github.com/users/xuhdev/orgs', 'repos_url': 'https://api.github.com/users/xuhdev/repos', 'events_url': 'https://api.github.com/users/xuhdev/events{/privacy}', 'received_events_url': 'https://api.github.com/users/xuhdev/received_events', 'type': 'User', 'site_admin': False}",referenced,ace9bd771d738d5dc17c7b728a4f36e0b58c8595,https://api.github.com/repos/pytorch/pytorch/commits/ace9bd771d738d5dc17c7b728a4f36e0b58c8595,2019-10-17T20:58:51Z,188,176,12
25016,2734215186,"{'login': 'xuhdev', 'id': 325476, 'node_id': 'MDQ6VXNlcjMyNTQ3Ng==', 'avatar_url': 'https://avatars1.githubusercontent.com/u/325476?v=4', 'gravatar_id': '', 'url': 'https://api.github.com/users/xuhdev', 'html_url': 'https://github.com/xuhdev', 'followers_url': 'https://api.github.com/users/xuhdev/followers', 'following_url': 'https://api.github.com/users/xuhdev/following{/other_user}', 'gists_url': 'https://api.github.com/users/xuhdev/gists{/gist_id}', 'starred_url': 'https://api.github.com/users/xuhdev/starred{/owner}{/repo}', 'subscriptions_url': 'https://api.github.com/users/xuhdev/subscriptions', 'organizations_url': 'https://api.github.com/users/xuhdev/orgs', 'repos_url': 'https://api.github.com/users/xuhdev/repos', 'events_url': 'https://api.github.com/users/xuhdev/events{/privacy}', 'received_events_url': 'https://api.github.com/users/xuhdev/received_events', 'type': 'User', 'site_admin': False}",referenced,7632f3504d8a9d59018954cdd8699186cd588772,https://api.github.com/repos/pytorch/pytorch/commits/7632f3504d8a9d59018954cdd8699186cd588772,2019-10-22T17:43:27Z,13540,9866,3674
25016,2734215324,"{'login': 'xuhdev', 'id': 325476, 'node_id': 'MDQ6VXNlcjMyNTQ3Ng==', 'avatar_url': 'https://avatars1.githubusercontent.com/u/325476?v=4', 'gravatar_id': '', 'url': 'https://api.github.com/users/xuhdev', 'html_url': 'https://github.com/xuhdev', 'followers_url': 'https://api.github.com/users/xuhdev/followers', 'following_url': 'https://api.github.com/users/xuhdev/following{/other_user}', 'gists_url': 'https://api.github.com/users/xuhdev/gists{/gist_id}', 'starred_url': 'https://api.github.com/users/xuhdev/starred{/owner}{/repo}', 'subscriptions_url': 'https://api.github.com/users/xuhdev/subscriptions', 'organizations_url': 'https://api.github.com/users/xuhdev/orgs', 'repos_url': 'https://api.github.com/users/xuhdev/repos', 'events_url': 'https://api.github.com/users/xuhdev/events{/privacy}', 'received_events_url': 'https://api.github.com/users/xuhdev/received_events', 'type': 'User', 'site_admin': False}",referenced,9cd72b6a765d85d13510f03179eba41847b69ed8,https://api.github.com/repos/pytorch/pytorch/commits/9cd72b6a765d85d13510f03179eba41847b69ed8,2019-10-22T17:43:30Z,188,176,12
25016,2741667795,"{'login': 'xuhdev', 'id': 325476, 'node_id': 'MDQ6VXNlcjMyNTQ3Ng==', 'avatar_url': 'https://avatars1.githubusercontent.com/u/325476?v=4', 'gravatar_id': '', 'url': 'https://api.github.com/users/xuhdev', 'html_url': 'https://github.com/xuhdev', 'followers_url': 'https://api.github.com/users/xuhdev/followers', 'following_url': 'https://api.github.com/users/xuhdev/following{/other_user}', 'gists_url': 'https://api.github.com/users/xuhdev/gists{/gist_id}', 'starred_url': 'https://api.github.com/users/xuhdev/starred{/owner}{/repo}', 'subscriptions_url': 'https://api.github.com/users/xuhdev/subscriptions', 'organizations_url': 'https://api.github.com/users/xuhdev/orgs', 'repos_url': 'https://api.github.com/users/xuhdev/repos', 'events_url': 'https://api.github.com/users/xuhdev/events{/privacy}', 'received_events_url': 'https://api.github.com/users/xuhdev/received_events', 'type': 'User', 'site_admin': False}",referenced,9a3c63550b55ca772c7e2f1a2160c0967a0a60a1,https://api.github.com/repos/pytorch/pytorch/commits/9a3c63550b55ca772c7e2f1a2160c0967a0a60a1,2019-10-24T17:50:13Z,5289,3355,1934
25016,2741667958,"{'login': 'xuhdev', 'id': 325476, 'node_id': 'MDQ6VXNlcjMyNTQ3Ng==', 'avatar_url': 'https://avatars1.githubusercontent.com/u/325476?v=4', 'gravatar_id': '', 'url': 'https://api.github.com/users/xuhdev', 'html_url': 'https://github.com/xuhdev', 'followers_url': 'https://api.github.com/users/xuhdev/followers', 'following_url': 'https://api.github.com/users/xuhdev/following{/other_user}', 'gists_url': 'https://api.github.com/users/xuhdev/gists{/gist_id}', 'starred_url': 'https://api.github.com/users/xuhdev/starred{/owner}{/repo}', 'subscriptions_url': 'https://api.github.com/users/xuhdev/subscriptions', 'organizations_url': 'https://api.github.com/users/xuhdev/orgs', 'repos_url': 'https://api.github.com/users/xuhdev/repos', 'events_url': 'https://api.github.com/users/xuhdev/events{/privacy}', 'received_events_url': 'https://api.github.com/users/xuhdev/received_events', 'type': 'User', 'site_admin': False}",referenced,253d95bebbb820d619122e36475561dbd2c3fb28,https://api.github.com/repos/pytorch/pytorch/commits/253d95bebbb820d619122e36475561dbd2c3fb28,2019-10-24T17:50:17Z,188,176,12
25016,2813523713,"{'login': 'xuhdev', 'id': 325476, 'node_id': 'MDQ6VXNlcjMyNTQ3Ng==', 'avatar_url': 'https://avatars1.githubusercontent.com/u/325476?v=4', 'gravatar_id': '', 'url': 'https://api.github.com/users/xuhdev', 'html_url': 'https://github.com/xuhdev', 'followers_url': 'https://api.github.com/users/xuhdev/followers', 'following_url': 'https://api.github.com/users/xuhdev/following{/other_user}', 'gists_url': 'https://api.github.com/users/xuhdev/gists{/gist_id}', 'starred_url': 'https://api.github.com/users/xuhdev/starred{/owner}{/repo}', 'subscriptions_url': 'https://api.github.com/users/xuhdev/subscriptions', 'organizations_url': 'https://api.github.com/users/xuhdev/orgs', 'repos_url': 'https://api.github.com/users/xuhdev/repos', 'events_url': 'https://api.github.com/users/xuhdev/events{/privacy}', 'received_events_url': 'https://api.github.com/users/xuhdev/received_events', 'type': 'User', 'site_admin': False}",referenced,409f9b5f500e9ed1dcda80991e26744ee2ba7422,https://api.github.com/repos/pytorch/pytorch/commits/409f9b5f500e9ed1dcda80991e26744ee2ba7422,2019-11-20T00:44:22Z,189,177,12
25016,2813524145,"{'login': 'xuhdev', 'id': 325476, 'node_id': 'MDQ6VXNlcjMyNTQ3Ng==', 'avatar_url': 'https://avatars1.githubusercontent.com/u/325476?v=4', 'gravatar_id': '', 'url': 'https://api.github.com/users/xuhdev', 'html_url': 'https://github.com/xuhdev', 'followers_url': 'https://api.github.com/users/xuhdev/followers', 'following_url': 'https://api.github.com/users/xuhdev/following{/other_user}', 'gists_url': 'https://api.github.com/users/xuhdev/gists{/gist_id}', 'starred_url': 'https://api.github.com/users/xuhdev/starred{/owner}{/repo}', 'subscriptions_url': 'https://api.github.com/users/xuhdev/subscriptions', 'organizations_url': 'https://api.github.com/users/xuhdev/orgs', 'repos_url': 'https://api.github.com/users/xuhdev/repos', 'events_url': 'https://api.github.com/users/xuhdev/events{/privacy}', 'received_events_url': 'https://api.github.com/users/xuhdev/received_events', 'type': 'User', 'site_admin': False}",referenced,c52122b5bd1a8bce84196bfb40dc7d6be16ed4c9,https://api.github.com/repos/pytorch/pytorch/commits/c52122b5bd1a8bce84196bfb40dc7d6be16ed4c9,2019-11-20T00:44:40Z,76873,52955,23918
25016,2816255557,"{'login': 'xuhdev', 'id': 325476, 'node_id': 'MDQ6VXNlcjMyNTQ3Ng==', 'avatar_url': 'https://avatars1.githubusercontent.com/u/325476?v=4', 'gravatar_id': '', 'url': 'https://api.github.com/users/xuhdev', 'html_url': 'https://github.com/xuhdev', 'followers_url': 'https://api.github.com/users/xuhdev/followers', 'following_url': 'https://api.github.com/users/xuhdev/following{/other_user}', 'gists_url': 'https://api.github.com/users/xuhdev/gists{/gist_id}', 'starred_url': 'https://api.github.com/users/xuhdev/starred{/owner}{/repo}', 'subscriptions_url': 'https://api.github.com/users/xuhdev/subscriptions', 'organizations_url': 'https://api.github.com/users/xuhdev/orgs', 'repos_url': 'https://api.github.com/users/xuhdev/repos', 'events_url': 'https://api.github.com/users/xuhdev/events{/privacy}', 'received_events_url': 'https://api.github.com/users/xuhdev/received_events', 'type': 'User', 'site_admin': False}",referenced,dd4d12e4827d289c687b2d0bb7fe7ad8ae96e311,https://api.github.com/repos/pytorch/pytorch/commits/dd4d12e4827d289c687b2d0bb7fe7ad8ae96e311,2019-11-20T18:01:48Z,4278,3294,984
25016,2816255694,"{'login': 'xuhdev', 'id': 325476, 'node_id': 'MDQ6VXNlcjMyNTQ3Ng==', 'avatar_url': 'https://avatars1.githubusercontent.com/u/325476?v=4', 'gravatar_id': '', 'url': 'https://api.github.com/users/xuhdev', 'html_url': 'https://github.com/xuhdev', 'followers_url': 'https://api.github.com/users/xuhdev/followers', 'following_url': 'https://api.github.com/users/xuhdev/following{/other_user}', 'gists_url': 'https://api.github.com/users/xuhdev/gists{/gist_id}', 'starred_url': 'https://api.github.com/users/xuhdev/starred{/owner}{/repo}', 'subscriptions_url': 'https://api.github.com/users/xuhdev/subscriptions', 'organizations_url': 'https://api.github.com/users/xuhdev/orgs', 'repos_url': 'https://api.github.com/users/xuhdev/repos', 'events_url': 'https://api.github.com/users/xuhdev/events{/privacy}', 'received_events_url': 'https://api.github.com/users/xuhdev/received_events', 'type': 'User', 'site_admin': False}",referenced,1ea277e5ac11e39bf7ae67df00d49cfcc5d95940,https://api.github.com/repos/pytorch/pytorch/commits/1ea277e5ac11e39bf7ae67df00d49cfcc5d95940,2019-11-20T18:01:51Z,189,177,12
25016,2816278680,"{'login': 'xuhdev', 'id': 325476, 'node_id': 'MDQ6VXNlcjMyNTQ3Ng==', 'avatar_url': 'https://avatars1.githubusercontent.com/u/325476?v=4', 'gravatar_id': '', 'url': 'https://api.github.com/users/xuhdev', 'html_url': 'https://github.com/xuhdev', 'followers_url': 'https://api.github.com/users/xuhdev/followers', 'following_url': 'https://api.github.com/users/xuhdev/following{/other_user}', 'gists_url': 'https://api.github.com/users/xuhdev/gists{/gist_id}', 'starred_url': 'https://api.github.com/users/xuhdev/starred{/owner}{/repo}', 'subscriptions_url': 'https://api.github.com/users/xuhdev/subscriptions', 'organizations_url': 'https://api.github.com/users/xuhdev/orgs', 'repos_url': 'https://api.github.com/users/xuhdev/repos', 'events_url': 'https://api.github.com/users/xuhdev/events{/privacy}', 'received_events_url': 'https://api.github.com/users/xuhdev/received_events', 'type': 'User', 'site_admin': False}",referenced,56dedec51b95735a07f8778905c654cc04087af1,https://api.github.com/repos/pytorch/pytorch/commits/56dedec51b95735a07f8778905c654cc04087af1,2019-11-20T18:09:40Z,8,4,4
25016,2816278883,"{'login': 'xuhdev', 'id': 325476, 'node_id': 'MDQ6VXNlcjMyNTQ3Ng==', 'avatar_url': 'https://avatars1.githubusercontent.com/u/325476?v=4', 'gravatar_id': '', 'url': 'https://api.github.com/users/xuhdev', 'html_url': 'https://github.com/xuhdev', 'followers_url': 'https://api.github.com/users/xuhdev/followers', 'following_url': 'https://api.github.com/users/xuhdev/following{/other_user}', 'gists_url': 'https://api.github.com/users/xuhdev/gists{/gist_id}', 'starred_url': 'https://api.github.com/users/xuhdev/starred{/owner}{/repo}', 'subscriptions_url': 'https://api.github.com/users/xuhdev/subscriptions', 'organizations_url': 'https://api.github.com/users/xuhdev/orgs', 'repos_url': 'https://api.github.com/users/xuhdev/repos', 'events_url': 'https://api.github.com/users/xuhdev/events{/privacy}', 'received_events_url': 'https://api.github.com/users/xuhdev/received_events', 'type': 'User', 'site_admin': False}",referenced,c1a71d75e8e589217ec80dc2deaa17a07bc7f55e,https://api.github.com/repos/pytorch/pytorch/commits/c1a71d75e8e589217ec80dc2deaa17a07bc7f55e,2019-11-20T18:09:44Z,189,177,12
25016,2817238214,"{'login': 'xuhdev', 'id': 325476, 'node_id': 'MDQ6VXNlcjMyNTQ3Ng==', 'avatar_url': 'https://avatars1.githubusercontent.com/u/325476?v=4', 'gravatar_id': '', 'url': 'https://api.github.com/users/xuhdev', 'html_url': 'https://github.com/xuhdev', 'followers_url': 'https://api.github.com/users/xuhdev/followers', 'following_url': 'https://api.github.com/users/xuhdev/following{/other_user}', 'gists_url': 'https://api.github.com/users/xuhdev/gists{/gist_id}', 'starred_url': 'https://api.github.com/users/xuhdev/starred{/owner}{/repo}', 'subscriptions_url': 'https://api.github.com/users/xuhdev/subscriptions', 'organizations_url': 'https://api.github.com/users/xuhdev/orgs', 'repos_url': 'https://api.github.com/users/xuhdev/repos', 'events_url': 'https://api.github.com/users/xuhdev/events{/privacy}', 'received_events_url': 'https://api.github.com/users/xuhdev/received_events', 'type': 'User', 'site_admin': False}",referenced,eea41b9017fcdc91c38b2587b7937d0cf6341a87,https://api.github.com/repos/pytorch/pytorch/commits/eea41b9017fcdc91c38b2587b7937d0cf6341a87,2019-11-20T23:46:15Z,2235,1428,807
25016,2817238411,"{'login': 'xuhdev', 'id': 325476, 'node_id': 'MDQ6VXNlcjMyNTQ3Ng==', 'avatar_url': 'https://avatars1.githubusercontent.com/u/325476?v=4', 'gravatar_id': '', 'url': 'https://api.github.com/users/xuhdev', 'html_url': 'https://github.com/xuhdev', 'followers_url': 'https://api.github.com/users/xuhdev/followers', 'following_url': 'https://api.github.com/users/xuhdev/following{/other_user}', 'gists_url': 'https://api.github.com/users/xuhdev/gists{/gist_id}', 'starred_url': 'https://api.github.com/users/xuhdev/starred{/owner}{/repo}', 'subscriptions_url': 'https://api.github.com/users/xuhdev/subscriptions', 'organizations_url': 'https://api.github.com/users/xuhdev/orgs', 'repos_url': 'https://api.github.com/users/xuhdev/repos', 'events_url': 'https://api.github.com/users/xuhdev/events{/privacy}', 'received_events_url': 'https://api.github.com/users/xuhdev/received_events', 'type': 'User', 'site_admin': False}",referenced,224bd4e4e162e9f60f58da1c7c19ec9b26f2b18f,https://api.github.com/repos/pytorch/pytorch/commits/224bd4e4e162e9f60f58da1c7c19ec9b26f2b18f,2019-11-20T23:46:18Z,189,177,12
25016,2820760874,"{'login': 'xuhdev', 'id': 325476, 'node_id': 'MDQ6VXNlcjMyNTQ3Ng==', 'avatar_url': 'https://avatars1.githubusercontent.com/u/325476?v=4', 'gravatar_id': '', 'url': 'https://api.github.com/users/xuhdev', 'html_url': 'https://github.com/xuhdev', 'followers_url': 'https://api.github.com/users/xuhdev/followers', 'following_url': 'https://api.github.com/users/xuhdev/following{/other_user}', 'gists_url': 'https://api.github.com/users/xuhdev/gists{/gist_id}', 'starred_url': 'https://api.github.com/users/xuhdev/starred{/owner}{/repo}', 'subscriptions_url': 'https://api.github.com/users/xuhdev/subscriptions', 'organizations_url': 'https://api.github.com/users/xuhdev/orgs', 'repos_url': 'https://api.github.com/users/xuhdev/repos', 'events_url': 'https://api.github.com/users/xuhdev/events{/privacy}', 'received_events_url': 'https://api.github.com/users/xuhdev/received_events', 'type': 'User', 'site_admin': False}",referenced,b07b1d837c98b873208020bacf6a05381dbf1cc5,https://api.github.com/repos/pytorch/pytorch/commits/b07b1d837c98b873208020bacf6a05381dbf1cc5,2019-11-21T18:46:49Z,1940,1477,463
25016,2820761074,"{'login': 'xuhdev', 'id': 325476, 'node_id': 'MDQ6VXNlcjMyNTQ3Ng==', 'avatar_url': 'https://avatars1.githubusercontent.com/u/325476?v=4', 'gravatar_id': '', 'url': 'https://api.github.com/users/xuhdev', 'html_url': 'https://github.com/xuhdev', 'followers_url': 'https://api.github.com/users/xuhdev/followers', 'following_url': 'https://api.github.com/users/xuhdev/following{/other_user}', 'gists_url': 'https://api.github.com/users/xuhdev/gists{/gist_id}', 'starred_url': 'https://api.github.com/users/xuhdev/starred{/owner}{/repo}', 'subscriptions_url': 'https://api.github.com/users/xuhdev/subscriptions', 'organizations_url': 'https://api.github.com/users/xuhdev/orgs', 'repos_url': 'https://api.github.com/users/xuhdev/repos', 'events_url': 'https://api.github.com/users/xuhdev/events{/privacy}', 'received_events_url': 'https://api.github.com/users/xuhdev/received_events', 'type': 'User', 'site_admin': False}",referenced,28eb34b6c67f6b4ac54e2dbcfb4132871ae2ccba,https://api.github.com/repos/pytorch/pytorch/commits/28eb34b6c67f6b4ac54e2dbcfb4132871ae2ccba,2019-11-21T18:46:52Z,191,178,13
25016,2820762731,"{'login': 'xuhdev', 'id': 325476, 'node_id': 'MDQ6VXNlcjMyNTQ3Ng==', 'avatar_url': 'https://avatars1.githubusercontent.com/u/325476?v=4', 'gravatar_id': '', 'url': 'https://api.github.com/users/xuhdev', 'html_url': 'https://github.com/xuhdev', 'followers_url': 'https://api.github.com/users/xuhdev/followers', 'following_url': 'https://api.github.com/users/xuhdev/following{/other_user}', 'gists_url': 'https://api.github.com/users/xuhdev/gists{/gist_id}', 'starred_url': 'https://api.github.com/users/xuhdev/starred{/owner}{/repo}', 'subscriptions_url': 'https://api.github.com/users/xuhdev/subscriptions', 'organizations_url': 'https://api.github.com/users/xuhdev/orgs', 'repos_url': 'https://api.github.com/users/xuhdev/repos', 'events_url': 'https://api.github.com/users/xuhdev/events{/privacy}', 'received_events_url': 'https://api.github.com/users/xuhdev/received_events', 'type': 'User', 'site_admin': False}",referenced,f15bb39906e0bf5897c2131bc7d92e91f5fd97ed,https://api.github.com/repos/pytorch/pytorch/commits/f15bb39906e0bf5897c2131bc7d92e91f5fd97ed,2019-11-21T18:47:28Z,2,1,1
25016,2820762987,"{'login': 'xuhdev', 'id': 325476, 'node_id': 'MDQ6VXNlcjMyNTQ3Ng==', 'avatar_url': 'https://avatars1.githubusercontent.com/u/325476?v=4', 'gravatar_id': '', 'url': 'https://api.github.com/users/xuhdev', 'html_url': 'https://github.com/xuhdev', 'followers_url': 'https://api.github.com/users/xuhdev/followers', 'following_url': 'https://api.github.com/users/xuhdev/following{/other_user}', 'gists_url': 'https://api.github.com/users/xuhdev/gists{/gist_id}', 'starred_url': 'https://api.github.com/users/xuhdev/starred{/owner}{/repo}', 'subscriptions_url': 'https://api.github.com/users/xuhdev/subscriptions', 'organizations_url': 'https://api.github.com/users/xuhdev/orgs', 'repos_url': 'https://api.github.com/users/xuhdev/repos', 'events_url': 'https://api.github.com/users/xuhdev/events{/privacy}', 'received_events_url': 'https://api.github.com/users/xuhdev/received_events', 'type': 'User', 'site_admin': False}",referenced,45cfaa2ce01511d1a6c8ee3290809ab38f455c90,https://api.github.com/repos/pytorch/pytorch/commits/45cfaa2ce01511d1a6c8ee3290809ab38f455c90,2019-11-21T18:47:32Z,191,178,13
25010,2580668938,"{'login': 'facebook-github-bot', 'id': 6422482, 'node_id': 'MDQ6VXNlcjY0MjI0ODI=', 'avatar_url': 'https://avatars3.githubusercontent.com/u/6422482?v=4', 'gravatar_id': '', 'url': 'https://api.github.com/users/facebook-github-bot', 'html_url': 'https://github.com/facebook-github-bot', 'followers_url': 'https://api.github.com/users/facebook-github-bot/followers', 'following_url': 'https://api.github.com/users/facebook-github-bot/following{/other_user}', 'gists_url': 'https://api.github.com/users/facebook-github-bot/gists{/gist_id}', 'starred_url': 'https://api.github.com/users/facebook-github-bot/starred{/owner}{/repo}', 'subscriptions_url': 'https://api.github.com/users/facebook-github-bot/subscriptions', 'organizations_url': 'https://api.github.com/users/facebook-github-bot/orgs', 'repos_url': 'https://api.github.com/users/facebook-github-bot/repos', 'events_url': 'https://api.github.com/users/facebook-github-bot/events{/privacy}', 'received_events_url': 'https://api.github.com/users/facebook-github-bot/received_events', 'type': 'User', 'site_admin': False}",closed,e42b238f7ffca8751e4f1aa1ffca78ccd7f3fc68,https://api.github.com/repos/pytorch/pytorch/commits/e42b238f7ffca8751e4f1aa1ffca78ccd7f3fc68,2019-08-23T19:42:22Z,4,4,0
24987,2574687961,"{'login': 'driazati', 'id': 9407960, 'node_id': 'MDQ6VXNlcjk0MDc5NjA=', 'avatar_url': 'https://avatars3.githubusercontent.com/u/9407960?v=4', 'gravatar_id': '', 'url': 'https://api.github.com/users/driazati', 'html_url': 'https://github.com/driazati', 'followers_url': 'https://api.github.com/users/driazati/followers', 'following_url': 'https://api.github.com/users/driazati/following{/other_user}', 'gists_url': 'https://api.github.com/users/driazati/gists{/gist_id}', 'starred_url': 'https://api.github.com/users/driazati/starred{/owner}{/repo}', 'subscriptions_url': 'https://api.github.com/users/driazati/subscriptions', 'organizations_url': 'https://api.github.com/users/driazati/orgs', 'repos_url': 'https://api.github.com/users/driazati/repos', 'events_url': 'https://api.github.com/users/driazati/events{/privacy}', 'received_events_url': 'https://api.github.com/users/driazati/received_events', 'type': 'User', 'site_admin': False}",referenced,c840d01e946656dcba3bbe5413851819b49e4d8c,https://api.github.com/repos/pytorch/pytorch/commits/c840d01e946656dcba3bbe5413851819b49e4d8c,2019-08-21T22:30:56Z,46,38,8
24987,2592288175,"{'login': 'facebook-github-bot', 'id': 6422482, 'node_id': 'MDQ6VXNlcjY0MjI0ODI=', 'avatar_url': 'https://avatars3.githubusercontent.com/u/6422482?v=4', 'gravatar_id': '', 'url': 'https://api.github.com/users/facebook-github-bot', 'html_url': 'https://github.com/facebook-github-bot', 'followers_url': 'https://api.github.com/users/facebook-github-bot/followers', 'following_url': 'https://api.github.com/users/facebook-github-bot/following{/other_user}', 'gists_url': 'https://api.github.com/users/facebook-github-bot/gists{/gist_id}', 'starred_url': 'https://api.github.com/users/facebook-github-bot/starred{/owner}{/repo}', 'subscriptions_url': 'https://api.github.com/users/facebook-github-bot/subscriptions', 'organizations_url': 'https://api.github.com/users/facebook-github-bot/orgs', 'repos_url': 'https://api.github.com/users/facebook-github-bot/repos', 'events_url': 'https://api.github.com/users/facebook-github-bot/events{/privacy}', 'received_events_url': 'https://api.github.com/users/facebook-github-bot/received_events', 'type': 'User', 'site_admin': False}",closed,43c4b9f2a59e3ab4478508e8f12db9609f35c3b5,https://api.github.com/repos/pytorch/pytorch/commits/43c4b9f2a59e3ab4478508e8f12db9609f35c3b5,2019-08-29T00:14:12Z,74,54,20
24968,2580149315,"{'login': 'facebook-github-bot', 'id': 6422482, 'node_id': 'MDQ6VXNlcjY0MjI0ODI=', 'avatar_url': 'https://avatars3.githubusercontent.com/u/6422482?v=4', 'gravatar_id': '', 'url': 'https://api.github.com/users/facebook-github-bot', 'html_url': 'https://github.com/facebook-github-bot', 'followers_url': 'https://api.github.com/users/facebook-github-bot/followers', 'following_url': 'https://api.github.com/users/facebook-github-bot/following{/other_user}', 'gists_url': 'https://api.github.com/users/facebook-github-bot/gists{/gist_id}', 'starred_url': 'https://api.github.com/users/facebook-github-bot/starred{/owner}{/repo}', 'subscriptions_url': 'https://api.github.com/users/facebook-github-bot/subscriptions', 'organizations_url': 'https://api.github.com/users/facebook-github-bot/orgs', 'repos_url': 'https://api.github.com/users/facebook-github-bot/repos', 'events_url': 'https://api.github.com/users/facebook-github-bot/events{/privacy}', 'received_events_url': 'https://api.github.com/users/facebook-github-bot/received_events', 'type': 'User', 'site_admin': False}",referenced,f583f2e657f3edea03009df3742d69fb14894925,https://api.github.com/repos/pytorch/pytorch/commits/f583f2e657f3edea03009df3742d69fb14894925,2019-08-23T15:58:19Z,21,14,7
24962,2594381188,"{'login': 'facebook-github-bot', 'id': 6422482, 'node_id': 'MDQ6VXNlcjY0MjI0ODI=', 'avatar_url': 'https://avatars3.githubusercontent.com/u/6422482?v=4', 'gravatar_id': '', 'url': 'https://api.github.com/users/facebook-github-bot', 'html_url': 'https://github.com/facebook-github-bot', 'followers_url': 'https://api.github.com/users/facebook-github-bot/followers', 'following_url': 'https://api.github.com/users/facebook-github-bot/following{/other_user}', 'gists_url': 'https://api.github.com/users/facebook-github-bot/gists{/gist_id}', 'starred_url': 'https://api.github.com/users/facebook-github-bot/starred{/owner}{/repo}', 'subscriptions_url': 'https://api.github.com/users/facebook-github-bot/subscriptions', 'organizations_url': 'https://api.github.com/users/facebook-github-bot/orgs', 'repos_url': 'https://api.github.com/users/facebook-github-bot/repos', 'events_url': 'https://api.github.com/users/facebook-github-bot/events{/privacy}', 'received_events_url': 'https://api.github.com/users/facebook-github-bot/received_events', 'type': 'User', 'site_admin': False}",referenced,c84dfa8fa347824ec16e4e0acc9c9f8da92c418d,https://api.github.com/repos/pytorch/pytorch/commits/c84dfa8fa347824ec16e4e0acc9c9f8da92c418d,2019-08-29T15:17:08Z,2,1,1
24927,2591858511,"{'login': 'facebook-github-bot', 'id': 6422482, 'node_id': 'MDQ6VXNlcjY0MjI0ODI=', 'avatar_url': 'https://avatars3.githubusercontent.com/u/6422482?v=4', 'gravatar_id': '', 'url': 'https://api.github.com/users/facebook-github-bot', 'html_url': 'https://github.com/facebook-github-bot', 'followers_url': 'https://api.github.com/users/facebook-github-bot/followers', 'following_url': 'https://api.github.com/users/facebook-github-bot/following{/other_user}', 'gists_url': 'https://api.github.com/users/facebook-github-bot/gists{/gist_id}', 'starred_url': 'https://api.github.com/users/facebook-github-bot/starred{/owner}{/repo}', 'subscriptions_url': 'https://api.github.com/users/facebook-github-bot/subscriptions', 'organizations_url': 'https://api.github.com/users/facebook-github-bot/orgs', 'repos_url': 'https://api.github.com/users/facebook-github-bot/repos', 'events_url': 'https://api.github.com/users/facebook-github-bot/events{/privacy}', 'received_events_url': 'https://api.github.com/users/facebook-github-bot/received_events', 'type': 'User', 'site_admin': False}",referenced,eb756746ab0172b7f1a35a4a34b520700da93db6,https://api.github.com/repos/pytorch/pytorch/commits/eb756746ab0172b7f1a35a4a34b520700da93db6,2019-08-28T20:34:13Z,8,8,0
24881,2570303585,"{'login': 'facebook-github-bot', 'id': 6422482, 'node_id': 'MDQ6VXNlcjY0MjI0ODI=', 'avatar_url': 'https://avatars3.githubusercontent.com/u/6422482?v=4', 'gravatar_id': '', 'url': 'https://api.github.com/users/facebook-github-bot', 'html_url': 'https://github.com/facebook-github-bot', 'followers_url': 'https://api.github.com/users/facebook-github-bot/followers', 'following_url': 'https://api.github.com/users/facebook-github-bot/following{/other_user}', 'gists_url': 'https://api.github.com/users/facebook-github-bot/gists{/gist_id}', 'starred_url': 'https://api.github.com/users/facebook-github-bot/starred{/owner}{/repo}', 'subscriptions_url': 'https://api.github.com/users/facebook-github-bot/subscriptions', 'organizations_url': 'https://api.github.com/users/facebook-github-bot/orgs', 'repos_url': 'https://api.github.com/users/facebook-github-bot/repos', 'events_url': 'https://api.github.com/users/facebook-github-bot/events{/privacy}', 'received_events_url': 'https://api.github.com/users/facebook-github-bot/received_events', 'type': 'User', 'site_admin': False}",referenced,d33623f7c12b16fd49f74594e0e89ceecb817be9,https://api.github.com/repos/pytorch/pytorch/commits/d33623f7c12b16fd49f74594e0e89ceecb817be9,2019-08-20T16:22:52Z,9,8,1
24856,2581140023,"{'login': 'bhosmer', 'id': 355313, 'node_id': 'MDQ6VXNlcjM1NTMxMw==', 'avatar_url': 'https://avatars3.githubusercontent.com/u/355313?v=4', 'gravatar_id': '', 'url': 'https://api.github.com/users/bhosmer', 'html_url': 'https://github.com/bhosmer', 'followers_url': 'https://api.github.com/users/bhosmer/followers', 'following_url': 'https://api.github.com/users/bhosmer/following{/other_user}', 'gists_url': 'https://api.github.com/users/bhosmer/gists{/gist_id}', 'starred_url': 'https://api.github.com/users/bhosmer/starred{/owner}{/repo}', 'subscriptions_url': 'https://api.github.com/users/bhosmer/subscriptions', 'organizations_url': 'https://api.github.com/users/bhosmer/orgs', 'repos_url': 'https://api.github.com/users/bhosmer/repos', 'events_url': 'https://api.github.com/users/bhosmer/events{/privacy}', 'received_events_url': 'https://api.github.com/users/bhosmer/received_events', 'type': 'User', 'site_admin': False}",referenced,a95c524edfd71c16d0c764c14678d1631829498e,https://api.github.com/repos/pytorch/pytorch/commits/a95c524edfd71c16d0c764c14678d1631829498e,2019-08-24T01:04:51Z,10,7,3
24856,2581140083,"{'login': 'bhosmer', 'id': 355313, 'node_id': 'MDQ6VXNlcjM1NTMxMw==', 'avatar_url': 'https://avatars3.githubusercontent.com/u/355313?v=4', 'gravatar_id': '', 'url': 'https://api.github.com/users/bhosmer', 'html_url': 'https://github.com/bhosmer', 'followers_url': 'https://api.github.com/users/bhosmer/followers', 'following_url': 'https://api.github.com/users/bhosmer/following{/other_user}', 'gists_url': 'https://api.github.com/users/bhosmer/gists{/gist_id}', 'starred_url': 'https://api.github.com/users/bhosmer/starred{/owner}{/repo}', 'subscriptions_url': 'https://api.github.com/users/bhosmer/subscriptions', 'organizations_url': 'https://api.github.com/users/bhosmer/orgs', 'repos_url': 'https://api.github.com/users/bhosmer/repos', 'events_url': 'https://api.github.com/users/bhosmer/events{/privacy}', 'received_events_url': 'https://api.github.com/users/bhosmer/received_events', 'type': 'User', 'site_admin': False}",referenced,3fc81519727f01bcd05522155ddd29fdbb5d4307,https://api.github.com/repos/pytorch/pytorch/commits/3fc81519727f01bcd05522155ddd29fdbb5d4307,2019-08-24T01:04:59Z,10,7,3
24856,2588086690,"{'login': 'bhosmer', 'id': 355313, 'node_id': 'MDQ6VXNlcjM1NTMxMw==', 'avatar_url': 'https://avatars3.githubusercontent.com/u/355313?v=4', 'gravatar_id': '', 'url': 'https://api.github.com/users/bhosmer', 'html_url': 'https://github.com/bhosmer', 'followers_url': 'https://api.github.com/users/bhosmer/followers', 'following_url': 'https://api.github.com/users/bhosmer/following{/other_user}', 'gists_url': 'https://api.github.com/users/bhosmer/gists{/gist_id}', 'starred_url': 'https://api.github.com/users/bhosmer/starred{/owner}{/repo}', 'subscriptions_url': 'https://api.github.com/users/bhosmer/subscriptions', 'organizations_url': 'https://api.github.com/users/bhosmer/orgs', 'repos_url': 'https://api.github.com/users/bhosmer/repos', 'events_url': 'https://api.github.com/users/bhosmer/events{/privacy}', 'received_events_url': 'https://api.github.com/users/bhosmer/received_events', 'type': 'User', 'site_admin': False}",referenced,f5483692bbdbf040f565a77229247fc2f7d2220a,https://api.github.com/repos/pytorch/pytorch/commits/f5483692bbdbf040f565a77229247fc2f7d2220a,2019-08-27T18:37:23Z,10,7,3
24856,2588086824,"{'login': 'bhosmer', 'id': 355313, 'node_id': 'MDQ6VXNlcjM1NTMxMw==', 'avatar_url': 'https://avatars3.githubusercontent.com/u/355313?v=4', 'gravatar_id': '', 'url': 'https://api.github.com/users/bhosmer', 'html_url': 'https://github.com/bhosmer', 'followers_url': 'https://api.github.com/users/bhosmer/followers', 'following_url': 'https://api.github.com/users/bhosmer/following{/other_user}', 'gists_url': 'https://api.github.com/users/bhosmer/gists{/gist_id}', 'starred_url': 'https://api.github.com/users/bhosmer/starred{/owner}{/repo}', 'subscriptions_url': 'https://api.github.com/users/bhosmer/subscriptions', 'organizations_url': 'https://api.github.com/users/bhosmer/orgs', 'repos_url': 'https://api.github.com/users/bhosmer/repos', 'events_url': 'https://api.github.com/users/bhosmer/events{/privacy}', 'received_events_url': 'https://api.github.com/users/bhosmer/received_events', 'type': 'User', 'site_admin': False}",referenced,5fa5343ab55557c7798afad6ec18e8f4369b1c7c,https://api.github.com/repos/pytorch/pytorch/commits/5fa5343ab55557c7798afad6ec18e8f4369b1c7c,2019-08-27T18:37:25Z,11224,9591,1633
24856,2588091997,"{'login': 'bhosmer', 'id': 355313, 'node_id': 'MDQ6VXNlcjM1NTMxMw==', 'avatar_url': 'https://avatars3.githubusercontent.com/u/355313?v=4', 'gravatar_id': '', 'url': 'https://api.github.com/users/bhosmer', 'html_url': 'https://github.com/bhosmer', 'followers_url': 'https://api.github.com/users/bhosmer/followers', 'following_url': 'https://api.github.com/users/bhosmer/following{/other_user}', 'gists_url': 'https://api.github.com/users/bhosmer/gists{/gist_id}', 'starred_url': 'https://api.github.com/users/bhosmer/starred{/owner}{/repo}', 'subscriptions_url': 'https://api.github.com/users/bhosmer/subscriptions', 'organizations_url': 'https://api.github.com/users/bhosmer/orgs', 'repos_url': 'https://api.github.com/users/bhosmer/repos', 'events_url': 'https://api.github.com/users/bhosmer/events{/privacy}', 'received_events_url': 'https://api.github.com/users/bhosmer/received_events', 'type': 'User', 'site_admin': False}",referenced,efbf6bad1b322897dc97a611ece0e7254902b790,https://api.github.com/repos/pytorch/pytorch/commits/efbf6bad1b322897dc97a611ece0e7254902b790,2019-08-27T18:39:14Z,3,1,2
24856,2588092152,"{'login': 'bhosmer', 'id': 355313, 'node_id': 'MDQ6VXNlcjM1NTMxMw==', 'avatar_url': 'https://avatars3.githubusercontent.com/u/355313?v=4', 'gravatar_id': '', 'url': 'https://api.github.com/users/bhosmer', 'html_url': 'https://github.com/bhosmer', 'followers_url': 'https://api.github.com/users/bhosmer/followers', 'following_url': 'https://api.github.com/users/bhosmer/following{/other_user}', 'gists_url': 'https://api.github.com/users/bhosmer/gists{/gist_id}', 'starred_url': 'https://api.github.com/users/bhosmer/starred{/owner}{/repo}', 'subscriptions_url': 'https://api.github.com/users/bhosmer/subscriptions', 'organizations_url': 'https://api.github.com/users/bhosmer/orgs', 'repos_url': 'https://api.github.com/users/bhosmer/repos', 'events_url': 'https://api.github.com/users/bhosmer/events{/privacy}', 'received_events_url': 'https://api.github.com/users/bhosmer/received_events', 'type': 'User', 'site_admin': False}",referenced,2c823fe082c7541dfb06e0d809d90cccfd073b52,https://api.github.com/repos/pytorch/pytorch/commits/2c823fe082c7541dfb06e0d809d90cccfd073b52,2019-08-27T18:39:18Z,9,6,3
24856,2592318950,"{'login': 'facebook-github-bot', 'id': 6422482, 'node_id': 'MDQ6VXNlcjY0MjI0ODI=', 'avatar_url': 'https://avatars3.githubusercontent.com/u/6422482?v=4', 'gravatar_id': '', 'url': 'https://api.github.com/users/facebook-github-bot', 'html_url': 'https://github.com/facebook-github-bot', 'followers_url': 'https://api.github.com/users/facebook-github-bot/followers', 'following_url': 'https://api.github.com/users/facebook-github-bot/following{/other_user}', 'gists_url': 'https://api.github.com/users/facebook-github-bot/gists{/gist_id}', 'starred_url': 'https://api.github.com/users/facebook-github-bot/starred{/owner}{/repo}', 'subscriptions_url': 'https://api.github.com/users/facebook-github-bot/subscriptions', 'organizations_url': 'https://api.github.com/users/facebook-github-bot/orgs', 'repos_url': 'https://api.github.com/users/facebook-github-bot/repos', 'events_url': 'https://api.github.com/users/facebook-github-bot/events{/privacy}', 'received_events_url': 'https://api.github.com/users/facebook-github-bot/received_events', 'type': 'User', 'site_admin': False}",referenced,91db62a8bb80675df7c652096d5050cae0e27a3e,https://api.github.com/repos/pytorch/pytorch/commits/91db62a8bb80675df7c652096d5050cae0e27a3e,2019-08-29T00:37:20Z,9,6,3
24856,2645544193,"{'login': 'bhosmer', 'id': 355313, 'node_id': 'MDQ6VXNlcjM1NTMxMw==', 'avatar_url': 'https://avatars3.githubusercontent.com/u/355313?v=4', 'gravatar_id': '', 'url': 'https://api.github.com/users/bhosmer', 'html_url': 'https://github.com/bhosmer', 'followers_url': 'https://api.github.com/users/bhosmer/followers', 'following_url': 'https://api.github.com/users/bhosmer/following{/other_user}', 'gists_url': 'https://api.github.com/users/bhosmer/gists{/gist_id}', 'starred_url': 'https://api.github.com/users/bhosmer/starred{/owner}{/repo}', 'subscriptions_url': 'https://api.github.com/users/bhosmer/subscriptions', 'organizations_url': 'https://api.github.com/users/bhosmer/orgs', 'repos_url': 'https://api.github.com/users/bhosmer/repos', 'events_url': 'https://api.github.com/users/bhosmer/events{/privacy}', 'received_events_url': 'https://api.github.com/users/bhosmer/received_events', 'type': 'User', 'site_admin': False}",referenced,4ab4557d39db865b74a9ee3a3e80f507ad4b9338,https://api.github.com/repos/pytorch/pytorch/commits/4ab4557d39db865b74a9ee3a3e80f507ad4b9338,2019-09-19T03:43:10Z,32,15,17
24856,2645544335,"{'login': 'bhosmer', 'id': 355313, 'node_id': 'MDQ6VXNlcjM1NTMxMw==', 'avatar_url': 'https://avatars3.githubusercontent.com/u/355313?v=4', 'gravatar_id': '', 'url': 'https://api.github.com/users/bhosmer', 'html_url': 'https://github.com/bhosmer', 'followers_url': 'https://api.github.com/users/bhosmer/followers', 'following_url': 'https://api.github.com/users/bhosmer/following{/other_user}', 'gists_url': 'https://api.github.com/users/bhosmer/gists{/gist_id}', 'starred_url': 'https://api.github.com/users/bhosmer/starred{/owner}{/repo}', 'subscriptions_url': 'https://api.github.com/users/bhosmer/subscriptions', 'organizations_url': 'https://api.github.com/users/bhosmer/orgs', 'repos_url': 'https://api.github.com/users/bhosmer/repos', 'events_url': 'https://api.github.com/users/bhosmer/events{/privacy}', 'received_events_url': 'https://api.github.com/users/bhosmer/received_events', 'type': 'User', 'site_admin': False}",referenced,1a627203aa03a754ae62099035ca73130eef39c3,https://api.github.com/repos/pytorch/pytorch/commits/1a627203aa03a754ae62099035ca73130eef39c3,2019-09-19T03:43:18Z,32,15,17
24856,2647586477,"{'login': 'bhosmer', 'id': 355313, 'node_id': 'MDQ6VXNlcjM1NTMxMw==', 'avatar_url': 'https://avatars3.githubusercontent.com/u/355313?v=4', 'gravatar_id': '', 'url': 'https://api.github.com/users/bhosmer', 'html_url': 'https://github.com/bhosmer', 'followers_url': 'https://api.github.com/users/bhosmer/followers', 'following_url': 'https://api.github.com/users/bhosmer/following{/other_user}', 'gists_url': 'https://api.github.com/users/bhosmer/gists{/gist_id}', 'starred_url': 'https://api.github.com/users/bhosmer/starred{/owner}{/repo}', 'subscriptions_url': 'https://api.github.com/users/bhosmer/subscriptions', 'organizations_url': 'https://api.github.com/users/bhosmer/orgs', 'repos_url': 'https://api.github.com/users/bhosmer/repos', 'events_url': 'https://api.github.com/users/bhosmer/events{/privacy}', 'received_events_url': 'https://api.github.com/users/bhosmer/received_events', 'type': 'User', 'site_admin': False}",referenced,485d0ce6f8faeed2348530936d337c49ba1abf25,https://api.github.com/repos/pytorch/pytorch/commits/485d0ce6f8faeed2348530936d337c49ba1abf25,2019-09-19T16:10:48Z,5916,4234,1682
24856,2647586833,"{'login': 'bhosmer', 'id': 355313, 'node_id': 'MDQ6VXNlcjM1NTMxMw==', 'avatar_url': 'https://avatars3.githubusercontent.com/u/355313?v=4', 'gravatar_id': '', 'url': 'https://api.github.com/users/bhosmer', 'html_url': 'https://github.com/bhosmer', 'followers_url': 'https://api.github.com/users/bhosmer/followers', 'following_url': 'https://api.github.com/users/bhosmer/following{/other_user}', 'gists_url': 'https://api.github.com/users/bhosmer/gists{/gist_id}', 'starred_url': 'https://api.github.com/users/bhosmer/starred{/owner}{/repo}', 'subscriptions_url': 'https://api.github.com/users/bhosmer/subscriptions', 'organizations_url': 'https://api.github.com/users/bhosmer/orgs', 'repos_url': 'https://api.github.com/users/bhosmer/repos', 'events_url': 'https://api.github.com/users/bhosmer/events{/privacy}', 'received_events_url': 'https://api.github.com/users/bhosmer/received_events', 'type': 'User', 'site_admin': False}",referenced,bb432f4f62a1ed9941b298925cd94a93955112d8,https://api.github.com/repos/pytorch/pytorch/commits/bb432f4f62a1ed9941b298925cd94a93955112d8,2019-09-19T16:10:55Z,31,14,17
24856,2648829196,"{'login': 'bhosmer', 'id': 355313, 'node_id': 'MDQ6VXNlcjM1NTMxMw==', 'avatar_url': 'https://avatars3.githubusercontent.com/u/355313?v=4', 'gravatar_id': '', 'url': 'https://api.github.com/users/bhosmer', 'html_url': 'https://github.com/bhosmer', 'followers_url': 'https://api.github.com/users/bhosmer/followers', 'following_url': 'https://api.github.com/users/bhosmer/following{/other_user}', 'gists_url': 'https://api.github.com/users/bhosmer/gists{/gist_id}', 'starred_url': 'https://api.github.com/users/bhosmer/starred{/owner}{/repo}', 'subscriptions_url': 'https://api.github.com/users/bhosmer/subscriptions', 'organizations_url': 'https://api.github.com/users/bhosmer/orgs', 'repos_url': 'https://api.github.com/users/bhosmer/repos', 'events_url': 'https://api.github.com/users/bhosmer/events{/privacy}', 'received_events_url': 'https://api.github.com/users/bhosmer/received_events', 'type': 'User', 'site_admin': False}",referenced,114a967354fa187f82cf8061351133a479229d63,https://api.github.com/repos/pytorch/pytorch/commits/114a967354fa187f82cf8061351133a479229d63,2019-09-20T01:26:13Z,8,8,0
24856,2648829321,"{'login': 'bhosmer', 'id': 355313, 'node_id': 'MDQ6VXNlcjM1NTMxMw==', 'avatar_url': 'https://avatars3.githubusercontent.com/u/355313?v=4', 'gravatar_id': '', 'url': 'https://api.github.com/users/bhosmer', 'html_url': 'https://github.com/bhosmer', 'followers_url': 'https://api.github.com/users/bhosmer/followers', 'following_url': 'https://api.github.com/users/bhosmer/following{/other_user}', 'gists_url': 'https://api.github.com/users/bhosmer/gists{/gist_id}', 'starred_url': 'https://api.github.com/users/bhosmer/starred{/owner}{/repo}', 'subscriptions_url': 'https://api.github.com/users/bhosmer/subscriptions', 'organizations_url': 'https://api.github.com/users/bhosmer/orgs', 'repos_url': 'https://api.github.com/users/bhosmer/repos', 'events_url': 'https://api.github.com/users/bhosmer/events{/privacy}', 'received_events_url': 'https://api.github.com/users/bhosmer/received_events', 'type': 'User', 'site_admin': False}",referenced,786936ab4f16f9d9e940170f4325d599e0950a7c,https://api.github.com/repos/pytorch/pytorch/commits/786936ab4f16f9d9e940170f4325d599e0950a7c,2019-09-20T01:26:20Z,39,22,17
24856,2650821918,"{'login': 'bhosmer', 'id': 355313, 'node_id': 'MDQ6VXNlcjM1NTMxMw==', 'avatar_url': 'https://avatars3.githubusercontent.com/u/355313?v=4', 'gravatar_id': '', 'url': 'https://api.github.com/users/bhosmer', 'html_url': 'https://github.com/bhosmer', 'followers_url': 'https://api.github.com/users/bhosmer/followers', 'following_url': 'https://api.github.com/users/bhosmer/following{/other_user}', 'gists_url': 'https://api.github.com/users/bhosmer/gists{/gist_id}', 'starred_url': 'https://api.github.com/users/bhosmer/starred{/owner}{/repo}', 'subscriptions_url': 'https://api.github.com/users/bhosmer/subscriptions', 'organizations_url': 'https://api.github.com/users/bhosmer/orgs', 'repos_url': 'https://api.github.com/users/bhosmer/repos', 'events_url': 'https://api.github.com/users/bhosmer/events{/privacy}', 'received_events_url': 'https://api.github.com/users/bhosmer/received_events', 'type': 'User', 'site_admin': False}",referenced,c5f5b93c66979c07568f0351635e72db7da5a6e4,https://api.github.com/repos/pytorch/pytorch/commits/c5f5b93c66979c07568f0351635e72db7da5a6e4,2019-09-20T16:07:22Z,2414,1731,683
24856,2650822294,"{'login': 'bhosmer', 'id': 355313, 'node_id': 'MDQ6VXNlcjM1NTMxMw==', 'avatar_url': 'https://avatars3.githubusercontent.com/u/355313?v=4', 'gravatar_id': '', 'url': 'https://api.github.com/users/bhosmer', 'html_url': 'https://github.com/bhosmer', 'followers_url': 'https://api.github.com/users/bhosmer/followers', 'following_url': 'https://api.github.com/users/bhosmer/following{/other_user}', 'gists_url': 'https://api.github.com/users/bhosmer/gists{/gist_id}', 'starred_url': 'https://api.github.com/users/bhosmer/starred{/owner}{/repo}', 'subscriptions_url': 'https://api.github.com/users/bhosmer/subscriptions', 'organizations_url': 'https://api.github.com/users/bhosmer/orgs', 'repos_url': 'https://api.github.com/users/bhosmer/repos', 'events_url': 'https://api.github.com/users/bhosmer/events{/privacy}', 'received_events_url': 'https://api.github.com/users/bhosmer/received_events', 'type': 'User', 'site_admin': False}",referenced,a9d00780f94b5fdcb81ea101cf33351a3efe8724,https://api.github.com/repos/pytorch/pytorch/commits/a9d00780f94b5fdcb81ea101cf33351a3efe8724,2019-09-20T16:07:30Z,39,22,17
24856,2651827234,"{'login': 'bhosmer', 'id': 355313, 'node_id': 'MDQ6VXNlcjM1NTMxMw==', 'avatar_url': 'https://avatars3.githubusercontent.com/u/355313?v=4', 'gravatar_id': '', 'url': 'https://api.github.com/users/bhosmer', 'html_url': 'https://github.com/bhosmer', 'followers_url': 'https://api.github.com/users/bhosmer/followers', 'following_url': 'https://api.github.com/users/bhosmer/following{/other_user}', 'gists_url': 'https://api.github.com/users/bhosmer/gists{/gist_id}', 'starred_url': 'https://api.github.com/users/bhosmer/starred{/owner}{/repo}', 'subscriptions_url': 'https://api.github.com/users/bhosmer/subscriptions', 'organizations_url': 'https://api.github.com/users/bhosmer/orgs', 'repos_url': 'https://api.github.com/users/bhosmer/repos', 'events_url': 'https://api.github.com/users/bhosmer/events{/privacy}', 'received_events_url': 'https://api.github.com/users/bhosmer/received_events', 'type': 'User', 'site_admin': False}",referenced,c97b509fef8188a9b251b8ca977731336cf6cbb8,https://api.github.com/repos/pytorch/pytorch/commits/c97b509fef8188a9b251b8ca977731336cf6cbb8,2019-09-21T00:47:11Z,3202,1886,1316
24856,2651827332,"{'login': 'bhosmer', 'id': 355313, 'node_id': 'MDQ6VXNlcjM1NTMxMw==', 'avatar_url': 'https://avatars3.githubusercontent.com/u/355313?v=4', 'gravatar_id': '', 'url': 'https://api.github.com/users/bhosmer', 'html_url': 'https://github.com/bhosmer', 'followers_url': 'https://api.github.com/users/bhosmer/followers', 'following_url': 'https://api.github.com/users/bhosmer/following{/other_user}', 'gists_url': 'https://api.github.com/users/bhosmer/gists{/gist_id}', 'starred_url': 'https://api.github.com/users/bhosmer/starred{/owner}{/repo}', 'subscriptions_url': 'https://api.github.com/users/bhosmer/subscriptions', 'organizations_url': 'https://api.github.com/users/bhosmer/orgs', 'repos_url': 'https://api.github.com/users/bhosmer/repos', 'events_url': 'https://api.github.com/users/bhosmer/events{/privacy}', 'received_events_url': 'https://api.github.com/users/bhosmer/received_events', 'type': 'User', 'site_admin': False}",referenced,14d7c96be680eeaff85e2486d6c5bbfc9017dece,https://api.github.com/repos/pytorch/pytorch/commits/14d7c96be680eeaff85e2486d6c5bbfc9017dece,2019-09-21T00:47:17Z,90,70,20
24856,2651841972,"{'login': 'bhosmer', 'id': 355313, 'node_id': 'MDQ6VXNlcjM1NTMxMw==', 'avatar_url': 'https://avatars3.githubusercontent.com/u/355313?v=4', 'gravatar_id': '', 'url': 'https://api.github.com/users/bhosmer', 'html_url': 'https://github.com/bhosmer', 'followers_url': 'https://api.github.com/users/bhosmer/followers', 'following_url': 'https://api.github.com/users/bhosmer/following{/other_user}', 'gists_url': 'https://api.github.com/users/bhosmer/gists{/gist_id}', 'starred_url': 'https://api.github.com/users/bhosmer/starred{/owner}{/repo}', 'subscriptions_url': 'https://api.github.com/users/bhosmer/subscriptions', 'organizations_url': 'https://api.github.com/users/bhosmer/orgs', 'repos_url': 'https://api.github.com/users/bhosmer/repos', 'events_url': 'https://api.github.com/users/bhosmer/events{/privacy}', 'received_events_url': 'https://api.github.com/users/bhosmer/received_events', 'type': 'User', 'site_admin': False}",referenced,8cfa045fda4d1e8cbe7b300c64711ab7da56e853,https://api.github.com/repos/pytorch/pytorch/commits/8cfa045fda4d1e8cbe7b300c64711ab7da56e853,2019-09-21T01:11:58Z,17,9,8
24856,2651842041,"{'login': 'bhosmer', 'id': 355313, 'node_id': 'MDQ6VXNlcjM1NTMxMw==', 'avatar_url': 'https://avatars3.githubusercontent.com/u/355313?v=4', 'gravatar_id': '', 'url': 'https://api.github.com/users/bhosmer', 'html_url': 'https://github.com/bhosmer', 'followers_url': 'https://api.github.com/users/bhosmer/followers', 'following_url': 'https://api.github.com/users/bhosmer/following{/other_user}', 'gists_url': 'https://api.github.com/users/bhosmer/gists{/gist_id}', 'starred_url': 'https://api.github.com/users/bhosmer/starred{/owner}{/repo}', 'subscriptions_url': 'https://api.github.com/users/bhosmer/subscriptions', 'organizations_url': 'https://api.github.com/users/bhosmer/orgs', 'repos_url': 'https://api.github.com/users/bhosmer/repos', 'events_url': 'https://api.github.com/users/bhosmer/events{/privacy}', 'received_events_url': 'https://api.github.com/users/bhosmer/received_events', 'type': 'User', 'site_admin': False}",referenced,3a5b5c5eda1ca008987c45087e35beaff90d9da4,https://api.github.com/repos/pytorch/pytorch/commits/3a5b5c5eda1ca008987c45087e35beaff90d9da4,2019-09-21T01:12:05Z,91,71,20
24856,2653248439,"{'login': 'bhosmer', 'id': 355313, 'node_id': 'MDQ6VXNlcjM1NTMxMw==', 'avatar_url': 'https://avatars3.githubusercontent.com/u/355313?v=4', 'gravatar_id': '', 'url': 'https://api.github.com/users/bhosmer', 'html_url': 'https://github.com/bhosmer', 'followers_url': 'https://api.github.com/users/bhosmer/followers', 'following_url': 'https://api.github.com/users/bhosmer/following{/other_user}', 'gists_url': 'https://api.github.com/users/bhosmer/gists{/gist_id}', 'starred_url': 'https://api.github.com/users/bhosmer/starred{/owner}{/repo}', 'subscriptions_url': 'https://api.github.com/users/bhosmer/subscriptions', 'organizations_url': 'https://api.github.com/users/bhosmer/orgs', 'repos_url': 'https://api.github.com/users/bhosmer/repos', 'events_url': 'https://api.github.com/users/bhosmer/events{/privacy}', 'received_events_url': 'https://api.github.com/users/bhosmer/received_events', 'type': 'User', 'site_admin': False}",referenced,954558cc0cb0cfddfd073ffaf32273facf3a5439,https://api.github.com/repos/pytorch/pytorch/commits/954558cc0cb0cfddfd073ffaf32273facf3a5439,2019-09-23T05:26:36Z,9801,5912,3889
24856,2653248558,"{'login': 'bhosmer', 'id': 355313, 'node_id': 'MDQ6VXNlcjM1NTMxMw==', 'avatar_url': 'https://avatars3.githubusercontent.com/u/355313?v=4', 'gravatar_id': '', 'url': 'https://api.github.com/users/bhosmer', 'html_url': 'https://github.com/bhosmer', 'followers_url': 'https://api.github.com/users/bhosmer/followers', 'following_url': 'https://api.github.com/users/bhosmer/following{/other_user}', 'gists_url': 'https://api.github.com/users/bhosmer/gists{/gist_id}', 'starred_url': 'https://api.github.com/users/bhosmer/starred{/owner}{/repo}', 'subscriptions_url': 'https://api.github.com/users/bhosmer/subscriptions', 'organizations_url': 'https://api.github.com/users/bhosmer/orgs', 'repos_url': 'https://api.github.com/users/bhosmer/repos', 'events_url': 'https://api.github.com/users/bhosmer/events{/privacy}', 'received_events_url': 'https://api.github.com/users/bhosmer/received_events', 'type': 'User', 'site_admin': False}",referenced,6b71d61523c05f4830b1498d501c9f5e50b84f75,https://api.github.com/repos/pytorch/pytorch/commits/6b71d61523c05f4830b1498d501c9f5e50b84f75,2019-09-23T05:26:43Z,91,71,20
24856,2655411665,"{'login': 'bhosmer', 'id': 355313, 'node_id': 'MDQ6VXNlcjM1NTMxMw==', 'avatar_url': 'https://avatars3.githubusercontent.com/u/355313?v=4', 'gravatar_id': '', 'url': 'https://api.github.com/users/bhosmer', 'html_url': 'https://github.com/bhosmer', 'followers_url': 'https://api.github.com/users/bhosmer/followers', 'following_url': 'https://api.github.com/users/bhosmer/following{/other_user}', 'gists_url': 'https://api.github.com/users/bhosmer/gists{/gist_id}', 'starred_url': 'https://api.github.com/users/bhosmer/starred{/owner}{/repo}', 'subscriptions_url': 'https://api.github.com/users/bhosmer/subscriptions', 'organizations_url': 'https://api.github.com/users/bhosmer/orgs', 'repos_url': 'https://api.github.com/users/bhosmer/repos', 'events_url': 'https://api.github.com/users/bhosmer/events{/privacy}', 'received_events_url': 'https://api.github.com/users/bhosmer/received_events', 'type': 'User', 'site_admin': False}",referenced,c59346453322121daa29f4c4c56001f4ac603557,https://api.github.com/repos/pytorch/pytorch/commits/c59346453322121daa29f4c4c56001f4ac603557,2019-09-23T18:12:22Z,18,13,5
24856,2655412042,"{'login': 'bhosmer', 'id': 355313, 'node_id': 'MDQ6VXNlcjM1NTMxMw==', 'avatar_url': 'https://avatars3.githubusercontent.com/u/355313?v=4', 'gravatar_id': '', 'url': 'https://api.github.com/users/bhosmer', 'html_url': 'https://github.com/bhosmer', 'followers_url': 'https://api.github.com/users/bhosmer/followers', 'following_url': 'https://api.github.com/users/bhosmer/following{/other_user}', 'gists_url': 'https://api.github.com/users/bhosmer/gists{/gist_id}', 'starred_url': 'https://api.github.com/users/bhosmer/starred{/owner}{/repo}', 'subscriptions_url': 'https://api.github.com/users/bhosmer/subscriptions', 'organizations_url': 'https://api.github.com/users/bhosmer/orgs', 'repos_url': 'https://api.github.com/users/bhosmer/repos', 'events_url': 'https://api.github.com/users/bhosmer/events{/privacy}', 'received_events_url': 'https://api.github.com/users/bhosmer/received_events', 'type': 'User', 'site_admin': False}",referenced,30f9ffab3c055b4a743971df165c923ea64c708d,https://api.github.com/repos/pytorch/pytorch/commits/30f9ffab3c055b4a743971df165c923ea64c708d,2019-09-23T18:12:30Z,101,80,21
24856,2658981436,"{'login': 'bhosmer', 'id': 355313, 'node_id': 'MDQ6VXNlcjM1NTMxMw==', 'avatar_url': 'https://avatars3.githubusercontent.com/u/355313?v=4', 'gravatar_id': '', 'url': 'https://api.github.com/users/bhosmer', 'html_url': 'https://github.com/bhosmer', 'followers_url': 'https://api.github.com/users/bhosmer/followers', 'following_url': 'https://api.github.com/users/bhosmer/following{/other_user}', 'gists_url': 'https://api.github.com/users/bhosmer/gists{/gist_id}', 'starred_url': 'https://api.github.com/users/bhosmer/starred{/owner}{/repo}', 'subscriptions_url': 'https://api.github.com/users/bhosmer/subscriptions', 'organizations_url': 'https://api.github.com/users/bhosmer/orgs', 'repos_url': 'https://api.github.com/users/bhosmer/repos', 'events_url': 'https://api.github.com/users/bhosmer/events{/privacy}', 'received_events_url': 'https://api.github.com/users/bhosmer/received_events', 'type': 'User', 'site_admin': False}",referenced,b58b46f3ecb68d630152bdaf5e29a53aa6ddd32e,https://api.github.com/repos/pytorch/pytorch/commits/b58b46f3ecb68d630152bdaf5e29a53aa6ddd32e,2019-09-24T17:49:18Z,65,51,14
24856,2658981784,"{'login': 'bhosmer', 'id': 355313, 'node_id': 'MDQ6VXNlcjM1NTMxMw==', 'avatar_url': 'https://avatars3.githubusercontent.com/u/355313?v=4', 'gravatar_id': '', 'url': 'https://api.github.com/users/bhosmer', 'html_url': 'https://github.com/bhosmer', 'followers_url': 'https://api.github.com/users/bhosmer/followers', 'following_url': 'https://api.github.com/users/bhosmer/following{/other_user}', 'gists_url': 'https://api.github.com/users/bhosmer/gists{/gist_id}', 'starred_url': 'https://api.github.com/users/bhosmer/starred{/owner}{/repo}', 'subscriptions_url': 'https://api.github.com/users/bhosmer/subscriptions', 'organizations_url': 'https://api.github.com/users/bhosmer/orgs', 'repos_url': 'https://api.github.com/users/bhosmer/repos', 'events_url': 'https://api.github.com/users/bhosmer/events{/privacy}', 'received_events_url': 'https://api.github.com/users/bhosmer/received_events', 'type': 'User', 'site_admin': False}",referenced,1540c714764161bd626979e5a8dc14a96b6e6a4f,https://api.github.com/repos/pytorch/pytorch/commits/1540c714764161bd626979e5a8dc14a96b6e6a4f,2019-09-24T17:49:25Z,148,122,26
24821,2575148744,"{'login': 'facebook-github-bot', 'id': 6422482, 'node_id': 'MDQ6VXNlcjY0MjI0ODI=', 'avatar_url': 'https://avatars3.githubusercontent.com/u/6422482?v=4', 'gravatar_id': '', 'url': 'https://api.github.com/users/facebook-github-bot', 'html_url': 'https://github.com/facebook-github-bot', 'followers_url': 'https://api.github.com/users/facebook-github-bot/followers', 'following_url': 'https://api.github.com/users/facebook-github-bot/following{/other_user}', 'gists_url': 'https://api.github.com/users/facebook-github-bot/gists{/gist_id}', 'starred_url': 'https://api.github.com/users/facebook-github-bot/starred{/owner}{/repo}', 'subscriptions_url': 'https://api.github.com/users/facebook-github-bot/subscriptions', 'organizations_url': 'https://api.github.com/users/facebook-github-bot/orgs', 'repos_url': 'https://api.github.com/users/facebook-github-bot/repos', 'events_url': 'https://api.github.com/users/facebook-github-bot/events{/privacy}', 'received_events_url': 'https://api.github.com/users/facebook-github-bot/received_events', 'type': 'User', 'site_admin': False}",closed,74b65c32be68b15dc7c9e8bb62459efbfbde33d8,https://api.github.com/repos/pytorch/pytorch/commits/74b65c32be68b15dc7c9e8bb62459efbfbde33d8,2019-08-22T04:18:01Z,1954,1270,684
24806,2571097410,"{'login': 'facebook-github-bot', 'id': 6422482, 'node_id': 'MDQ6VXNlcjY0MjI0ODI=', 'avatar_url': 'https://avatars3.githubusercontent.com/u/6422482?v=4', 'gravatar_id': '', 'url': 'https://api.github.com/users/facebook-github-bot', 'html_url': 'https://github.com/facebook-github-bot', 'followers_url': 'https://api.github.com/users/facebook-github-bot/followers', 'following_url': 'https://api.github.com/users/facebook-github-bot/following{/other_user}', 'gists_url': 'https://api.github.com/users/facebook-github-bot/gists{/gist_id}', 'starred_url': 'https://api.github.com/users/facebook-github-bot/starred{/owner}{/repo}', 'subscriptions_url': 'https://api.github.com/users/facebook-github-bot/subscriptions', 'organizations_url': 'https://api.github.com/users/facebook-github-bot/orgs', 'repos_url': 'https://api.github.com/users/facebook-github-bot/repos', 'events_url': 'https://api.github.com/users/facebook-github-bot/events{/privacy}', 'received_events_url': 'https://api.github.com/users/facebook-github-bot/received_events', 'type': 'User', 'site_admin': False}",closed,012526dd6bf677fd029e9c27ecb49e401b210d2f,https://api.github.com/repos/pytorch/pytorch/commits/012526dd6bf677fd029e9c27ecb49e401b210d2f,2019-08-20T21:14:24Z,44,25,19
24791,2656284827,"{'login': 'facebook-github-bot', 'id': 6422482, 'node_id': 'MDQ6VXNlcjY0MjI0ODI=', 'avatar_url': 'https://avatars3.githubusercontent.com/u/6422482?v=4', 'gravatar_id': '', 'url': 'https://api.github.com/users/facebook-github-bot', 'html_url': 'https://github.com/facebook-github-bot', 'followers_url': 'https://api.github.com/users/facebook-github-bot/followers', 'following_url': 'https://api.github.com/users/facebook-github-bot/following{/other_user}', 'gists_url': 'https://api.github.com/users/facebook-github-bot/gists{/gist_id}', 'starred_url': 'https://api.github.com/users/facebook-github-bot/starred{/owner}{/repo}', 'subscriptions_url': 'https://api.github.com/users/facebook-github-bot/subscriptions', 'organizations_url': 'https://api.github.com/users/facebook-github-bot/orgs', 'repos_url': 'https://api.github.com/users/facebook-github-bot/repos', 'events_url': 'https://api.github.com/users/facebook-github-bot/events{/privacy}', 'received_events_url': 'https://api.github.com/users/facebook-github-bot/received_events', 'type': 'User', 'site_admin': False}",closed,1eaaf8b68bd0c3490f1be37c6f8c89ab315e83e2,https://api.github.com/repos/pytorch/pytorch/commits/1eaaf8b68bd0c3490f1be37c6f8c89ab315e83e2,2019-09-24T00:24:31Z,203,134,69
24778,2577723899,"{'login': 'facebook-github-bot', 'id': 6422482, 'node_id': 'MDQ6VXNlcjY0MjI0ODI=', 'avatar_url': 'https://avatars3.githubusercontent.com/u/6422482?v=4', 'gravatar_id': '', 'url': 'https://api.github.com/users/facebook-github-bot', 'html_url': 'https://github.com/facebook-github-bot', 'followers_url': 'https://api.github.com/users/facebook-github-bot/followers', 'following_url': 'https://api.github.com/users/facebook-github-bot/following{/other_user}', 'gists_url': 'https://api.github.com/users/facebook-github-bot/gists{/gist_id}', 'starred_url': 'https://api.github.com/users/facebook-github-bot/starred{/owner}{/repo}', 'subscriptions_url': 'https://api.github.com/users/facebook-github-bot/subscriptions', 'organizations_url': 'https://api.github.com/users/facebook-github-bot/orgs', 'repos_url': 'https://api.github.com/users/facebook-github-bot/repos', 'events_url': 'https://api.github.com/users/facebook-github-bot/events{/privacy}', 'received_events_url': 'https://api.github.com/users/facebook-github-bot/received_events', 'type': 'User', 'site_admin': False}",referenced,a805a0d3ca0c4fe089799b83b8c621d22bc34903,https://api.github.com/repos/pytorch/pytorch/commits/a805a0d3ca0c4fe089799b83b8c621d22bc34903,2019-08-22T20:19:59Z,71,2,69
24767,2933034792,"{'login': 'facebook-github-bot', 'id': 6422482, 'node_id': 'MDQ6VXNlcjY0MjI0ODI=', 'avatar_url': 'https://avatars3.githubusercontent.com/u/6422482?v=4', 'gravatar_id': '', 'url': 'https://api.github.com/users/facebook-github-bot', 'html_url': 'https://github.com/facebook-github-bot', 'followers_url': 'https://api.github.com/users/facebook-github-bot/followers', 'following_url': 'https://api.github.com/users/facebook-github-bot/following{/other_user}', 'gists_url': 'https://api.github.com/users/facebook-github-bot/gists{/gist_id}', 'starred_url': 'https://api.github.com/users/facebook-github-bot/starred{/owner}{/repo}', 'subscriptions_url': 'https://api.github.com/users/facebook-github-bot/subscriptions', 'organizations_url': 'https://api.github.com/users/facebook-github-bot/orgs', 'repos_url': 'https://api.github.com/users/facebook-github-bot/repos', 'events_url': 'https://api.github.com/users/facebook-github-bot/events{/privacy}', 'received_events_url': 'https://api.github.com/users/facebook-github-bot/received_events', 'type': 'User', 'site_admin': False}",referenced,4f9d2f74e2f6308271945d1486f8231e1b48a166,https://api.github.com/repos/pytorch/pytorch/commits/4f9d2f74e2f6308271945d1486f8231e1b48a166,2020-01-08T23:04:09Z,282,92,190
24766,2933034788,"{'login': 'facebook-github-bot', 'id': 6422482, 'node_id': 'MDQ6VXNlcjY0MjI0ODI=', 'avatar_url': 'https://avatars3.githubusercontent.com/u/6422482?v=4', 'gravatar_id': '', 'url': 'https://api.github.com/users/facebook-github-bot', 'html_url': 'https://github.com/facebook-github-bot', 'followers_url': 'https://api.github.com/users/facebook-github-bot/followers', 'following_url': 'https://api.github.com/users/facebook-github-bot/following{/other_user}', 'gists_url': 'https://api.github.com/users/facebook-github-bot/gists{/gist_id}', 'starred_url': 'https://api.github.com/users/facebook-github-bot/starred{/owner}{/repo}', 'subscriptions_url': 'https://api.github.com/users/facebook-github-bot/subscriptions', 'organizations_url': 'https://api.github.com/users/facebook-github-bot/orgs', 'repos_url': 'https://api.github.com/users/facebook-github-bot/repos', 'events_url': 'https://api.github.com/users/facebook-github-bot/events{/privacy}', 'received_events_url': 'https://api.github.com/users/facebook-github-bot/received_events', 'type': 'User', 'site_admin': False}",referenced,4f9d2f74e2f6308271945d1486f8231e1b48a166,https://api.github.com/repos/pytorch/pytorch/commits/4f9d2f74e2f6308271945d1486f8231e1b48a166,2020-01-08T23:04:09Z,282,92,190
24765,2714511538,"{'login': 'facebook-github-bot', 'id': 6422482, 'node_id': 'MDQ6VXNlcjY0MjI0ODI=', 'avatar_url': 'https://avatars3.githubusercontent.com/u/6422482?v=4', 'gravatar_id': '', 'url': 'https://api.github.com/users/facebook-github-bot', 'html_url': 'https://github.com/facebook-github-bot', 'followers_url': 'https://api.github.com/users/facebook-github-bot/followers', 'following_url': 'https://api.github.com/users/facebook-github-bot/following{/other_user}', 'gists_url': 'https://api.github.com/users/facebook-github-bot/gists{/gist_id}', 'starred_url': 'https://api.github.com/users/facebook-github-bot/starred{/owner}{/repo}', 'subscriptions_url': 'https://api.github.com/users/facebook-github-bot/subscriptions', 'organizations_url': 'https://api.github.com/users/facebook-github-bot/orgs', 'repos_url': 'https://api.github.com/users/facebook-github-bot/repos', 'events_url': 'https://api.github.com/users/facebook-github-bot/events{/privacy}', 'received_events_url': 'https://api.github.com/users/facebook-github-bot/received_events', 'type': 'User', 'site_admin': False}",referenced,9033ace9c4235b2fdaa93d0402f994efbcc186a5,https://api.github.com/repos/pytorch/pytorch/commits/9033ace9c4235b2fdaa93d0402f994efbcc186a5,2019-10-15T15:45:13Z,310,8,302
24765,2895118822,"{'login': 'facebook-github-bot', 'id': 6422482, 'node_id': 'MDQ6VXNlcjY0MjI0ODI=', 'avatar_url': 'https://avatars3.githubusercontent.com/u/6422482?v=4', 'gravatar_id': '', 'url': 'https://api.github.com/users/facebook-github-bot', 'html_url': 'https://github.com/facebook-github-bot', 'followers_url': 'https://api.github.com/users/facebook-github-bot/followers', 'following_url': 'https://api.github.com/users/facebook-github-bot/following{/other_user}', 'gists_url': 'https://api.github.com/users/facebook-github-bot/gists{/gist_id}', 'starred_url': 'https://api.github.com/users/facebook-github-bot/starred{/owner}{/repo}', 'subscriptions_url': 'https://api.github.com/users/facebook-github-bot/subscriptions', 'organizations_url': 'https://api.github.com/users/facebook-github-bot/orgs', 'repos_url': 'https://api.github.com/users/facebook-github-bot/repos', 'events_url': 'https://api.github.com/users/facebook-github-bot/events{/privacy}', 'received_events_url': 'https://api.github.com/users/facebook-github-bot/received_events', 'type': 'User', 'site_admin': False}",referenced,5e8bac24b4c3b9abd0e056d663a9029cc79c44d5,https://api.github.com/repos/pytorch/pytorch/commits/5e8bac24b4c3b9abd0e056d663a9029cc79c44d5,2019-12-18T21:34:11Z,300,40,260
24764,2714511533,"{'login': 'facebook-github-bot', 'id': 6422482, 'node_id': 'MDQ6VXNlcjY0MjI0ODI=', 'avatar_url': 'https://avatars3.githubusercontent.com/u/6422482?v=4', 'gravatar_id': '', 'url': 'https://api.github.com/users/facebook-github-bot', 'html_url': 'https://github.com/facebook-github-bot', 'followers_url': 'https://api.github.com/users/facebook-github-bot/followers', 'following_url': 'https://api.github.com/users/facebook-github-bot/following{/other_user}', 'gists_url': 'https://api.github.com/users/facebook-github-bot/gists{/gist_id}', 'starred_url': 'https://api.github.com/users/facebook-github-bot/starred{/owner}{/repo}', 'subscriptions_url': 'https://api.github.com/users/facebook-github-bot/subscriptions', 'organizations_url': 'https://api.github.com/users/facebook-github-bot/orgs', 'repos_url': 'https://api.github.com/users/facebook-github-bot/repos', 'events_url': 'https://api.github.com/users/facebook-github-bot/events{/privacy}', 'received_events_url': 'https://api.github.com/users/facebook-github-bot/received_events', 'type': 'User', 'site_admin': False}",referenced,9033ace9c4235b2fdaa93d0402f994efbcc186a5,https://api.github.com/repos/pytorch/pytorch/commits/9033ace9c4235b2fdaa93d0402f994efbcc186a5,2019-10-15T15:45:13Z,310,8,302
24764,2895118815,"{'login': 'facebook-github-bot', 'id': 6422482, 'node_id': 'MDQ6VXNlcjY0MjI0ODI=', 'avatar_url': 'https://avatars3.githubusercontent.com/u/6422482?v=4', 'gravatar_id': '', 'url': 'https://api.github.com/users/facebook-github-bot', 'html_url': 'https://github.com/facebook-github-bot', 'followers_url': 'https://api.github.com/users/facebook-github-bot/followers', 'following_url': 'https://api.github.com/users/facebook-github-bot/following{/other_user}', 'gists_url': 'https://api.github.com/users/facebook-github-bot/gists{/gist_id}', 'starred_url': 'https://api.github.com/users/facebook-github-bot/starred{/owner}{/repo}', 'subscriptions_url': 'https://api.github.com/users/facebook-github-bot/subscriptions', 'organizations_url': 'https://api.github.com/users/facebook-github-bot/orgs', 'repos_url': 'https://api.github.com/users/facebook-github-bot/repos', 'events_url': 'https://api.github.com/users/facebook-github-bot/events{/privacy}', 'received_events_url': 'https://api.github.com/users/facebook-github-bot/received_events', 'type': 'User', 'site_admin': False}",referenced,5e8bac24b4c3b9abd0e056d663a9029cc79c44d5,https://api.github.com/repos/pytorch/pytorch/commits/5e8bac24b4c3b9abd0e056d663a9029cc79c44d5,2019-12-18T21:34:11Z,300,40,260
24758,2960030920,"{'login': 'facebook-github-bot', 'id': 6422482, 'node_id': 'MDQ6VXNlcjY0MjI0ODI=', 'avatar_url': 'https://avatars3.githubusercontent.com/u/6422482?v=4', 'gravatar_id': '', 'url': 'https://api.github.com/users/facebook-github-bot', 'html_url': 'https://github.com/facebook-github-bot', 'followers_url': 'https://api.github.com/users/facebook-github-bot/followers', 'following_url': 'https://api.github.com/users/facebook-github-bot/following{/other_user}', 'gists_url': 'https://api.github.com/users/facebook-github-bot/gists{/gist_id}', 'starred_url': 'https://api.github.com/users/facebook-github-bot/starred{/owner}{/repo}', 'subscriptions_url': 'https://api.github.com/users/facebook-github-bot/subscriptions', 'organizations_url': 'https://api.github.com/users/facebook-github-bot/orgs', 'repos_url': 'https://api.github.com/users/facebook-github-bot/repos', 'events_url': 'https://api.github.com/users/facebook-github-bot/events{/privacy}', 'received_events_url': 'https://api.github.com/users/facebook-github-bot/received_events', 'type': 'User', 'site_admin': False}",referenced,61ee8c972ff1b22dc42f1b984f859e81125b69c4,https://api.github.com/repos/pytorch/pytorch/commits/61ee8c972ff1b22dc42f1b984f859e81125b69c4,2020-01-18T05:38:21Z,245,209,36
24757,3054123432,"{'login': 'facebook-github-bot', 'id': 6422482, 'node_id': 'MDQ6VXNlcjY0MjI0ODI=', 'avatar_url': 'https://avatars3.githubusercontent.com/u/6422482?v=4', 'gravatar_id': '', 'url': 'https://api.github.com/users/facebook-github-bot', 'html_url': 'https://github.com/facebook-github-bot', 'followers_url': 'https://api.github.com/users/facebook-github-bot/followers', 'following_url': 'https://api.github.com/users/facebook-github-bot/following{/other_user}', 'gists_url': 'https://api.github.com/users/facebook-github-bot/gists{/gist_id}', 'starred_url': 'https://api.github.com/users/facebook-github-bot/starred{/owner}{/repo}', 'subscriptions_url': 'https://api.github.com/users/facebook-github-bot/subscriptions', 'organizations_url': 'https://api.github.com/users/facebook-github-bot/orgs', 'repos_url': 'https://api.github.com/users/facebook-github-bot/repos', 'events_url': 'https://api.github.com/users/facebook-github-bot/events{/privacy}', 'received_events_url': 'https://api.github.com/users/facebook-github-bot/received_events', 'type': 'User', 'site_admin': False}",closed,602ef0d9d06882bde1a5ba7914599bbbfeb537bb,https://api.github.com/repos/pytorch/pytorch/commits/602ef0d9d06882bde1a5ba7914599bbbfeb537bb,2020-02-20T02:19:33Z,213,127,86
24756,2920988250,"{'login': 'facebook-github-bot', 'id': 6422482, 'node_id': 'MDQ6VXNlcjY0MjI0ODI=', 'avatar_url': 'https://avatars3.githubusercontent.com/u/6422482?v=4', 'gravatar_id': '', 'url': 'https://api.github.com/users/facebook-github-bot', 'html_url': 'https://github.com/facebook-github-bot', 'followers_url': 'https://api.github.com/users/facebook-github-bot/followers', 'following_url': 'https://api.github.com/users/facebook-github-bot/following{/other_user}', 'gists_url': 'https://api.github.com/users/facebook-github-bot/gists{/gist_id}', 'starred_url': 'https://api.github.com/users/facebook-github-bot/starred{/owner}{/repo}', 'subscriptions_url': 'https://api.github.com/users/facebook-github-bot/subscriptions', 'organizations_url': 'https://api.github.com/users/facebook-github-bot/orgs', 'repos_url': 'https://api.github.com/users/facebook-github-bot/repos', 'events_url': 'https://api.github.com/users/facebook-github-bot/events{/privacy}', 'received_events_url': 'https://api.github.com/users/facebook-github-bot/received_events', 'type': 'User', 'site_admin': False}",referenced,a02a5129a871324fc049e209e30a9c6b4bad58eb,https://api.github.com/repos/pytorch/pytorch/commits/a02a5129a871324fc049e209e30a9c6b4bad58eb,2020-01-03T19:10:12Z,293,120,173
24755,2920988241,"{'login': 'facebook-github-bot', 'id': 6422482, 'node_id': 'MDQ6VXNlcjY0MjI0ODI=', 'avatar_url': 'https://avatars3.githubusercontent.com/u/6422482?v=4', 'gravatar_id': '', 'url': 'https://api.github.com/users/facebook-github-bot', 'html_url': 'https://github.com/facebook-github-bot', 'followers_url': 'https://api.github.com/users/facebook-github-bot/followers', 'following_url': 'https://api.github.com/users/facebook-github-bot/following{/other_user}', 'gists_url': 'https://api.github.com/users/facebook-github-bot/gists{/gist_id}', 'starred_url': 'https://api.github.com/users/facebook-github-bot/starred{/owner}{/repo}', 'subscriptions_url': 'https://api.github.com/users/facebook-github-bot/subscriptions', 'organizations_url': 'https://api.github.com/users/facebook-github-bot/orgs', 'repos_url': 'https://api.github.com/users/facebook-github-bot/repos', 'events_url': 'https://api.github.com/users/facebook-github-bot/events{/privacy}', 'received_events_url': 'https://api.github.com/users/facebook-github-bot/received_events', 'type': 'User', 'site_admin': False}",closed,a02a5129a871324fc049e209e30a9c6b4bad58eb,https://api.github.com/repos/pytorch/pytorch/commits/a02a5129a871324fc049e209e30a9c6b4bad58eb,2020-01-03T19:10:12Z,293,120,173
24752,2974620831,"{'login': 'pbelevich', 'id': 1160355, 'node_id': 'MDQ6VXNlcjExNjAzNTU=', 'avatar_url': 'https://avatars1.githubusercontent.com/u/1160355?v=4', 'gravatar_id': '', 'url': 'https://api.github.com/users/pbelevich', 'html_url': 'https://github.com/pbelevich', 'followers_url': 'https://api.github.com/users/pbelevich/followers', 'following_url': 'https://api.github.com/users/pbelevich/following{/other_user}', 'gists_url': 'https://api.github.com/users/pbelevich/gists{/gist_id}', 'starred_url': 'https://api.github.com/users/pbelevich/starred{/owner}{/repo}', 'subscriptions_url': 'https://api.github.com/users/pbelevich/subscriptions', 'organizations_url': 'https://api.github.com/users/pbelevich/orgs', 'repos_url': 'https://api.github.com/users/pbelevich/repos', 'events_url': 'https://api.github.com/users/pbelevich/events{/privacy}', 'received_events_url': 'https://api.github.com/users/pbelevich/received_events', 'type': 'User', 'site_admin': False}",referenced,83afe554a84a48daa508ed31f97ef44863c59a59,https://api.github.com/repos/pytorch/pytorch/commits/83afe554a84a48daa508ed31f97ef44863c59a59,2020-01-23T17:32:36Z,19,15,4
24752,2975048016,"{'login': 'pbelevich', 'id': 1160355, 'node_id': 'MDQ6VXNlcjExNjAzNTU=', 'avatar_url': 'https://avatars1.githubusercontent.com/u/1160355?v=4', 'gravatar_id': '', 'url': 'https://api.github.com/users/pbelevich', 'html_url': 'https://github.com/pbelevich', 'followers_url': 'https://api.github.com/users/pbelevich/followers', 'following_url': 'https://api.github.com/users/pbelevich/following{/other_user}', 'gists_url': 'https://api.github.com/users/pbelevich/gists{/gist_id}', 'starred_url': 'https://api.github.com/users/pbelevich/starred{/owner}{/repo}', 'subscriptions_url': 'https://api.github.com/users/pbelevich/subscriptions', 'organizations_url': 'https://api.github.com/users/pbelevich/orgs', 'repos_url': 'https://api.github.com/users/pbelevich/repos', 'events_url': 'https://api.github.com/users/pbelevich/events{/privacy}', 'received_events_url': 'https://api.github.com/users/pbelevich/received_events', 'type': 'User', 'site_admin': False}",referenced,8d470d3b2d040b15dc58ba78f31dc6283a75aa84,https://api.github.com/repos/pytorch/pytorch/commits/8d470d3b2d040b15dc58ba78f31dc6283a75aa84,2020-01-23T19:51:10Z,345,220,125
24752,2975305944,"{'login': 'pbelevich', 'id': 1160355, 'node_id': 'MDQ6VXNlcjExNjAzNTU=', 'avatar_url': 'https://avatars1.githubusercontent.com/u/1160355?v=4', 'gravatar_id': '', 'url': 'https://api.github.com/users/pbelevich', 'html_url': 'https://github.com/pbelevich', 'followers_url': 'https://api.github.com/users/pbelevich/followers', 'following_url': 'https://api.github.com/users/pbelevich/following{/other_user}', 'gists_url': 'https://api.github.com/users/pbelevich/gists{/gist_id}', 'starred_url': 'https://api.github.com/users/pbelevich/starred{/owner}{/repo}', 'subscriptions_url': 'https://api.github.com/users/pbelevich/subscriptions', 'organizations_url': 'https://api.github.com/users/pbelevich/orgs', 'repos_url': 'https://api.github.com/users/pbelevich/repos', 'events_url': 'https://api.github.com/users/pbelevich/events{/privacy}', 'received_events_url': 'https://api.github.com/users/pbelevich/received_events', 'type': 'User', 'site_admin': False}",referenced,2a83c8b2aa2bbaa7ee65f9755acf8ae7277bf992,https://api.github.com/repos/pytorch/pytorch/commits/2a83c8b2aa2bbaa7ee65f9755acf8ae7277bf992,2020-01-23T21:15:26Z,78,74,4
24752,2983608096,"{'login': 'pbelevich', 'id': 1160355, 'node_id': 'MDQ6VXNlcjExNjAzNTU=', 'avatar_url': 'https://avatars1.githubusercontent.com/u/1160355?v=4', 'gravatar_id': '', 'url': 'https://api.github.com/users/pbelevich', 'html_url': 'https://github.com/pbelevich', 'followers_url': 'https://api.github.com/users/pbelevich/followers', 'following_url': 'https://api.github.com/users/pbelevich/following{/other_user}', 'gists_url': 'https://api.github.com/users/pbelevich/gists{/gist_id}', 'starred_url': 'https://api.github.com/users/pbelevich/starred{/owner}{/repo}', 'subscriptions_url': 'https://api.github.com/users/pbelevich/subscriptions', 'organizations_url': 'https://api.github.com/users/pbelevich/orgs', 'repos_url': 'https://api.github.com/users/pbelevich/repos', 'events_url': 'https://api.github.com/users/pbelevich/events{/privacy}', 'received_events_url': 'https://api.github.com/users/pbelevich/received_events', 'type': 'User', 'site_admin': False}",referenced,c14b9786e3de7b2d430609f3ddff63f6ce8b983c,https://api.github.com/repos/pytorch/pytorch/commits/c14b9786e3de7b2d430609f3ddff63f6ce8b983c,2020-01-27T22:16:49Z,4570,3297,1273
24752,2998395568,"{'login': 'pbelevich', 'id': 1160355, 'node_id': 'MDQ6VXNlcjExNjAzNTU=', 'avatar_url': 'https://avatars1.githubusercontent.com/u/1160355?v=4', 'gravatar_id': '', 'url': 'https://api.github.com/users/pbelevich', 'html_url': 'https://github.com/pbelevich', 'followers_url': 'https://api.github.com/users/pbelevich/followers', 'following_url': 'https://api.github.com/users/pbelevich/following{/other_user}', 'gists_url': 'https://api.github.com/users/pbelevich/gists{/gist_id}', 'starred_url': 'https://api.github.com/users/pbelevich/starred{/owner}{/repo}', 'subscriptions_url': 'https://api.github.com/users/pbelevich/subscriptions', 'organizations_url': 'https://api.github.com/users/pbelevich/orgs', 'repos_url': 'https://api.github.com/users/pbelevich/repos', 'events_url': 'https://api.github.com/users/pbelevich/events{/privacy}', 'received_events_url': 'https://api.github.com/users/pbelevich/received_events', 'type': 'User', 'site_admin': False}",referenced,803d2cb9b59c902dc80660565cc002cd4ce202ca,https://api.github.com/repos/pytorch/pytorch/commits/803d2cb9b59c902dc80660565cc002cd4ce202ca,2020-01-31T20:21:28Z,11355,6382,4973
24752,2998982923,"{'login': 'pbelevich', 'id': 1160355, 'node_id': 'MDQ6VXNlcjExNjAzNTU=', 'avatar_url': 'https://avatars1.githubusercontent.com/u/1160355?v=4', 'gravatar_id': '', 'url': 'https://api.github.com/users/pbelevich', 'html_url': 'https://github.com/pbelevich', 'followers_url': 'https://api.github.com/users/pbelevich/followers', 'following_url': 'https://api.github.com/users/pbelevich/following{/other_user}', 'gists_url': 'https://api.github.com/users/pbelevich/gists{/gist_id}', 'starred_url': 'https://api.github.com/users/pbelevich/starred{/owner}{/repo}', 'subscriptions_url': 'https://api.github.com/users/pbelevich/subscriptions', 'organizations_url': 'https://api.github.com/users/pbelevich/orgs', 'repos_url': 'https://api.github.com/users/pbelevich/repos', 'events_url': 'https://api.github.com/users/pbelevich/events{/privacy}', 'received_events_url': 'https://api.github.com/users/pbelevich/received_events', 'type': 'User', 'site_admin': False}",referenced,90ee94ab96a2dc4fcf06a2b77fcc4e996ad79884,https://api.github.com/repos/pytorch/pytorch/commits/90ee94ab96a2dc4fcf06a2b77fcc4e996ad79884,2020-02-01T01:28:39Z,661,502,159
24752,3002661759,"{'login': 'pbelevich', 'id': 1160355, 'node_id': 'MDQ6VXNlcjExNjAzNTU=', 'avatar_url': 'https://avatars1.githubusercontent.com/u/1160355?v=4', 'gravatar_id': '', 'url': 'https://api.github.com/users/pbelevich', 'html_url': 'https://github.com/pbelevich', 'followers_url': 'https://api.github.com/users/pbelevich/followers', 'following_url': 'https://api.github.com/users/pbelevich/following{/other_user}', 'gists_url': 'https://api.github.com/users/pbelevich/gists{/gist_id}', 'starred_url': 'https://api.github.com/users/pbelevich/starred{/owner}{/repo}', 'subscriptions_url': 'https://api.github.com/users/pbelevich/subscriptions', 'organizations_url': 'https://api.github.com/users/pbelevich/orgs', 'repos_url': 'https://api.github.com/users/pbelevich/repos', 'events_url': 'https://api.github.com/users/pbelevich/events{/privacy}', 'received_events_url': 'https://api.github.com/users/pbelevich/received_events', 'type': 'User', 'site_admin': False}",referenced,b65a25b34902eb1f2b55c389eaf0b6e0225090b5,https://api.github.com/repos/pytorch/pytorch/commits/b65a25b34902eb1f2b55c389eaf0b6e0225090b5,2020-02-03T15:30:19Z,386,300,86
24752,3014810777,"{'login': 'pbelevich', 'id': 1160355, 'node_id': 'MDQ6VXNlcjExNjAzNTU=', 'avatar_url': 'https://avatars1.githubusercontent.com/u/1160355?v=4', 'gravatar_id': '', 'url': 'https://api.github.com/users/pbelevich', 'html_url': 'https://github.com/pbelevich', 'followers_url': 'https://api.github.com/users/pbelevich/followers', 'following_url': 'https://api.github.com/users/pbelevich/following{/other_user}', 'gists_url': 'https://api.github.com/users/pbelevich/gists{/gist_id}', 'starred_url': 'https://api.github.com/users/pbelevich/starred{/owner}{/repo}', 'subscriptions_url': 'https://api.github.com/users/pbelevich/subscriptions', 'organizations_url': 'https://api.github.com/users/pbelevich/orgs', 'repos_url': 'https://api.github.com/users/pbelevich/repos', 'events_url': 'https://api.github.com/users/pbelevich/events{/privacy}', 'received_events_url': 'https://api.github.com/users/pbelevich/received_events', 'type': 'User', 'site_admin': False}",referenced,04a0c53c14b9ea63b7a325a4bdc0debd86f161d2,https://api.github.com/repos/pytorch/pytorch/commits/04a0c53c14b9ea63b7a325a4bdc0debd86f161d2,2020-02-06T17:31:34Z,6119,4485,1634
24752,3015410887,"{'login': 'pbelevich', 'id': 1160355, 'node_id': 'MDQ6VXNlcjExNjAzNTU=', 'avatar_url': 'https://avatars1.githubusercontent.com/u/1160355?v=4', 'gravatar_id': '', 'url': 'https://api.github.com/users/pbelevich', 'html_url': 'https://github.com/pbelevich', 'followers_url': 'https://api.github.com/users/pbelevich/followers', 'following_url': 'https://api.github.com/users/pbelevich/following{/other_user}', 'gists_url': 'https://api.github.com/users/pbelevich/gists{/gist_id}', 'starred_url': 'https://api.github.com/users/pbelevich/starred{/owner}{/repo}', 'subscriptions_url': 'https://api.github.com/users/pbelevich/subscriptions', 'organizations_url': 'https://api.github.com/users/pbelevich/orgs', 'repos_url': 'https://api.github.com/users/pbelevich/repos', 'events_url': 'https://api.github.com/users/pbelevich/events{/privacy}', 'received_events_url': 'https://api.github.com/users/pbelevich/received_events', 'type': 'User', 'site_admin': False}",referenced,7d9db5efc8b51519f5d8ebdc9bc5073c86332e8a,https://api.github.com/repos/pytorch/pytorch/commits/7d9db5efc8b51519f5d8ebdc9bc5073c86332e8a,2020-02-06T20:42:13Z,79,75,4
24752,3015614685,"{'login': 'pbelevich', 'id': 1160355, 'node_id': 'MDQ6VXNlcjExNjAzNTU=', 'avatar_url': 'https://avatars1.githubusercontent.com/u/1160355?v=4', 'gravatar_id': '', 'url': 'https://api.github.com/users/pbelevich', 'html_url': 'https://github.com/pbelevich', 'followers_url': 'https://api.github.com/users/pbelevich/followers', 'following_url': 'https://api.github.com/users/pbelevich/following{/other_user}', 'gists_url': 'https://api.github.com/users/pbelevich/gists{/gist_id}', 'starred_url': 'https://api.github.com/users/pbelevich/starred{/owner}{/repo}', 'subscriptions_url': 'https://api.github.com/users/pbelevich/subscriptions', 'organizations_url': 'https://api.github.com/users/pbelevich/orgs', 'repos_url': 'https://api.github.com/users/pbelevich/repos', 'events_url': 'https://api.github.com/users/pbelevich/events{/privacy}', 'received_events_url': 'https://api.github.com/users/pbelevich/received_events', 'type': 'User', 'site_admin': False}",referenced,fbd07dee04f54b6427331df79e0aeb7e32e66c50,https://api.github.com/repos/pytorch/pytorch/commits/fbd07dee04f54b6427331df79e0aeb7e32e66c50,2020-02-06T21:52:23Z,21,5,16
24752,3015765105,"{'login': 'pbelevich', 'id': 1160355, 'node_id': 'MDQ6VXNlcjExNjAzNTU=', 'avatar_url': 'https://avatars1.githubusercontent.com/u/1160355?v=4', 'gravatar_id': '', 'url': 'https://api.github.com/users/pbelevich', 'html_url': 'https://github.com/pbelevich', 'followers_url': 'https://api.github.com/users/pbelevich/followers', 'following_url': 'https://api.github.com/users/pbelevich/following{/other_user}', 'gists_url': 'https://api.github.com/users/pbelevich/gists{/gist_id}', 'starred_url': 'https://api.github.com/users/pbelevich/starred{/owner}{/repo}', 'subscriptions_url': 'https://api.github.com/users/pbelevich/subscriptions', 'organizations_url': 'https://api.github.com/users/pbelevich/orgs', 'repos_url': 'https://api.github.com/users/pbelevich/repos', 'events_url': 'https://api.github.com/users/pbelevich/events{/privacy}', 'received_events_url': 'https://api.github.com/users/pbelevich/received_events', 'type': 'User', 'site_admin': False}",referenced,3d0207305a025f3958e50e2c267460116367d788,https://api.github.com/repos/pytorch/pytorch/commits/3d0207305a025f3958e50e2c267460116367d788,2020-02-06T22:48:35Z,12,6,6
24752,3015827119,"{'login': 'pbelevich', 'id': 1160355, 'node_id': 'MDQ6VXNlcjExNjAzNTU=', 'avatar_url': 'https://avatars1.githubusercontent.com/u/1160355?v=4', 'gravatar_id': '', 'url': 'https://api.github.com/users/pbelevich', 'html_url': 'https://github.com/pbelevich', 'followers_url': 'https://api.github.com/users/pbelevich/followers', 'following_url': 'https://api.github.com/users/pbelevich/following{/other_user}', 'gists_url': 'https://api.github.com/users/pbelevich/gists{/gist_id}', 'starred_url': 'https://api.github.com/users/pbelevich/starred{/owner}{/repo}', 'subscriptions_url': 'https://api.github.com/users/pbelevich/subscriptions', 'organizations_url': 'https://api.github.com/users/pbelevich/orgs', 'repos_url': 'https://api.github.com/users/pbelevich/repos', 'events_url': 'https://api.github.com/users/pbelevich/events{/privacy}', 'received_events_url': 'https://api.github.com/users/pbelevich/received_events', 'type': 'User', 'site_admin': False}",referenced,fa6232882389f7954e981d31c08670cc08b47e99,https://api.github.com/repos/pytorch/pytorch/commits/fa6232882389f7954e981d31c08670cc08b47e99,2020-02-06T23:16:05Z,4,3,1
24752,3015943954,"{'login': 'pbelevich', 'id': 1160355, 'node_id': 'MDQ6VXNlcjExNjAzNTU=', 'avatar_url': 'https://avatars1.githubusercontent.com/u/1160355?v=4', 'gravatar_id': '', 'url': 'https://api.github.com/users/pbelevich', 'html_url': 'https://github.com/pbelevich', 'followers_url': 'https://api.github.com/users/pbelevich/followers', 'following_url': 'https://api.github.com/users/pbelevich/following{/other_user}', 'gists_url': 'https://api.github.com/users/pbelevich/gists{/gist_id}', 'starred_url': 'https://api.github.com/users/pbelevich/starred{/owner}{/repo}', 'subscriptions_url': 'https://api.github.com/users/pbelevich/subscriptions', 'organizations_url': 'https://api.github.com/users/pbelevich/orgs', 'repos_url': 'https://api.github.com/users/pbelevich/repos', 'events_url': 'https://api.github.com/users/pbelevich/events{/privacy}', 'received_events_url': 'https://api.github.com/users/pbelevich/received_events', 'type': 'User', 'site_admin': False}",referenced,aae0dece363fbb6f05b4b82453d30637ecf49e49,https://api.github.com/repos/pytorch/pytorch/commits/aae0dece363fbb6f05b4b82453d30637ecf49e49,2020-02-07T00:15:29Z,25,13,12
24752,3016193997,"{'login': 'pbelevich', 'id': 1160355, 'node_id': 'MDQ6VXNlcjExNjAzNTU=', 'avatar_url': 'https://avatars1.githubusercontent.com/u/1160355?v=4', 'gravatar_id': '', 'url': 'https://api.github.com/users/pbelevich', 'html_url': 'https://github.com/pbelevich', 'followers_url': 'https://api.github.com/users/pbelevich/followers', 'following_url': 'https://api.github.com/users/pbelevich/following{/other_user}', 'gists_url': 'https://api.github.com/users/pbelevich/gists{/gist_id}', 'starred_url': 'https://api.github.com/users/pbelevich/starred{/owner}{/repo}', 'subscriptions_url': 'https://api.github.com/users/pbelevich/subscriptions', 'organizations_url': 'https://api.github.com/users/pbelevich/orgs', 'repos_url': 'https://api.github.com/users/pbelevich/repos', 'events_url': 'https://api.github.com/users/pbelevich/events{/privacy}', 'received_events_url': 'https://api.github.com/users/pbelevich/received_events', 'type': 'User', 'site_admin': False}",referenced,236a3e2be46fc03145780d72948c8bf159fce96d,https://api.github.com/repos/pytorch/pytorch/commits/236a3e2be46fc03145780d72948c8bf159fce96d,2020-02-07T02:47:41Z,149,132,17
24752,3017910605,"{'login': 'pbelevich', 'id': 1160355, 'node_id': 'MDQ6VXNlcjExNjAzNTU=', 'avatar_url': 'https://avatars1.githubusercontent.com/u/1160355?v=4', 'gravatar_id': '', 'url': 'https://api.github.com/users/pbelevich', 'html_url': 'https://github.com/pbelevich', 'followers_url': 'https://api.github.com/users/pbelevich/followers', 'following_url': 'https://api.github.com/users/pbelevich/following{/other_user}', 'gists_url': 'https://api.github.com/users/pbelevich/gists{/gist_id}', 'starred_url': 'https://api.github.com/users/pbelevich/starred{/owner}{/repo}', 'subscriptions_url': 'https://api.github.com/users/pbelevich/subscriptions', 'organizations_url': 'https://api.github.com/users/pbelevich/orgs', 'repos_url': 'https://api.github.com/users/pbelevich/repos', 'events_url': 'https://api.github.com/users/pbelevich/events{/privacy}', 'received_events_url': 'https://api.github.com/users/pbelevich/received_events', 'type': 'User', 'site_admin': False}",referenced,5d4bda9b056975a7cf3875f862db06939979c7bd,https://api.github.com/repos/pytorch/pytorch/commits/5d4bda9b056975a7cf3875f862db06939979c7bd,2020-02-07T14:47:55Z,263,190,73
24752,3021148116,"{'login': 'pbelevich', 'id': 1160355, 'node_id': 'MDQ6VXNlcjExNjAzNTU=', 'avatar_url': 'https://avatars1.githubusercontent.com/u/1160355?v=4', 'gravatar_id': '', 'url': 'https://api.github.com/users/pbelevich', 'html_url': 'https://github.com/pbelevich', 'followers_url': 'https://api.github.com/users/pbelevich/followers', 'following_url': 'https://api.github.com/users/pbelevich/following{/other_user}', 'gists_url': 'https://api.github.com/users/pbelevich/gists{/gist_id}', 'starred_url': 'https://api.github.com/users/pbelevich/starred{/owner}{/repo}', 'subscriptions_url': 'https://api.github.com/users/pbelevich/subscriptions', 'organizations_url': 'https://api.github.com/users/pbelevich/orgs', 'repos_url': 'https://api.github.com/users/pbelevich/repos', 'events_url': 'https://api.github.com/users/pbelevich/events{/privacy}', 'received_events_url': 'https://api.github.com/users/pbelevich/received_events', 'type': 'User', 'site_admin': False}",referenced,a82ca171eee32350b458f5bbc637646bca85c775,https://api.github.com/repos/pytorch/pytorch/commits/a82ca171eee32350b458f5bbc637646bca85c775,2020-02-10T02:38:51Z,1266,833,433
24752,3023272050,"{'login': 'pbelevich', 'id': 1160355, 'node_id': 'MDQ6VXNlcjExNjAzNTU=', 'avatar_url': 'https://avatars1.githubusercontent.com/u/1160355?v=4', 'gravatar_id': '', 'url': 'https://api.github.com/users/pbelevich', 'html_url': 'https://github.com/pbelevich', 'followers_url': 'https://api.github.com/users/pbelevich/followers', 'following_url': 'https://api.github.com/users/pbelevich/following{/other_user}', 'gists_url': 'https://api.github.com/users/pbelevich/gists{/gist_id}', 'starred_url': 'https://api.github.com/users/pbelevich/starred{/owner}{/repo}', 'subscriptions_url': 'https://api.github.com/users/pbelevich/subscriptions', 'organizations_url': 'https://api.github.com/users/pbelevich/orgs', 'repos_url': 'https://api.github.com/users/pbelevich/repos', 'events_url': 'https://api.github.com/users/pbelevich/events{/privacy}', 'received_events_url': 'https://api.github.com/users/pbelevich/received_events', 'type': 'User', 'site_admin': False}",referenced,38e780ba37a0d3776b2d2a92b6b04a83e8fcb133,https://api.github.com/repos/pytorch/pytorch/commits/38e780ba37a0d3776b2d2a92b6b04a83e8fcb133,2020-02-10T15:49:45Z,318,211,107
24752,3032950004,"{'login': 'pbelevich', 'id': 1160355, 'node_id': 'MDQ6VXNlcjExNjAzNTU=', 'avatar_url': 'https://avatars1.githubusercontent.com/u/1160355?v=4', 'gravatar_id': '', 'url': 'https://api.github.com/users/pbelevich', 'html_url': 'https://github.com/pbelevich', 'followers_url': 'https://api.github.com/users/pbelevich/followers', 'following_url': 'https://api.github.com/users/pbelevich/following{/other_user}', 'gists_url': 'https://api.github.com/users/pbelevich/gists{/gist_id}', 'starred_url': 'https://api.github.com/users/pbelevich/starred{/owner}{/repo}', 'subscriptions_url': 'https://api.github.com/users/pbelevich/subscriptions', 'organizations_url': 'https://api.github.com/users/pbelevich/orgs', 'repos_url': 'https://api.github.com/users/pbelevich/repos', 'events_url': 'https://api.github.com/users/pbelevich/events{/privacy}', 'received_events_url': 'https://api.github.com/users/pbelevich/received_events', 'type': 'User', 'site_admin': False}",referenced,af147add7ee4e3067ca4a52a149574c8dab71c24,https://api.github.com/repos/pytorch/pytorch/commits/af147add7ee4e3067ca4a52a149574c8dab71c24,2020-02-13T00:11:09Z,4783,2866,1917
24752,3033038363,"{'login': 'pbelevich', 'id': 1160355, 'node_id': 'MDQ6VXNlcjExNjAzNTU=', 'avatar_url': 'https://avatars1.githubusercontent.com/u/1160355?v=4', 'gravatar_id': '', 'url': 'https://api.github.com/users/pbelevich', 'html_url': 'https://github.com/pbelevich', 'followers_url': 'https://api.github.com/users/pbelevich/followers', 'following_url': 'https://api.github.com/users/pbelevich/following{/other_user}', 'gists_url': 'https://api.github.com/users/pbelevich/gists{/gist_id}', 'starred_url': 'https://api.github.com/users/pbelevich/starred{/owner}{/repo}', 'subscriptions_url': 'https://api.github.com/users/pbelevich/subscriptions', 'organizations_url': 'https://api.github.com/users/pbelevich/orgs', 'repos_url': 'https://api.github.com/users/pbelevich/repos', 'events_url': 'https://api.github.com/users/pbelevich/events{/privacy}', 'received_events_url': 'https://api.github.com/users/pbelevich/received_events', 'type': 'User', 'site_admin': False}",referenced,e1d791f4cab9f3cf614bbe98cc4934de4e2e0240,https://api.github.com/repos/pytorch/pytorch/commits/e1d791f4cab9f3cf614bbe98cc4934de4e2e0240,2020-02-13T00:59:42Z,542,328,214
24752,3033076017,"{'login': 'pbelevich', 'id': 1160355, 'node_id': 'MDQ6VXNlcjExNjAzNTU=', 'avatar_url': 'https://avatars1.githubusercontent.com/u/1160355?v=4', 'gravatar_id': '', 'url': 'https://api.github.com/users/pbelevich', 'html_url': 'https://github.com/pbelevich', 'followers_url': 'https://api.github.com/users/pbelevich/followers', 'following_url': 'https://api.github.com/users/pbelevich/following{/other_user}', 'gists_url': 'https://api.github.com/users/pbelevich/gists{/gist_id}', 'starred_url': 'https://api.github.com/users/pbelevich/starred{/owner}{/repo}', 'subscriptions_url': 'https://api.github.com/users/pbelevich/subscriptions', 'organizations_url': 'https://api.github.com/users/pbelevich/orgs', 'repos_url': 'https://api.github.com/users/pbelevich/repos', 'events_url': 'https://api.github.com/users/pbelevich/events{/privacy}', 'received_events_url': 'https://api.github.com/users/pbelevich/received_events', 'type': 'User', 'site_admin': False}",referenced,ad96f1155dd778cbab94f1462c2d45f2c6c91ff9,https://api.github.com/repos/pytorch/pytorch/commits/ad96f1155dd778cbab94f1462c2d45f2c6c91ff9,2020-02-13T01:20:00Z,6,3,3
24752,3033145543,"{'login': 'pbelevich', 'id': 1160355, 'node_id': 'MDQ6VXNlcjExNjAzNTU=', 'avatar_url': 'https://avatars1.githubusercontent.com/u/1160355?v=4', 'gravatar_id': '', 'url': 'https://api.github.com/users/pbelevich', 'html_url': 'https://github.com/pbelevich', 'followers_url': 'https://api.github.com/users/pbelevich/followers', 'following_url': 'https://api.github.com/users/pbelevich/following{/other_user}', 'gists_url': 'https://api.github.com/users/pbelevich/gists{/gist_id}', 'starred_url': 'https://api.github.com/users/pbelevich/starred{/owner}{/repo}', 'subscriptions_url': 'https://api.github.com/users/pbelevich/subscriptions', 'organizations_url': 'https://api.github.com/users/pbelevich/orgs', 'repos_url': 'https://api.github.com/users/pbelevich/repos', 'events_url': 'https://api.github.com/users/pbelevich/events{/privacy}', 'received_events_url': 'https://api.github.com/users/pbelevich/received_events', 'type': 'User', 'site_admin': False}",referenced,e33fc3a60cf59123db68ff57e608b37dea5eaaf8,https://api.github.com/repos/pytorch/pytorch/commits/e33fc3a60cf59123db68ff57e608b37dea5eaaf8,2020-02-13T02:00:29Z,37,28,9
24752,3034894918,"{'login': 'pbelevich', 'id': 1160355, 'node_id': 'MDQ6VXNlcjExNjAzNTU=', 'avatar_url': 'https://avatars1.githubusercontent.com/u/1160355?v=4', 'gravatar_id': '', 'url': 'https://api.github.com/users/pbelevich', 'html_url': 'https://github.com/pbelevich', 'followers_url': 'https://api.github.com/users/pbelevich/followers', 'following_url': 'https://api.github.com/users/pbelevich/following{/other_user}', 'gists_url': 'https://api.github.com/users/pbelevich/gists{/gist_id}', 'starred_url': 'https://api.github.com/users/pbelevich/starred{/owner}{/repo}', 'subscriptions_url': 'https://api.github.com/users/pbelevich/subscriptions', 'organizations_url': 'https://api.github.com/users/pbelevich/orgs', 'repos_url': 'https://api.github.com/users/pbelevich/repos', 'events_url': 'https://api.github.com/users/pbelevich/events{/privacy}', 'received_events_url': 'https://api.github.com/users/pbelevich/received_events', 'type': 'User', 'site_admin': False}",referenced,92cbd0ec371dc025195f33352c6947b4c037c237,https://api.github.com/repos/pytorch/pytorch/commits/92cbd0ec371dc025195f33352c6947b4c037c237,2020-02-13T13:44:11Z,621,429,192
24752,3034901024,"{'login': 'pbelevich', 'id': 1160355, 'node_id': 'MDQ6VXNlcjExNjAzNTU=', 'avatar_url': 'https://avatars1.githubusercontent.com/u/1160355?v=4', 'gravatar_id': '', 'url': 'https://api.github.com/users/pbelevich', 'html_url': 'https://github.com/pbelevich', 'followers_url': 'https://api.github.com/users/pbelevich/followers', 'following_url': 'https://api.github.com/users/pbelevich/following{/other_user}', 'gists_url': 'https://api.github.com/users/pbelevich/gists{/gist_id}', 'starred_url': 'https://api.github.com/users/pbelevich/starred{/owner}{/repo}', 'subscriptions_url': 'https://api.github.com/users/pbelevich/subscriptions', 'organizations_url': 'https://api.github.com/users/pbelevich/orgs', 'repos_url': 'https://api.github.com/users/pbelevich/repos', 'events_url': 'https://api.github.com/users/pbelevich/events{/privacy}', 'received_events_url': 'https://api.github.com/users/pbelevich/received_events', 'type': 'User', 'site_admin': False}",referenced,91dfd386e156364790b6d5b04022b82808944eca,https://api.github.com/repos/pytorch/pytorch/commits/91dfd386e156364790b6d5b04022b82808944eca,2020-02-13T13:45:50Z,2,0,2
24750,2591119463,"{'login': 'facebook-github-bot', 'id': 6422482, 'node_id': 'MDQ6VXNlcjY0MjI0ODI=', 'avatar_url': 'https://avatars3.githubusercontent.com/u/6422482?v=4', 'gravatar_id': '', 'url': 'https://api.github.com/users/facebook-github-bot', 'html_url': 'https://github.com/facebook-github-bot', 'followers_url': 'https://api.github.com/users/facebook-github-bot/followers', 'following_url': 'https://api.github.com/users/facebook-github-bot/following{/other_user}', 'gists_url': 'https://api.github.com/users/facebook-github-bot/gists{/gist_id}', 'starred_url': 'https://api.github.com/users/facebook-github-bot/starred{/owner}{/repo}', 'subscriptions_url': 'https://api.github.com/users/facebook-github-bot/subscriptions', 'organizations_url': 'https://api.github.com/users/facebook-github-bot/orgs', 'repos_url': 'https://api.github.com/users/facebook-github-bot/repos', 'events_url': 'https://api.github.com/users/facebook-github-bot/events{/privacy}', 'received_events_url': 'https://api.github.com/users/facebook-github-bot/received_events', 'type': 'User', 'site_admin': False}",referenced,112f249446dcfcad3d570c5eb2dfee0f28bc3fb7,https://api.github.com/repos/pytorch/pytorch/commits/112f249446dcfcad3d570c5eb2dfee0f28bc3fb7,2019-08-28T16:12:00Z,960,759,201
24746,3012485206,"{'login': 'facebook-github-bot', 'id': 6422482, 'node_id': 'MDQ6VXNlcjY0MjI0ODI=', 'avatar_url': 'https://avatars3.githubusercontent.com/u/6422482?v=4', 'gravatar_id': '', 'url': 'https://api.github.com/users/facebook-github-bot', 'html_url': 'https://github.com/facebook-github-bot', 'followers_url': 'https://api.github.com/users/facebook-github-bot/followers', 'following_url': 'https://api.github.com/users/facebook-github-bot/following{/other_user}', 'gists_url': 'https://api.github.com/users/facebook-github-bot/gists{/gist_id}', 'starred_url': 'https://api.github.com/users/facebook-github-bot/starred{/owner}{/repo}', 'subscriptions_url': 'https://api.github.com/users/facebook-github-bot/subscriptions', 'organizations_url': 'https://api.github.com/users/facebook-github-bot/orgs', 'repos_url': 'https://api.github.com/users/facebook-github-bot/repos', 'events_url': 'https://api.github.com/users/facebook-github-bot/events{/privacy}', 'received_events_url': 'https://api.github.com/users/facebook-github-bot/received_events', 'type': 'User', 'site_admin': False}",closed,b00345a6f2660e14cf5eed7d115675314ddf4d0c,https://api.github.com/repos/pytorch/pytorch/commits/b00345a6f2660e14cf5eed7d115675314ddf4d0c,2020-02-06T04:41:08Z,363,176,187
24740,2670200178,"{'login': 'facebook-github-bot', 'id': 6422482, 'node_id': 'MDQ6VXNlcjY0MjI0ODI=', 'avatar_url': 'https://avatars3.githubusercontent.com/u/6422482?v=4', 'gravatar_id': '', 'url': 'https://api.github.com/users/facebook-github-bot', 'html_url': 'https://github.com/facebook-github-bot', 'followers_url': 'https://api.github.com/users/facebook-github-bot/followers', 'following_url': 'https://api.github.com/users/facebook-github-bot/following{/other_user}', 'gists_url': 'https://api.github.com/users/facebook-github-bot/gists{/gist_id}', 'starred_url': 'https://api.github.com/users/facebook-github-bot/starred{/owner}{/repo}', 'subscriptions_url': 'https://api.github.com/users/facebook-github-bot/subscriptions', 'organizations_url': 'https://api.github.com/users/facebook-github-bot/orgs', 'repos_url': 'https://api.github.com/users/facebook-github-bot/repos', 'events_url': 'https://api.github.com/users/facebook-github-bot/events{/privacy}', 'received_events_url': 'https://api.github.com/users/facebook-github-bot/received_events', 'type': 'User', 'site_admin': False}",referenced,541de7e140e35eced300c8b0f31218bb6320d183,https://api.github.com/repos/pytorch/pytorch/commits/541de7e140e35eced300c8b0f31218bb6320d183,2019-09-28T00:29:07Z,1553,335,1218
24738,2604240098,"{'login': 'facebook-github-bot', 'id': 6422482, 'node_id': 'MDQ6VXNlcjY0MjI0ODI=', 'avatar_url': 'https://avatars3.githubusercontent.com/u/6422482?v=4', 'gravatar_id': '', 'url': 'https://api.github.com/users/facebook-github-bot', 'html_url': 'https://github.com/facebook-github-bot', 'followers_url': 'https://api.github.com/users/facebook-github-bot/followers', 'following_url': 'https://api.github.com/users/facebook-github-bot/following{/other_user}', 'gists_url': 'https://api.github.com/users/facebook-github-bot/gists{/gist_id}', 'starred_url': 'https://api.github.com/users/facebook-github-bot/starred{/owner}{/repo}', 'subscriptions_url': 'https://api.github.com/users/facebook-github-bot/subscriptions', 'organizations_url': 'https://api.github.com/users/facebook-github-bot/orgs', 'repos_url': 'https://api.github.com/users/facebook-github-bot/repos', 'events_url': 'https://api.github.com/users/facebook-github-bot/events{/privacy}', 'received_events_url': 'https://api.github.com/users/facebook-github-bot/received_events', 'type': 'User', 'site_admin': False}",referenced,c89301a6250ca17c568f11e52f715f939c08d7ce,https://api.github.com/repos/pytorch/pytorch/commits/c89301a6250ca17c568f11e52f715f939c08d7ce,2019-09-03T16:38:38Z,361,163,198
24727,2666936660,"{'login': 'facebook-github-bot', 'id': 6422482, 'node_id': 'MDQ6VXNlcjY0MjI0ODI=', 'avatar_url': 'https://avatars3.githubusercontent.com/u/6422482?v=4', 'gravatar_id': '', 'url': 'https://api.github.com/users/facebook-github-bot', 'html_url': 'https://github.com/facebook-github-bot', 'followers_url': 'https://api.github.com/users/facebook-github-bot/followers', 'following_url': 'https://api.github.com/users/facebook-github-bot/following{/other_user}', 'gists_url': 'https://api.github.com/users/facebook-github-bot/gists{/gist_id}', 'starred_url': 'https://api.github.com/users/facebook-github-bot/starred{/owner}{/repo}', 'subscriptions_url': 'https://api.github.com/users/facebook-github-bot/subscriptions', 'organizations_url': 'https://api.github.com/users/facebook-github-bot/orgs', 'repos_url': 'https://api.github.com/users/facebook-github-bot/repos', 'events_url': 'https://api.github.com/users/facebook-github-bot/events{/privacy}', 'received_events_url': 'https://api.github.com/users/facebook-github-bot/received_events', 'type': 'User', 'site_admin': False}",referenced,f99bc714c7bacf9a74c85514ef70b677415d4f0c,https://api.github.com/repos/pytorch/pytorch/commits/f99bc714c7bacf9a74c85514ef70b677415d4f0c,2019-09-26T23:05:50Z,462,264,198
24725,2935995162,"{'login': 'facebook-github-bot', 'id': 6422482, 'node_id': 'MDQ6VXNlcjY0MjI0ODI=', 'avatar_url': 'https://avatars3.githubusercontent.com/u/6422482?v=4', 'gravatar_id': '', 'url': 'https://api.github.com/users/facebook-github-bot', 'html_url': 'https://github.com/facebook-github-bot', 'followers_url': 'https://api.github.com/users/facebook-github-bot/followers', 'following_url': 'https://api.github.com/users/facebook-github-bot/following{/other_user}', 'gists_url': 'https://api.github.com/users/facebook-github-bot/gists{/gist_id}', 'starred_url': 'https://api.github.com/users/facebook-github-bot/starred{/owner}{/repo}', 'subscriptions_url': 'https://api.github.com/users/facebook-github-bot/subscriptions', 'organizations_url': 'https://api.github.com/users/facebook-github-bot/orgs', 'repos_url': 'https://api.github.com/users/facebook-github-bot/repos', 'events_url': 'https://api.github.com/users/facebook-github-bot/events{/privacy}', 'received_events_url': 'https://api.github.com/users/facebook-github-bot/received_events', 'type': 'User', 'site_admin': False}",referenced,99b3f9cac47ba18d24a446d366f63796e18899eb,https://api.github.com/repos/pytorch/pytorch/commits/99b3f9cac47ba18d24a446d366f63796e18899eb,2020-01-09T18:30:16Z,183,113,70
24724,2935995153,"{'login': 'facebook-github-bot', 'id': 6422482, 'node_id': 'MDQ6VXNlcjY0MjI0ODI=', 'avatar_url': 'https://avatars3.githubusercontent.com/u/6422482?v=4', 'gravatar_id': '', 'url': 'https://api.github.com/users/facebook-github-bot', 'html_url': 'https://github.com/facebook-github-bot', 'followers_url': 'https://api.github.com/users/facebook-github-bot/followers', 'following_url': 'https://api.github.com/users/facebook-github-bot/following{/other_user}', 'gists_url': 'https://api.github.com/users/facebook-github-bot/gists{/gist_id}', 'starred_url': 'https://api.github.com/users/facebook-github-bot/starred{/owner}{/repo}', 'subscriptions_url': 'https://api.github.com/users/facebook-github-bot/subscriptions', 'organizations_url': 'https://api.github.com/users/facebook-github-bot/orgs', 'repos_url': 'https://api.github.com/users/facebook-github-bot/repos', 'events_url': 'https://api.github.com/users/facebook-github-bot/events{/privacy}', 'received_events_url': 'https://api.github.com/users/facebook-github-bot/received_events', 'type': 'User', 'site_admin': False}",closed,99b3f9cac47ba18d24a446d366f63796e18899eb,https://api.github.com/repos/pytorch/pytorch/commits/99b3f9cac47ba18d24a446d366f63796e18899eb,2020-01-09T18:30:16Z,183,113,70
24723,2968540538,"{'login': 'facebook-github-bot', 'id': 6422482, 'node_id': 'MDQ6VXNlcjY0MjI0ODI=', 'avatar_url': 'https://avatars3.githubusercontent.com/u/6422482?v=4', 'gravatar_id': '', 'url': 'https://api.github.com/users/facebook-github-bot', 'html_url': 'https://github.com/facebook-github-bot', 'followers_url': 'https://api.github.com/users/facebook-github-bot/followers', 'following_url': 'https://api.github.com/users/facebook-github-bot/following{/other_user}', 'gists_url': 'https://api.github.com/users/facebook-github-bot/gists{/gist_id}', 'starred_url': 'https://api.github.com/users/facebook-github-bot/starred{/owner}{/repo}', 'subscriptions_url': 'https://api.github.com/users/facebook-github-bot/subscriptions', 'organizations_url': 'https://api.github.com/users/facebook-github-bot/orgs', 'repos_url': 'https://api.github.com/users/facebook-github-bot/repos', 'events_url': 'https://api.github.com/users/facebook-github-bot/events{/privacy}', 'received_events_url': 'https://api.github.com/users/facebook-github-bot/received_events', 'type': 'User', 'site_admin': False}",closed,64de93d8e7c6ba085997b18bcf85681b330d9afb,https://api.github.com/repos/pytorch/pytorch/commits/64de93d8e7c6ba085997b18bcf85681b330d9afb,2020-01-22T03:08:58Z,60,23,37
24722,2648479360,"{'login': 'facebook-github-bot', 'id': 6422482, 'node_id': 'MDQ6VXNlcjY0MjI0ODI=', 'avatar_url': 'https://avatars3.githubusercontent.com/u/6422482?v=4', 'gravatar_id': '', 'url': 'https://api.github.com/users/facebook-github-bot', 'html_url': 'https://github.com/facebook-github-bot', 'followers_url': 'https://api.github.com/users/facebook-github-bot/followers', 'following_url': 'https://api.github.com/users/facebook-github-bot/following{/other_user}', 'gists_url': 'https://api.github.com/users/facebook-github-bot/gists{/gist_id}', 'starred_url': 'https://api.github.com/users/facebook-github-bot/starred{/owner}{/repo}', 'subscriptions_url': 'https://api.github.com/users/facebook-github-bot/subscriptions', 'organizations_url': 'https://api.github.com/users/facebook-github-bot/orgs', 'repos_url': 'https://api.github.com/users/facebook-github-bot/repos', 'events_url': 'https://api.github.com/users/facebook-github-bot/events{/privacy}', 'received_events_url': 'https://api.github.com/users/facebook-github-bot/received_events', 'type': 'User', 'site_admin': False}",referenced,454bf21b367002556ce9a92a919eed884375d4c6,https://api.github.com/repos/pytorch/pytorch/commits/454bf21b367002556ce9a92a919eed884375d4c6,2019-09-19T21:33:15Z,23,18,5
24721,2895065994,"{'login': 'facebook-github-bot', 'id': 6422482, 'node_id': 'MDQ6VXNlcjY0MjI0ODI=', 'avatar_url': 'https://avatars3.githubusercontent.com/u/6422482?v=4', 'gravatar_id': '', 'url': 'https://api.github.com/users/facebook-github-bot', 'html_url': 'https://github.com/facebook-github-bot', 'followers_url': 'https://api.github.com/users/facebook-github-bot/followers', 'following_url': 'https://api.github.com/users/facebook-github-bot/following{/other_user}', 'gists_url': 'https://api.github.com/users/facebook-github-bot/gists{/gist_id}', 'starred_url': 'https://api.github.com/users/facebook-github-bot/starred{/owner}{/repo}', 'subscriptions_url': 'https://api.github.com/users/facebook-github-bot/subscriptions', 'organizations_url': 'https://api.github.com/users/facebook-github-bot/orgs', 'repos_url': 'https://api.github.com/users/facebook-github-bot/repos', 'events_url': 'https://api.github.com/users/facebook-github-bot/events{/privacy}', 'received_events_url': 'https://api.github.com/users/facebook-github-bot/received_events', 'type': 'User', 'site_admin': False}",referenced,7cf8b9bada11fcdf81fe709fd7fba7cd5e9f1bb8,https://api.github.com/repos/pytorch/pytorch/commits/7cf8b9bada11fcdf81fe709fd7fba7cd5e9f1bb8,2019-12-18T21:14:21Z,357,114,243
24720,2895066029,"{'login': 'facebook-github-bot', 'id': 6422482, 'node_id': 'MDQ6VXNlcjY0MjI0ODI=', 'avatar_url': 'https://avatars3.githubusercontent.com/u/6422482?v=4', 'gravatar_id': '', 'url': 'https://api.github.com/users/facebook-github-bot', 'html_url': 'https://github.com/facebook-github-bot', 'followers_url': 'https://api.github.com/users/facebook-github-bot/followers', 'following_url': 'https://api.github.com/users/facebook-github-bot/following{/other_user}', 'gists_url': 'https://api.github.com/users/facebook-github-bot/gists{/gist_id}', 'starred_url': 'https://api.github.com/users/facebook-github-bot/starred{/owner}{/repo}', 'subscriptions_url': 'https://api.github.com/users/facebook-github-bot/subscriptions', 'organizations_url': 'https://api.github.com/users/facebook-github-bot/orgs', 'repos_url': 'https://api.github.com/users/facebook-github-bot/repos', 'events_url': 'https://api.github.com/users/facebook-github-bot/events{/privacy}', 'received_events_url': 'https://api.github.com/users/facebook-github-bot/received_events', 'type': 'User', 'site_admin': False}",referenced,7cf8b9bada11fcdf81fe709fd7fba7cd5e9f1bb8,https://api.github.com/repos/pytorch/pytorch/commits/7cf8b9bada11fcdf81fe709fd7fba7cd5e9f1bb8,2019-12-18T21:14:22Z,357,114,243
24719,2670200189,"{'login': 'facebook-github-bot', 'id': 6422482, 'node_id': 'MDQ6VXNlcjY0MjI0ODI=', 'avatar_url': 'https://avatars3.githubusercontent.com/u/6422482?v=4', 'gravatar_id': '', 'url': 'https://api.github.com/users/facebook-github-bot', 'html_url': 'https://github.com/facebook-github-bot', 'followers_url': 'https://api.github.com/users/facebook-github-bot/followers', 'following_url': 'https://api.github.com/users/facebook-github-bot/following{/other_user}', 'gists_url': 'https://api.github.com/users/facebook-github-bot/gists{/gist_id}', 'starred_url': 'https://api.github.com/users/facebook-github-bot/starred{/owner}{/repo}', 'subscriptions_url': 'https://api.github.com/users/facebook-github-bot/subscriptions', 'organizations_url': 'https://api.github.com/users/facebook-github-bot/orgs', 'repos_url': 'https://api.github.com/users/facebook-github-bot/repos', 'events_url': 'https://api.github.com/users/facebook-github-bot/events{/privacy}', 'received_events_url': 'https://api.github.com/users/facebook-github-bot/received_events', 'type': 'User', 'site_admin': False}",referenced,541de7e140e35eced300c8b0f31218bb6320d183,https://api.github.com/repos/pytorch/pytorch/commits/541de7e140e35eced300c8b0f31218bb6320d183,2019-09-28T00:29:07Z,1553,335,1218
24709,2670200182,"{'login': 'facebook-github-bot', 'id': 6422482, 'node_id': 'MDQ6VXNlcjY0MjI0ODI=', 'avatar_url': 'https://avatars3.githubusercontent.com/u/6422482?v=4', 'gravatar_id': '', 'url': 'https://api.github.com/users/facebook-github-bot', 'html_url': 'https://github.com/facebook-github-bot', 'followers_url': 'https://api.github.com/users/facebook-github-bot/followers', 'following_url': 'https://api.github.com/users/facebook-github-bot/following{/other_user}', 'gists_url': 'https://api.github.com/users/facebook-github-bot/gists{/gist_id}', 'starred_url': 'https://api.github.com/users/facebook-github-bot/starred{/owner}{/repo}', 'subscriptions_url': 'https://api.github.com/users/facebook-github-bot/subscriptions', 'organizations_url': 'https://api.github.com/users/facebook-github-bot/orgs', 'repos_url': 'https://api.github.com/users/facebook-github-bot/repos', 'events_url': 'https://api.github.com/users/facebook-github-bot/events{/privacy}', 'received_events_url': 'https://api.github.com/users/facebook-github-bot/received_events', 'type': 'User', 'site_admin': False}",referenced,541de7e140e35eced300c8b0f31218bb6320d183,https://api.github.com/repos/pytorch/pytorch/commits/541de7e140e35eced300c8b0f31218bb6320d183,2019-09-28T00:29:07Z,1553,335,1218
24704,2936045603,"{'login': 'facebook-github-bot', 'id': 6422482, 'node_id': 'MDQ6VXNlcjY0MjI0ODI=', 'avatar_url': 'https://avatars3.githubusercontent.com/u/6422482?v=4', 'gravatar_id': '', 'url': 'https://api.github.com/users/facebook-github-bot', 'html_url': 'https://github.com/facebook-github-bot', 'followers_url': 'https://api.github.com/users/facebook-github-bot/followers', 'following_url': 'https://api.github.com/users/facebook-github-bot/following{/other_user}', 'gists_url': 'https://api.github.com/users/facebook-github-bot/gists{/gist_id}', 'starred_url': 'https://api.github.com/users/facebook-github-bot/starred{/owner}{/repo}', 'subscriptions_url': 'https://api.github.com/users/facebook-github-bot/subscriptions', 'organizations_url': 'https://api.github.com/users/facebook-github-bot/orgs', 'repos_url': 'https://api.github.com/users/facebook-github-bot/repos', 'events_url': 'https://api.github.com/users/facebook-github-bot/events{/privacy}', 'received_events_url': 'https://api.github.com/users/facebook-github-bot/received_events', 'type': 'User', 'site_admin': False}",closed,e59e5ba5a3b9fc37af2c6ec9afb1432d3bb512bc,https://api.github.com/repos/pytorch/pytorch/commits/e59e5ba5a3b9fc37af2c6ec9afb1432d3bb512bc,2020-01-09T18:48:10Z,55,23,32
24703,2670200187,"{'login': 'facebook-github-bot', 'id': 6422482, 'node_id': 'MDQ6VXNlcjY0MjI0ODI=', 'avatar_url': 'https://avatars3.githubusercontent.com/u/6422482?v=4', 'gravatar_id': '', 'url': 'https://api.github.com/users/facebook-github-bot', 'html_url': 'https://github.com/facebook-github-bot', 'followers_url': 'https://api.github.com/users/facebook-github-bot/followers', 'following_url': 'https://api.github.com/users/facebook-github-bot/following{/other_user}', 'gists_url': 'https://api.github.com/users/facebook-github-bot/gists{/gist_id}', 'starred_url': 'https://api.github.com/users/facebook-github-bot/starred{/owner}{/repo}', 'subscriptions_url': 'https://api.github.com/users/facebook-github-bot/subscriptions', 'organizations_url': 'https://api.github.com/users/facebook-github-bot/orgs', 'repos_url': 'https://api.github.com/users/facebook-github-bot/repos', 'events_url': 'https://api.github.com/users/facebook-github-bot/events{/privacy}', 'received_events_url': 'https://api.github.com/users/facebook-github-bot/received_events', 'type': 'User', 'site_admin': False}",referenced,541de7e140e35eced300c8b0f31218bb6320d183,https://api.github.com/repos/pytorch/pytorch/commits/541de7e140e35eced300c8b0f31218bb6320d183,2019-09-28T00:29:07Z,1553,335,1218
24702,2975733396,"{'login': 'facebook-github-bot', 'id': 6422482, 'node_id': 'MDQ6VXNlcjY0MjI0ODI=', 'avatar_url': 'https://avatars3.githubusercontent.com/u/6422482?v=4', 'gravatar_id': '', 'url': 'https://api.github.com/users/facebook-github-bot', 'html_url': 'https://github.com/facebook-github-bot', 'followers_url': 'https://api.github.com/users/facebook-github-bot/followers', 'following_url': 'https://api.github.com/users/facebook-github-bot/following{/other_user}', 'gists_url': 'https://api.github.com/users/facebook-github-bot/gists{/gist_id}', 'starred_url': 'https://api.github.com/users/facebook-github-bot/starred{/owner}{/repo}', 'subscriptions_url': 'https://api.github.com/users/facebook-github-bot/subscriptions', 'organizations_url': 'https://api.github.com/users/facebook-github-bot/orgs', 'repos_url': 'https://api.github.com/users/facebook-github-bot/repos', 'events_url': 'https://api.github.com/users/facebook-github-bot/events{/privacy}', 'received_events_url': 'https://api.github.com/users/facebook-github-bot/received_events', 'type': 'User', 'site_admin': False}",referenced,d2f66083c5b64e64355eb0fc580cfa4230bd17d8,https://api.github.com/repos/pytorch/pytorch/commits/d2f66083c5b64e64355eb0fc580cfa4230bd17d8,2020-01-24T00:16:32Z,112,75,37
24699,2987839146,"{'login': 'facebook-github-bot', 'id': 6422482, 'node_id': 'MDQ6VXNlcjY0MjI0ODI=', 'avatar_url': 'https://avatars3.githubusercontent.com/u/6422482?v=4', 'gravatar_id': '', 'url': 'https://api.github.com/users/facebook-github-bot', 'html_url': 'https://github.com/facebook-github-bot', 'followers_url': 'https://api.github.com/users/facebook-github-bot/followers', 'following_url': 'https://api.github.com/users/facebook-github-bot/following{/other_user}', 'gists_url': 'https://api.github.com/users/facebook-github-bot/gists{/gist_id}', 'starred_url': 'https://api.github.com/users/facebook-github-bot/starred{/owner}{/repo}', 'subscriptions_url': 'https://api.github.com/users/facebook-github-bot/subscriptions', 'organizations_url': 'https://api.github.com/users/facebook-github-bot/orgs', 'repos_url': 'https://api.github.com/users/facebook-github-bot/repos', 'events_url': 'https://api.github.com/users/facebook-github-bot/events{/privacy}', 'received_events_url': 'https://api.github.com/users/facebook-github-bot/received_events', 'type': 'User', 'site_admin': False}",referenced,18aab32959dfd8e6d3780ae754925851998b47aa,https://api.github.com/repos/pytorch/pytorch/commits/18aab32959dfd8e6d3780ae754925851998b47aa,2020-01-29T01:00:38Z,92,50,42
24698,2577222554,"{'login': 'facebook-github-bot', 'id': 6422482, 'node_id': 'MDQ6VXNlcjY0MjI0ODI=', 'avatar_url': 'https://avatars3.githubusercontent.com/u/6422482?v=4', 'gravatar_id': '', 'url': 'https://api.github.com/users/facebook-github-bot', 'html_url': 'https://github.com/facebook-github-bot', 'followers_url': 'https://api.github.com/users/facebook-github-bot/followers', 'following_url': 'https://api.github.com/users/facebook-github-bot/following{/other_user}', 'gists_url': 'https://api.github.com/users/facebook-github-bot/gists{/gist_id}', 'starred_url': 'https://api.github.com/users/facebook-github-bot/starred{/owner}{/repo}', 'subscriptions_url': 'https://api.github.com/users/facebook-github-bot/subscriptions', 'organizations_url': 'https://api.github.com/users/facebook-github-bot/orgs', 'repos_url': 'https://api.github.com/users/facebook-github-bot/repos', 'events_url': 'https://api.github.com/users/facebook-github-bot/events{/privacy}', 'received_events_url': 'https://api.github.com/users/facebook-github-bot/received_events', 'type': 'User', 'site_admin': False}",referenced,901f9eaa8985e9d1a7b7acd27ee2e8630101e6a4,https://api.github.com/repos/pytorch/pytorch/commits/901f9eaa8985e9d1a7b7acd27ee2e8630101e6a4,2019-08-22T17:13:39Z,196,128,68
24696,2670200184,"{'login': 'facebook-github-bot', 'id': 6422482, 'node_id': 'MDQ6VXNlcjY0MjI0ODI=', 'avatar_url': 'https://avatars3.githubusercontent.com/u/6422482?v=4', 'gravatar_id': '', 'url': 'https://api.github.com/users/facebook-github-bot', 'html_url': 'https://github.com/facebook-github-bot', 'followers_url': 'https://api.github.com/users/facebook-github-bot/followers', 'following_url': 'https://api.github.com/users/facebook-github-bot/following{/other_user}', 'gists_url': 'https://api.github.com/users/facebook-github-bot/gists{/gist_id}', 'starred_url': 'https://api.github.com/users/facebook-github-bot/starred{/owner}{/repo}', 'subscriptions_url': 'https://api.github.com/users/facebook-github-bot/subscriptions', 'organizations_url': 'https://api.github.com/users/facebook-github-bot/orgs', 'repos_url': 'https://api.github.com/users/facebook-github-bot/repos', 'events_url': 'https://api.github.com/users/facebook-github-bot/events{/privacy}', 'received_events_url': 'https://api.github.com/users/facebook-github-bot/received_events', 'type': 'User', 'site_admin': False}",referenced,541de7e140e35eced300c8b0f31218bb6320d183,https://api.github.com/repos/pytorch/pytorch/commits/541de7e140e35eced300c8b0f31218bb6320d183,2019-09-28T00:29:07Z,1553,335,1218
24686,2597704189,"{'login': 'facebook-github-bot', 'id': 6422482, 'node_id': 'MDQ6VXNlcjY0MjI0ODI=', 'avatar_url': 'https://avatars3.githubusercontent.com/u/6422482?v=4', 'gravatar_id': '', 'url': 'https://api.github.com/users/facebook-github-bot', 'html_url': 'https://github.com/facebook-github-bot', 'followers_url': 'https://api.github.com/users/facebook-github-bot/followers', 'following_url': 'https://api.github.com/users/facebook-github-bot/following{/other_user}', 'gists_url': 'https://api.github.com/users/facebook-github-bot/gists{/gist_id}', 'starred_url': 'https://api.github.com/users/facebook-github-bot/starred{/owner}{/repo}', 'subscriptions_url': 'https://api.github.com/users/facebook-github-bot/subscriptions', 'organizations_url': 'https://api.github.com/users/facebook-github-bot/orgs', 'repos_url': 'https://api.github.com/users/facebook-github-bot/repos', 'events_url': 'https://api.github.com/users/facebook-github-bot/events{/privacy}', 'received_events_url': 'https://api.github.com/users/facebook-github-bot/received_events', 'type': 'User', 'site_admin': False}",referenced,1a92b225db8519ab4697954a5559674f58e91aa7,https://api.github.com/repos/pytorch/pytorch/commits/1a92b225db8519ab4697954a5559674f58e91aa7,2019-08-30T16:27:08Z,240,190,50
24684,2933047833,"{'login': 'facebook-github-bot', 'id': 6422482, 'node_id': 'MDQ6VXNlcjY0MjI0ODI=', 'avatar_url': 'https://avatars3.githubusercontent.com/u/6422482?v=4', 'gravatar_id': '', 'url': 'https://api.github.com/users/facebook-github-bot', 'html_url': 'https://github.com/facebook-github-bot', 'followers_url': 'https://api.github.com/users/facebook-github-bot/followers', 'following_url': 'https://api.github.com/users/facebook-github-bot/following{/other_user}', 'gists_url': 'https://api.github.com/users/facebook-github-bot/gists{/gist_id}', 'starred_url': 'https://api.github.com/users/facebook-github-bot/starred{/owner}{/repo}', 'subscriptions_url': 'https://api.github.com/users/facebook-github-bot/subscriptions', 'organizations_url': 'https://api.github.com/users/facebook-github-bot/orgs', 'repos_url': 'https://api.github.com/users/facebook-github-bot/repos', 'events_url': 'https://api.github.com/users/facebook-github-bot/events{/privacy}', 'received_events_url': 'https://api.github.com/users/facebook-github-bot/received_events', 'type': 'User', 'site_admin': False}",closed,9a3cb1e859495477d95bf5fb5255e02fd4df82b5,https://api.github.com/repos/pytorch/pytorch/commits/9a3cb1e859495477d95bf5fb5255e02fd4df82b5,2020-01-08T23:11:05Z,69,28,41
24664,2793460949,"{'login': 'facebook-github-bot', 'id': 6422482, 'node_id': 'MDQ6VXNlcjY0MjI0ODI=', 'avatar_url': 'https://avatars3.githubusercontent.com/u/6422482?v=4', 'gravatar_id': '', 'url': 'https://api.github.com/users/facebook-github-bot', 'html_url': 'https://github.com/facebook-github-bot', 'followers_url': 'https://api.github.com/users/facebook-github-bot/followers', 'following_url': 'https://api.github.com/users/facebook-github-bot/following{/other_user}', 'gists_url': 'https://api.github.com/users/facebook-github-bot/gists{/gist_id}', 'starred_url': 'https://api.github.com/users/facebook-github-bot/starred{/owner}{/repo}', 'subscriptions_url': 'https://api.github.com/users/facebook-github-bot/subscriptions', 'organizations_url': 'https://api.github.com/users/facebook-github-bot/orgs', 'repos_url': 'https://api.github.com/users/facebook-github-bot/repos', 'events_url': 'https://api.github.com/users/facebook-github-bot/events{/privacy}', 'received_events_url': 'https://api.github.com/users/facebook-github-bot/received_events', 'type': 'User', 'site_admin': False}",closed,bd0394d47321c310bd6ff70d138e3ea648b79427,https://api.github.com/repos/pytorch/pytorch/commits/bd0394d47321c310bd6ff70d138e3ea648b79427,2019-11-13T00:14:16Z,355,186,169
24663,2939515891,"{'login': 'facebook-github-bot', 'id': 6422482, 'node_id': 'MDQ6VXNlcjY0MjI0ODI=', 'avatar_url': 'https://avatars3.githubusercontent.com/u/6422482?v=4', 'gravatar_id': '', 'url': 'https://api.github.com/users/facebook-github-bot', 'html_url': 'https://github.com/facebook-github-bot', 'followers_url': 'https://api.github.com/users/facebook-github-bot/followers', 'following_url': 'https://api.github.com/users/facebook-github-bot/following{/other_user}', 'gists_url': 'https://api.github.com/users/facebook-github-bot/gists{/gist_id}', 'starred_url': 'https://api.github.com/users/facebook-github-bot/starred{/owner}{/repo}', 'subscriptions_url': 'https://api.github.com/users/facebook-github-bot/subscriptions', 'organizations_url': 'https://api.github.com/users/facebook-github-bot/orgs', 'repos_url': 'https://api.github.com/users/facebook-github-bot/repos', 'events_url': 'https://api.github.com/users/facebook-github-bot/events{/privacy}', 'received_events_url': 'https://api.github.com/users/facebook-github-bot/received_events', 'type': 'User', 'site_admin': False}",referenced,8098ae455c82075acf78430b5d58c5067968b768,https://api.github.com/repos/pytorch/pytorch/commits/8098ae455c82075acf78430b5d58c5067968b768,2020-01-10T18:52:32Z,349,103,246
24662,2933043207,"{'login': 'facebook-github-bot', 'id': 6422482, 'node_id': 'MDQ6VXNlcjY0MjI0ODI=', 'avatar_url': 'https://avatars3.githubusercontent.com/u/6422482?v=4', 'gravatar_id': '', 'url': 'https://api.github.com/users/facebook-github-bot', 'html_url': 'https://github.com/facebook-github-bot', 'followers_url': 'https://api.github.com/users/facebook-github-bot/followers', 'following_url': 'https://api.github.com/users/facebook-github-bot/following{/other_user}', 'gists_url': 'https://api.github.com/users/facebook-github-bot/gists{/gist_id}', 'starred_url': 'https://api.github.com/users/facebook-github-bot/starred{/owner}{/repo}', 'subscriptions_url': 'https://api.github.com/users/facebook-github-bot/subscriptions', 'organizations_url': 'https://api.github.com/users/facebook-github-bot/orgs', 'repos_url': 'https://api.github.com/users/facebook-github-bot/repos', 'events_url': 'https://api.github.com/users/facebook-github-bot/events{/privacy}', 'received_events_url': 'https://api.github.com/users/facebook-github-bot/received_events', 'type': 'User', 'site_admin': False}",referenced,9ba6a768de929670c18a78f409c360543b240f09,https://api.github.com/repos/pytorch/pytorch/commits/9ba6a768de929670c18a78f409c360543b240f09,2020-01-08T23:08:40Z,399,191,208
24661,2935854575,"{'login': 'facebook-github-bot', 'id': 6422482, 'node_id': 'MDQ6VXNlcjY0MjI0ODI=', 'avatar_url': 'https://avatars3.githubusercontent.com/u/6422482?v=4', 'gravatar_id': '', 'url': 'https://api.github.com/users/facebook-github-bot', 'html_url': 'https://github.com/facebook-github-bot', 'followers_url': 'https://api.github.com/users/facebook-github-bot/followers', 'following_url': 'https://api.github.com/users/facebook-github-bot/following{/other_user}', 'gists_url': 'https://api.github.com/users/facebook-github-bot/gists{/gist_id}', 'starred_url': 'https://api.github.com/users/facebook-github-bot/starred{/owner}{/repo}', 'subscriptions_url': 'https://api.github.com/users/facebook-github-bot/subscriptions', 'organizations_url': 'https://api.github.com/users/facebook-github-bot/orgs', 'repos_url': 'https://api.github.com/users/facebook-github-bot/repos', 'events_url': 'https://api.github.com/users/facebook-github-bot/events{/privacy}', 'received_events_url': 'https://api.github.com/users/facebook-github-bot/received_events', 'type': 'User', 'site_admin': False}",referenced,5a76335aaac3435f763226da4b11406a9dce8c87,https://api.github.com/repos/pytorch/pytorch/commits/5a76335aaac3435f763226da4b11406a9dce8c87,2020-01-09T17:41:48Z,349,103,246
24660,2793460936,"{'login': 'facebook-github-bot', 'id': 6422482, 'node_id': 'MDQ6VXNlcjY0MjI0ODI=', 'avatar_url': 'https://avatars3.githubusercontent.com/u/6422482?v=4', 'gravatar_id': '', 'url': 'https://api.github.com/users/facebook-github-bot', 'html_url': 'https://github.com/facebook-github-bot', 'followers_url': 'https://api.github.com/users/facebook-github-bot/followers', 'following_url': 'https://api.github.com/users/facebook-github-bot/following{/other_user}', 'gists_url': 'https://api.github.com/users/facebook-github-bot/gists{/gist_id}', 'starred_url': 'https://api.github.com/users/facebook-github-bot/starred{/owner}{/repo}', 'subscriptions_url': 'https://api.github.com/users/facebook-github-bot/subscriptions', 'organizations_url': 'https://api.github.com/users/facebook-github-bot/orgs', 'repos_url': 'https://api.github.com/users/facebook-github-bot/repos', 'events_url': 'https://api.github.com/users/facebook-github-bot/events{/privacy}', 'received_events_url': 'https://api.github.com/users/facebook-github-bot/received_events', 'type': 'User', 'site_admin': False}",closed,bd0394d47321c310bd6ff70d138e3ea648b79427,https://api.github.com/repos/pytorch/pytorch/commits/bd0394d47321c310bd6ff70d138e3ea648b79427,2019-11-13T00:14:16Z,355,186,169
24659,2939515888,"{'login': 'facebook-github-bot', 'id': 6422482, 'node_id': 'MDQ6VXNlcjY0MjI0ODI=', 'avatar_url': 'https://avatars3.githubusercontent.com/u/6422482?v=4', 'gravatar_id': '', 'url': 'https://api.github.com/users/facebook-github-bot', 'html_url': 'https://github.com/facebook-github-bot', 'followers_url': 'https://api.github.com/users/facebook-github-bot/followers', 'following_url': 'https://api.github.com/users/facebook-github-bot/following{/other_user}', 'gists_url': 'https://api.github.com/users/facebook-github-bot/gists{/gist_id}', 'starred_url': 'https://api.github.com/users/facebook-github-bot/starred{/owner}{/repo}', 'subscriptions_url': 'https://api.github.com/users/facebook-github-bot/subscriptions', 'organizations_url': 'https://api.github.com/users/facebook-github-bot/orgs', 'repos_url': 'https://api.github.com/users/facebook-github-bot/repos', 'events_url': 'https://api.github.com/users/facebook-github-bot/events{/privacy}', 'received_events_url': 'https://api.github.com/users/facebook-github-bot/received_events', 'type': 'User', 'site_admin': False}",referenced,8098ae455c82075acf78430b5d58c5067968b768,https://api.github.com/repos/pytorch/pytorch/commits/8098ae455c82075acf78430b5d58c5067968b768,2020-01-10T18:52:32Z,349,103,246
24658,2933043205,"{'login': 'facebook-github-bot', 'id': 6422482, 'node_id': 'MDQ6VXNlcjY0MjI0ODI=', 'avatar_url': 'https://avatars3.githubusercontent.com/u/6422482?v=4', 'gravatar_id': '', 'url': 'https://api.github.com/users/facebook-github-bot', 'html_url': 'https://github.com/facebook-github-bot', 'followers_url': 'https://api.github.com/users/facebook-github-bot/followers', 'following_url': 'https://api.github.com/users/facebook-github-bot/following{/other_user}', 'gists_url': 'https://api.github.com/users/facebook-github-bot/gists{/gist_id}', 'starred_url': 'https://api.github.com/users/facebook-github-bot/starred{/owner}{/repo}', 'subscriptions_url': 'https://api.github.com/users/facebook-github-bot/subscriptions', 'organizations_url': 'https://api.github.com/users/facebook-github-bot/orgs', 'repos_url': 'https://api.github.com/users/facebook-github-bot/repos', 'events_url': 'https://api.github.com/users/facebook-github-bot/events{/privacy}', 'received_events_url': 'https://api.github.com/users/facebook-github-bot/received_events', 'type': 'User', 'site_admin': False}",referenced,9ba6a768de929670c18a78f409c360543b240f09,https://api.github.com/repos/pytorch/pytorch/commits/9ba6a768de929670c18a78f409c360543b240f09,2020-01-08T23:08:39Z,399,191,208
24657,2935854570,"{'login': 'facebook-github-bot', 'id': 6422482, 'node_id': 'MDQ6VXNlcjY0MjI0ODI=', 'avatar_url': 'https://avatars3.githubusercontent.com/u/6422482?v=4', 'gravatar_id': '', 'url': 'https://api.github.com/users/facebook-github-bot', 'html_url': 'https://github.com/facebook-github-bot', 'followers_url': 'https://api.github.com/users/facebook-github-bot/followers', 'following_url': 'https://api.github.com/users/facebook-github-bot/following{/other_user}', 'gists_url': 'https://api.github.com/users/facebook-github-bot/gists{/gist_id}', 'starred_url': 'https://api.github.com/users/facebook-github-bot/starred{/owner}{/repo}', 'subscriptions_url': 'https://api.github.com/users/facebook-github-bot/subscriptions', 'organizations_url': 'https://api.github.com/users/facebook-github-bot/orgs', 'repos_url': 'https://api.github.com/users/facebook-github-bot/repos', 'events_url': 'https://api.github.com/users/facebook-github-bot/events{/privacy}', 'received_events_url': 'https://api.github.com/users/facebook-github-bot/received_events', 'type': 'User', 'site_admin': False}",referenced,5a76335aaac3435f763226da4b11406a9dce8c87,https://api.github.com/repos/pytorch/pytorch/commits/5a76335aaac3435f763226da4b11406a9dce8c87,2020-01-09T17:41:48Z,349,103,246
24656,2920907424,"{'login': 'facebook-github-bot', 'id': 6422482, 'node_id': 'MDQ6VXNlcjY0MjI0ODI=', 'avatar_url': 'https://avatars3.githubusercontent.com/u/6422482?v=4', 'gravatar_id': '', 'url': 'https://api.github.com/users/facebook-github-bot', 'html_url': 'https://github.com/facebook-github-bot', 'followers_url': 'https://api.github.com/users/facebook-github-bot/followers', 'following_url': 'https://api.github.com/users/facebook-github-bot/following{/other_user}', 'gists_url': 'https://api.github.com/users/facebook-github-bot/gists{/gist_id}', 'starred_url': 'https://api.github.com/users/facebook-github-bot/starred{/owner}{/repo}', 'subscriptions_url': 'https://api.github.com/users/facebook-github-bot/subscriptions', 'organizations_url': 'https://api.github.com/users/facebook-github-bot/orgs', 'repos_url': 'https://api.github.com/users/facebook-github-bot/repos', 'events_url': 'https://api.github.com/users/facebook-github-bot/events{/privacy}', 'received_events_url': 'https://api.github.com/users/facebook-github-bot/received_events', 'type': 'User', 'site_admin': False}",referenced,b47e9b97a236d96da89c606fd053d33484f2227c,https://api.github.com/repos/pytorch/pytorch/commits/b47e9b97a236d96da89c606fd053d33484f2227c,2020-01-03T18:32:50Z,404,182,222
24655,2920907420,"{'login': 'facebook-github-bot', 'id': 6422482, 'node_id': 'MDQ6VXNlcjY0MjI0ODI=', 'avatar_url': 'https://avatars3.githubusercontent.com/u/6422482?v=4', 'gravatar_id': '', 'url': 'https://api.github.com/users/facebook-github-bot', 'html_url': 'https://github.com/facebook-github-bot', 'followers_url': 'https://api.github.com/users/facebook-github-bot/followers', 'following_url': 'https://api.github.com/users/facebook-github-bot/following{/other_user}', 'gists_url': 'https://api.github.com/users/facebook-github-bot/gists{/gist_id}', 'starred_url': 'https://api.github.com/users/facebook-github-bot/starred{/owner}{/repo}', 'subscriptions_url': 'https://api.github.com/users/facebook-github-bot/subscriptions', 'organizations_url': 'https://api.github.com/users/facebook-github-bot/orgs', 'repos_url': 'https://api.github.com/users/facebook-github-bot/repos', 'events_url': 'https://api.github.com/users/facebook-github-bot/events{/privacy}', 'received_events_url': 'https://api.github.com/users/facebook-github-bot/received_events', 'type': 'User', 'site_admin': False}",referenced,b47e9b97a236d96da89c606fd053d33484f2227c,https://api.github.com/repos/pytorch/pytorch/commits/b47e9b97a236d96da89c606fd053d33484f2227c,2020-01-03T18:32:50Z,404,182,222
24650,2595250440,"{'login': 'xuhdev', 'id': 325476, 'node_id': 'MDQ6VXNlcjMyNTQ3Ng==', 'avatar_url': 'https://avatars1.githubusercontent.com/u/325476?v=4', 'gravatar_id': '', 'url': 'https://api.github.com/users/xuhdev', 'html_url': 'https://github.com/xuhdev', 'followers_url': 'https://api.github.com/users/xuhdev/followers', 'following_url': 'https://api.github.com/users/xuhdev/following{/other_user}', 'gists_url': 'https://api.github.com/users/xuhdev/gists{/gist_id}', 'starred_url': 'https://api.github.com/users/xuhdev/starred{/owner}{/repo}', 'subscriptions_url': 'https://api.github.com/users/xuhdev/subscriptions', 'organizations_url': 'https://api.github.com/users/xuhdev/orgs', 'repos_url': 'https://api.github.com/users/xuhdev/repos', 'events_url': 'https://api.github.com/users/xuhdev/events{/privacy}', 'received_events_url': 'https://api.github.com/users/xuhdev/received_events', 'type': 'User', 'site_admin': False}",referenced,b6a2f2465c4ef347abb4f747153228a2c2984534,https://api.github.com/repos/pytorch/pytorch/commits/b6a2f2465c4ef347abb4f747153228a2c2984534,2019-08-29T20:30:51Z,51,17,34
24650,2595251001,"{'login': 'xuhdev', 'id': 325476, 'node_id': 'MDQ6VXNlcjMyNTQ3Ng==', 'avatar_url': 'https://avatars1.githubusercontent.com/u/325476?v=4', 'gravatar_id': '', 'url': 'https://api.github.com/users/xuhdev', 'html_url': 'https://github.com/xuhdev', 'followers_url': 'https://api.github.com/users/xuhdev/followers', 'following_url': 'https://api.github.com/users/xuhdev/following{/other_user}', 'gists_url': 'https://api.github.com/users/xuhdev/gists{/gist_id}', 'starred_url': 'https://api.github.com/users/xuhdev/starred{/owner}{/repo}', 'subscriptions_url': 'https://api.github.com/users/xuhdev/subscriptions', 'organizations_url': 'https://api.github.com/users/xuhdev/orgs', 'repos_url': 'https://api.github.com/users/xuhdev/repos', 'events_url': 'https://api.github.com/users/xuhdev/events{/privacy}', 'received_events_url': 'https://api.github.com/users/xuhdev/received_events', 'type': 'User', 'site_admin': False}",referenced,e3c1a923393924c097f8a7ae4a5436b2bbb0ce3b,https://api.github.com/repos/pytorch/pytorch/commits/e3c1a923393924c097f8a7ae4a5436b2bbb0ce3b,2019-08-29T20:31:03Z,51,17,34
24650,2604468424,"{'login': 'xuhdev', 'id': 325476, 'node_id': 'MDQ6VXNlcjMyNTQ3Ng==', 'avatar_url': 'https://avatars1.githubusercontent.com/u/325476?v=4', 'gravatar_id': '', 'url': 'https://api.github.com/users/xuhdev', 'html_url': 'https://github.com/xuhdev', 'followers_url': 'https://api.github.com/users/xuhdev/followers', 'following_url': 'https://api.github.com/users/xuhdev/following{/other_user}', 'gists_url': 'https://api.github.com/users/xuhdev/gists{/gist_id}', 'starred_url': 'https://api.github.com/users/xuhdev/starred{/owner}{/repo}', 'subscriptions_url': 'https://api.github.com/users/xuhdev/subscriptions', 'organizations_url': 'https://api.github.com/users/xuhdev/orgs', 'repos_url': 'https://api.github.com/users/xuhdev/repos', 'events_url': 'https://api.github.com/users/xuhdev/events{/privacy}', 'received_events_url': 'https://api.github.com/users/xuhdev/received_events', 'type': 'User', 'site_admin': False}",referenced,f43b059dc5d41311c988b86a7dfe320bc750c590,https://api.github.com/repos/pytorch/pytorch/commits/f43b059dc5d41311c988b86a7dfe320bc750c590,2019-09-03T17:53:32Z,51,17,34
24650,2604469137,"{'login': 'xuhdev', 'id': 325476, 'node_id': 'MDQ6VXNlcjMyNTQ3Ng==', 'avatar_url': 'https://avatars1.githubusercontent.com/u/325476?v=4', 'gravatar_id': '', 'url': 'https://api.github.com/users/xuhdev', 'html_url': 'https://github.com/xuhdev', 'followers_url': 'https://api.github.com/users/xuhdev/followers', 'following_url': 'https://api.github.com/users/xuhdev/following{/other_user}', 'gists_url': 'https://api.github.com/users/xuhdev/gists{/gist_id}', 'starred_url': 'https://api.github.com/users/xuhdev/starred{/owner}{/repo}', 'subscriptions_url': 'https://api.github.com/users/xuhdev/subscriptions', 'organizations_url': 'https://api.github.com/users/xuhdev/orgs', 'repos_url': 'https://api.github.com/users/xuhdev/repos', 'events_url': 'https://api.github.com/users/xuhdev/events{/privacy}', 'received_events_url': 'https://api.github.com/users/xuhdev/received_events', 'type': 'User', 'site_admin': False}",referenced,ac92a158fd45decd5cef94cacb6a320ba8d6a744,https://api.github.com/repos/pytorch/pytorch/commits/ac92a158fd45decd5cef94cacb6a320ba8d6a744,2019-09-03T17:53:47Z,16323,8639,7684
24650,2605107640,"{'login': 'xuhdev', 'id': 325476, 'node_id': 'MDQ6VXNlcjMyNTQ3Ng==', 'avatar_url': 'https://avatars1.githubusercontent.com/u/325476?v=4', 'gravatar_id': '', 'url': 'https://api.github.com/users/xuhdev', 'html_url': 'https://github.com/xuhdev', 'followers_url': 'https://api.github.com/users/xuhdev/followers', 'following_url': 'https://api.github.com/users/xuhdev/following{/other_user}', 'gists_url': 'https://api.github.com/users/xuhdev/gists{/gist_id}', 'starred_url': 'https://api.github.com/users/xuhdev/starred{/owner}{/repo}', 'subscriptions_url': 'https://api.github.com/users/xuhdev/subscriptions', 'organizations_url': 'https://api.github.com/users/xuhdev/orgs', 'repos_url': 'https://api.github.com/users/xuhdev/repos', 'events_url': 'https://api.github.com/users/xuhdev/events{/privacy}', 'received_events_url': 'https://api.github.com/users/xuhdev/received_events', 'type': 'User', 'site_admin': False}",referenced,02ceb83ed8eb2d4e9e7f24e2d58948ea47dcb7aa,https://api.github.com/repos/pytorch/pytorch/commits/02ceb83ed8eb2d4e9e7f24e2d58948ea47dcb7aa,2019-09-03T21:52:44Z,634,544,90
24650,2608657563,"{'login': 'xuhdev', 'id': 325476, 'node_id': 'MDQ6VXNlcjMyNTQ3Ng==', 'avatar_url': 'https://avatars1.githubusercontent.com/u/325476?v=4', 'gravatar_id': '', 'url': 'https://api.github.com/users/xuhdev', 'html_url': 'https://github.com/xuhdev', 'followers_url': 'https://api.github.com/users/xuhdev/followers', 'following_url': 'https://api.github.com/users/xuhdev/following{/other_user}', 'gists_url': 'https://api.github.com/users/xuhdev/gists{/gist_id}', 'starred_url': 'https://api.github.com/users/xuhdev/starred{/owner}{/repo}', 'subscriptions_url': 'https://api.github.com/users/xuhdev/subscriptions', 'organizations_url': 'https://api.github.com/users/xuhdev/orgs', 'repos_url': 'https://api.github.com/users/xuhdev/repos', 'events_url': 'https://api.github.com/users/xuhdev/events{/privacy}', 'received_events_url': 'https://api.github.com/users/xuhdev/received_events', 'type': 'User', 'site_admin': False}",referenced,718be8e9d4941edeae328fab2326734c11cab05a,https://api.github.com/repos/pytorch/pytorch/commits/718be8e9d4941edeae328fab2326734c11cab05a,2019-09-04T22:14:29Z,6747,4072,2675
24650,2612620964,"{'login': 'xuhdev', 'id': 325476, 'node_id': 'MDQ6VXNlcjMyNTQ3Ng==', 'avatar_url': 'https://avatars1.githubusercontent.com/u/325476?v=4', 'gravatar_id': '', 'url': 'https://api.github.com/users/xuhdev', 'html_url': 'https://github.com/xuhdev', 'followers_url': 'https://api.github.com/users/xuhdev/followers', 'following_url': 'https://api.github.com/users/xuhdev/following{/other_user}', 'gists_url': 'https://api.github.com/users/xuhdev/gists{/gist_id}', 'starred_url': 'https://api.github.com/users/xuhdev/starred{/owner}{/repo}', 'subscriptions_url': 'https://api.github.com/users/xuhdev/subscriptions', 'organizations_url': 'https://api.github.com/users/xuhdev/orgs', 'repos_url': 'https://api.github.com/users/xuhdev/repos', 'events_url': 'https://api.github.com/users/xuhdev/events{/privacy}', 'received_events_url': 'https://api.github.com/users/xuhdev/received_events', 'type': 'User', 'site_admin': False}",referenced,b9b90a504706d50189e3e11a9a0815ee23350d0f,https://api.github.com/repos/pytorch/pytorch/commits/b9b90a504706d50189e3e11a9a0815ee23350d0f,2019-09-05T23:09:12Z,3744,2535,1209
24650,2615689970,"{'login': 'xuhdev', 'id': 325476, 'node_id': 'MDQ6VXNlcjMyNTQ3Ng==', 'avatar_url': 'https://avatars1.githubusercontent.com/u/325476?v=4', 'gravatar_id': '', 'url': 'https://api.github.com/users/xuhdev', 'html_url': 'https://github.com/xuhdev', 'followers_url': 'https://api.github.com/users/xuhdev/followers', 'following_url': 'https://api.github.com/users/xuhdev/following{/other_user}', 'gists_url': 'https://api.github.com/users/xuhdev/gists{/gist_id}', 'starred_url': 'https://api.github.com/users/xuhdev/starred{/owner}{/repo}', 'subscriptions_url': 'https://api.github.com/users/xuhdev/subscriptions', 'organizations_url': 'https://api.github.com/users/xuhdev/orgs', 'repos_url': 'https://api.github.com/users/xuhdev/repos', 'events_url': 'https://api.github.com/users/xuhdev/events{/privacy}', 'received_events_url': 'https://api.github.com/users/xuhdev/received_events', 'type': 'User', 'site_admin': False}",referenced,97d427b022a51a06ef2907aedd4b8725db6c3df9,https://api.github.com/repos/pytorch/pytorch/commits/97d427b022a51a06ef2907aedd4b8725db6c3df9,2019-09-06T21:50:54Z,3276,2199,1077
24650,2615708586,"{'login': 'xuhdev', 'id': 325476, 'node_id': 'MDQ6VXNlcjMyNTQ3Ng==', 'avatar_url': 'https://avatars1.githubusercontent.com/u/325476?v=4', 'gravatar_id': '', 'url': 'https://api.github.com/users/xuhdev', 'html_url': 'https://github.com/xuhdev', 'followers_url': 'https://api.github.com/users/xuhdev/followers', 'following_url': 'https://api.github.com/users/xuhdev/following{/other_user}', 'gists_url': 'https://api.github.com/users/xuhdev/gists{/gist_id}', 'starred_url': 'https://api.github.com/users/xuhdev/starred{/owner}{/repo}', 'subscriptions_url': 'https://api.github.com/users/xuhdev/subscriptions', 'organizations_url': 'https://api.github.com/users/xuhdev/orgs', 'repos_url': 'https://api.github.com/users/xuhdev/repos', 'events_url': 'https://api.github.com/users/xuhdev/events{/privacy}', 'received_events_url': 'https://api.github.com/users/xuhdev/received_events', 'type': 'User', 'site_admin': False}",referenced,f959d20a6dd8bfdf47608885e0bc9a781db6a01c,https://api.github.com/repos/pytorch/pytorch/commits/f959d20a6dd8bfdf47608885e0bc9a781db6a01c,2019-09-06T22:01:07Z,2,1,1
24650,2620062462,"{'login': 'xuhdev', 'id': 325476, 'node_id': 'MDQ6VXNlcjMyNTQ3Ng==', 'avatar_url': 'https://avatars1.githubusercontent.com/u/325476?v=4', 'gravatar_id': '', 'url': 'https://api.github.com/users/xuhdev', 'html_url': 'https://github.com/xuhdev', 'followers_url': 'https://api.github.com/users/xuhdev/followers', 'following_url': 'https://api.github.com/users/xuhdev/following{/other_user}', 'gists_url': 'https://api.github.com/users/xuhdev/gists{/gist_id}', 'starred_url': 'https://api.github.com/users/xuhdev/starred{/owner}{/repo}', 'subscriptions_url': 'https://api.github.com/users/xuhdev/subscriptions', 'organizations_url': 'https://api.github.com/users/xuhdev/orgs', 'repos_url': 'https://api.github.com/users/xuhdev/repos', 'events_url': 'https://api.github.com/users/xuhdev/events{/privacy}', 'received_events_url': 'https://api.github.com/users/xuhdev/received_events', 'type': 'User', 'site_admin': False}",referenced,b3ee09f471e546e826ed95f28c283ad6ffb3f5dc,https://api.github.com/repos/pytorch/pytorch/commits/b3ee09f471e546e826ed95f28c283ad6ffb3f5dc,2019-09-09T20:31:09Z,13,2,11
24650,2630100802,"{'login': 'xuhdev', 'id': 325476, 'node_id': 'MDQ6VXNlcjMyNTQ3Ng==', 'avatar_url': 'https://avatars1.githubusercontent.com/u/325476?v=4', 'gravatar_id': '', 'url': 'https://api.github.com/users/xuhdev', 'html_url': 'https://github.com/xuhdev', 'followers_url': 'https://api.github.com/users/xuhdev/followers', 'following_url': 'https://api.github.com/users/xuhdev/following{/other_user}', 'gists_url': 'https://api.github.com/users/xuhdev/gists{/gist_id}', 'starred_url': 'https://api.github.com/users/xuhdev/starred{/owner}{/repo}', 'subscriptions_url': 'https://api.github.com/users/xuhdev/subscriptions', 'organizations_url': 'https://api.github.com/users/xuhdev/orgs', 'repos_url': 'https://api.github.com/users/xuhdev/repos', 'events_url': 'https://api.github.com/users/xuhdev/events{/privacy}', 'received_events_url': 'https://api.github.com/users/xuhdev/received_events', 'type': 'User', 'site_admin': False}",referenced,8a933cbe4c98a4a4823f5aaf40d6737d5f982fe2,https://api.github.com/repos/pytorch/pytorch/commits/8a933cbe4c98a4a4823f5aaf40d6737d5f982fe2,2019-09-12T18:12:06Z,79990,76159,3831
24650,2637124109,"{'login': 'xuhdev', 'id': 325476, 'node_id': 'MDQ6VXNlcjMyNTQ3Ng==', 'avatar_url': 'https://avatars1.githubusercontent.com/u/325476?v=4', 'gravatar_id': '', 'url': 'https://api.github.com/users/xuhdev', 'html_url': 'https://github.com/xuhdev', 'followers_url': 'https://api.github.com/users/xuhdev/followers', 'following_url': 'https://api.github.com/users/xuhdev/following{/other_user}', 'gists_url': 'https://api.github.com/users/xuhdev/gists{/gist_id}', 'starred_url': 'https://api.github.com/users/xuhdev/starred{/owner}{/repo}', 'subscriptions_url': 'https://api.github.com/users/xuhdev/subscriptions', 'organizations_url': 'https://api.github.com/users/xuhdev/orgs', 'repos_url': 'https://api.github.com/users/xuhdev/repos', 'events_url': 'https://api.github.com/users/xuhdev/events{/privacy}', 'received_events_url': 'https://api.github.com/users/xuhdev/received_events', 'type': 'User', 'site_admin': False}",referenced,b1c96af9f920fe289c9eb8c3138e76144c79633a,https://api.github.com/repos/pytorch/pytorch/commits/b1c96af9f920fe289c9eb8c3138e76144c79633a,2019-09-16T16:58:38Z,31166,17381,13785
24650,2637458205,"{'login': 'xuhdev', 'id': 325476, 'node_id': 'MDQ6VXNlcjMyNTQ3Ng==', 'avatar_url': 'https://avatars1.githubusercontent.com/u/325476?v=4', 'gravatar_id': '', 'url': 'https://api.github.com/users/xuhdev', 'html_url': 'https://github.com/xuhdev', 'followers_url': 'https://api.github.com/users/xuhdev/followers', 'following_url': 'https://api.github.com/users/xuhdev/following{/other_user}', 'gists_url': 'https://api.github.com/users/xuhdev/gists{/gist_id}', 'starred_url': 'https://api.github.com/users/xuhdev/starred{/owner}{/repo}', 'subscriptions_url': 'https://api.github.com/users/xuhdev/subscriptions', 'organizations_url': 'https://api.github.com/users/xuhdev/orgs', 'repos_url': 'https://api.github.com/users/xuhdev/repos', 'events_url': 'https://api.github.com/users/xuhdev/events{/privacy}', 'received_events_url': 'https://api.github.com/users/xuhdev/received_events', 'type': 'User', 'site_admin': False}",referenced,b65c551da44484cd63ff9db2a9985a8e1a00096b,https://api.github.com/repos/pytorch/pytorch/commits/b65c551da44484cd63ff9db2a9985a8e1a00096b,2019-09-16T18:56:14Z,90,74,16
24650,2647794420,"{'login': 'xuhdev', 'id': 325476, 'node_id': 'MDQ6VXNlcjMyNTQ3Ng==', 'avatar_url': 'https://avatars1.githubusercontent.com/u/325476?v=4', 'gravatar_id': '', 'url': 'https://api.github.com/users/xuhdev', 'html_url': 'https://github.com/xuhdev', 'followers_url': 'https://api.github.com/users/xuhdev/followers', 'following_url': 'https://api.github.com/users/xuhdev/following{/other_user}', 'gists_url': 'https://api.github.com/users/xuhdev/gists{/gist_id}', 'starred_url': 'https://api.github.com/users/xuhdev/starred{/owner}{/repo}', 'subscriptions_url': 'https://api.github.com/users/xuhdev/subscriptions', 'organizations_url': 'https://api.github.com/users/xuhdev/orgs', 'repos_url': 'https://api.github.com/users/xuhdev/repos', 'events_url': 'https://api.github.com/users/xuhdev/events{/privacy}', 'received_events_url': 'https://api.github.com/users/xuhdev/received_events', 'type': 'User', 'site_admin': False}",referenced,3a098d7cfabde2d376758ed74f533a77fbf50a2d,https://api.github.com/repos/pytorch/pytorch/commits/3a098d7cfabde2d376758ed74f533a77fbf50a2d,2019-09-19T17:14:18Z,22103,14561,7542
24650,2648662038,"{'login': 'xuhdev', 'id': 325476, 'node_id': 'MDQ6VXNlcjMyNTQ3Ng==', 'avatar_url': 'https://avatars1.githubusercontent.com/u/325476?v=4', 'gravatar_id': '', 'url': 'https://api.github.com/users/xuhdev', 'html_url': 'https://github.com/xuhdev', 'followers_url': 'https://api.github.com/users/xuhdev/followers', 'following_url': 'https://api.github.com/users/xuhdev/following{/other_user}', 'gists_url': 'https://api.github.com/users/xuhdev/gists{/gist_id}', 'starred_url': 'https://api.github.com/users/xuhdev/starred{/owner}{/repo}', 'subscriptions_url': 'https://api.github.com/users/xuhdev/subscriptions', 'organizations_url': 'https://api.github.com/users/xuhdev/orgs', 'repos_url': 'https://api.github.com/users/xuhdev/repos', 'events_url': 'https://api.github.com/users/xuhdev/events{/privacy}', 'received_events_url': 'https://api.github.com/users/xuhdev/received_events', 'type': 'User', 'site_admin': False}",referenced,5c39f5c2a915430a93d898ce012d188ebbd0dc11,https://api.github.com/repos/pytorch/pytorch/commits/5c39f5c2a915430a93d898ce012d188ebbd0dc11,2019-09-19T23:14:48Z,1797,1165,632
24650,2655451005,"{'login': 'xuhdev', 'id': 325476, 'node_id': 'MDQ6VXNlcjMyNTQ3Ng==', 'avatar_url': 'https://avatars1.githubusercontent.com/u/325476?v=4', 'gravatar_id': '', 'url': 'https://api.github.com/users/xuhdev', 'html_url': 'https://github.com/xuhdev', 'followers_url': 'https://api.github.com/users/xuhdev/followers', 'following_url': 'https://api.github.com/users/xuhdev/following{/other_user}', 'gists_url': 'https://api.github.com/users/xuhdev/gists{/gist_id}', 'starred_url': 'https://api.github.com/users/xuhdev/starred{/owner}{/repo}', 'subscriptions_url': 'https://api.github.com/users/xuhdev/subscriptions', 'organizations_url': 'https://api.github.com/users/xuhdev/orgs', 'repos_url': 'https://api.github.com/users/xuhdev/repos', 'events_url': 'https://api.github.com/users/xuhdev/events{/privacy}', 'received_events_url': 'https://api.github.com/users/xuhdev/received_events', 'type': 'User', 'site_admin': False}",referenced,c5c2ae3a23e231480200f0550121bff4f82373dd,https://api.github.com/repos/pytorch/pytorch/commits/c5c2ae3a23e231480200f0550121bff4f82373dd,2019-09-23T18:26:00Z,13104,8130,4974
24650,2655451206,"{'login': 'xuhdev', 'id': 325476, 'node_id': 'MDQ6VXNlcjMyNTQ3Ng==', 'avatar_url': 'https://avatars1.githubusercontent.com/u/325476?v=4', 'gravatar_id': '', 'url': 'https://api.github.com/users/xuhdev', 'html_url': 'https://github.com/xuhdev', 'followers_url': 'https://api.github.com/users/xuhdev/followers', 'following_url': 'https://api.github.com/users/xuhdev/following{/other_user}', 'gists_url': 'https://api.github.com/users/xuhdev/gists{/gist_id}', 'starred_url': 'https://api.github.com/users/xuhdev/starred{/owner}{/repo}', 'subscriptions_url': 'https://api.github.com/users/xuhdev/subscriptions', 'organizations_url': 'https://api.github.com/users/xuhdev/orgs', 'repos_url': 'https://api.github.com/users/xuhdev/repos', 'events_url': 'https://api.github.com/users/xuhdev/events{/privacy}', 'received_events_url': 'https://api.github.com/users/xuhdev/received_events', 'type': 'User', 'site_admin': False}",referenced,bdc1dae4aebb24b874aa68ec8dc8d6d74e4a6ad2,https://api.github.com/repos/pytorch/pytorch/commits/bdc1dae4aebb24b874aa68ec8dc8d6d74e4a6ad2,2019-09-23T18:26:04Z,13104,8130,4974
24650,2658212620,"{'login': 'facebook-github-bot', 'id': 6422482, 'node_id': 'MDQ6VXNlcjY0MjI0ODI=', 'avatar_url': 'https://avatars3.githubusercontent.com/u/6422482?v=4', 'gravatar_id': '', 'url': 'https://api.github.com/users/facebook-github-bot', 'html_url': 'https://github.com/facebook-github-bot', 'followers_url': 'https://api.github.com/users/facebook-github-bot/followers', 'following_url': 'https://api.github.com/users/facebook-github-bot/following{/other_user}', 'gists_url': 'https://api.github.com/users/facebook-github-bot/gists{/gist_id}', 'starred_url': 'https://api.github.com/users/facebook-github-bot/starred{/owner}{/repo}', 'subscriptions_url': 'https://api.github.com/users/facebook-github-bot/subscriptions', 'organizations_url': 'https://api.github.com/users/facebook-github-bot/orgs', 'repos_url': 'https://api.github.com/users/facebook-github-bot/repos', 'events_url': 'https://api.github.com/users/facebook-github-bot/events{/privacy}', 'received_events_url': 'https://api.github.com/users/facebook-github-bot/received_events', 'type': 'User', 'site_admin': False}",closed,7bdc0c138af9728295a153fdf7bb36a31d537437,https://api.github.com/repos/pytorch/pytorch/commits/7bdc0c138af9728295a153fdf7bb36a31d537437,2019-09-24T14:09:08Z,61,27,34
24638,2688055495,"{'login': 'xuhdev', 'id': 325476, 'node_id': 'MDQ6VXNlcjMyNTQ3Ng==', 'avatar_url': 'https://avatars1.githubusercontent.com/u/325476?v=4', 'gravatar_id': '', 'url': 'https://api.github.com/users/xuhdev', 'html_url': 'https://github.com/xuhdev', 'followers_url': 'https://api.github.com/users/xuhdev/followers', 'following_url': 'https://api.github.com/users/xuhdev/following{/other_user}', 'gists_url': 'https://api.github.com/users/xuhdev/gists{/gist_id}', 'starred_url': 'https://api.github.com/users/xuhdev/starred{/owner}{/repo}', 'subscriptions_url': 'https://api.github.com/users/xuhdev/subscriptions', 'organizations_url': 'https://api.github.com/users/xuhdev/orgs', 'repos_url': 'https://api.github.com/users/xuhdev/repos', 'events_url': 'https://api.github.com/users/xuhdev/events{/privacy}', 'received_events_url': 'https://api.github.com/users/xuhdev/received_events', 'type': 'User', 'site_admin': False}",referenced,a7cfa39819424bdb341350c88ed39698e2d8004d,https://api.github.com/repos/pytorch/pytorch/commits/a7cfa39819424bdb341350c88ed39698e2d8004d,2019-10-04T16:53:21Z,114,16,98
24638,2688055967,"{'login': 'xuhdev', 'id': 325476, 'node_id': 'MDQ6VXNlcjMyNTQ3Ng==', 'avatar_url': 'https://avatars1.githubusercontent.com/u/325476?v=4', 'gravatar_id': '', 'url': 'https://api.github.com/users/xuhdev', 'html_url': 'https://github.com/xuhdev', 'followers_url': 'https://api.github.com/users/xuhdev/followers', 'following_url': 'https://api.github.com/users/xuhdev/following{/other_user}', 'gists_url': 'https://api.github.com/users/xuhdev/gists{/gist_id}', 'starred_url': 'https://api.github.com/users/xuhdev/starred{/owner}{/repo}', 'subscriptions_url': 'https://api.github.com/users/xuhdev/subscriptions', 'organizations_url': 'https://api.github.com/users/xuhdev/orgs', 'repos_url': 'https://api.github.com/users/xuhdev/repos', 'events_url': 'https://api.github.com/users/xuhdev/events{/privacy}', 'received_events_url': 'https://api.github.com/users/xuhdev/received_events', 'type': 'User', 'site_admin': False}",referenced,3261fa5c75efdffa856bdfc4e2ad136bb9153b71,https://api.github.com/repos/pytorch/pytorch/commits/3261fa5c75efdffa856bdfc4e2ad136bb9153b71,2019-10-04T16:53:31Z,114,16,98
24638,2696822412,"{'login': 'xuhdev', 'id': 325476, 'node_id': 'MDQ6VXNlcjMyNTQ3Ng==', 'avatar_url': 'https://avatars1.githubusercontent.com/u/325476?v=4', 'gravatar_id': '', 'url': 'https://api.github.com/users/xuhdev', 'html_url': 'https://github.com/xuhdev', 'followers_url': 'https://api.github.com/users/xuhdev/followers', 'following_url': 'https://api.github.com/users/xuhdev/following{/other_user}', 'gists_url': 'https://api.github.com/users/xuhdev/gists{/gist_id}', 'starred_url': 'https://api.github.com/users/xuhdev/starred{/owner}{/repo}', 'subscriptions_url': 'https://api.github.com/users/xuhdev/subscriptions', 'organizations_url': 'https://api.github.com/users/xuhdev/orgs', 'repos_url': 'https://api.github.com/users/xuhdev/repos', 'events_url': 'https://api.github.com/users/xuhdev/events{/privacy}', 'received_events_url': 'https://api.github.com/users/xuhdev/received_events', 'type': 'User', 'site_admin': False}",referenced,e7d31b5bb670b0e9e7fb7e1a2dc2d420d99f14e5,https://api.github.com/repos/pytorch/pytorch/commits/e7d31b5bb670b0e9e7fb7e1a2dc2d420d99f14e5,2019-10-08T20:43:55Z,32068,16788,15280
24638,2696822524,"{'login': 'xuhdev', 'id': 325476, 'node_id': 'MDQ6VXNlcjMyNTQ3Ng==', 'avatar_url': 'https://avatars1.githubusercontent.com/u/325476?v=4', 'gravatar_id': '', 'url': 'https://api.github.com/users/xuhdev', 'html_url': 'https://github.com/xuhdev', 'followers_url': 'https://api.github.com/users/xuhdev/followers', 'following_url': 'https://api.github.com/users/xuhdev/following{/other_user}', 'gists_url': 'https://api.github.com/users/xuhdev/gists{/gist_id}', 'starred_url': 'https://api.github.com/users/xuhdev/starred{/owner}{/repo}', 'subscriptions_url': 'https://api.github.com/users/xuhdev/subscriptions', 'organizations_url': 'https://api.github.com/users/xuhdev/orgs', 'repos_url': 'https://api.github.com/users/xuhdev/repos', 'events_url': 'https://api.github.com/users/xuhdev/events{/privacy}', 'received_events_url': 'https://api.github.com/users/xuhdev/received_events', 'type': 'User', 'site_admin': False}",referenced,3e2c491cb19cdbe27eaf982dabb60331c0241c3f,https://api.github.com/repos/pytorch/pytorch/commits/3e2c491cb19cdbe27eaf982dabb60331c0241c3f,2019-10-08T20:43:57Z,106,15,91
24638,2696894574,"{'login': 'xuhdev', 'id': 325476, 'node_id': 'MDQ6VXNlcjMyNTQ3Ng==', 'avatar_url': 'https://avatars1.githubusercontent.com/u/325476?v=4', 'gravatar_id': '', 'url': 'https://api.github.com/users/xuhdev', 'html_url': 'https://github.com/xuhdev', 'followers_url': 'https://api.github.com/users/xuhdev/followers', 'following_url': 'https://api.github.com/users/xuhdev/following{/other_user}', 'gists_url': 'https://api.github.com/users/xuhdev/gists{/gist_id}', 'starred_url': 'https://api.github.com/users/xuhdev/starred{/owner}{/repo}', 'subscriptions_url': 'https://api.github.com/users/xuhdev/subscriptions', 'organizations_url': 'https://api.github.com/users/xuhdev/orgs', 'repos_url': 'https://api.github.com/users/xuhdev/repos', 'events_url': 'https://api.github.com/users/xuhdev/events{/privacy}', 'received_events_url': 'https://api.github.com/users/xuhdev/received_events', 'type': 'User', 'site_admin': False}",referenced,2259fc9a537033d525b09898e024025336962553,https://api.github.com/repos/pytorch/pytorch/commits/2259fc9a537033d525b09898e024025336962553,2019-10-08T21:10:06Z,215,198,17
24638,2696894856,"{'login': 'xuhdev', 'id': 325476, 'node_id': 'MDQ6VXNlcjMyNTQ3Ng==', 'avatar_url': 'https://avatars1.githubusercontent.com/u/325476?v=4', 'gravatar_id': '', 'url': 'https://api.github.com/users/xuhdev', 'html_url': 'https://github.com/xuhdev', 'followers_url': 'https://api.github.com/users/xuhdev/followers', 'following_url': 'https://api.github.com/users/xuhdev/following{/other_user}', 'gists_url': 'https://api.github.com/users/xuhdev/gists{/gist_id}', 'starred_url': 'https://api.github.com/users/xuhdev/starred{/owner}{/repo}', 'subscriptions_url': 'https://api.github.com/users/xuhdev/subscriptions', 'organizations_url': 'https://api.github.com/users/xuhdev/orgs', 'repos_url': 'https://api.github.com/users/xuhdev/repos', 'events_url': 'https://api.github.com/users/xuhdev/events{/privacy}', 'received_events_url': 'https://api.github.com/users/xuhdev/received_events', 'type': 'User', 'site_admin': False}",referenced,4bee7260582d1842626789933e2c289e5bcdd58e,https://api.github.com/repos/pytorch/pytorch/commits/4bee7260582d1842626789933e2c289e5bcdd58e,2019-10-08T21:10:11Z,106,15,91
24638,2718711918,"{'login': 'xuhdev', 'id': 325476, 'node_id': 'MDQ6VXNlcjMyNTQ3Ng==', 'avatar_url': 'https://avatars1.githubusercontent.com/u/325476?v=4', 'gravatar_id': '', 'url': 'https://api.github.com/users/xuhdev', 'html_url': 'https://github.com/xuhdev', 'followers_url': 'https://api.github.com/users/xuhdev/followers', 'following_url': 'https://api.github.com/users/xuhdev/following{/other_user}', 'gists_url': 'https://api.github.com/users/xuhdev/gists{/gist_id}', 'starred_url': 'https://api.github.com/users/xuhdev/starred{/owner}{/repo}', 'subscriptions_url': 'https://api.github.com/users/xuhdev/subscriptions', 'organizations_url': 'https://api.github.com/users/xuhdev/orgs', 'repos_url': 'https://api.github.com/users/xuhdev/repos', 'events_url': 'https://api.github.com/users/xuhdev/events{/privacy}', 'received_events_url': 'https://api.github.com/users/xuhdev/received_events', 'type': 'User', 'site_admin': False}",referenced,c3278ca2dc0c9b4f25dac9e0eac8e84dbf982e06,https://api.github.com/repos/pytorch/pytorch/commits/c3278ca2dc0c9b4f25dac9e0eac8e84dbf982e06,2019-10-16T18:42:20Z,44,15,29
24638,2718712832,"{'login': 'xuhdev', 'id': 325476, 'node_id': 'MDQ6VXNlcjMyNTQ3Ng==', 'avatar_url': 'https://avatars1.githubusercontent.com/u/325476?v=4', 'gravatar_id': '', 'url': 'https://api.github.com/users/xuhdev', 'html_url': 'https://github.com/xuhdev', 'followers_url': 'https://api.github.com/users/xuhdev/followers', 'following_url': 'https://api.github.com/users/xuhdev/following{/other_user}', 'gists_url': 'https://api.github.com/users/xuhdev/gists{/gist_id}', 'starred_url': 'https://api.github.com/users/xuhdev/starred{/owner}{/repo}', 'subscriptions_url': 'https://api.github.com/users/xuhdev/subscriptions', 'organizations_url': 'https://api.github.com/users/xuhdev/orgs', 'repos_url': 'https://api.github.com/users/xuhdev/repos', 'events_url': 'https://api.github.com/users/xuhdev/events{/privacy}', 'received_events_url': 'https://api.github.com/users/xuhdev/received_events', 'type': 'User', 'site_admin': False}",referenced,a89aa2b9424d9d55ad8b1211d7acb73a5636d3c1,https://api.github.com/repos/pytorch/pytorch/commits/a89aa2b9424d9d55ad8b1211d7acb73a5636d3c1,2019-10-16T18:42:38Z,50990,31785,19205
24638,2722210703,"{'login': 'xuhdev', 'id': 325476, 'node_id': 'MDQ6VXNlcjMyNTQ3Ng==', 'avatar_url': 'https://avatars1.githubusercontent.com/u/325476?v=4', 'gravatar_id': '', 'url': 'https://api.github.com/users/xuhdev', 'html_url': 'https://github.com/xuhdev', 'followers_url': 'https://api.github.com/users/xuhdev/followers', 'following_url': 'https://api.github.com/users/xuhdev/following{/other_user}', 'gists_url': 'https://api.github.com/users/xuhdev/gists{/gist_id}', 'starred_url': 'https://api.github.com/users/xuhdev/starred{/owner}{/repo}', 'subscriptions_url': 'https://api.github.com/users/xuhdev/subscriptions', 'organizations_url': 'https://api.github.com/users/xuhdev/orgs', 'repos_url': 'https://api.github.com/users/xuhdev/repos', 'events_url': 'https://api.github.com/users/xuhdev/events{/privacy}', 'received_events_url': 'https://api.github.com/users/xuhdev/received_events', 'type': 'User', 'site_admin': False}",referenced,e567378230adfb92c7d746d608adf25df1e73483,https://api.github.com/repos/pytorch/pytorch/commits/e567378230adfb92c7d746d608adf25df1e73483,2019-10-17T17:52:29Z,3462,2247,1215
24638,2722210779,"{'login': 'xuhdev', 'id': 325476, 'node_id': 'MDQ6VXNlcjMyNTQ3Ng==', 'avatar_url': 'https://avatars1.githubusercontent.com/u/325476?v=4', 'gravatar_id': '', 'url': 'https://api.github.com/users/xuhdev', 'html_url': 'https://github.com/xuhdev', 'followers_url': 'https://api.github.com/users/xuhdev/followers', 'following_url': 'https://api.github.com/users/xuhdev/following{/other_user}', 'gists_url': 'https://api.github.com/users/xuhdev/gists{/gist_id}', 'starred_url': 'https://api.github.com/users/xuhdev/starred{/owner}{/repo}', 'subscriptions_url': 'https://api.github.com/users/xuhdev/subscriptions', 'organizations_url': 'https://api.github.com/users/xuhdev/orgs', 'repos_url': 'https://api.github.com/users/xuhdev/repos', 'events_url': 'https://api.github.com/users/xuhdev/events{/privacy}', 'received_events_url': 'https://api.github.com/users/xuhdev/received_events', 'type': 'User', 'site_admin': False}",referenced,daea05e8b6b024dec666c8e2a05df5a9670e1157,https://api.github.com/repos/pytorch/pytorch/commits/daea05e8b6b024dec666c8e2a05df5a9670e1157,2019-10-17T17:52:31Z,44,15,29
24638,2722404543,"{'login': 'xuhdev', 'id': 325476, 'node_id': 'MDQ6VXNlcjMyNTQ3Ng==', 'avatar_url': 'https://avatars1.githubusercontent.com/u/325476?v=4', 'gravatar_id': '', 'url': 'https://api.github.com/users/xuhdev', 'html_url': 'https://github.com/xuhdev', 'followers_url': 'https://api.github.com/users/xuhdev/followers', 'following_url': 'https://api.github.com/users/xuhdev/following{/other_user}', 'gists_url': 'https://api.github.com/users/xuhdev/gists{/gist_id}', 'starred_url': 'https://api.github.com/users/xuhdev/starred{/owner}{/repo}', 'subscriptions_url': 'https://api.github.com/users/xuhdev/subscriptions', 'organizations_url': 'https://api.github.com/users/xuhdev/orgs', 'repos_url': 'https://api.github.com/users/xuhdev/repos', 'events_url': 'https://api.github.com/users/xuhdev/events{/privacy}', 'received_events_url': 'https://api.github.com/users/xuhdev/received_events', 'type': 'User', 'site_admin': False}",referenced,df09e666ec9013f26f173b2225a7b95668f2b951,https://api.github.com/repos/pytorch/pytorch/commits/df09e666ec9013f26f173b2225a7b95668f2b951,2019-10-17T18:58:05Z,541,450,91
24638,2722407190,"{'login': 'xuhdev', 'id': 325476, 'node_id': 'MDQ6VXNlcjMyNTQ3Ng==', 'avatar_url': 'https://avatars1.githubusercontent.com/u/325476?v=4', 'gravatar_id': '', 'url': 'https://api.github.com/users/xuhdev', 'html_url': 'https://github.com/xuhdev', 'followers_url': 'https://api.github.com/users/xuhdev/followers', 'following_url': 'https://api.github.com/users/xuhdev/following{/other_user}', 'gists_url': 'https://api.github.com/users/xuhdev/gists{/gist_id}', 'starred_url': 'https://api.github.com/users/xuhdev/starred{/owner}{/repo}', 'subscriptions_url': 'https://api.github.com/users/xuhdev/subscriptions', 'organizations_url': 'https://api.github.com/users/xuhdev/orgs', 'repos_url': 'https://api.github.com/users/xuhdev/repos', 'events_url': 'https://api.github.com/users/xuhdev/events{/privacy}', 'received_events_url': 'https://api.github.com/users/xuhdev/received_events', 'type': 'User', 'site_admin': False}",referenced,2c318525bdd5c9bd8f3d73e587d6f0704f6c0eaa,https://api.github.com/repos/pytorch/pytorch/commits/2c318525bdd5c9bd8f3d73e587d6f0704f6c0eaa,2019-10-17T18:59:06Z,144,72,72
24638,2725700843,"{'login': 'xuhdev', 'id': 325476, 'node_id': 'MDQ6VXNlcjMyNTQ3Ng==', 'avatar_url': 'https://avatars1.githubusercontent.com/u/325476?v=4', 'gravatar_id': '', 'url': 'https://api.github.com/users/xuhdev', 'html_url': 'https://github.com/xuhdev', 'followers_url': 'https://api.github.com/users/xuhdev/followers', 'following_url': 'https://api.github.com/users/xuhdev/following{/other_user}', 'gists_url': 'https://api.github.com/users/xuhdev/gists{/gist_id}', 'starred_url': 'https://api.github.com/users/xuhdev/starred{/owner}{/repo}', 'subscriptions_url': 'https://api.github.com/users/xuhdev/subscriptions', 'organizations_url': 'https://api.github.com/users/xuhdev/orgs', 'repos_url': 'https://api.github.com/users/xuhdev/repos', 'events_url': 'https://api.github.com/users/xuhdev/events{/privacy}', 'received_events_url': 'https://api.github.com/users/xuhdev/received_events', 'type': 'User', 'site_admin': False}",referenced,c2fb7481a9838582d4ef0aee921dff687660c4a1,https://api.github.com/repos/pytorch/pytorch/commits/c2fb7481a9838582d4ef0aee921dff687660c4a1,2019-10-18T17:42:55Z,2465,2014,451
24638,2734809140,"{'login': 'facebook-github-bot', 'id': 6422482, 'node_id': 'MDQ6VXNlcjY0MjI0ODI=', 'avatar_url': 'https://avatars3.githubusercontent.com/u/6422482?v=4', 'gravatar_id': '', 'url': 'https://api.github.com/users/facebook-github-bot', 'html_url': 'https://github.com/facebook-github-bot', 'followers_url': 'https://api.github.com/users/facebook-github-bot/followers', 'following_url': 'https://api.github.com/users/facebook-github-bot/following{/other_user}', 'gists_url': 'https://api.github.com/users/facebook-github-bot/gists{/gist_id}', 'starred_url': 'https://api.github.com/users/facebook-github-bot/starred{/owner}{/repo}', 'subscriptions_url': 'https://api.github.com/users/facebook-github-bot/subscriptions', 'organizations_url': 'https://api.github.com/users/facebook-github-bot/orgs', 'repos_url': 'https://api.github.com/users/facebook-github-bot/repos', 'events_url': 'https://api.github.com/users/facebook-github-bot/events{/privacy}', 'received_events_url': 'https://api.github.com/users/facebook-github-bot/received_events', 'type': 'User', 'site_admin': False}",closed,30712f6e3052e43a74ff66205d900f9d15795036,https://api.github.com/repos/pytorch/pytorch/commits/30712f6e3052e43a74ff66205d900f9d15795036,2019-10-22T21:01:34Z,43,13,30
24634,2933034786,"{'login': 'facebook-github-bot', 'id': 6422482, 'node_id': 'MDQ6VXNlcjY0MjI0ODI=', 'avatar_url': 'https://avatars3.githubusercontent.com/u/6422482?v=4', 'gravatar_id': '', 'url': 'https://api.github.com/users/facebook-github-bot', 'html_url': 'https://github.com/facebook-github-bot', 'followers_url': 'https://api.github.com/users/facebook-github-bot/followers', 'following_url': 'https://api.github.com/users/facebook-github-bot/following{/other_user}', 'gists_url': 'https://api.github.com/users/facebook-github-bot/gists{/gist_id}', 'starred_url': 'https://api.github.com/users/facebook-github-bot/starred{/owner}{/repo}', 'subscriptions_url': 'https://api.github.com/users/facebook-github-bot/subscriptions', 'organizations_url': 'https://api.github.com/users/facebook-github-bot/orgs', 'repos_url': 'https://api.github.com/users/facebook-github-bot/repos', 'events_url': 'https://api.github.com/users/facebook-github-bot/events{/privacy}', 'received_events_url': 'https://api.github.com/users/facebook-github-bot/received_events', 'type': 'User', 'site_admin': False}",referenced,4f9d2f74e2f6308271945d1486f8231e1b48a166,https://api.github.com/repos/pytorch/pytorch/commits/4f9d2f74e2f6308271945d1486f8231e1b48a166,2020-01-08T23:04:09Z,282,92,190
24633,2933034779,"{'login': 'facebook-github-bot', 'id': 6422482, 'node_id': 'MDQ6VXNlcjY0MjI0ODI=', 'avatar_url': 'https://avatars3.githubusercontent.com/u/6422482?v=4', 'gravatar_id': '', 'url': 'https://api.github.com/users/facebook-github-bot', 'html_url': 'https://github.com/facebook-github-bot', 'followers_url': 'https://api.github.com/users/facebook-github-bot/followers', 'following_url': 'https://api.github.com/users/facebook-github-bot/following{/other_user}', 'gists_url': 'https://api.github.com/users/facebook-github-bot/gists{/gist_id}', 'starred_url': 'https://api.github.com/users/facebook-github-bot/starred{/owner}{/repo}', 'subscriptions_url': 'https://api.github.com/users/facebook-github-bot/subscriptions', 'organizations_url': 'https://api.github.com/users/facebook-github-bot/orgs', 'repos_url': 'https://api.github.com/users/facebook-github-bot/repos', 'events_url': 'https://api.github.com/users/facebook-github-bot/events{/privacy}', 'received_events_url': 'https://api.github.com/users/facebook-github-bot/received_events', 'type': 'User', 'site_admin': False}",closed,4f9d2f74e2f6308271945d1486f8231e1b48a166,https://api.github.com/repos/pytorch/pytorch/commits/4f9d2f74e2f6308271945d1486f8231e1b48a166,2020-01-08T23:04:09Z,282,92,190
24632,2714511530,"{'login': 'facebook-github-bot', 'id': 6422482, 'node_id': 'MDQ6VXNlcjY0MjI0ODI=', 'avatar_url': 'https://avatars3.githubusercontent.com/u/6422482?v=4', 'gravatar_id': '', 'url': 'https://api.github.com/users/facebook-github-bot', 'html_url': 'https://github.com/facebook-github-bot', 'followers_url': 'https://api.github.com/users/facebook-github-bot/followers', 'following_url': 'https://api.github.com/users/facebook-github-bot/following{/other_user}', 'gists_url': 'https://api.github.com/users/facebook-github-bot/gists{/gist_id}', 'starred_url': 'https://api.github.com/users/facebook-github-bot/starred{/owner}{/repo}', 'subscriptions_url': 'https://api.github.com/users/facebook-github-bot/subscriptions', 'organizations_url': 'https://api.github.com/users/facebook-github-bot/orgs', 'repos_url': 'https://api.github.com/users/facebook-github-bot/repos', 'events_url': 'https://api.github.com/users/facebook-github-bot/events{/privacy}', 'received_events_url': 'https://api.github.com/users/facebook-github-bot/received_events', 'type': 'User', 'site_admin': False}",referenced,9033ace9c4235b2fdaa93d0402f994efbcc186a5,https://api.github.com/repos/pytorch/pytorch/commits/9033ace9c4235b2fdaa93d0402f994efbcc186a5,2019-10-15T15:45:13Z,310,8,302
24632,2895118809,"{'login': 'facebook-github-bot', 'id': 6422482, 'node_id': 'MDQ6VXNlcjY0MjI0ODI=', 'avatar_url': 'https://avatars3.githubusercontent.com/u/6422482?v=4', 'gravatar_id': '', 'url': 'https://api.github.com/users/facebook-github-bot', 'html_url': 'https://github.com/facebook-github-bot', 'followers_url': 'https://api.github.com/users/facebook-github-bot/followers', 'following_url': 'https://api.github.com/users/facebook-github-bot/following{/other_user}', 'gists_url': 'https://api.github.com/users/facebook-github-bot/gists{/gist_id}', 'starred_url': 'https://api.github.com/users/facebook-github-bot/starred{/owner}{/repo}', 'subscriptions_url': 'https://api.github.com/users/facebook-github-bot/subscriptions', 'organizations_url': 'https://api.github.com/users/facebook-github-bot/orgs', 'repos_url': 'https://api.github.com/users/facebook-github-bot/repos', 'events_url': 'https://api.github.com/users/facebook-github-bot/events{/privacy}', 'received_events_url': 'https://api.github.com/users/facebook-github-bot/received_events', 'type': 'User', 'site_admin': False}",referenced,5e8bac24b4c3b9abd0e056d663a9029cc79c44d5,https://api.github.com/repos/pytorch/pytorch/commits/5e8bac24b4c3b9abd0e056d663a9029cc79c44d5,2019-12-18T21:34:11Z,300,40,260
24631,2714511525,"{'login': 'facebook-github-bot', 'id': 6422482, 'node_id': 'MDQ6VXNlcjY0MjI0ODI=', 'avatar_url': 'https://avatars3.githubusercontent.com/u/6422482?v=4', 'gravatar_id': '', 'url': 'https://api.github.com/users/facebook-github-bot', 'html_url': 'https://github.com/facebook-github-bot', 'followers_url': 'https://api.github.com/users/facebook-github-bot/followers', 'following_url': 'https://api.github.com/users/facebook-github-bot/following{/other_user}', 'gists_url': 'https://api.github.com/users/facebook-github-bot/gists{/gist_id}', 'starred_url': 'https://api.github.com/users/facebook-github-bot/starred{/owner}{/repo}', 'subscriptions_url': 'https://api.github.com/users/facebook-github-bot/subscriptions', 'organizations_url': 'https://api.github.com/users/facebook-github-bot/orgs', 'repos_url': 'https://api.github.com/users/facebook-github-bot/repos', 'events_url': 'https://api.github.com/users/facebook-github-bot/events{/privacy}', 'received_events_url': 'https://api.github.com/users/facebook-github-bot/received_events', 'type': 'User', 'site_admin': False}",referenced,9033ace9c4235b2fdaa93d0402f994efbcc186a5,https://api.github.com/repos/pytorch/pytorch/commits/9033ace9c4235b2fdaa93d0402f994efbcc186a5,2019-10-15T15:45:13Z,310,8,302
24631,2895118800,"{'login': 'facebook-github-bot', 'id': 6422482, 'node_id': 'MDQ6VXNlcjY0MjI0ODI=', 'avatar_url': 'https://avatars3.githubusercontent.com/u/6422482?v=4', 'gravatar_id': '', 'url': 'https://api.github.com/users/facebook-github-bot', 'html_url': 'https://github.com/facebook-github-bot', 'followers_url': 'https://api.github.com/users/facebook-github-bot/followers', 'following_url': 'https://api.github.com/users/facebook-github-bot/following{/other_user}', 'gists_url': 'https://api.github.com/users/facebook-github-bot/gists{/gist_id}', 'starred_url': 'https://api.github.com/users/facebook-github-bot/starred{/owner}{/repo}', 'subscriptions_url': 'https://api.github.com/users/facebook-github-bot/subscriptions', 'organizations_url': 'https://api.github.com/users/facebook-github-bot/orgs', 'repos_url': 'https://api.github.com/users/facebook-github-bot/repos', 'events_url': 'https://api.github.com/users/facebook-github-bot/events{/privacy}', 'received_events_url': 'https://api.github.com/users/facebook-github-bot/received_events', 'type': 'User', 'site_admin': False}",closed,5e8bac24b4c3b9abd0e056d663a9029cc79c44d5,https://api.github.com/repos/pytorch/pytorch/commits/5e8bac24b4c3b9abd0e056d663a9029cc79c44d5,2019-12-18T21:34:10Z,300,40,260
24628,2738089171,"{'login': 'xuhdev', 'id': 325476, 'node_id': 'MDQ6VXNlcjMyNTQ3Ng==', 'avatar_url': 'https://avatars1.githubusercontent.com/u/325476?v=4', 'gravatar_id': '', 'url': 'https://api.github.com/users/xuhdev', 'html_url': 'https://github.com/xuhdev', 'followers_url': 'https://api.github.com/users/xuhdev/followers', 'following_url': 'https://api.github.com/users/xuhdev/following{/other_user}', 'gists_url': 'https://api.github.com/users/xuhdev/gists{/gist_id}', 'starred_url': 'https://api.github.com/users/xuhdev/starred{/owner}{/repo}', 'subscriptions_url': 'https://api.github.com/users/xuhdev/subscriptions', 'organizations_url': 'https://api.github.com/users/xuhdev/orgs', 'repos_url': 'https://api.github.com/users/xuhdev/repos', 'events_url': 'https://api.github.com/users/xuhdev/events{/privacy}', 'received_events_url': 'https://api.github.com/users/xuhdev/received_events', 'type': 'User', 'site_admin': False}",referenced,6ec162fda659de482acdf7716c66f0000fee72d0,https://api.github.com/repos/pytorch/pytorch/commits/6ec162fda659de482acdf7716c66f0000fee72d0,2019-10-23T18:19:16Z,44,13,31
24628,2738090023,"{'login': 'xuhdev', 'id': 325476, 'node_id': 'MDQ6VXNlcjMyNTQ3Ng==', 'avatar_url': 'https://avatars1.githubusercontent.com/u/325476?v=4', 'gravatar_id': '', 'url': 'https://api.github.com/users/xuhdev', 'html_url': 'https://github.com/xuhdev', 'followers_url': 'https://api.github.com/users/xuhdev/followers', 'following_url': 'https://api.github.com/users/xuhdev/following{/other_user}', 'gists_url': 'https://api.github.com/users/xuhdev/gists{/gist_id}', 'starred_url': 'https://api.github.com/users/xuhdev/starred{/owner}{/repo}', 'subscriptions_url': 'https://api.github.com/users/xuhdev/subscriptions', 'organizations_url': 'https://api.github.com/users/xuhdev/orgs', 'repos_url': 'https://api.github.com/users/xuhdev/repos', 'events_url': 'https://api.github.com/users/xuhdev/events{/privacy}', 'received_events_url': 'https://api.github.com/users/xuhdev/received_events', 'type': 'User', 'site_admin': False}",referenced,e6307698e6769b2c4a04b51d19d1989146404fca,https://api.github.com/repos/pytorch/pytorch/commits/e6307698e6769b2c4a04b51d19d1989146404fca,2019-10-23T18:19:34Z,44,13,31
24628,2757069047,"{'login': 'facebook-github-bot', 'id': 6422482, 'node_id': 'MDQ6VXNlcjY0MjI0ODI=', 'avatar_url': 'https://avatars3.githubusercontent.com/u/6422482?v=4', 'gravatar_id': '', 'url': 'https://api.github.com/users/facebook-github-bot', 'html_url': 'https://github.com/facebook-github-bot', 'followers_url': 'https://api.github.com/users/facebook-github-bot/followers', 'following_url': 'https://api.github.com/users/facebook-github-bot/following{/other_user}', 'gists_url': 'https://api.github.com/users/facebook-github-bot/gists{/gist_id}', 'starred_url': 'https://api.github.com/users/facebook-github-bot/starred{/owner}{/repo}', 'subscriptions_url': 'https://api.github.com/users/facebook-github-bot/subscriptions', 'organizations_url': 'https://api.github.com/users/facebook-github-bot/orgs', 'repos_url': 'https://api.github.com/users/facebook-github-bot/repos', 'events_url': 'https://api.github.com/users/facebook-github-bot/events{/privacy}', 'received_events_url': 'https://api.github.com/users/facebook-github-bot/received_events', 'type': 'User', 'site_admin': False}",closed,e0009fdeb1da2ad2866a6ccfb210b27e413de3e9,https://api.github.com/repos/pytorch/pytorch/commits/e0009fdeb1da2ad2866a6ccfb210b27e413de3e9,2019-10-30T17:57:29Z,44,13,31
24627,2722403970,"{'login': 'xuhdev', 'id': 325476, 'node_id': 'MDQ6VXNlcjMyNTQ3Ng==', 'avatar_url': 'https://avatars1.githubusercontent.com/u/325476?v=4', 'gravatar_id': '', 'url': 'https://api.github.com/users/xuhdev', 'html_url': 'https://github.com/xuhdev', 'followers_url': 'https://api.github.com/users/xuhdev/followers', 'following_url': 'https://api.github.com/users/xuhdev/following{/other_user}', 'gists_url': 'https://api.github.com/users/xuhdev/gists{/gist_id}', 'starred_url': 'https://api.github.com/users/xuhdev/starred{/owner}{/repo}', 'subscriptions_url': 'https://api.github.com/users/xuhdev/subscriptions', 'organizations_url': 'https://api.github.com/users/xuhdev/orgs', 'repos_url': 'https://api.github.com/users/xuhdev/repos', 'events_url': 'https://api.github.com/users/xuhdev/events{/privacy}', 'received_events_url': 'https://api.github.com/users/xuhdev/received_events', 'type': 'User', 'site_admin': False}",referenced,b4b463767e846b0fc65057f60757e14be767fb36,https://api.github.com/repos/pytorch/pytorch/commits/b4b463767e846b0fc65057f60757e14be767fb36,2019-10-17T18:57:51Z,46,16,30
24627,2722404770,"{'login': 'xuhdev', 'id': 325476, 'node_id': 'MDQ6VXNlcjMyNTQ3Ng==', 'avatar_url': 'https://avatars1.githubusercontent.com/u/325476?v=4', 'gravatar_id': '', 'url': 'https://api.github.com/users/xuhdev', 'html_url': 'https://github.com/xuhdev', 'followers_url': 'https://api.github.com/users/xuhdev/followers', 'following_url': 'https://api.github.com/users/xuhdev/following{/other_user}', 'gists_url': 'https://api.github.com/users/xuhdev/gists{/gist_id}', 'starred_url': 'https://api.github.com/users/xuhdev/starred{/owner}{/repo}', 'subscriptions_url': 'https://api.github.com/users/xuhdev/subscriptions', 'organizations_url': 'https://api.github.com/users/xuhdev/orgs', 'repos_url': 'https://api.github.com/users/xuhdev/repos', 'events_url': 'https://api.github.com/users/xuhdev/events{/privacy}', 'received_events_url': 'https://api.github.com/users/xuhdev/received_events', 'type': 'User', 'site_admin': False}",referenced,a55d783b9627b62d9cbc76e15489792fe3f7ec5c,https://api.github.com/repos/pytorch/pytorch/commits/a55d783b9627b62d9cbc76e15489792fe3f7ec5c,2019-10-17T18:58:10Z,46,16,30
24627,2722407364,"{'login': 'xuhdev', 'id': 325476, 'node_id': 'MDQ6VXNlcjMyNTQ3Ng==', 'avatar_url': 'https://avatars1.githubusercontent.com/u/325476?v=4', 'gravatar_id': '', 'url': 'https://api.github.com/users/xuhdev', 'html_url': 'https://github.com/xuhdev', 'followers_url': 'https://api.github.com/users/xuhdev/followers', 'following_url': 'https://api.github.com/users/xuhdev/following{/other_user}', 'gists_url': 'https://api.github.com/users/xuhdev/gists{/gist_id}', 'starred_url': 'https://api.github.com/users/xuhdev/starred{/owner}{/repo}', 'subscriptions_url': 'https://api.github.com/users/xuhdev/subscriptions', 'organizations_url': 'https://api.github.com/users/xuhdev/orgs', 'repos_url': 'https://api.github.com/users/xuhdev/repos', 'events_url': 'https://api.github.com/users/xuhdev/events{/privacy}', 'received_events_url': 'https://api.github.com/users/xuhdev/received_events', 'type': 'User', 'site_admin': False}",referenced,b6eec24e035c078c61278a43cb8265c9fe5d993a,https://api.github.com/repos/pytorch/pytorch/commits/b6eec24e035c078c61278a43cb8265c9fe5d993a,2019-10-17T18:59:09Z,144,72,72
24627,2722407585,"{'login': 'xuhdev', 'id': 325476, 'node_id': 'MDQ6VXNlcjMyNTQ3Ng==', 'avatar_url': 'https://avatars1.githubusercontent.com/u/325476?v=4', 'gravatar_id': '', 'url': 'https://api.github.com/users/xuhdev', 'html_url': 'https://github.com/xuhdev', 'followers_url': 'https://api.github.com/users/xuhdev/followers', 'following_url': 'https://api.github.com/users/xuhdev/following{/other_user}', 'gists_url': 'https://api.github.com/users/xuhdev/gists{/gist_id}', 'starred_url': 'https://api.github.com/users/xuhdev/starred{/owner}{/repo}', 'subscriptions_url': 'https://api.github.com/users/xuhdev/subscriptions', 'organizations_url': 'https://api.github.com/users/xuhdev/orgs', 'repos_url': 'https://api.github.com/users/xuhdev/repos', 'events_url': 'https://api.github.com/users/xuhdev/events{/privacy}', 'received_events_url': 'https://api.github.com/users/xuhdev/received_events', 'type': 'User', 'site_admin': False}",referenced,39bda6750822fbfbe4801d64ec46902acf69534e,https://api.github.com/repos/pytorch/pytorch/commits/39bda6750822fbfbe4801d64ec46902acf69534e,2019-10-17T18:59:15Z,46,16,30
24627,2722412442,"{'login': 'xuhdev', 'id': 325476, 'node_id': 'MDQ6VXNlcjMyNTQ3Ng==', 'avatar_url': 'https://avatars1.githubusercontent.com/u/325476?v=4', 'gravatar_id': '', 'url': 'https://api.github.com/users/xuhdev', 'html_url': 'https://github.com/xuhdev', 'followers_url': 'https://api.github.com/users/xuhdev/followers', 'following_url': 'https://api.github.com/users/xuhdev/following{/other_user}', 'gists_url': 'https://api.github.com/users/xuhdev/gists{/gist_id}', 'starred_url': 'https://api.github.com/users/xuhdev/starred{/owner}{/repo}', 'subscriptions_url': 'https://api.github.com/users/xuhdev/subscriptions', 'organizations_url': 'https://api.github.com/users/xuhdev/orgs', 'repos_url': 'https://api.github.com/users/xuhdev/repos', 'events_url': 'https://api.github.com/users/xuhdev/events{/privacy}', 'received_events_url': 'https://api.github.com/users/xuhdev/received_events', 'type': 'User', 'site_admin': False}",referenced,313d416554813f6a51eaba09d4cc64492ac9b66c,https://api.github.com/repos/pytorch/pytorch/commits/313d416554813f6a51eaba09d4cc64492ac9b66c,2019-10-17T19:00:58Z,2,1,1
24627,2722412692,"{'login': 'xuhdev', 'id': 325476, 'node_id': 'MDQ6VXNlcjMyNTQ3Ng==', 'avatar_url': 'https://avatars1.githubusercontent.com/u/325476?v=4', 'gravatar_id': '', 'url': 'https://api.github.com/users/xuhdev', 'html_url': 'https://github.com/xuhdev', 'followers_url': 'https://api.github.com/users/xuhdev/followers', 'following_url': 'https://api.github.com/users/xuhdev/following{/other_user}', 'gists_url': 'https://api.github.com/users/xuhdev/gists{/gist_id}', 'starred_url': 'https://api.github.com/users/xuhdev/starred{/owner}{/repo}', 'subscriptions_url': 'https://api.github.com/users/xuhdev/subscriptions', 'organizations_url': 'https://api.github.com/users/xuhdev/orgs', 'repos_url': 'https://api.github.com/users/xuhdev/repos', 'events_url': 'https://api.github.com/users/xuhdev/events{/privacy}', 'received_events_url': 'https://api.github.com/users/xuhdev/received_events', 'type': 'User', 'site_admin': False}",referenced,e873cd98d40cb5a454f9b9956e5af77418dec294,https://api.github.com/repos/pytorch/pytorch/commits/e873cd98d40cb5a454f9b9956e5af77418dec294,2019-10-17T19:01:02Z,48,17,31
24627,2725700992,"{'login': 'xuhdev', 'id': 325476, 'node_id': 'MDQ6VXNlcjMyNTQ3Ng==', 'avatar_url': 'https://avatars1.githubusercontent.com/u/325476?v=4', 'gravatar_id': '', 'url': 'https://api.github.com/users/xuhdev', 'html_url': 'https://github.com/xuhdev', 'followers_url': 'https://api.github.com/users/xuhdev/followers', 'following_url': 'https://api.github.com/users/xuhdev/following{/other_user}', 'gists_url': 'https://api.github.com/users/xuhdev/gists{/gist_id}', 'starred_url': 'https://api.github.com/users/xuhdev/starred{/owner}{/repo}', 'subscriptions_url': 'https://api.github.com/users/xuhdev/subscriptions', 'organizations_url': 'https://api.github.com/users/xuhdev/orgs', 'repos_url': 'https://api.github.com/users/xuhdev/repos', 'events_url': 'https://api.github.com/users/xuhdev/events{/privacy}', 'received_events_url': 'https://api.github.com/users/xuhdev/received_events', 'type': 'User', 'site_admin': False}",referenced,d614f441e51d4c7bc3d621864f49ab39af321bf6,https://api.github.com/repos/pytorch/pytorch/commits/d614f441e51d4c7bc3d621864f49ab39af321bf6,2019-10-18T17:42:59Z,47,15,32
24627,2725701105,"{'login': 'xuhdev', 'id': 325476, 'node_id': 'MDQ6VXNlcjMyNTQ3Ng==', 'avatar_url': 'https://avatars1.githubusercontent.com/u/325476?v=4', 'gravatar_id': '', 'url': 'https://api.github.com/users/xuhdev', 'html_url': 'https://github.com/xuhdev', 'followers_url': 'https://api.github.com/users/xuhdev/followers', 'following_url': 'https://api.github.com/users/xuhdev/following{/other_user}', 'gists_url': 'https://api.github.com/users/xuhdev/gists{/gist_id}', 'starred_url': 'https://api.github.com/users/xuhdev/starred{/owner}{/repo}', 'subscriptions_url': 'https://api.github.com/users/xuhdev/subscriptions', 'organizations_url': 'https://api.github.com/users/xuhdev/orgs', 'repos_url': 'https://api.github.com/users/xuhdev/repos', 'events_url': 'https://api.github.com/users/xuhdev/events{/privacy}', 'received_events_url': 'https://api.github.com/users/xuhdev/received_events', 'type': 'User', 'site_admin': False}",referenced,20d2711b3f3ff58c7b7e8d7484a02fb3b0a4c498,https://api.github.com/repos/pytorch/pytorch/commits/20d2711b3f3ff58c7b7e8d7484a02fb3b0a4c498,2019-10-18T17:43:02Z,2468,2014,454
24627,2734959707,"{'login': 'xuhdev', 'id': 325476, 'node_id': 'MDQ6VXNlcjMyNTQ3Ng==', 'avatar_url': 'https://avatars1.githubusercontent.com/u/325476?v=4', 'gravatar_id': '', 'url': 'https://api.github.com/users/xuhdev', 'html_url': 'https://github.com/xuhdev', 'followers_url': 'https://api.github.com/users/xuhdev/followers', 'following_url': 'https://api.github.com/users/xuhdev/following{/other_user}', 'gists_url': 'https://api.github.com/users/xuhdev/gists{/gist_id}', 'starred_url': 'https://api.github.com/users/xuhdev/starred{/owner}{/repo}', 'subscriptions_url': 'https://api.github.com/users/xuhdev/subscriptions', 'organizations_url': 'https://api.github.com/users/xuhdev/orgs', 'repos_url': 'https://api.github.com/users/xuhdev/repos', 'events_url': 'https://api.github.com/users/xuhdev/events{/privacy}', 'received_events_url': 'https://api.github.com/users/xuhdev/received_events', 'type': 'User', 'site_admin': False}",referenced,1d9388c9b03abef39fb5df1012cb15a7b2a9d3a4,https://api.github.com/repos/pytorch/pytorch/commits/1d9388c9b03abef39fb5df1012cb15a7b2a9d3a4,2019-10-22T21:55:58Z,11053,8029,3024
24627,2734959909,"{'login': 'xuhdev', 'id': 325476, 'node_id': 'MDQ6VXNlcjMyNTQ3Ng==', 'avatar_url': 'https://avatars1.githubusercontent.com/u/325476?v=4', 'gravatar_id': '', 'url': 'https://api.github.com/users/xuhdev', 'html_url': 'https://github.com/xuhdev', 'followers_url': 'https://api.github.com/users/xuhdev/followers', 'following_url': 'https://api.github.com/users/xuhdev/following{/other_user}', 'gists_url': 'https://api.github.com/users/xuhdev/gists{/gist_id}', 'starred_url': 'https://api.github.com/users/xuhdev/starred{/owner}{/repo}', 'subscriptions_url': 'https://api.github.com/users/xuhdev/subscriptions', 'organizations_url': 'https://api.github.com/users/xuhdev/orgs', 'repos_url': 'https://api.github.com/users/xuhdev/repos', 'events_url': 'https://api.github.com/users/xuhdev/events{/privacy}', 'received_events_url': 'https://api.github.com/users/xuhdev/received_events', 'type': 'User', 'site_admin': False}",referenced,4a6ffbd1296c9c2e98efda2b8de98ccb1f915dce,https://api.github.com/repos/pytorch/pytorch/commits/4a6ffbd1296c9c2e98efda2b8de98ccb1f915dce,2019-10-22T21:56:03Z,11056,8032,3024
24627,2734960010,"{'login': 'xuhdev', 'id': 325476, 'node_id': 'MDQ6VXNlcjMyNTQ3Ng==', 'avatar_url': 'https://avatars1.githubusercontent.com/u/325476?v=4', 'gravatar_id': '', 'url': 'https://api.github.com/users/xuhdev', 'html_url': 'https://github.com/xuhdev', 'followers_url': 'https://api.github.com/users/xuhdev/followers', 'following_url': 'https://api.github.com/users/xuhdev/following{/other_user}', 'gists_url': 'https://api.github.com/users/xuhdev/gists{/gist_id}', 'starred_url': 'https://api.github.com/users/xuhdev/starred{/owner}{/repo}', 'subscriptions_url': 'https://api.github.com/users/xuhdev/subscriptions', 'organizations_url': 'https://api.github.com/users/xuhdev/orgs', 'repos_url': 'https://api.github.com/users/xuhdev/repos', 'events_url': 'https://api.github.com/users/xuhdev/events{/privacy}', 'received_events_url': 'https://api.github.com/users/xuhdev/received_events', 'type': 'User', 'site_admin': False}",referenced,e3374ed13253ad8f6d571992a968ccba9d0f0acb,https://api.github.com/repos/pytorch/pytorch/commits/e3374ed13253ad8f6d571992a968ccba9d0f0acb,2019-10-22T21:56:05Z,48,17,31
24627,2735289091,"{'login': 'xuhdev', 'id': 325476, 'node_id': 'MDQ6VXNlcjMyNTQ3Ng==', 'avatar_url': 'https://avatars1.githubusercontent.com/u/325476?v=4', 'gravatar_id': '', 'url': 'https://api.github.com/users/xuhdev', 'html_url': 'https://github.com/xuhdev', 'followers_url': 'https://api.github.com/users/xuhdev/followers', 'following_url': 'https://api.github.com/users/xuhdev/following{/other_user}', 'gists_url': 'https://api.github.com/users/xuhdev/gists{/gist_id}', 'starred_url': 'https://api.github.com/users/xuhdev/starred{/owner}{/repo}', 'subscriptions_url': 'https://api.github.com/users/xuhdev/subscriptions', 'organizations_url': 'https://api.github.com/users/xuhdev/orgs', 'repos_url': 'https://api.github.com/users/xuhdev/repos', 'events_url': 'https://api.github.com/users/xuhdev/events{/privacy}', 'received_events_url': 'https://api.github.com/users/xuhdev/received_events', 'type': 'User', 'site_admin': False}",referenced,bd444867b3c322d2472d006f3d0f7450b8bee89e,https://api.github.com/repos/pytorch/pytorch/commits/bd444867b3c322d2472d006f3d0f7450b8bee89e,2019-10-23T01:05:11Z,419,272,147
24627,2735289218,"{'login': 'xuhdev', 'id': 325476, 'node_id': 'MDQ6VXNlcjMyNTQ3Ng==', 'avatar_url': 'https://avatars1.githubusercontent.com/u/325476?v=4', 'gravatar_id': '', 'url': 'https://api.github.com/users/xuhdev', 'html_url': 'https://github.com/xuhdev', 'followers_url': 'https://api.github.com/users/xuhdev/followers', 'following_url': 'https://api.github.com/users/xuhdev/following{/other_user}', 'gists_url': 'https://api.github.com/users/xuhdev/gists{/gist_id}', 'starred_url': 'https://api.github.com/users/xuhdev/starred{/owner}{/repo}', 'subscriptions_url': 'https://api.github.com/users/xuhdev/subscriptions', 'organizations_url': 'https://api.github.com/users/xuhdev/orgs', 'repos_url': 'https://api.github.com/users/xuhdev/repos', 'events_url': 'https://api.github.com/users/xuhdev/events{/privacy}', 'received_events_url': 'https://api.github.com/users/xuhdev/received_events', 'type': 'User', 'site_admin': False}",referenced,06b516b7a2ca5e82006cebb056c6e941b766225c,https://api.github.com/repos/pytorch/pytorch/commits/06b516b7a2ca5e82006cebb056c6e941b766225c,2019-10-23T01:05:16Z,419,272,147
24627,2738089607,"{'login': 'xuhdev', 'id': 325476, 'node_id': 'MDQ6VXNlcjMyNTQ3Ng==', 'avatar_url': 'https://avatars1.githubusercontent.com/u/325476?v=4', 'gravatar_id': '', 'url': 'https://api.github.com/users/xuhdev', 'html_url': 'https://github.com/xuhdev', 'followers_url': 'https://api.github.com/users/xuhdev/followers', 'following_url': 'https://api.github.com/users/xuhdev/following{/other_user}', 'gists_url': 'https://api.github.com/users/xuhdev/gists{/gist_id}', 'starred_url': 'https://api.github.com/users/xuhdev/starred{/owner}{/repo}', 'subscriptions_url': 'https://api.github.com/users/xuhdev/subscriptions', 'organizations_url': 'https://api.github.com/users/xuhdev/orgs', 'repos_url': 'https://api.github.com/users/xuhdev/repos', 'events_url': 'https://api.github.com/users/xuhdev/events{/privacy}', 'received_events_url': 'https://api.github.com/users/xuhdev/received_events', 'type': 'User', 'site_admin': False}",referenced,ac99343a9649956c43d37e573ca15b91ade6afcc,https://api.github.com/repos/pytorch/pytorch/commits/ac99343a9649956c43d37e573ca15b91ade6afcc,2019-10-23T18:19:26Z,969,493,476
24627,2738089608,"{'login': 'xuhdev', 'id': 325476, 'node_id': 'MDQ6VXNlcjMyNTQ3Ng==', 'avatar_url': 'https://avatars1.githubusercontent.com/u/325476?v=4', 'gravatar_id': '', 'url': 'https://api.github.com/users/xuhdev', 'html_url': 'https://github.com/xuhdev', 'followers_url': 'https://api.github.com/users/xuhdev/followers', 'following_url': 'https://api.github.com/users/xuhdev/following{/other_user}', 'gists_url': 'https://api.github.com/users/xuhdev/gists{/gist_id}', 'starred_url': 'https://api.github.com/users/xuhdev/starred{/owner}{/repo}', 'subscriptions_url': 'https://api.github.com/users/xuhdev/subscriptions', 'organizations_url': 'https://api.github.com/users/xuhdev/orgs', 'repos_url': 'https://api.github.com/users/xuhdev/repos', 'events_url': 'https://api.github.com/users/xuhdev/events{/privacy}', 'received_events_url': 'https://api.github.com/users/xuhdev/received_events', 'type': 'User', 'site_admin': False}",referenced,da19d9bb3c49dca0fd39aae2a581d723e2addadf,https://api.github.com/repos/pytorch/pytorch/commits/da19d9bb3c49dca0fd39aae2a581d723e2addadf,2019-10-23T18:19:26Z,969,493,476
24627,2757068960,"{'login': 'facebook-github-bot', 'id': 6422482, 'node_id': 'MDQ6VXNlcjY0MjI0ODI=', 'avatar_url': 'https://avatars3.githubusercontent.com/u/6422482?v=4', 'gravatar_id': '', 'url': 'https://api.github.com/users/facebook-github-bot', 'html_url': 'https://github.com/facebook-github-bot', 'followers_url': 'https://api.github.com/users/facebook-github-bot/followers', 'following_url': 'https://api.github.com/users/facebook-github-bot/following{/other_user}', 'gists_url': 'https://api.github.com/users/facebook-github-bot/gists{/gist_id}', 'starred_url': 'https://api.github.com/users/facebook-github-bot/starred{/owner}{/repo}', 'subscriptions_url': 'https://api.github.com/users/facebook-github-bot/subscriptions', 'organizations_url': 'https://api.github.com/users/facebook-github-bot/orgs', 'repos_url': 'https://api.github.com/users/facebook-github-bot/repos', 'events_url': 'https://api.github.com/users/facebook-github-bot/events{/privacy}', 'received_events_url': 'https://api.github.com/users/facebook-github-bot/received_events', 'type': 'User', 'site_admin': False}",closed,d0bd8a3afc631321092e0408ebf74249ae632f1b,https://api.github.com/repos/pytorch/pytorch/commits/d0bd8a3afc631321092e0408ebf74249ae632f1b,2019-10-30T17:57:28Z,48,17,31
24624,2768170370,"{'login': 'facebook-github-bot', 'id': 6422482, 'node_id': 'MDQ6VXNlcjY0MjI0ODI=', 'avatar_url': 'https://avatars3.githubusercontent.com/u/6422482?v=4', 'gravatar_id': '', 'url': 'https://api.github.com/users/facebook-github-bot', 'html_url': 'https://github.com/facebook-github-bot', 'followers_url': 'https://api.github.com/users/facebook-github-bot/followers', 'following_url': 'https://api.github.com/users/facebook-github-bot/following{/other_user}', 'gists_url': 'https://api.github.com/users/facebook-github-bot/gists{/gist_id}', 'starred_url': 'https://api.github.com/users/facebook-github-bot/starred{/owner}{/repo}', 'subscriptions_url': 'https://api.github.com/users/facebook-github-bot/subscriptions', 'organizations_url': 'https://api.github.com/users/facebook-github-bot/orgs', 'repos_url': 'https://api.github.com/users/facebook-github-bot/repos', 'events_url': 'https://api.github.com/users/facebook-github-bot/events{/privacy}', 'received_events_url': 'https://api.github.com/users/facebook-github-bot/received_events', 'type': 'User', 'site_admin': False}",referenced,a90389f20e7cf12587d018ee47bdff09a18e88d3,https://api.github.com/repos/pytorch/pytorch/commits/a90389f20e7cf12587d018ee47bdff09a18e88d3,2019-11-04T15:40:20Z,39,17,22
24620,2588993335,"{'login': 'xuhdev', 'id': 325476, 'node_id': 'MDQ6VXNlcjMyNTQ3Ng==', 'avatar_url': 'https://avatars1.githubusercontent.com/u/325476?v=4', 'gravatar_id': '', 'url': 'https://api.github.com/users/xuhdev', 'html_url': 'https://github.com/xuhdev', 'followers_url': 'https://api.github.com/users/xuhdev/followers', 'following_url': 'https://api.github.com/users/xuhdev/following{/other_user}', 'gists_url': 'https://api.github.com/users/xuhdev/gists{/gist_id}', 'starred_url': 'https://api.github.com/users/xuhdev/starred{/owner}{/repo}', 'subscriptions_url': 'https://api.github.com/users/xuhdev/subscriptions', 'organizations_url': 'https://api.github.com/users/xuhdev/orgs', 'repos_url': 'https://api.github.com/users/xuhdev/repos', 'events_url': 'https://api.github.com/users/xuhdev/events{/privacy}', 'received_events_url': 'https://api.github.com/users/xuhdev/received_events', 'type': 'User', 'site_admin': False}",referenced,9cf998d1afc5731e026a00285f3702f92aabc315,https://api.github.com/repos/pytorch/pytorch/commits/9cf998d1afc5731e026a00285f3702f92aabc315,2019-08-28T02:02:49Z,63,28,35
24620,2588993593,"{'login': 'xuhdev', 'id': 325476, 'node_id': 'MDQ6VXNlcjMyNTQ3Ng==', 'avatar_url': 'https://avatars1.githubusercontent.com/u/325476?v=4', 'gravatar_id': '', 'url': 'https://api.github.com/users/xuhdev', 'html_url': 'https://github.com/xuhdev', 'followers_url': 'https://api.github.com/users/xuhdev/followers', 'following_url': 'https://api.github.com/users/xuhdev/following{/other_user}', 'gists_url': 'https://api.github.com/users/xuhdev/gists{/gist_id}', 'starred_url': 'https://api.github.com/users/xuhdev/starred{/owner}{/repo}', 'subscriptions_url': 'https://api.github.com/users/xuhdev/subscriptions', 'organizations_url': 'https://api.github.com/users/xuhdev/orgs', 'repos_url': 'https://api.github.com/users/xuhdev/repos', 'events_url': 'https://api.github.com/users/xuhdev/events{/privacy}', 'received_events_url': 'https://api.github.com/users/xuhdev/received_events', 'type': 'User', 'site_admin': False}",referenced,2a2d8788280f27e4565bfa0e847fd72dad744af1,https://api.github.com/repos/pytorch/pytorch/commits/2a2d8788280f27e4565bfa0e847fd72dad744af1,2019-08-28T02:03:01Z,63,28,35
24620,2589138725,"{'login': 'xuhdev', 'id': 325476, 'node_id': 'MDQ6VXNlcjMyNTQ3Ng==', 'avatar_url': 'https://avatars1.githubusercontent.com/u/325476?v=4', 'gravatar_id': '', 'url': 'https://api.github.com/users/xuhdev', 'html_url': 'https://github.com/xuhdev', 'followers_url': 'https://api.github.com/users/xuhdev/followers', 'following_url': 'https://api.github.com/users/xuhdev/following{/other_user}', 'gists_url': 'https://api.github.com/users/xuhdev/gists{/gist_id}', 'starred_url': 'https://api.github.com/users/xuhdev/starred{/owner}{/repo}', 'subscriptions_url': 'https://api.github.com/users/xuhdev/subscriptions', 'organizations_url': 'https://api.github.com/users/xuhdev/orgs', 'repos_url': 'https://api.github.com/users/xuhdev/repos', 'events_url': 'https://api.github.com/users/xuhdev/events{/privacy}', 'received_events_url': 'https://api.github.com/users/xuhdev/received_events', 'type': 'User', 'site_admin': False}",referenced,bad935d91127ed93875518fffd7d813d72f84959,https://api.github.com/repos/pytorch/pytorch/commits/bad935d91127ed93875518fffd7d813d72f84959,2019-08-28T03:57:28Z,10,5,5
24620,2589138804,"{'login': 'xuhdev', 'id': 325476, 'node_id': 'MDQ6VXNlcjMyNTQ3Ng==', 'avatar_url': 'https://avatars1.githubusercontent.com/u/325476?v=4', 'gravatar_id': '', 'url': 'https://api.github.com/users/xuhdev', 'html_url': 'https://github.com/xuhdev', 'followers_url': 'https://api.github.com/users/xuhdev/followers', 'following_url': 'https://api.github.com/users/xuhdev/following{/other_user}', 'gists_url': 'https://api.github.com/users/xuhdev/gists{/gist_id}', 'starred_url': 'https://api.github.com/users/xuhdev/starred{/owner}{/repo}', 'subscriptions_url': 'https://api.github.com/users/xuhdev/subscriptions', 'organizations_url': 'https://api.github.com/users/xuhdev/orgs', 'repos_url': 'https://api.github.com/users/xuhdev/repos', 'events_url': 'https://api.github.com/users/xuhdev/events{/privacy}', 'received_events_url': 'https://api.github.com/users/xuhdev/received_events', 'type': 'User', 'site_admin': False}",referenced,b6fc765710eeefef987d9cfdaeed12516bcf1df3,https://api.github.com/repos/pytorch/pytorch/commits/b6fc765710eeefef987d9cfdaeed12516bcf1df3,2019-08-28T03:57:33Z,63,28,35
24620,2591514428,"{'login': 'xuhdev', 'id': 325476, 'node_id': 'MDQ6VXNlcjMyNTQ3Ng==', 'avatar_url': 'https://avatars1.githubusercontent.com/u/325476?v=4', 'gravatar_id': '', 'url': 'https://api.github.com/users/xuhdev', 'html_url': 'https://github.com/xuhdev', 'followers_url': 'https://api.github.com/users/xuhdev/followers', 'following_url': 'https://api.github.com/users/xuhdev/following{/other_user}', 'gists_url': 'https://api.github.com/users/xuhdev/gists{/gist_id}', 'starred_url': 'https://api.github.com/users/xuhdev/starred{/owner}{/repo}', 'subscriptions_url': 'https://api.github.com/users/xuhdev/subscriptions', 'organizations_url': 'https://api.github.com/users/xuhdev/orgs', 'repos_url': 'https://api.github.com/users/xuhdev/repos', 'events_url': 'https://api.github.com/users/xuhdev/events{/privacy}', 'received_events_url': 'https://api.github.com/users/xuhdev/received_events', 'type': 'User', 'site_admin': False}",referenced,524bf1c018f40ffdd3563a3d939d378782de5553,https://api.github.com/repos/pytorch/pytorch/commits/524bf1c018f40ffdd3563a3d939d378782de5553,2019-08-28T18:26:49Z,65,29,36
24620,2591514540,"{'login': 'xuhdev', 'id': 325476, 'node_id': 'MDQ6VXNlcjMyNTQ3Ng==', 'avatar_url': 'https://avatars1.githubusercontent.com/u/325476?v=4', 'gravatar_id': '', 'url': 'https://api.github.com/users/xuhdev', 'html_url': 'https://github.com/xuhdev', 'followers_url': 'https://api.github.com/users/xuhdev/followers', 'following_url': 'https://api.github.com/users/xuhdev/following{/other_user}', 'gists_url': 'https://api.github.com/users/xuhdev/gists{/gist_id}', 'starred_url': 'https://api.github.com/users/xuhdev/starred{/owner}{/repo}', 'subscriptions_url': 'https://api.github.com/users/xuhdev/subscriptions', 'organizations_url': 'https://api.github.com/users/xuhdev/orgs', 'repos_url': 'https://api.github.com/users/xuhdev/repos', 'events_url': 'https://api.github.com/users/xuhdev/events{/privacy}', 'received_events_url': 'https://api.github.com/users/xuhdev/received_events', 'type': 'User', 'site_admin': False}",referenced,8209f24868a7850cede9310fe8a17f3a4fcb1180,https://api.github.com/repos/pytorch/pytorch/commits/8209f24868a7850cede9310fe8a17f3a4fcb1180,2019-08-28T18:26:52Z,5798,3632,2166
24620,2591610329,"{'login': 'xuhdev', 'id': 325476, 'node_id': 'MDQ6VXNlcjMyNTQ3Ng==', 'avatar_url': 'https://avatars1.githubusercontent.com/u/325476?v=4', 'gravatar_id': '', 'url': 'https://api.github.com/users/xuhdev', 'html_url': 'https://github.com/xuhdev', 'followers_url': 'https://api.github.com/users/xuhdev/followers', 'following_url': 'https://api.github.com/users/xuhdev/following{/other_user}', 'gists_url': 'https://api.github.com/users/xuhdev/gists{/gist_id}', 'starred_url': 'https://api.github.com/users/xuhdev/starred{/owner}{/repo}', 'subscriptions_url': 'https://api.github.com/users/xuhdev/subscriptions', 'organizations_url': 'https://api.github.com/users/xuhdev/orgs', 'repos_url': 'https://api.github.com/users/xuhdev/repos', 'events_url': 'https://api.github.com/users/xuhdev/events{/privacy}', 'received_events_url': 'https://api.github.com/users/xuhdev/received_events', 'type': 'User', 'site_admin': False}",referenced,0e45783a48a99fac13e110419597681bb63f9f94,https://api.github.com/repos/pytorch/pytorch/commits/0e45783a48a99fac13e110419597681bb63f9f94,2019-08-28T19:00:36Z,29,11,18
24620,2591610348,"{'login': 'xuhdev', 'id': 325476, 'node_id': 'MDQ6VXNlcjMyNTQ3Ng==', 'avatar_url': 'https://avatars1.githubusercontent.com/u/325476?v=4', 'gravatar_id': '', 'url': 'https://api.github.com/users/xuhdev', 'html_url': 'https://github.com/xuhdev', 'followers_url': 'https://api.github.com/users/xuhdev/followers', 'following_url': 'https://api.github.com/users/xuhdev/following{/other_user}', 'gists_url': 'https://api.github.com/users/xuhdev/gists{/gist_id}', 'starred_url': 'https://api.github.com/users/xuhdev/starred{/owner}{/repo}', 'subscriptions_url': 'https://api.github.com/users/xuhdev/subscriptions', 'organizations_url': 'https://api.github.com/users/xuhdev/orgs', 'repos_url': 'https://api.github.com/users/xuhdev/repos', 'events_url': 'https://api.github.com/users/xuhdev/events{/privacy}', 'received_events_url': 'https://api.github.com/users/xuhdev/received_events', 'type': 'User', 'site_admin': False}",referenced,84bd3e315f23c733878079c2311a1f1970fb49e8,https://api.github.com/repos/pytorch/pytorch/commits/84bd3e315f23c733878079c2311a1f1970fb49e8,2019-08-28T19:00:37Z,65,29,36
24620,2592023002,"{'login': 'xuhdev', 'id': 325476, 'node_id': 'MDQ6VXNlcjMyNTQ3Ng==', 'avatar_url': 'https://avatars1.githubusercontent.com/u/325476?v=4', 'gravatar_id': '', 'url': 'https://api.github.com/users/xuhdev', 'html_url': 'https://github.com/xuhdev', 'followers_url': 'https://api.github.com/users/xuhdev/followers', 'following_url': 'https://api.github.com/users/xuhdev/following{/other_user}', 'gists_url': 'https://api.github.com/users/xuhdev/gists{/gist_id}', 'starred_url': 'https://api.github.com/users/xuhdev/starred{/owner}{/repo}', 'subscriptions_url': 'https://api.github.com/users/xuhdev/subscriptions', 'organizations_url': 'https://api.github.com/users/xuhdev/orgs', 'repos_url': 'https://api.github.com/users/xuhdev/repos', 'events_url': 'https://api.github.com/users/xuhdev/events{/privacy}', 'received_events_url': 'https://api.github.com/users/xuhdev/received_events', 'type': 'User', 'site_admin': False}",referenced,b5d680cf54145342b7526b8eeacd2c20e1a7e202,https://api.github.com/repos/pytorch/pytorch/commits/b5d680cf54145342b7526b8eeacd2c20e1a7e202,2019-08-28T21:39:24Z,2,1,1
24620,2592023260,"{'login': 'xuhdev', 'id': 325476, 'node_id': 'MDQ6VXNlcjMyNTQ3Ng==', 'avatar_url': 'https://avatars1.githubusercontent.com/u/325476?v=4', 'gravatar_id': '', 'url': 'https://api.github.com/users/xuhdev', 'html_url': 'https://github.com/xuhdev', 'followers_url': 'https://api.github.com/users/xuhdev/followers', 'following_url': 'https://api.github.com/users/xuhdev/following{/other_user}', 'gists_url': 'https://api.github.com/users/xuhdev/gists{/gist_id}', 'starred_url': 'https://api.github.com/users/xuhdev/starred{/owner}{/repo}', 'subscriptions_url': 'https://api.github.com/users/xuhdev/subscriptions', 'organizations_url': 'https://api.github.com/users/xuhdev/orgs', 'repos_url': 'https://api.github.com/users/xuhdev/repos', 'events_url': 'https://api.github.com/users/xuhdev/events{/privacy}', 'received_events_url': 'https://api.github.com/users/xuhdev/received_events', 'type': 'User', 'site_admin': False}",referenced,ffa65a200ae708e54965194bab6782aeb6b4fa81,https://api.github.com/repos/pytorch/pytorch/commits/ffa65a200ae708e54965194bab6782aeb6b4fa81,2019-08-28T21:39:31Z,65,29,36
24620,2592086650,"{'login': 'xuhdev', 'id': 325476, 'node_id': 'MDQ6VXNlcjMyNTQ3Ng==', 'avatar_url': 'https://avatars1.githubusercontent.com/u/325476?v=4', 'gravatar_id': '', 'url': 'https://api.github.com/users/xuhdev', 'html_url': 'https://github.com/xuhdev', 'followers_url': 'https://api.github.com/users/xuhdev/followers', 'following_url': 'https://api.github.com/users/xuhdev/following{/other_user}', 'gists_url': 'https://api.github.com/users/xuhdev/gists{/gist_id}', 'starred_url': 'https://api.github.com/users/xuhdev/starred{/owner}{/repo}', 'subscriptions_url': 'https://api.github.com/users/xuhdev/subscriptions', 'organizations_url': 'https://api.github.com/users/xuhdev/orgs', 'repos_url': 'https://api.github.com/users/xuhdev/repos', 'events_url': 'https://api.github.com/users/xuhdev/events{/privacy}', 'received_events_url': 'https://api.github.com/users/xuhdev/received_events', 'type': 'User', 'site_admin': False}",referenced,3ded08260d9c4ac9e0b53ff864eeb49a26fafda1,https://api.github.com/repos/pytorch/pytorch/commits/3ded08260d9c4ac9e0b53ff864eeb49a26fafda1,2019-08-28T22:09:23Z,4,2,2
24620,2592086780,"{'login': 'xuhdev', 'id': 325476, 'node_id': 'MDQ6VXNlcjMyNTQ3Ng==', 'avatar_url': 'https://avatars1.githubusercontent.com/u/325476?v=4', 'gravatar_id': '', 'url': 'https://api.github.com/users/xuhdev', 'html_url': 'https://github.com/xuhdev', 'followers_url': 'https://api.github.com/users/xuhdev/followers', 'following_url': 'https://api.github.com/users/xuhdev/following{/other_user}', 'gists_url': 'https://api.github.com/users/xuhdev/gists{/gist_id}', 'starred_url': 'https://api.github.com/users/xuhdev/starred{/owner}{/repo}', 'subscriptions_url': 'https://api.github.com/users/xuhdev/subscriptions', 'organizations_url': 'https://api.github.com/users/xuhdev/orgs', 'repos_url': 'https://api.github.com/users/xuhdev/repos', 'events_url': 'https://api.github.com/users/xuhdev/events{/privacy}', 'received_events_url': 'https://api.github.com/users/xuhdev/received_events', 'type': 'User', 'site_admin': False}",referenced,357194e82cbb7e7c448b1f3a8b2522933125b9fd,https://api.github.com/repos/pytorch/pytorch/commits/357194e82cbb7e7c448b1f3a8b2522933125b9fd,2019-08-28T22:09:27Z,65,29,36
24620,2592319726,"{'login': 'xuhdev', 'id': 325476, 'node_id': 'MDQ6VXNlcjMyNTQ3Ng==', 'avatar_url': 'https://avatars1.githubusercontent.com/u/325476?v=4', 'gravatar_id': '', 'url': 'https://api.github.com/users/xuhdev', 'html_url': 'https://github.com/xuhdev', 'followers_url': 'https://api.github.com/users/xuhdev/followers', 'following_url': 'https://api.github.com/users/xuhdev/following{/other_user}', 'gists_url': 'https://api.github.com/users/xuhdev/gists{/gist_id}', 'starred_url': 'https://api.github.com/users/xuhdev/starred{/owner}{/repo}', 'subscriptions_url': 'https://api.github.com/users/xuhdev/subscriptions', 'organizations_url': 'https://api.github.com/users/xuhdev/orgs', 'repos_url': 'https://api.github.com/users/xuhdev/repos', 'events_url': 'https://api.github.com/users/xuhdev/events{/privacy}', 'received_events_url': 'https://api.github.com/users/xuhdev/received_events', 'type': 'User', 'site_admin': False}",referenced,68cb5d5f5f6974d44fca2bbf1b24cce2daf33535,https://api.github.com/repos/pytorch/pytorch/commits/68cb5d5f5f6974d44fca2bbf1b24cce2daf33535,2019-08-29T00:37:57Z,5,0,5
24620,2595108039,"{'login': 'xuhdev', 'id': 325476, 'node_id': 'MDQ6VXNlcjMyNTQ3Ng==', 'avatar_url': 'https://avatars1.githubusercontent.com/u/325476?v=4', 'gravatar_id': '', 'url': 'https://api.github.com/users/xuhdev', 'html_url': 'https://github.com/xuhdev', 'followers_url': 'https://api.github.com/users/xuhdev/followers', 'following_url': 'https://api.github.com/users/xuhdev/following{/other_user}', 'gists_url': 'https://api.github.com/users/xuhdev/gists{/gist_id}', 'starred_url': 'https://api.github.com/users/xuhdev/starred{/owner}{/repo}', 'subscriptions_url': 'https://api.github.com/users/xuhdev/subscriptions', 'organizations_url': 'https://api.github.com/users/xuhdev/orgs', 'repos_url': 'https://api.github.com/users/xuhdev/repos', 'events_url': 'https://api.github.com/users/xuhdev/events{/privacy}', 'received_events_url': 'https://api.github.com/users/xuhdev/received_events', 'type': 'User', 'site_admin': False}",referenced,784cf77d845dcc4f3c1bb435254ac1c7c4785b80,https://api.github.com/repos/pytorch/pytorch/commits/784cf77d845dcc4f3c1bb435254ac1c7c4785b80,2019-08-29T19:34:31Z,9552,5570,3982
24620,2604468259,"{'login': 'xuhdev', 'id': 325476, 'node_id': 'MDQ6VXNlcjMyNTQ3Ng==', 'avatar_url': 'https://avatars1.githubusercontent.com/u/325476?v=4', 'gravatar_id': '', 'url': 'https://api.github.com/users/xuhdev', 'html_url': 'https://github.com/xuhdev', 'followers_url': 'https://api.github.com/users/xuhdev/followers', 'following_url': 'https://api.github.com/users/xuhdev/following{/other_user}', 'gists_url': 'https://api.github.com/users/xuhdev/gists{/gist_id}', 'starred_url': 'https://api.github.com/users/xuhdev/starred{/owner}{/repo}', 'subscriptions_url': 'https://api.github.com/users/xuhdev/subscriptions', 'organizations_url': 'https://api.github.com/users/xuhdev/orgs', 'repos_url': 'https://api.github.com/users/xuhdev/repos', 'events_url': 'https://api.github.com/users/xuhdev/events{/privacy}', 'received_events_url': 'https://api.github.com/users/xuhdev/received_events', 'type': 'User', 'site_admin': False}",referenced,d3df05ce4dc321e1d247e8b364316e0e37b80f54,https://api.github.com/repos/pytorch/pytorch/commits/d3df05ce4dc321e1d247e8b364316e0e37b80f54,2019-09-03T17:53:28Z,16323,8639,7684
24620,2605107414,"{'login': 'xuhdev', 'id': 325476, 'node_id': 'MDQ6VXNlcjMyNTQ3Ng==', 'avatar_url': 'https://avatars1.githubusercontent.com/u/325476?v=4', 'gravatar_id': '', 'url': 'https://api.github.com/users/xuhdev', 'html_url': 'https://github.com/xuhdev', 'followers_url': 'https://api.github.com/users/xuhdev/followers', 'following_url': 'https://api.github.com/users/xuhdev/following{/other_user}', 'gists_url': 'https://api.github.com/users/xuhdev/gists{/gist_id}', 'starred_url': 'https://api.github.com/users/xuhdev/starred{/owner}{/repo}', 'subscriptions_url': 'https://api.github.com/users/xuhdev/subscriptions', 'organizations_url': 'https://api.github.com/users/xuhdev/orgs', 'repos_url': 'https://api.github.com/users/xuhdev/repos', 'events_url': 'https://api.github.com/users/xuhdev/events{/privacy}', 'received_events_url': 'https://api.github.com/users/xuhdev/received_events', 'type': 'User', 'site_admin': False}",referenced,d6d9acaf424845f1aa7beb7977621933bacc046c,https://api.github.com/repos/pytorch/pytorch/commits/d6d9acaf424845f1aa7beb7977621933bacc046c,2019-09-03T21:52:38Z,634,544,90
24620,2608657271,"{'login': 'xuhdev', 'id': 325476, 'node_id': 'MDQ6VXNlcjMyNTQ3Ng==', 'avatar_url': 'https://avatars1.githubusercontent.com/u/325476?v=4', 'gravatar_id': '', 'url': 'https://api.github.com/users/xuhdev', 'html_url': 'https://github.com/xuhdev', 'followers_url': 'https://api.github.com/users/xuhdev/followers', 'following_url': 'https://api.github.com/users/xuhdev/following{/other_user}', 'gists_url': 'https://api.github.com/users/xuhdev/gists{/gist_id}', 'starred_url': 'https://api.github.com/users/xuhdev/starred{/owner}{/repo}', 'subscriptions_url': 'https://api.github.com/users/xuhdev/subscriptions', 'organizations_url': 'https://api.github.com/users/xuhdev/orgs', 'repos_url': 'https://api.github.com/users/xuhdev/repos', 'events_url': 'https://api.github.com/users/xuhdev/events{/privacy}', 'received_events_url': 'https://api.github.com/users/xuhdev/received_events', 'type': 'User', 'site_admin': False}",referenced,88c1fdeadfbe36512ad66fff067c97bf7039043b,https://api.github.com/repos/pytorch/pytorch/commits/88c1fdeadfbe36512ad66fff067c97bf7039043b,2019-09-04T22:14:21Z,6747,4072,2675
24620,2612620957,"{'login': 'xuhdev', 'id': 325476, 'node_id': 'MDQ6VXNlcjMyNTQ3Ng==', 'avatar_url': 'https://avatars1.githubusercontent.com/u/325476?v=4', 'gravatar_id': '', 'url': 'https://api.github.com/users/xuhdev', 'html_url': 'https://github.com/xuhdev', 'followers_url': 'https://api.github.com/users/xuhdev/followers', 'following_url': 'https://api.github.com/users/xuhdev/following{/other_user}', 'gists_url': 'https://api.github.com/users/xuhdev/gists{/gist_id}', 'starred_url': 'https://api.github.com/users/xuhdev/starred{/owner}{/repo}', 'subscriptions_url': 'https://api.github.com/users/xuhdev/subscriptions', 'organizations_url': 'https://api.github.com/users/xuhdev/orgs', 'repos_url': 'https://api.github.com/users/xuhdev/repos', 'events_url': 'https://api.github.com/users/xuhdev/events{/privacy}', 'received_events_url': 'https://api.github.com/users/xuhdev/received_events', 'type': 'User', 'site_admin': False}",referenced,339e6184f914b70f3b7dd7e5516011769114b662,https://api.github.com/repos/pytorch/pytorch/commits/339e6184f914b70f3b7dd7e5516011769114b662,2019-09-05T23:09:12Z,3736,2531,1205
24620,2615689966,"{'login': 'xuhdev', 'id': 325476, 'node_id': 'MDQ6VXNlcjMyNTQ3Ng==', 'avatar_url': 'https://avatars1.githubusercontent.com/u/325476?v=4', 'gravatar_id': '', 'url': 'https://api.github.com/users/xuhdev', 'html_url': 'https://github.com/xuhdev', 'followers_url': 'https://api.github.com/users/xuhdev/followers', 'following_url': 'https://api.github.com/users/xuhdev/following{/other_user}', 'gists_url': 'https://api.github.com/users/xuhdev/gists{/gist_id}', 'starred_url': 'https://api.github.com/users/xuhdev/starred{/owner}{/repo}', 'subscriptions_url': 'https://api.github.com/users/xuhdev/subscriptions', 'organizations_url': 'https://api.github.com/users/xuhdev/orgs', 'repos_url': 'https://api.github.com/users/xuhdev/repos', 'events_url': 'https://api.github.com/users/xuhdev/events{/privacy}', 'received_events_url': 'https://api.github.com/users/xuhdev/received_events', 'type': 'User', 'site_admin': False}",referenced,535ac3dedd7b05cc57ec3e520fd3a616b731cca2,https://api.github.com/repos/pytorch/pytorch/commits/535ac3dedd7b05cc57ec3e520fd3a616b731cca2,2019-09-06T21:50:54Z,3276,2199,1077
24620,2615708581,"{'login': 'xuhdev', 'id': 325476, 'node_id': 'MDQ6VXNlcjMyNTQ3Ng==', 'avatar_url': 'https://avatars1.githubusercontent.com/u/325476?v=4', 'gravatar_id': '', 'url': 'https://api.github.com/users/xuhdev', 'html_url': 'https://github.com/xuhdev', 'followers_url': 'https://api.github.com/users/xuhdev/followers', 'following_url': 'https://api.github.com/users/xuhdev/following{/other_user}', 'gists_url': 'https://api.github.com/users/xuhdev/gists{/gist_id}', 'starred_url': 'https://api.github.com/users/xuhdev/starred{/owner}{/repo}', 'subscriptions_url': 'https://api.github.com/users/xuhdev/subscriptions', 'organizations_url': 'https://api.github.com/users/xuhdev/orgs', 'repos_url': 'https://api.github.com/users/xuhdev/repos', 'events_url': 'https://api.github.com/users/xuhdev/events{/privacy}', 'received_events_url': 'https://api.github.com/users/xuhdev/received_events', 'type': 'User', 'site_admin': False}",referenced,063af4a92c7a5eaf603d4236c334a694d48b220b,https://api.github.com/repos/pytorch/pytorch/commits/063af4a92c7a5eaf603d4236c334a694d48b220b,2019-09-06T22:01:07Z,2,1,1
24620,2620062454,"{'login': 'xuhdev', 'id': 325476, 'node_id': 'MDQ6VXNlcjMyNTQ3Ng==', 'avatar_url': 'https://avatars1.githubusercontent.com/u/325476?v=4', 'gravatar_id': '', 'url': 'https://api.github.com/users/xuhdev', 'html_url': 'https://github.com/xuhdev', 'followers_url': 'https://api.github.com/users/xuhdev/followers', 'following_url': 'https://api.github.com/users/xuhdev/following{/other_user}', 'gists_url': 'https://api.github.com/users/xuhdev/gists{/gist_id}', 'starred_url': 'https://api.github.com/users/xuhdev/starred{/owner}{/repo}', 'subscriptions_url': 'https://api.github.com/users/xuhdev/subscriptions', 'organizations_url': 'https://api.github.com/users/xuhdev/orgs', 'repos_url': 'https://api.github.com/users/xuhdev/repos', 'events_url': 'https://api.github.com/users/xuhdev/events{/privacy}', 'received_events_url': 'https://api.github.com/users/xuhdev/received_events', 'type': 'User', 'site_admin': False}",referenced,3d089737febf216966424ebea1e2fd75eee4f860,https://api.github.com/repos/pytorch/pytorch/commits/3d089737febf216966424ebea1e2fd75eee4f860,2019-09-09T20:31:09Z,13,2,11
24620,2630100796,"{'login': 'xuhdev', 'id': 325476, 'node_id': 'MDQ6VXNlcjMyNTQ3Ng==', 'avatar_url': 'https://avatars1.githubusercontent.com/u/325476?v=4', 'gravatar_id': '', 'url': 'https://api.github.com/users/xuhdev', 'html_url': 'https://github.com/xuhdev', 'followers_url': 'https://api.github.com/users/xuhdev/followers', 'following_url': 'https://api.github.com/users/xuhdev/following{/other_user}', 'gists_url': 'https://api.github.com/users/xuhdev/gists{/gist_id}', 'starred_url': 'https://api.github.com/users/xuhdev/starred{/owner}{/repo}', 'subscriptions_url': 'https://api.github.com/users/xuhdev/subscriptions', 'organizations_url': 'https://api.github.com/users/xuhdev/orgs', 'repos_url': 'https://api.github.com/users/xuhdev/repos', 'events_url': 'https://api.github.com/users/xuhdev/events{/privacy}', 'received_events_url': 'https://api.github.com/users/xuhdev/received_events', 'type': 'User', 'site_admin': False}",referenced,1c0b145d9653b1a3a4ea0f3c8e9c0b7292746015,https://api.github.com/repos/pytorch/pytorch/commits/1c0b145d9653b1a3a4ea0f3c8e9c0b7292746015,2019-09-12T18:12:06Z,79998,76163,3835
24620,2637124103,"{'login': 'xuhdev', 'id': 325476, 'node_id': 'MDQ6VXNlcjMyNTQ3Ng==', 'avatar_url': 'https://avatars1.githubusercontent.com/u/325476?v=4', 'gravatar_id': '', 'url': 'https://api.github.com/users/xuhdev', 'html_url': 'https://github.com/xuhdev', 'followers_url': 'https://api.github.com/users/xuhdev/followers', 'following_url': 'https://api.github.com/users/xuhdev/following{/other_user}', 'gists_url': 'https://api.github.com/users/xuhdev/gists{/gist_id}', 'starred_url': 'https://api.github.com/users/xuhdev/starred{/owner}{/repo}', 'subscriptions_url': 'https://api.github.com/users/xuhdev/subscriptions', 'organizations_url': 'https://api.github.com/users/xuhdev/orgs', 'repos_url': 'https://api.github.com/users/xuhdev/repos', 'events_url': 'https://api.github.com/users/xuhdev/events{/privacy}', 'received_events_url': 'https://api.github.com/users/xuhdev/received_events', 'type': 'User', 'site_admin': False}",referenced,5212096c0baee1b7448d107c7a4c19ab3efad139,https://api.github.com/repos/pytorch/pytorch/commits/5212096c0baee1b7448d107c7a4c19ab3efad139,2019-09-16T16:58:38Z,31154,17370,13784
24620,2637458190,"{'login': 'xuhdev', 'id': 325476, 'node_id': 'MDQ6VXNlcjMyNTQ3Ng==', 'avatar_url': 'https://avatars1.githubusercontent.com/u/325476?v=4', 'gravatar_id': '', 'url': 'https://api.github.com/users/xuhdev', 'html_url': 'https://github.com/xuhdev', 'followers_url': 'https://api.github.com/users/xuhdev/followers', 'following_url': 'https://api.github.com/users/xuhdev/following{/other_user}', 'gists_url': 'https://api.github.com/users/xuhdev/gists{/gist_id}', 'starred_url': 'https://api.github.com/users/xuhdev/starred{/owner}{/repo}', 'subscriptions_url': 'https://api.github.com/users/xuhdev/subscriptions', 'organizations_url': 'https://api.github.com/users/xuhdev/orgs', 'repos_url': 'https://api.github.com/users/xuhdev/repos', 'events_url': 'https://api.github.com/users/xuhdev/events{/privacy}', 'received_events_url': 'https://api.github.com/users/xuhdev/received_events', 'type': 'User', 'site_admin': False}",referenced,22217941b6f9afec3bb6211ec9e2f8ba55a9de8b,https://api.github.com/repos/pytorch/pytorch/commits/22217941b6f9afec3bb6211ec9e2f8ba55a9de8b,2019-09-16T18:56:14Z,90,74,16
24617,2577959851,"{'login': 'xuhdev', 'id': 325476, 'node_id': 'MDQ6VXNlcjMyNTQ3Ng==', 'avatar_url': 'https://avatars1.githubusercontent.com/u/325476?v=4', 'gravatar_id': '', 'url': 'https://api.github.com/users/xuhdev', 'html_url': 'https://github.com/xuhdev', 'followers_url': 'https://api.github.com/users/xuhdev/followers', 'following_url': 'https://api.github.com/users/xuhdev/following{/other_user}', 'gists_url': 'https://api.github.com/users/xuhdev/gists{/gist_id}', 'starred_url': 'https://api.github.com/users/xuhdev/starred{/owner}{/repo}', 'subscriptions_url': 'https://api.github.com/users/xuhdev/subscriptions', 'organizations_url': 'https://api.github.com/users/xuhdev/orgs', 'repos_url': 'https://api.github.com/users/xuhdev/repos', 'events_url': 'https://api.github.com/users/xuhdev/events{/privacy}', 'received_events_url': 'https://api.github.com/users/xuhdev/received_events', 'type': 'User', 'site_admin': False}",referenced,90be53567177de811392d35d2d7e0359bbad6c7a,https://api.github.com/repos/pytorch/pytorch/commits/90be53567177de811392d35d2d7e0359bbad6c7a,2019-08-22T21:51:17Z,4,3,1
24617,2577959961,"{'login': 'xuhdev', 'id': 325476, 'node_id': 'MDQ6VXNlcjMyNTQ3Ng==', 'avatar_url': 'https://avatars1.githubusercontent.com/u/325476?v=4', 'gravatar_id': '', 'url': 'https://api.github.com/users/xuhdev', 'html_url': 'https://github.com/xuhdev', 'followers_url': 'https://api.github.com/users/xuhdev/followers', 'following_url': 'https://api.github.com/users/xuhdev/following{/other_user}', 'gists_url': 'https://api.github.com/users/xuhdev/gists{/gist_id}', 'starred_url': 'https://api.github.com/users/xuhdev/starred{/owner}{/repo}', 'subscriptions_url': 'https://api.github.com/users/xuhdev/subscriptions', 'organizations_url': 'https://api.github.com/users/xuhdev/orgs', 'repos_url': 'https://api.github.com/users/xuhdev/repos', 'events_url': 'https://api.github.com/users/xuhdev/events{/privacy}', 'received_events_url': 'https://api.github.com/users/xuhdev/received_events', 'type': 'User', 'site_admin': False}",referenced,f1a88fb90b0190d79c48e37f9aecaee583b389e3,https://api.github.com/repos/pytorch/pytorch/commits/f1a88fb90b0190d79c48e37f9aecaee583b389e3,2019-08-22T21:51:21Z,52,19,33
24617,2577975224,"{'login': 'xuhdev', 'id': 325476, 'node_id': 'MDQ6VXNlcjMyNTQ3Ng==', 'avatar_url': 'https://avatars1.githubusercontent.com/u/325476?v=4', 'gravatar_id': '', 'url': 'https://api.github.com/users/xuhdev', 'html_url': 'https://github.com/xuhdev', 'followers_url': 'https://api.github.com/users/xuhdev/followers', 'following_url': 'https://api.github.com/users/xuhdev/following{/other_user}', 'gists_url': 'https://api.github.com/users/xuhdev/gists{/gist_id}', 'starred_url': 'https://api.github.com/users/xuhdev/starred{/owner}{/repo}', 'subscriptions_url': 'https://api.github.com/users/xuhdev/subscriptions', 'organizations_url': 'https://api.github.com/users/xuhdev/orgs', 'repos_url': 'https://api.github.com/users/xuhdev/repos', 'events_url': 'https://api.github.com/users/xuhdev/events{/privacy}', 'received_events_url': 'https://api.github.com/users/xuhdev/received_events', 'type': 'User', 'site_admin': False}",referenced,5974927e2cb011159b930c7fdad375ee422cb770,https://api.github.com/repos/pytorch/pytorch/commits/5974927e2cb011159b930c7fdad375ee422cb770,2019-08-22T21:58:55Z,53,19,34
24617,2577975252,"{'login': 'xuhdev', 'id': 325476, 'node_id': 'MDQ6VXNlcjMyNTQ3Ng==', 'avatar_url': 'https://avatars1.githubusercontent.com/u/325476?v=4', 'gravatar_id': '', 'url': 'https://api.github.com/users/xuhdev', 'html_url': 'https://github.com/xuhdev', 'followers_url': 'https://api.github.com/users/xuhdev/followers', 'following_url': 'https://api.github.com/users/xuhdev/following{/other_user}', 'gists_url': 'https://api.github.com/users/xuhdev/gists{/gist_id}', 'starred_url': 'https://api.github.com/users/xuhdev/starred{/owner}{/repo}', 'subscriptions_url': 'https://api.github.com/users/xuhdev/subscriptions', 'organizations_url': 'https://api.github.com/users/xuhdev/orgs', 'repos_url': 'https://api.github.com/users/xuhdev/repos', 'events_url': 'https://api.github.com/users/xuhdev/events{/privacy}', 'received_events_url': 'https://api.github.com/users/xuhdev/received_events', 'type': 'User', 'site_admin': False}",referenced,2f722842ccd1c2efa0557d56ec7d677b7412ed00,https://api.github.com/repos/pytorch/pytorch/commits/2f722842ccd1c2efa0557d56ec7d677b7412ed00,2019-08-22T21:58:55Z,752,467,285
24617,2588540349,"{'login': 'xuhdev', 'id': 325476, 'node_id': 'MDQ6VXNlcjMyNTQ3Ng==', 'avatar_url': 'https://avatars1.githubusercontent.com/u/325476?v=4', 'gravatar_id': '', 'url': 'https://api.github.com/users/xuhdev', 'html_url': 'https://github.com/xuhdev', 'followers_url': 'https://api.github.com/users/xuhdev/followers', 'following_url': 'https://api.github.com/users/xuhdev/following{/other_user}', 'gists_url': 'https://api.github.com/users/xuhdev/gists{/gist_id}', 'starred_url': 'https://api.github.com/users/xuhdev/starred{/owner}{/repo}', 'subscriptions_url': 'https://api.github.com/users/xuhdev/subscriptions', 'organizations_url': 'https://api.github.com/users/xuhdev/orgs', 'repos_url': 'https://api.github.com/users/xuhdev/repos', 'events_url': 'https://api.github.com/users/xuhdev/events{/privacy}', 'received_events_url': 'https://api.github.com/users/xuhdev/received_events', 'type': 'User', 'site_admin': False}",referenced,e8bdfdfd19039dfd06d9621833e113357a957e2f,https://api.github.com/repos/pytorch/pytorch/commits/e8bdfdfd19039dfd06d9621833e113357a957e2f,2019-08-27T21:25:15Z,53,19,34
24617,2588541137,"{'login': 'xuhdev', 'id': 325476, 'node_id': 'MDQ6VXNlcjMyNTQ3Ng==', 'avatar_url': 'https://avatars1.githubusercontent.com/u/325476?v=4', 'gravatar_id': '', 'url': 'https://api.github.com/users/xuhdev', 'html_url': 'https://github.com/xuhdev', 'followers_url': 'https://api.github.com/users/xuhdev/followers', 'following_url': 'https://api.github.com/users/xuhdev/following{/other_user}', 'gists_url': 'https://api.github.com/users/xuhdev/gists{/gist_id}', 'starred_url': 'https://api.github.com/users/xuhdev/starred{/owner}{/repo}', 'subscriptions_url': 'https://api.github.com/users/xuhdev/subscriptions', 'organizations_url': 'https://api.github.com/users/xuhdev/orgs', 'repos_url': 'https://api.github.com/users/xuhdev/repos', 'events_url': 'https://api.github.com/users/xuhdev/events{/privacy}', 'received_events_url': 'https://api.github.com/users/xuhdev/received_events', 'type': 'User', 'site_admin': False}",referenced,af7a2b9fd2207a3a36e981b58878139e0acb8157,https://api.github.com/repos/pytorch/pytorch/commits/af7a2b9fd2207a3a36e981b58878139e0acb8157,2019-08-27T21:25:32Z,12486,10821,1665
24617,2588916155,"{'login': 'xuhdev', 'id': 325476, 'node_id': 'MDQ6VXNlcjMyNTQ3Ng==', 'avatar_url': 'https://avatars1.githubusercontent.com/u/325476?v=4', 'gravatar_id': '', 'url': 'https://api.github.com/users/xuhdev', 'html_url': 'https://github.com/xuhdev', 'followers_url': 'https://api.github.com/users/xuhdev/followers', 'following_url': 'https://api.github.com/users/xuhdev/following{/other_user}', 'gists_url': 'https://api.github.com/users/xuhdev/gists{/gist_id}', 'starred_url': 'https://api.github.com/users/xuhdev/starred{/owner}{/repo}', 'subscriptions_url': 'https://api.github.com/users/xuhdev/subscriptions', 'organizations_url': 'https://api.github.com/users/xuhdev/orgs', 'repos_url': 'https://api.github.com/users/xuhdev/repos', 'events_url': 'https://api.github.com/users/xuhdev/events{/privacy}', 'received_events_url': 'https://api.github.com/users/xuhdev/received_events', 'type': 'User', 'site_admin': False}",referenced,124400059e6ece6ae0632c73d2ee390709ed49d2,https://api.github.com/repos/pytorch/pytorch/commits/124400059e6ece6ae0632c73d2ee390709ed49d2,2019-08-28T01:05:26Z,16,8,8
24617,2588916257,"{'login': 'xuhdev', 'id': 325476, 'node_id': 'MDQ6VXNlcjMyNTQ3Ng==', 'avatar_url': 'https://avatars1.githubusercontent.com/u/325476?v=4', 'gravatar_id': '', 'url': 'https://api.github.com/users/xuhdev', 'html_url': 'https://github.com/xuhdev', 'followers_url': 'https://api.github.com/users/xuhdev/followers', 'following_url': 'https://api.github.com/users/xuhdev/following{/other_user}', 'gists_url': 'https://api.github.com/users/xuhdev/gists{/gist_id}', 'starred_url': 'https://api.github.com/users/xuhdev/starred{/owner}{/repo}', 'subscriptions_url': 'https://api.github.com/users/xuhdev/subscriptions', 'organizations_url': 'https://api.github.com/users/xuhdev/orgs', 'repos_url': 'https://api.github.com/users/xuhdev/repos', 'events_url': 'https://api.github.com/users/xuhdev/events{/privacy}', 'received_events_url': 'https://api.github.com/users/xuhdev/received_events', 'type': 'User', 'site_admin': False}",referenced,edce3386d49d7e4f3f9cf069125c83a1aad94f4c,https://api.github.com/repos/pytorch/pytorch/commits/edce3386d49d7e4f3f9cf069125c83a1aad94f4c,2019-08-28T01:05:31Z,53,19,34
24617,2591514534,"{'login': 'xuhdev', 'id': 325476, 'node_id': 'MDQ6VXNlcjMyNTQ3Ng==', 'avatar_url': 'https://avatars1.githubusercontent.com/u/325476?v=4', 'gravatar_id': '', 'url': 'https://api.github.com/users/xuhdev', 'html_url': 'https://github.com/xuhdev', 'followers_url': 'https://api.github.com/users/xuhdev/followers', 'following_url': 'https://api.github.com/users/xuhdev/following{/other_user}', 'gists_url': 'https://api.github.com/users/xuhdev/gists{/gist_id}', 'starred_url': 'https://api.github.com/users/xuhdev/starred{/owner}{/repo}', 'subscriptions_url': 'https://api.github.com/users/xuhdev/subscriptions', 'organizations_url': 'https://api.github.com/users/xuhdev/orgs', 'repos_url': 'https://api.github.com/users/xuhdev/repos', 'events_url': 'https://api.github.com/users/xuhdev/events{/privacy}', 'received_events_url': 'https://api.github.com/users/xuhdev/received_events', 'type': 'User', 'site_admin': False}",referenced,7380876d4b53250c73a7318bc27468a87c527529,https://api.github.com/repos/pytorch/pytorch/commits/7380876d4b53250c73a7318bc27468a87c527529,2019-08-28T18:26:52Z,5796,3631,2165
24617,2591610116,"{'login': 'xuhdev', 'id': 325476, 'node_id': 'MDQ6VXNlcjMyNTQ3Ng==', 'avatar_url': 'https://avatars1.githubusercontent.com/u/325476?v=4', 'gravatar_id': '', 'url': 'https://api.github.com/users/xuhdev', 'html_url': 'https://github.com/xuhdev', 'followers_url': 'https://api.github.com/users/xuhdev/followers', 'following_url': 'https://api.github.com/users/xuhdev/following{/other_user}', 'gists_url': 'https://api.github.com/users/xuhdev/gists{/gist_id}', 'starred_url': 'https://api.github.com/users/xuhdev/starred{/owner}{/repo}', 'subscriptions_url': 'https://api.github.com/users/xuhdev/subscriptions', 'organizations_url': 'https://api.github.com/users/xuhdev/orgs', 'repos_url': 'https://api.github.com/users/xuhdev/repos', 'events_url': 'https://api.github.com/users/xuhdev/events{/privacy}', 'received_events_url': 'https://api.github.com/users/xuhdev/received_events', 'type': 'User', 'site_admin': False}",referenced,100433db80b9a2657aac6a4a842ee23b5b75ee7e,https://api.github.com/repos/pytorch/pytorch/commits/100433db80b9a2657aac6a4a842ee23b5b75ee7e,2019-08-28T19:00:31Z,29,11,18
24617,2592319348,"{'login': 'xuhdev', 'id': 325476, 'node_id': 'MDQ6VXNlcjMyNTQ3Ng==', 'avatar_url': 'https://avatars1.githubusercontent.com/u/325476?v=4', 'gravatar_id': '', 'url': 'https://api.github.com/users/xuhdev', 'html_url': 'https://github.com/xuhdev', 'followers_url': 'https://api.github.com/users/xuhdev/followers', 'following_url': 'https://api.github.com/users/xuhdev/following{/other_user}', 'gists_url': 'https://api.github.com/users/xuhdev/gists{/gist_id}', 'starred_url': 'https://api.github.com/users/xuhdev/starred{/owner}{/repo}', 'subscriptions_url': 'https://api.github.com/users/xuhdev/subscriptions', 'organizations_url': 'https://api.github.com/users/xuhdev/orgs', 'repos_url': 'https://api.github.com/users/xuhdev/repos', 'events_url': 'https://api.github.com/users/xuhdev/events{/privacy}', 'received_events_url': 'https://api.github.com/users/xuhdev/received_events', 'type': 'User', 'site_admin': False}",referenced,936c1f4e00a46a85b62e0a263e9621f3f830c505,https://api.github.com/repos/pytorch/pytorch/commits/936c1f4e00a46a85b62e0a263e9621f3f830c505,2019-08-29T00:37:40Z,51,17,34
24617,2592319655,"{'login': 'xuhdev', 'id': 325476, 'node_id': 'MDQ6VXNlcjMyNTQ3Ng==', 'avatar_url': 'https://avatars1.githubusercontent.com/u/325476?v=4', 'gravatar_id': '', 'url': 'https://api.github.com/users/xuhdev', 'html_url': 'https://github.com/xuhdev', 'followers_url': 'https://api.github.com/users/xuhdev/followers', 'following_url': 'https://api.github.com/users/xuhdev/following{/other_user}', 'gists_url': 'https://api.github.com/users/xuhdev/gists{/gist_id}', 'starred_url': 'https://api.github.com/users/xuhdev/starred{/owner}{/repo}', 'subscriptions_url': 'https://api.github.com/users/xuhdev/subscriptions', 'organizations_url': 'https://api.github.com/users/xuhdev/orgs', 'repos_url': 'https://api.github.com/users/xuhdev/repos', 'events_url': 'https://api.github.com/users/xuhdev/events{/privacy}', 'received_events_url': 'https://api.github.com/users/xuhdev/received_events', 'type': 'User', 'site_admin': False}",referenced,657ba6ab7941b90751b76f3e3eb1938137a8e9c2,https://api.github.com/repos/pytorch/pytorch/commits/657ba6ab7941b90751b76f3e3eb1938137a8e9c2,2019-08-29T00:37:54Z,5,0,5
24617,2592319851,"{'login': 'xuhdev', 'id': 325476, 'node_id': 'MDQ6VXNlcjMyNTQ3Ng==', 'avatar_url': 'https://avatars1.githubusercontent.com/u/325476?v=4', 'gravatar_id': '', 'url': 'https://api.github.com/users/xuhdev', 'html_url': 'https://github.com/xuhdev', 'followers_url': 'https://api.github.com/users/xuhdev/followers', 'following_url': 'https://api.github.com/users/xuhdev/following{/other_user}', 'gists_url': 'https://api.github.com/users/xuhdev/gists{/gist_id}', 'starred_url': 'https://api.github.com/users/xuhdev/starred{/owner}{/repo}', 'subscriptions_url': 'https://api.github.com/users/xuhdev/subscriptions', 'organizations_url': 'https://api.github.com/users/xuhdev/orgs', 'repos_url': 'https://api.github.com/users/xuhdev/repos', 'events_url': 'https://api.github.com/users/xuhdev/events{/privacy}', 'received_events_url': 'https://api.github.com/users/xuhdev/received_events', 'type': 'User', 'site_admin': False}",referenced,16518a6c7f5d7ba826800f1d720817e054478410,https://api.github.com/repos/pytorch/pytorch/commits/16518a6c7f5d7ba826800f1d720817e054478410,2019-08-29T00:38:03Z,51,17,34
24617,2595108034,"{'login': 'xuhdev', 'id': 325476, 'node_id': 'MDQ6VXNlcjMyNTQ3Ng==', 'avatar_url': 'https://avatars1.githubusercontent.com/u/325476?v=4', 'gravatar_id': '', 'url': 'https://api.github.com/users/xuhdev', 'html_url': 'https://github.com/xuhdev', 'followers_url': 'https://api.github.com/users/xuhdev/followers', 'following_url': 'https://api.github.com/users/xuhdev/following{/other_user}', 'gists_url': 'https://api.github.com/users/xuhdev/gists{/gist_id}', 'starred_url': 'https://api.github.com/users/xuhdev/starred{/owner}{/repo}', 'subscriptions_url': 'https://api.github.com/users/xuhdev/subscriptions', 'organizations_url': 'https://api.github.com/users/xuhdev/orgs', 'repos_url': 'https://api.github.com/users/xuhdev/repos', 'events_url': 'https://api.github.com/users/xuhdev/events{/privacy}', 'received_events_url': 'https://api.github.com/users/xuhdev/received_events', 'type': 'User', 'site_admin': False}",referenced,2fb637357f93a5b41d1b517443f357e0ea01f24c,https://api.github.com/repos/pytorch/pytorch/commits/2fb637357f93a5b41d1b517443f357e0ea01f24c,2019-08-29T19:34:31Z,51,17,34
24617,2595108036,"{'login': 'xuhdev', 'id': 325476, 'node_id': 'MDQ6VXNlcjMyNTQ3Ng==', 'avatar_url': 'https://avatars1.githubusercontent.com/u/325476?v=4', 'gravatar_id': '', 'url': 'https://api.github.com/users/xuhdev', 'html_url': 'https://github.com/xuhdev', 'followers_url': 'https://api.github.com/users/xuhdev/followers', 'following_url': 'https://api.github.com/users/xuhdev/following{/other_user}', 'gists_url': 'https://api.github.com/users/xuhdev/gists{/gist_id}', 'starred_url': 'https://api.github.com/users/xuhdev/starred{/owner}{/repo}', 'subscriptions_url': 'https://api.github.com/users/xuhdev/subscriptions', 'organizations_url': 'https://api.github.com/users/xuhdev/orgs', 'repos_url': 'https://api.github.com/users/xuhdev/repos', 'events_url': 'https://api.github.com/users/xuhdev/events{/privacy}', 'received_events_url': 'https://api.github.com/users/xuhdev/received_events', 'type': 'User', 'site_admin': False}",referenced,a37f18a68e9c6d679cba92792aa9657ba7c42be6,https://api.github.com/repos/pytorch/pytorch/commits/a37f18a68e9c6d679cba92792aa9657ba7c42be6,2019-08-29T19:34:31Z,9552,5570,3982
24617,2595108040,"{'login': 'xuhdev', 'id': 325476, 'node_id': 'MDQ6VXNlcjMyNTQ3Ng==', 'avatar_url': 'https://avatars1.githubusercontent.com/u/325476?v=4', 'gravatar_id': '', 'url': 'https://api.github.com/users/xuhdev', 'html_url': 'https://github.com/xuhdev', 'followers_url': 'https://api.github.com/users/xuhdev/followers', 'following_url': 'https://api.github.com/users/xuhdev/following{/other_user}', 'gists_url': 'https://api.github.com/users/xuhdev/gists{/gist_id}', 'starred_url': 'https://api.github.com/users/xuhdev/starred{/owner}{/repo}', 'subscriptions_url': 'https://api.github.com/users/xuhdev/subscriptions', 'organizations_url': 'https://api.github.com/users/xuhdev/orgs', 'repos_url': 'https://api.github.com/users/xuhdev/repos', 'events_url': 'https://api.github.com/users/xuhdev/events{/privacy}', 'received_events_url': 'https://api.github.com/users/xuhdev/received_events', 'type': 'User', 'site_admin': False}",referenced,b5bdca8784f0ca08e4e833d10d083ea94a82d43a,https://api.github.com/repos/pytorch/pytorch/commits/b5bdca8784f0ca08e4e833d10d083ea94a82d43a,2019-08-29T19:34:31Z,9552,5570,3982
24617,2604468248,"{'login': 'xuhdev', 'id': 325476, 'node_id': 'MDQ6VXNlcjMyNTQ3Ng==', 'avatar_url': 'https://avatars1.githubusercontent.com/u/325476?v=4', 'gravatar_id': '', 'url': 'https://api.github.com/users/xuhdev', 'html_url': 'https://github.com/xuhdev', 'followers_url': 'https://api.github.com/users/xuhdev/followers', 'following_url': 'https://api.github.com/users/xuhdev/following{/other_user}', 'gists_url': 'https://api.github.com/users/xuhdev/gists{/gist_id}', 'starred_url': 'https://api.github.com/users/xuhdev/starred{/owner}{/repo}', 'subscriptions_url': 'https://api.github.com/users/xuhdev/subscriptions', 'organizations_url': 'https://api.github.com/users/xuhdev/orgs', 'repos_url': 'https://api.github.com/users/xuhdev/repos', 'events_url': 'https://api.github.com/users/xuhdev/events{/privacy}', 'received_events_url': 'https://api.github.com/users/xuhdev/received_events', 'type': 'User', 'site_admin': False}",referenced,80f4855cece95c609ceadb7c3bd1ca3251e70ce4,https://api.github.com/repos/pytorch/pytorch/commits/80f4855cece95c609ceadb7c3bd1ca3251e70ce4,2019-09-03T17:53:28Z,16323,8639,7684
24617,2604468255,"{'login': 'xuhdev', 'id': 325476, 'node_id': 'MDQ6VXNlcjMyNTQ3Ng==', 'avatar_url': 'https://avatars1.githubusercontent.com/u/325476?v=4', 'gravatar_id': '', 'url': 'https://api.github.com/users/xuhdev', 'html_url': 'https://github.com/xuhdev', 'followers_url': 'https://api.github.com/users/xuhdev/followers', 'following_url': 'https://api.github.com/users/xuhdev/following{/other_user}', 'gists_url': 'https://api.github.com/users/xuhdev/gists{/gist_id}', 'starred_url': 'https://api.github.com/users/xuhdev/starred{/owner}{/repo}', 'subscriptions_url': 'https://api.github.com/users/xuhdev/subscriptions', 'organizations_url': 'https://api.github.com/users/xuhdev/orgs', 'repos_url': 'https://api.github.com/users/xuhdev/repos', 'events_url': 'https://api.github.com/users/xuhdev/events{/privacy}', 'received_events_url': 'https://api.github.com/users/xuhdev/received_events', 'type': 'User', 'site_admin': False}",referenced,818cec868f4e3274608c88b8d6d4d5f5340c9dda,https://api.github.com/repos/pytorch/pytorch/commits/818cec868f4e3274608c88b8d6d4d5f5340c9dda,2019-09-03T17:53:28Z,16323,8639,7684
24617,2604468260,"{'login': 'xuhdev', 'id': 325476, 'node_id': 'MDQ6VXNlcjMyNTQ3Ng==', 'avatar_url': 'https://avatars1.githubusercontent.com/u/325476?v=4', 'gravatar_id': '', 'url': 'https://api.github.com/users/xuhdev', 'html_url': 'https://github.com/xuhdev', 'followers_url': 'https://api.github.com/users/xuhdev/followers', 'following_url': 'https://api.github.com/users/xuhdev/following{/other_user}', 'gists_url': 'https://api.github.com/users/xuhdev/gists{/gist_id}', 'starred_url': 'https://api.github.com/users/xuhdev/starred{/owner}{/repo}', 'subscriptions_url': 'https://api.github.com/users/xuhdev/subscriptions', 'organizations_url': 'https://api.github.com/users/xuhdev/orgs', 'repos_url': 'https://api.github.com/users/xuhdev/repos', 'events_url': 'https://api.github.com/users/xuhdev/events{/privacy}', 'received_events_url': 'https://api.github.com/users/xuhdev/received_events', 'type': 'User', 'site_admin': False}",referenced,e98a53eec28f73d890cc1569b700c2b022ce7381,https://api.github.com/repos/pytorch/pytorch/commits/e98a53eec28f73d890cc1569b700c2b022ce7381,2019-09-03T17:53:28Z,16323,8639,7684
24617,2605107398,"{'login': 'xuhdev', 'id': 325476, 'node_id': 'MDQ6VXNlcjMyNTQ3Ng==', 'avatar_url': 'https://avatars1.githubusercontent.com/u/325476?v=4', 'gravatar_id': '', 'url': 'https://api.github.com/users/xuhdev', 'html_url': 'https://github.com/xuhdev', 'followers_url': 'https://api.github.com/users/xuhdev/followers', 'following_url': 'https://api.github.com/users/xuhdev/following{/other_user}', 'gists_url': 'https://api.github.com/users/xuhdev/gists{/gist_id}', 'starred_url': 'https://api.github.com/users/xuhdev/starred{/owner}{/repo}', 'subscriptions_url': 'https://api.github.com/users/xuhdev/subscriptions', 'organizations_url': 'https://api.github.com/users/xuhdev/orgs', 'repos_url': 'https://api.github.com/users/xuhdev/repos', 'events_url': 'https://api.github.com/users/xuhdev/events{/privacy}', 'received_events_url': 'https://api.github.com/users/xuhdev/received_events', 'type': 'User', 'site_admin': False}",referenced,d121fc414a07870f51e543af0033680a5fe0f37a,https://api.github.com/repos/pytorch/pytorch/commits/d121fc414a07870f51e543af0033680a5fe0f37a,2019-09-03T21:52:38Z,634,544,90
24617,2605107405,"{'login': 'xuhdev', 'id': 325476, 'node_id': 'MDQ6VXNlcjMyNTQ3Ng==', 'avatar_url': 'https://avatars1.githubusercontent.com/u/325476?v=4', 'gravatar_id': '', 'url': 'https://api.github.com/users/xuhdev', 'html_url': 'https://github.com/xuhdev', 'followers_url': 'https://api.github.com/users/xuhdev/followers', 'following_url': 'https://api.github.com/users/xuhdev/following{/other_user}', 'gists_url': 'https://api.github.com/users/xuhdev/gists{/gist_id}', 'starred_url': 'https://api.github.com/users/xuhdev/starred{/owner}{/repo}', 'subscriptions_url': 'https://api.github.com/users/xuhdev/subscriptions', 'organizations_url': 'https://api.github.com/users/xuhdev/orgs', 'repos_url': 'https://api.github.com/users/xuhdev/repos', 'events_url': 'https://api.github.com/users/xuhdev/events{/privacy}', 'received_events_url': 'https://api.github.com/users/xuhdev/received_events', 'type': 'User', 'site_admin': False}",referenced,40afbfc70b7bc27a1946bb5245f1d20690ae02cb,https://api.github.com/repos/pytorch/pytorch/commits/40afbfc70b7bc27a1946bb5245f1d20690ae02cb,2019-09-03T21:52:38Z,634,544,90
24617,2605107637,"{'login': 'xuhdev', 'id': 325476, 'node_id': 'MDQ6VXNlcjMyNTQ3Ng==', 'avatar_url': 'https://avatars1.githubusercontent.com/u/325476?v=4', 'gravatar_id': '', 'url': 'https://api.github.com/users/xuhdev', 'html_url': 'https://github.com/xuhdev', 'followers_url': 'https://api.github.com/users/xuhdev/followers', 'following_url': 'https://api.github.com/users/xuhdev/following{/other_user}', 'gists_url': 'https://api.github.com/users/xuhdev/gists{/gist_id}', 'starred_url': 'https://api.github.com/users/xuhdev/starred{/owner}{/repo}', 'subscriptions_url': 'https://api.github.com/users/xuhdev/subscriptions', 'organizations_url': 'https://api.github.com/users/xuhdev/orgs', 'repos_url': 'https://api.github.com/users/xuhdev/repos', 'events_url': 'https://api.github.com/users/xuhdev/events{/privacy}', 'received_events_url': 'https://api.github.com/users/xuhdev/received_events', 'type': 'User', 'site_admin': False}",referenced,27620c78db3bcef1c739dafc9d56b14fe3d88f60,https://api.github.com/repos/pytorch/pytorch/commits/27620c78db3bcef1c739dafc9d56b14fe3d88f60,2019-09-03T21:52:44Z,634,544,90
24617,2608657146,"{'login': 'xuhdev', 'id': 325476, 'node_id': 'MDQ6VXNlcjMyNTQ3Ng==', 'avatar_url': 'https://avatars1.githubusercontent.com/u/325476?v=4', 'gravatar_id': '', 'url': 'https://api.github.com/users/xuhdev', 'html_url': 'https://github.com/xuhdev', 'followers_url': 'https://api.github.com/users/xuhdev/followers', 'following_url': 'https://api.github.com/users/xuhdev/following{/other_user}', 'gists_url': 'https://api.github.com/users/xuhdev/gists{/gist_id}', 'starred_url': 'https://api.github.com/users/xuhdev/starred{/owner}{/repo}', 'subscriptions_url': 'https://api.github.com/users/xuhdev/subscriptions', 'organizations_url': 'https://api.github.com/users/xuhdev/orgs', 'repos_url': 'https://api.github.com/users/xuhdev/repos', 'events_url': 'https://api.github.com/users/xuhdev/events{/privacy}', 'received_events_url': 'https://api.github.com/users/xuhdev/received_events', 'type': 'User', 'site_admin': False}",referenced,1b6a024fcd979c28492040000b979f937b6145f6,https://api.github.com/repos/pytorch/pytorch/commits/1b6a024fcd979c28492040000b979f937b6145f6,2019-09-04T22:14:17Z,6747,4072,2675
24617,2608657150,"{'login': 'xuhdev', 'id': 325476, 'node_id': 'MDQ6VXNlcjMyNTQ3Ng==', 'avatar_url': 'https://avatars1.githubusercontent.com/u/325476?v=4', 'gravatar_id': '', 'url': 'https://api.github.com/users/xuhdev', 'html_url': 'https://github.com/xuhdev', 'followers_url': 'https://api.github.com/users/xuhdev/followers', 'following_url': 'https://api.github.com/users/xuhdev/following{/other_user}', 'gists_url': 'https://api.github.com/users/xuhdev/gists{/gist_id}', 'starred_url': 'https://api.github.com/users/xuhdev/starred{/owner}{/repo}', 'subscriptions_url': 'https://api.github.com/users/xuhdev/subscriptions', 'organizations_url': 'https://api.github.com/users/xuhdev/orgs', 'repos_url': 'https://api.github.com/users/xuhdev/repos', 'events_url': 'https://api.github.com/users/xuhdev/events{/privacy}', 'received_events_url': 'https://api.github.com/users/xuhdev/received_events', 'type': 'User', 'site_admin': False}",referenced,af3234b1a09b63ff63cd0cf7e2730e6be8544450,https://api.github.com/repos/pytorch/pytorch/commits/af3234b1a09b63ff63cd0cf7e2730e6be8544450,2019-09-04T22:14:17Z,6747,4072,2675
24613,2623643916,"{'login': 'facebook-github-bot', 'id': 6422482, 'node_id': 'MDQ6VXNlcjY0MjI0ODI=', 'avatar_url': 'https://avatars3.githubusercontent.com/u/6422482?v=4', 'gravatar_id': '', 'url': 'https://api.github.com/users/facebook-github-bot', 'html_url': 'https://github.com/facebook-github-bot', 'followers_url': 'https://api.github.com/users/facebook-github-bot/followers', 'following_url': 'https://api.github.com/users/facebook-github-bot/following{/other_user}', 'gists_url': 'https://api.github.com/users/facebook-github-bot/gists{/gist_id}', 'starred_url': 'https://api.github.com/users/facebook-github-bot/starred{/owner}{/repo}', 'subscriptions_url': 'https://api.github.com/users/facebook-github-bot/subscriptions', 'organizations_url': 'https://api.github.com/users/facebook-github-bot/orgs', 'repos_url': 'https://api.github.com/users/facebook-github-bot/repos', 'events_url': 'https://api.github.com/users/facebook-github-bot/events{/privacy}', 'received_events_url': 'https://api.github.com/users/facebook-github-bot/received_events', 'type': 'User', 'site_admin': False}",closed,a14e88454690645d57e056f45829331df7eef611,https://api.github.com/repos/pytorch/pytorch/commits/a14e88454690645d57e056f45829331df7eef611,2019-09-10T20:46:36Z,447,120,327
24612,2590977697,"{'login': 'facebook-github-bot', 'id': 6422482, 'node_id': 'MDQ6VXNlcjY0MjI0ODI=', 'avatar_url': 'https://avatars3.githubusercontent.com/u/6422482?v=4', 'gravatar_id': '', 'url': 'https://api.github.com/users/facebook-github-bot', 'html_url': 'https://github.com/facebook-github-bot', 'followers_url': 'https://api.github.com/users/facebook-github-bot/followers', 'following_url': 'https://api.github.com/users/facebook-github-bot/following{/other_user}', 'gists_url': 'https://api.github.com/users/facebook-github-bot/gists{/gist_id}', 'starred_url': 'https://api.github.com/users/facebook-github-bot/starred{/owner}{/repo}', 'subscriptions_url': 'https://api.github.com/users/facebook-github-bot/subscriptions', 'organizations_url': 'https://api.github.com/users/facebook-github-bot/orgs', 'repos_url': 'https://api.github.com/users/facebook-github-bot/repos', 'events_url': 'https://api.github.com/users/facebook-github-bot/events{/privacy}', 'received_events_url': 'https://api.github.com/users/facebook-github-bot/received_events', 'type': 'User', 'site_admin': False}",referenced,9b1097958e8f72167711ce1b447e1d8b9d77c0ff,https://api.github.com/repos/pytorch/pytorch/commits/9b1097958e8f72167711ce1b447e1d8b9d77c0ff,2019-08-28T15:29:24Z,453,219,234
24612,2612995450,"{'login': 'facebook-github-bot', 'id': 6422482, 'node_id': 'MDQ6VXNlcjY0MjI0ODI=', 'avatar_url': 'https://avatars3.githubusercontent.com/u/6422482?v=4', 'gravatar_id': '', 'url': 'https://api.github.com/users/facebook-github-bot', 'html_url': 'https://github.com/facebook-github-bot', 'followers_url': 'https://api.github.com/users/facebook-github-bot/followers', 'following_url': 'https://api.github.com/users/facebook-github-bot/following{/other_user}', 'gists_url': 'https://api.github.com/users/facebook-github-bot/gists{/gist_id}', 'starred_url': 'https://api.github.com/users/facebook-github-bot/starred{/owner}{/repo}', 'subscriptions_url': 'https://api.github.com/users/facebook-github-bot/subscriptions', 'organizations_url': 'https://api.github.com/users/facebook-github-bot/orgs', 'repos_url': 'https://api.github.com/users/facebook-github-bot/repos', 'events_url': 'https://api.github.com/users/facebook-github-bot/events{/privacy}', 'received_events_url': 'https://api.github.com/users/facebook-github-bot/received_events', 'type': 'User', 'site_admin': False}",closed,d939ee2d85412f86b148f3f83c6cdc9c9567bef7,https://api.github.com/repos/pytorch/pytorch/commits/d939ee2d85412f86b148f3f83c6cdc9c9567bef7,2019-09-06T02:49:44Z,383,128,255
24606,2670200177,"{'login': 'facebook-github-bot', 'id': 6422482, 'node_id': 'MDQ6VXNlcjY0MjI0ODI=', 'avatar_url': 'https://avatars3.githubusercontent.com/u/6422482?v=4', 'gravatar_id': '', 'url': 'https://api.github.com/users/facebook-github-bot', 'html_url': 'https://github.com/facebook-github-bot', 'followers_url': 'https://api.github.com/users/facebook-github-bot/followers', 'following_url': 'https://api.github.com/users/facebook-github-bot/following{/other_user}', 'gists_url': 'https://api.github.com/users/facebook-github-bot/gists{/gist_id}', 'starred_url': 'https://api.github.com/users/facebook-github-bot/starred{/owner}{/repo}', 'subscriptions_url': 'https://api.github.com/users/facebook-github-bot/subscriptions', 'organizations_url': 'https://api.github.com/users/facebook-github-bot/orgs', 'repos_url': 'https://api.github.com/users/facebook-github-bot/repos', 'events_url': 'https://api.github.com/users/facebook-github-bot/events{/privacy}', 'received_events_url': 'https://api.github.com/users/facebook-github-bot/received_events', 'type': 'User', 'site_admin': False}",referenced,541de7e140e35eced300c8b0f31218bb6320d183,https://api.github.com/repos/pytorch/pytorch/commits/541de7e140e35eced300c8b0f31218bb6320d183,2019-09-28T00:29:07Z,1553,335,1218
24604,2663563416,"{'login': 'facebook-github-bot', 'id': 6422482, 'node_id': 'MDQ6VXNlcjY0MjI0ODI=', 'avatar_url': 'https://avatars3.githubusercontent.com/u/6422482?v=4', 'gravatar_id': '', 'url': 'https://api.github.com/users/facebook-github-bot', 'html_url': 'https://github.com/facebook-github-bot', 'followers_url': 'https://api.github.com/users/facebook-github-bot/followers', 'following_url': 'https://api.github.com/users/facebook-github-bot/following{/other_user}', 'gists_url': 'https://api.github.com/users/facebook-github-bot/gists{/gist_id}', 'starred_url': 'https://api.github.com/users/facebook-github-bot/starred{/owner}{/repo}', 'subscriptions_url': 'https://api.github.com/users/facebook-github-bot/subscriptions', 'organizations_url': 'https://api.github.com/users/facebook-github-bot/orgs', 'repos_url': 'https://api.github.com/users/facebook-github-bot/repos', 'events_url': 'https://api.github.com/users/facebook-github-bot/events{/privacy}', 'received_events_url': 'https://api.github.com/users/facebook-github-bot/received_events', 'type': 'User', 'site_admin': False}",referenced,2eb592324f4de32ab5626f45e40d0a8d6a962cb7,https://api.github.com/repos/pytorch/pytorch/commits/2eb592324f4de32ab5626f45e40d0a8d6a962cb7,2019-09-26T00:57:18Z,1017,492,525
24593,2666936657,"{'login': 'facebook-github-bot', 'id': 6422482, 'node_id': 'MDQ6VXNlcjY0MjI0ODI=', 'avatar_url': 'https://avatars3.githubusercontent.com/u/6422482?v=4', 'gravatar_id': '', 'url': 'https://api.github.com/users/facebook-github-bot', 'html_url': 'https://github.com/facebook-github-bot', 'followers_url': 'https://api.github.com/users/facebook-github-bot/followers', 'following_url': 'https://api.github.com/users/facebook-github-bot/following{/other_user}', 'gists_url': 'https://api.github.com/users/facebook-github-bot/gists{/gist_id}', 'starred_url': 'https://api.github.com/users/facebook-github-bot/starred{/owner}{/repo}', 'subscriptions_url': 'https://api.github.com/users/facebook-github-bot/subscriptions', 'organizations_url': 'https://api.github.com/users/facebook-github-bot/orgs', 'repos_url': 'https://api.github.com/users/facebook-github-bot/repos', 'events_url': 'https://api.github.com/users/facebook-github-bot/events{/privacy}', 'received_events_url': 'https://api.github.com/users/facebook-github-bot/received_events', 'type': 'User', 'site_admin': False}",referenced,f99bc714c7bacf9a74c85514ef70b677415d4f0c,https://api.github.com/repos/pytorch/pytorch/commits/f99bc714c7bacf9a74c85514ef70b677415d4f0c,2019-09-26T23:05:50Z,462,264,198
24589,2659867545,"{'login': 'xuhdev', 'id': 325476, 'node_id': 'MDQ6VXNlcjMyNTQ3Ng==', 'avatar_url': 'https://avatars1.githubusercontent.com/u/325476?v=4', 'gravatar_id': '', 'url': 'https://api.github.com/users/xuhdev', 'html_url': 'https://github.com/xuhdev', 'followers_url': 'https://api.github.com/users/xuhdev/followers', 'following_url': 'https://api.github.com/users/xuhdev/following{/other_user}', 'gists_url': 'https://api.github.com/users/xuhdev/gists{/gist_id}', 'starred_url': 'https://api.github.com/users/xuhdev/starred{/owner}{/repo}', 'subscriptions_url': 'https://api.github.com/users/xuhdev/subscriptions', 'organizations_url': 'https://api.github.com/users/xuhdev/orgs', 'repos_url': 'https://api.github.com/users/xuhdev/repos', 'events_url': 'https://api.github.com/users/xuhdev/events{/privacy}', 'received_events_url': 'https://api.github.com/users/xuhdev/received_events', 'type': 'User', 'site_admin': False}",referenced,1fecb5000faf045d663c5a1b84d910e9bd84ac24,https://api.github.com/repos/pytorch/pytorch/commits/1fecb5000faf045d663c5a1b84d910e9bd84ac24,2019-09-24T23:50:49Z,71,17,54
24589,2659867741,"{'login': 'xuhdev', 'id': 325476, 'node_id': 'MDQ6VXNlcjMyNTQ3Ng==', 'avatar_url': 'https://avatars1.githubusercontent.com/u/325476?v=4', 'gravatar_id': '', 'url': 'https://api.github.com/users/xuhdev', 'html_url': 'https://github.com/xuhdev', 'followers_url': 'https://api.github.com/users/xuhdev/followers', 'following_url': 'https://api.github.com/users/xuhdev/following{/other_user}', 'gists_url': 'https://api.github.com/users/xuhdev/gists{/gist_id}', 'starred_url': 'https://api.github.com/users/xuhdev/starred{/owner}{/repo}', 'subscriptions_url': 'https://api.github.com/users/xuhdev/subscriptions', 'organizations_url': 'https://api.github.com/users/xuhdev/orgs', 'repos_url': 'https://api.github.com/users/xuhdev/repos', 'events_url': 'https://api.github.com/users/xuhdev/events{/privacy}', 'received_events_url': 'https://api.github.com/users/xuhdev/received_events', 'type': 'User', 'site_admin': False}",referenced,cdc8179d642b28f9ad4e593925d13ac5ea48b3a4,https://api.github.com/repos/pytorch/pytorch/commits/cdc8179d642b28f9ad4e593925d13ac5ea48b3a4,2019-09-24T23:50:59Z,71,17,54
24589,2662598639,"{'login': 'xuhdev', 'id': 325476, 'node_id': 'MDQ6VXNlcjMyNTQ3Ng==', 'avatar_url': 'https://avatars1.githubusercontent.com/u/325476?v=4', 'gravatar_id': '', 'url': 'https://api.github.com/users/xuhdev', 'html_url': 'https://github.com/xuhdev', 'followers_url': 'https://api.github.com/users/xuhdev/followers', 'following_url': 'https://api.github.com/users/xuhdev/following{/other_user}', 'gists_url': 'https://api.github.com/users/xuhdev/gists{/gist_id}', 'starred_url': 'https://api.github.com/users/xuhdev/starred{/owner}{/repo}', 'subscriptions_url': 'https://api.github.com/users/xuhdev/subscriptions', 'organizations_url': 'https://api.github.com/users/xuhdev/orgs', 'repos_url': 'https://api.github.com/users/xuhdev/repos', 'events_url': 'https://api.github.com/users/xuhdev/events{/privacy}', 'received_events_url': 'https://api.github.com/users/xuhdev/received_events', 'type': 'User', 'site_admin': False}",referenced,dba0e2ca563b6cde2c7e169e1c52dddaa3db3a72,https://api.github.com/repos/pytorch/pytorch/commits/dba0e2ca563b6cde2c7e169e1c52dddaa3db3a72,2019-09-25T17:54:04Z,2254,1709,545
24589,2662598852,"{'login': 'xuhdev', 'id': 325476, 'node_id': 'MDQ6VXNlcjMyNTQ3Ng==', 'avatar_url': 'https://avatars1.githubusercontent.com/u/325476?v=4', 'gravatar_id': '', 'url': 'https://api.github.com/users/xuhdev', 'html_url': 'https://github.com/xuhdev', 'followers_url': 'https://api.github.com/users/xuhdev/followers', 'following_url': 'https://api.github.com/users/xuhdev/following{/other_user}', 'gists_url': 'https://api.github.com/users/xuhdev/gists{/gist_id}', 'starred_url': 'https://api.github.com/users/xuhdev/starred{/owner}{/repo}', 'subscriptions_url': 'https://api.github.com/users/xuhdev/subscriptions', 'organizations_url': 'https://api.github.com/users/xuhdev/orgs', 'repos_url': 'https://api.github.com/users/xuhdev/repos', 'events_url': 'https://api.github.com/users/xuhdev/events{/privacy}', 'received_events_url': 'https://api.github.com/users/xuhdev/received_events', 'type': 'User', 'site_admin': False}",referenced,309788913a6fa7524a465b2f72270bfa3650fba7,https://api.github.com/repos/pytorch/pytorch/commits/309788913a6fa7524a465b2f72270bfa3650fba7,2019-09-25T17:54:08Z,71,17,54
24589,2662672566,"{'login': 'xuhdev', 'id': 325476, 'node_id': 'MDQ6VXNlcjMyNTQ3Ng==', 'avatar_url': 'https://avatars1.githubusercontent.com/u/325476?v=4', 'gravatar_id': '', 'url': 'https://api.github.com/users/xuhdev', 'html_url': 'https://github.com/xuhdev', 'followers_url': 'https://api.github.com/users/xuhdev/followers', 'following_url': 'https://api.github.com/users/xuhdev/following{/other_user}', 'gists_url': 'https://api.github.com/users/xuhdev/gists{/gist_id}', 'starred_url': 'https://api.github.com/users/xuhdev/starred{/owner}{/repo}', 'subscriptions_url': 'https://api.github.com/users/xuhdev/subscriptions', 'organizations_url': 'https://api.github.com/users/xuhdev/orgs', 'repos_url': 'https://api.github.com/users/xuhdev/repos', 'events_url': 'https://api.github.com/users/xuhdev/events{/privacy}', 'received_events_url': 'https://api.github.com/users/xuhdev/received_events', 'type': 'User', 'site_admin': False}",referenced,c54bf27da04561f3a1770ffd195e42ad5a1f016f,https://api.github.com/repos/pytorch/pytorch/commits/c54bf27da04561f3a1770ffd195e42ad5a1f016f,2019-09-25T18:18:28Z,483,411,72
24589,2662672728,"{'login': 'xuhdev', 'id': 325476, 'node_id': 'MDQ6VXNlcjMyNTQ3Ng==', 'avatar_url': 'https://avatars1.githubusercontent.com/u/325476?v=4', 'gravatar_id': '', 'url': 'https://api.github.com/users/xuhdev', 'html_url': 'https://github.com/xuhdev', 'followers_url': 'https://api.github.com/users/xuhdev/followers', 'following_url': 'https://api.github.com/users/xuhdev/following{/other_user}', 'gists_url': 'https://api.github.com/users/xuhdev/gists{/gist_id}', 'starred_url': 'https://api.github.com/users/xuhdev/starred{/owner}{/repo}', 'subscriptions_url': 'https://api.github.com/users/xuhdev/subscriptions', 'organizations_url': 'https://api.github.com/users/xuhdev/orgs', 'repos_url': 'https://api.github.com/users/xuhdev/repos', 'events_url': 'https://api.github.com/users/xuhdev/events{/privacy}', 'received_events_url': 'https://api.github.com/users/xuhdev/received_events', 'type': 'User', 'site_admin': False}",referenced,9393978ad838d7b5aa80c503cde3d4cb2de6f518,https://api.github.com/repos/pytorch/pytorch/commits/9393978ad838d7b5aa80c503cde3d4cb2de6f518,2019-09-25T18:18:31Z,75,31,44
24589,2662679661,"{'login': 'xuhdev', 'id': 325476, 'node_id': 'MDQ6VXNlcjMyNTQ3Ng==', 'avatar_url': 'https://avatars1.githubusercontent.com/u/325476?v=4', 'gravatar_id': '', 'url': 'https://api.github.com/users/xuhdev', 'html_url': 'https://github.com/xuhdev', 'followers_url': 'https://api.github.com/users/xuhdev/followers', 'following_url': 'https://api.github.com/users/xuhdev/following{/other_user}', 'gists_url': 'https://api.github.com/users/xuhdev/gists{/gist_id}', 'starred_url': 'https://api.github.com/users/xuhdev/starred{/owner}{/repo}', 'subscriptions_url': 'https://api.github.com/users/xuhdev/subscriptions', 'organizations_url': 'https://api.github.com/users/xuhdev/orgs', 'repos_url': 'https://api.github.com/users/xuhdev/repos', 'events_url': 'https://api.github.com/users/xuhdev/events{/privacy}', 'received_events_url': 'https://api.github.com/users/xuhdev/received_events', 'type': 'User', 'site_admin': False}",referenced,014fb5e3e7100b72a09bbe21d6a6da69b9c75a66,https://api.github.com/repos/pytorch/pytorch/commits/014fb5e3e7100b72a09bbe21d6a6da69b9c75a66,2019-09-25T18:20:49Z,22,0,22
24589,2662679821,"{'login': 'xuhdev', 'id': 325476, 'node_id': 'MDQ6VXNlcjMyNTQ3Ng==', 'avatar_url': 'https://avatars1.githubusercontent.com/u/325476?v=4', 'gravatar_id': '', 'url': 'https://api.github.com/users/xuhdev', 'html_url': 'https://github.com/xuhdev', 'followers_url': 'https://api.github.com/users/xuhdev/followers', 'following_url': 'https://api.github.com/users/xuhdev/following{/other_user}', 'gists_url': 'https://api.github.com/users/xuhdev/gists{/gist_id}', 'starred_url': 'https://api.github.com/users/xuhdev/starred{/owner}{/repo}', 'subscriptions_url': 'https://api.github.com/users/xuhdev/subscriptions', 'organizations_url': 'https://api.github.com/users/xuhdev/orgs', 'repos_url': 'https://api.github.com/users/xuhdev/repos', 'events_url': 'https://api.github.com/users/xuhdev/events{/privacy}', 'received_events_url': 'https://api.github.com/users/xuhdev/received_events', 'type': 'User', 'site_admin': False}",referenced,aab2a41d27719d3adf3e5543c5d6fd2c75e84cf2,https://api.github.com/repos/pytorch/pytorch/commits/aab2a41d27719d3adf3e5543c5d6fd2c75e84cf2,2019-09-25T18:20:53Z,69,17,52
24589,2662682206,"{'login': 'xuhdev', 'id': 325476, 'node_id': 'MDQ6VXNlcjMyNTQ3Ng==', 'avatar_url': 'https://avatars1.githubusercontent.com/u/325476?v=4', 'gravatar_id': '', 'url': 'https://api.github.com/users/xuhdev', 'html_url': 'https://github.com/xuhdev', 'followers_url': 'https://api.github.com/users/xuhdev/followers', 'following_url': 'https://api.github.com/users/xuhdev/following{/other_user}', 'gists_url': 'https://api.github.com/users/xuhdev/gists{/gist_id}', 'starred_url': 'https://api.github.com/users/xuhdev/starred{/owner}{/repo}', 'subscriptions_url': 'https://api.github.com/users/xuhdev/subscriptions', 'organizations_url': 'https://api.github.com/users/xuhdev/orgs', 'repos_url': 'https://api.github.com/users/xuhdev/repos', 'events_url': 'https://api.github.com/users/xuhdev/events{/privacy}', 'received_events_url': 'https://api.github.com/users/xuhdev/received_events', 'type': 'User', 'site_admin': False}",referenced,969e97707fcc4090bcfe8cec3773b599e0b9e42a,https://api.github.com/repos/pytorch/pytorch/commits/969e97707fcc4090bcfe8cec3773b599e0b9e42a,2019-09-25T18:21:40Z,2,0,2
24589,2662682442,"{'login': 'xuhdev', 'id': 325476, 'node_id': 'MDQ6VXNlcjMyNTQ3Ng==', 'avatar_url': 'https://avatars1.githubusercontent.com/u/325476?v=4', 'gravatar_id': '', 'url': 'https://api.github.com/users/xuhdev', 'html_url': 'https://github.com/xuhdev', 'followers_url': 'https://api.github.com/users/xuhdev/followers', 'following_url': 'https://api.github.com/users/xuhdev/following{/other_user}', 'gists_url': 'https://api.github.com/users/xuhdev/gists{/gist_id}', 'starred_url': 'https://api.github.com/users/xuhdev/starred{/owner}{/repo}', 'subscriptions_url': 'https://api.github.com/users/xuhdev/subscriptions', 'organizations_url': 'https://api.github.com/users/xuhdev/orgs', 'repos_url': 'https://api.github.com/users/xuhdev/repos', 'events_url': 'https://api.github.com/users/xuhdev/events{/privacy}', 'received_events_url': 'https://api.github.com/users/xuhdev/received_events', 'type': 'User', 'site_admin': False}",referenced,b64200afe95a5ea7edac9cea8b347ddef966f6a0,https://api.github.com/repos/pytorch/pytorch/commits/b64200afe95a5ea7edac9cea8b347ddef966f6a0,2019-09-25T18:21:44Z,71,17,54
24589,2663472661,"{'login': 'xuhdev', 'id': 325476, 'node_id': 'MDQ6VXNlcjMyNTQ3Ng==', 'avatar_url': 'https://avatars1.githubusercontent.com/u/325476?v=4', 'gravatar_id': '', 'url': 'https://api.github.com/users/xuhdev', 'html_url': 'https://github.com/xuhdev', 'followers_url': 'https://api.github.com/users/xuhdev/followers', 'following_url': 'https://api.github.com/users/xuhdev/following{/other_user}', 'gists_url': 'https://api.github.com/users/xuhdev/gists{/gist_id}', 'starred_url': 'https://api.github.com/users/xuhdev/starred{/owner}{/repo}', 'subscriptions_url': 'https://api.github.com/users/xuhdev/subscriptions', 'organizations_url': 'https://api.github.com/users/xuhdev/orgs', 'repos_url': 'https://api.github.com/users/xuhdev/repos', 'events_url': 'https://api.github.com/users/xuhdev/events{/privacy}', 'received_events_url': 'https://api.github.com/users/xuhdev/received_events', 'type': 'User', 'site_admin': False}",referenced,8abc9e42f4686f88feb5c63da5d2ee1777460a73,https://api.github.com/repos/pytorch/pytorch/commits/8abc9e42f4686f88feb5c63da5d2ee1777460a73,2019-09-25T23:49:35Z,2,1,1
24589,2663472721,"{'login': 'xuhdev', 'id': 325476, 'node_id': 'MDQ6VXNlcjMyNTQ3Ng==', 'avatar_url': 'https://avatars1.githubusercontent.com/u/325476?v=4', 'gravatar_id': '', 'url': 'https://api.github.com/users/xuhdev', 'html_url': 'https://github.com/xuhdev', 'followers_url': 'https://api.github.com/users/xuhdev/followers', 'following_url': 'https://api.github.com/users/xuhdev/following{/other_user}', 'gists_url': 'https://api.github.com/users/xuhdev/gists{/gist_id}', 'starred_url': 'https://api.github.com/users/xuhdev/starred{/owner}{/repo}', 'subscriptions_url': 'https://api.github.com/users/xuhdev/subscriptions', 'organizations_url': 'https://api.github.com/users/xuhdev/orgs', 'repos_url': 'https://api.github.com/users/xuhdev/repos', 'events_url': 'https://api.github.com/users/xuhdev/events{/privacy}', 'received_events_url': 'https://api.github.com/users/xuhdev/received_events', 'type': 'User', 'site_admin': False}",referenced,57574f0b0c7ed985b00953085fe462921fa6897e,https://api.github.com/repos/pytorch/pytorch/commits/57574f0b0c7ed985b00953085fe462921fa6897e,2019-09-25T23:49:39Z,71,17,54
24589,2666210371,"{'login': 'xuhdev', 'id': 325476, 'node_id': 'MDQ6VXNlcjMyNTQ3Ng==', 'avatar_url': 'https://avatars1.githubusercontent.com/u/325476?v=4', 'gravatar_id': '', 'url': 'https://api.github.com/users/xuhdev', 'html_url': 'https://github.com/xuhdev', 'followers_url': 'https://api.github.com/users/xuhdev/followers', 'following_url': 'https://api.github.com/users/xuhdev/following{/other_user}', 'gists_url': 'https://api.github.com/users/xuhdev/gists{/gist_id}', 'starred_url': 'https://api.github.com/users/xuhdev/starred{/owner}{/repo}', 'subscriptions_url': 'https://api.github.com/users/xuhdev/subscriptions', 'organizations_url': 'https://api.github.com/users/xuhdev/orgs', 'repos_url': 'https://api.github.com/users/xuhdev/repos', 'events_url': 'https://api.github.com/users/xuhdev/events{/privacy}', 'received_events_url': 'https://api.github.com/users/xuhdev/received_events', 'type': 'User', 'site_admin': False}",referenced,49384a15d09ca338879de274e3def0f8c755658d,https://api.github.com/repos/pytorch/pytorch/commits/49384a15d09ca338879de274e3def0f8c755658d,2019-09-26T18:06:09Z,6130,4512,1618
24589,2666210390,"{'login': 'xuhdev', 'id': 325476, 'node_id': 'MDQ6VXNlcjMyNTQ3Ng==', 'avatar_url': 'https://avatars1.githubusercontent.com/u/325476?v=4', 'gravatar_id': '', 'url': 'https://api.github.com/users/xuhdev', 'html_url': 'https://github.com/xuhdev', 'followers_url': 'https://api.github.com/users/xuhdev/followers', 'following_url': 'https://api.github.com/users/xuhdev/following{/other_user}', 'gists_url': 'https://api.github.com/users/xuhdev/gists{/gist_id}', 'starred_url': 'https://api.github.com/users/xuhdev/starred{/owner}{/repo}', 'subscriptions_url': 'https://api.github.com/users/xuhdev/subscriptions', 'organizations_url': 'https://api.github.com/users/xuhdev/orgs', 'repos_url': 'https://api.github.com/users/xuhdev/repos', 'events_url': 'https://api.github.com/users/xuhdev/events{/privacy}', 'received_events_url': 'https://api.github.com/users/xuhdev/received_events', 'type': 'User', 'site_admin': False}",referenced,67ceb30e2a9b32ad273f054e739042dae5f0d9be,https://api.github.com/repos/pytorch/pytorch/commits/67ceb30e2a9b32ad273f054e739042dae5f0d9be,2019-09-26T18:06:09Z,71,17,54
24589,2666225753,"{'login': 'xuhdev', 'id': 325476, 'node_id': 'MDQ6VXNlcjMyNTQ3Ng==', 'avatar_url': 'https://avatars1.githubusercontent.com/u/325476?v=4', 'gravatar_id': '', 'url': 'https://api.github.com/users/xuhdev', 'html_url': 'https://github.com/xuhdev', 'followers_url': 'https://api.github.com/users/xuhdev/followers', 'following_url': 'https://api.github.com/users/xuhdev/following{/other_user}', 'gists_url': 'https://api.github.com/users/xuhdev/gists{/gist_id}', 'starred_url': 'https://api.github.com/users/xuhdev/starred{/owner}{/repo}', 'subscriptions_url': 'https://api.github.com/users/xuhdev/subscriptions', 'organizations_url': 'https://api.github.com/users/xuhdev/orgs', 'repos_url': 'https://api.github.com/users/xuhdev/repos', 'events_url': 'https://api.github.com/users/xuhdev/events{/privacy}', 'received_events_url': 'https://api.github.com/users/xuhdev/received_events', 'type': 'User', 'site_admin': False}",referenced,b89bb91af9474504a6bbbeb0fa21dba91e5cc90d,https://api.github.com/repos/pytorch/pytorch/commits/b89bb91af9474504a6bbbeb0fa21dba91e5cc90d,2019-09-26T18:11:33Z,4,2,2
24589,2666225924,"{'login': 'xuhdev', 'id': 325476, 'node_id': 'MDQ6VXNlcjMyNTQ3Ng==', 'avatar_url': 'https://avatars1.githubusercontent.com/u/325476?v=4', 'gravatar_id': '', 'url': 'https://api.github.com/users/xuhdev', 'html_url': 'https://github.com/xuhdev', 'followers_url': 'https://api.github.com/users/xuhdev/followers', 'following_url': 'https://api.github.com/users/xuhdev/following{/other_user}', 'gists_url': 'https://api.github.com/users/xuhdev/gists{/gist_id}', 'starred_url': 'https://api.github.com/users/xuhdev/starred{/owner}{/repo}', 'subscriptions_url': 'https://api.github.com/users/xuhdev/subscriptions', 'organizations_url': 'https://api.github.com/users/xuhdev/orgs', 'repos_url': 'https://api.github.com/users/xuhdev/repos', 'events_url': 'https://api.github.com/users/xuhdev/events{/privacy}', 'received_events_url': 'https://api.github.com/users/xuhdev/received_events', 'type': 'User', 'site_admin': False}",referenced,8d4477453e5b951c228d02fe1ef68db093167063,https://api.github.com/repos/pytorch/pytorch/commits/8d4477453e5b951c228d02fe1ef68db093167063,2019-09-26T18:11:38Z,71,17,54
24589,2674550133,"{'login': 'xuhdev', 'id': 325476, 'node_id': 'MDQ6VXNlcjMyNTQ3Ng==', 'avatar_url': 'https://avatars1.githubusercontent.com/u/325476?v=4', 'gravatar_id': '', 'url': 'https://api.github.com/users/xuhdev', 'html_url': 'https://github.com/xuhdev', 'followers_url': 'https://api.github.com/users/xuhdev/followers', 'following_url': 'https://api.github.com/users/xuhdev/following{/other_user}', 'gists_url': 'https://api.github.com/users/xuhdev/gists{/gist_id}', 'starred_url': 'https://api.github.com/users/xuhdev/starred{/owner}{/repo}', 'subscriptions_url': 'https://api.github.com/users/xuhdev/subscriptions', 'organizations_url': 'https://api.github.com/users/xuhdev/orgs', 'repos_url': 'https://api.github.com/users/xuhdev/repos', 'events_url': 'https://api.github.com/users/xuhdev/events{/privacy}', 'received_events_url': 'https://api.github.com/users/xuhdev/received_events', 'type': 'User', 'site_admin': False}",referenced,ae67f1b7575334114beab135755638a22fc45c95,https://api.github.com/repos/pytorch/pytorch/commits/ae67f1b7575334114beab135755638a22fc45c95,2019-09-30T19:40:16Z,14357,10937,3420
24589,2674582439,"{'login': 'xuhdev', 'id': 325476, 'node_id': 'MDQ6VXNlcjMyNTQ3Ng==', 'avatar_url': 'https://avatars1.githubusercontent.com/u/325476?v=4', 'gravatar_id': '', 'url': 'https://api.github.com/users/xuhdev', 'html_url': 'https://github.com/xuhdev', 'followers_url': 'https://api.github.com/users/xuhdev/followers', 'following_url': 'https://api.github.com/users/xuhdev/following{/other_user}', 'gists_url': 'https://api.github.com/users/xuhdev/gists{/gist_id}', 'starred_url': 'https://api.github.com/users/xuhdev/starred{/owner}{/repo}', 'subscriptions_url': 'https://api.github.com/users/xuhdev/subscriptions', 'organizations_url': 'https://api.github.com/users/xuhdev/orgs', 'repos_url': 'https://api.github.com/users/xuhdev/repos', 'events_url': 'https://api.github.com/users/xuhdev/events{/privacy}', 'received_events_url': 'https://api.github.com/users/xuhdev/received_events', 'type': 'User', 'site_admin': False}",referenced,147704bf7d734748fee57bfbfe61fe381d04af35,https://api.github.com/repos/pytorch/pytorch/commits/147704bf7d734748fee57bfbfe61fe381d04af35,2019-09-30T19:50:50Z,482,482,0
24589,2674802979,"{'login': 'xuhdev', 'id': 325476, 'node_id': 'MDQ6VXNlcjMyNTQ3Ng==', 'avatar_url': 'https://avatars1.githubusercontent.com/u/325476?v=4', 'gravatar_id': '', 'url': 'https://api.github.com/users/xuhdev', 'html_url': 'https://github.com/xuhdev', 'followers_url': 'https://api.github.com/users/xuhdev/followers', 'following_url': 'https://api.github.com/users/xuhdev/following{/other_user}', 'gists_url': 'https://api.github.com/users/xuhdev/gists{/gist_id}', 'starred_url': 'https://api.github.com/users/xuhdev/starred{/owner}{/repo}', 'subscriptions_url': 'https://api.github.com/users/xuhdev/subscriptions', 'organizations_url': 'https://api.github.com/users/xuhdev/orgs', 'repos_url': 'https://api.github.com/users/xuhdev/repos', 'events_url': 'https://api.github.com/users/xuhdev/events{/privacy}', 'received_events_url': 'https://api.github.com/users/xuhdev/received_events', 'type': 'User', 'site_admin': False}",referenced,7dc2963f07fa86411e92586a7c3efb4f07338f5f,https://api.github.com/repos/pytorch/pytorch/commits/7dc2963f07fa86411e92586a7c3efb4f07338f5f,2019-09-30T21:03:02Z,70,54,16
24589,2685627528,"{'login': 'xuhdev', 'id': 325476, 'node_id': 'MDQ6VXNlcjMyNTQ3Ng==', 'avatar_url': 'https://avatars1.githubusercontent.com/u/325476?v=4', 'gravatar_id': '', 'url': 'https://api.github.com/users/xuhdev', 'html_url': 'https://github.com/xuhdev', 'followers_url': 'https://api.github.com/users/xuhdev/followers', 'following_url': 'https://api.github.com/users/xuhdev/following{/other_user}', 'gists_url': 'https://api.github.com/users/xuhdev/gists{/gist_id}', 'starred_url': 'https://api.github.com/users/xuhdev/starred{/owner}{/repo}', 'subscriptions_url': 'https://api.github.com/users/xuhdev/subscriptions', 'organizations_url': 'https://api.github.com/users/xuhdev/orgs', 'repos_url': 'https://api.github.com/users/xuhdev/repos', 'events_url': 'https://api.github.com/users/xuhdev/events{/privacy}', 'received_events_url': 'https://api.github.com/users/xuhdev/received_events', 'type': 'User', 'site_admin': False}",referenced,823e38a56467d3fb48dd8d52ee9be3839b1a7b9e,https://api.github.com/repos/pytorch/pytorch/commits/823e38a56467d3fb48dd8d52ee9be3839b1a7b9e,2019-10-03T22:11:15Z,26999,13935,13064
24589,2685627679,"{'login': 'xuhdev', 'id': 325476, 'node_id': 'MDQ6VXNlcjMyNTQ3Ng==', 'avatar_url': 'https://avatars1.githubusercontent.com/u/325476?v=4', 'gravatar_id': '', 'url': 'https://api.github.com/users/xuhdev', 'html_url': 'https://github.com/xuhdev', 'followers_url': 'https://api.github.com/users/xuhdev/followers', 'following_url': 'https://api.github.com/users/xuhdev/following{/other_user}', 'gists_url': 'https://api.github.com/users/xuhdev/gists{/gist_id}', 'starred_url': 'https://api.github.com/users/xuhdev/starred{/owner}{/repo}', 'subscriptions_url': 'https://api.github.com/users/xuhdev/subscriptions', 'organizations_url': 'https://api.github.com/users/xuhdev/orgs', 'repos_url': 'https://api.github.com/users/xuhdev/repos', 'events_url': 'https://api.github.com/users/xuhdev/events{/privacy}', 'received_events_url': 'https://api.github.com/users/xuhdev/received_events', 'type': 'User', 'site_admin': False}",referenced,3c21498805ec225d2652a3b892dac1f78e92f1f3,https://api.github.com/repos/pytorch/pytorch/commits/3c21498805ec225d2652a3b892dac1f78e92f1f3,2019-10-03T22:11:19Z,26999,13935,13064
24589,2696822208,"{'login': 'xuhdev', 'id': 325476, 'node_id': 'MDQ6VXNlcjMyNTQ3Ng==', 'avatar_url': 'https://avatars1.githubusercontent.com/u/325476?v=4', 'gravatar_id': '', 'url': 'https://api.github.com/users/xuhdev', 'html_url': 'https://github.com/xuhdev', 'followers_url': 'https://api.github.com/users/xuhdev/followers', 'following_url': 'https://api.github.com/users/xuhdev/following{/other_user}', 'gists_url': 'https://api.github.com/users/xuhdev/gists{/gist_id}', 'starred_url': 'https://api.github.com/users/xuhdev/starred{/owner}{/repo}', 'subscriptions_url': 'https://api.github.com/users/xuhdev/subscriptions', 'organizations_url': 'https://api.github.com/users/xuhdev/orgs', 'repos_url': 'https://api.github.com/users/xuhdev/repos', 'events_url': 'https://api.github.com/users/xuhdev/events{/privacy}', 'received_events_url': 'https://api.github.com/users/xuhdev/received_events', 'type': 'User', 'site_admin': False}",referenced,a7f69aa700404d6099999ae578be48cf90ecdc4e,https://api.github.com/repos/pytorch/pytorch/commits/a7f69aa700404d6099999ae578be48cf90ecdc4e,2019-10-08T20:43:50Z,32080,16788,15292
24589,2696822215,"{'login': 'xuhdev', 'id': 325476, 'node_id': 'MDQ6VXNlcjMyNTQ3Ng==', 'avatar_url': 'https://avatars1.githubusercontent.com/u/325476?v=4', 'gravatar_id': '', 'url': 'https://api.github.com/users/xuhdev', 'html_url': 'https://github.com/xuhdev', 'followers_url': 'https://api.github.com/users/xuhdev/followers', 'following_url': 'https://api.github.com/users/xuhdev/following{/other_user}', 'gists_url': 'https://api.github.com/users/xuhdev/gists{/gist_id}', 'starred_url': 'https://api.github.com/users/xuhdev/starred{/owner}{/repo}', 'subscriptions_url': 'https://api.github.com/users/xuhdev/subscriptions', 'organizations_url': 'https://api.github.com/users/xuhdev/orgs', 'repos_url': 'https://api.github.com/users/xuhdev/repos', 'events_url': 'https://api.github.com/users/xuhdev/events{/privacy}', 'received_events_url': 'https://api.github.com/users/xuhdev/received_events', 'type': 'User', 'site_admin': False}",referenced,0aea7c74725e08f220f7ab8bcd2019a7d61c3905,https://api.github.com/repos/pytorch/pytorch/commits/0aea7c74725e08f220f7ab8bcd2019a7d61c3905,2019-10-08T20:43:50Z,32074,16788,15286
24589,2696894289,"{'login': 'xuhdev', 'id': 325476, 'node_id': 'MDQ6VXNlcjMyNTQ3Ng==', 'avatar_url': 'https://avatars1.githubusercontent.com/u/325476?v=4', 'gravatar_id': '', 'url': 'https://api.github.com/users/xuhdev', 'html_url': 'https://github.com/xuhdev', 'followers_url': 'https://api.github.com/users/xuhdev/followers', 'following_url': 'https://api.github.com/users/xuhdev/following{/other_user}', 'gists_url': 'https://api.github.com/users/xuhdev/gists{/gist_id}', 'starred_url': 'https://api.github.com/users/xuhdev/starred{/owner}{/repo}', 'subscriptions_url': 'https://api.github.com/users/xuhdev/subscriptions', 'organizations_url': 'https://api.github.com/users/xuhdev/orgs', 'repos_url': 'https://api.github.com/users/xuhdev/repos', 'events_url': 'https://api.github.com/users/xuhdev/events{/privacy}', 'received_events_url': 'https://api.github.com/users/xuhdev/received_events', 'type': 'User', 'site_admin': False}",referenced,eb19c33caa33ebd1acc3164c9a35d07d54e2eb2a,https://api.github.com/repos/pytorch/pytorch/commits/eb19c33caa33ebd1acc3164c9a35d07d54e2eb2a,2019-10-08T21:10:01Z,215,198,17
24588,2666622626,"{'login': 'xuhdev', 'id': 325476, 'node_id': 'MDQ6VXNlcjMyNTQ3Ng==', 'avatar_url': 'https://avatars1.githubusercontent.com/u/325476?v=4', 'gravatar_id': '', 'url': 'https://api.github.com/users/xuhdev', 'html_url': 'https://github.com/xuhdev', 'followers_url': 'https://api.github.com/users/xuhdev/followers', 'following_url': 'https://api.github.com/users/xuhdev/following{/other_user}', 'gists_url': 'https://api.github.com/users/xuhdev/gists{/gist_id}', 'starred_url': 'https://api.github.com/users/xuhdev/starred{/owner}{/repo}', 'subscriptions_url': 'https://api.github.com/users/xuhdev/subscriptions', 'organizations_url': 'https://api.github.com/users/xuhdev/orgs', 'repos_url': 'https://api.github.com/users/xuhdev/repos', 'events_url': 'https://api.github.com/users/xuhdev/events{/privacy}', 'received_events_url': 'https://api.github.com/users/xuhdev/received_events', 'type': 'User', 'site_admin': False}",referenced,eed6e2372f99e659758524d91feb6296c44362e5,https://api.github.com/repos/pytorch/pytorch/commits/eed6e2372f99e659758524d91feb6296c44362e5,2019-09-26T20:35:56Z,41,18,23
24588,2666623191,"{'login': 'xuhdev', 'id': 325476, 'node_id': 'MDQ6VXNlcjMyNTQ3Ng==', 'avatar_url': 'https://avatars1.githubusercontent.com/u/325476?v=4', 'gravatar_id': '', 'url': 'https://api.github.com/users/xuhdev', 'html_url': 'https://github.com/xuhdev', 'followers_url': 'https://api.github.com/users/xuhdev/followers', 'following_url': 'https://api.github.com/users/xuhdev/following{/other_user}', 'gists_url': 'https://api.github.com/users/xuhdev/gists{/gist_id}', 'starred_url': 'https://api.github.com/users/xuhdev/starred{/owner}{/repo}', 'subscriptions_url': 'https://api.github.com/users/xuhdev/subscriptions', 'organizations_url': 'https://api.github.com/users/xuhdev/orgs', 'repos_url': 'https://api.github.com/users/xuhdev/repos', 'events_url': 'https://api.github.com/users/xuhdev/events{/privacy}', 'received_events_url': 'https://api.github.com/users/xuhdev/received_events', 'type': 'User', 'site_admin': False}",referenced,b161e6327f35996b4290b992dde9eff5542815f3,https://api.github.com/repos/pytorch/pytorch/commits/b161e6327f35996b4290b992dde9eff5542815f3,2019-09-26T20:36:08Z,41,18,23
24588,2666634792,"{'login': 'xuhdev', 'id': 325476, 'node_id': 'MDQ6VXNlcjMyNTQ3Ng==', 'avatar_url': 'https://avatars1.githubusercontent.com/u/325476?v=4', 'gravatar_id': '', 'url': 'https://api.github.com/users/xuhdev', 'html_url': 'https://github.com/xuhdev', 'followers_url': 'https://api.github.com/users/xuhdev/followers', 'following_url': 'https://api.github.com/users/xuhdev/following{/other_user}', 'gists_url': 'https://api.github.com/users/xuhdev/gists{/gist_id}', 'starred_url': 'https://api.github.com/users/xuhdev/starred{/owner}{/repo}', 'subscriptions_url': 'https://api.github.com/users/xuhdev/subscriptions', 'organizations_url': 'https://api.github.com/users/xuhdev/orgs', 'repos_url': 'https://api.github.com/users/xuhdev/repos', 'events_url': 'https://api.github.com/users/xuhdev/events{/privacy}', 'received_events_url': 'https://api.github.com/users/xuhdev/received_events', 'type': 'User', 'site_admin': False}",referenced,5645b93a5cdc1dca26ce73986382d7c23142b677,https://api.github.com/repos/pytorch/pytorch/commits/5645b93a5cdc1dca26ce73986382d7c23142b677,2019-09-26T20:40:14Z,27,0,27
24588,2666634951,"{'login': 'xuhdev', 'id': 325476, 'node_id': 'MDQ6VXNlcjMyNTQ3Ng==', 'avatar_url': 'https://avatars1.githubusercontent.com/u/325476?v=4', 'gravatar_id': '', 'url': 'https://api.github.com/users/xuhdev', 'html_url': 'https://github.com/xuhdev', 'followers_url': 'https://api.github.com/users/xuhdev/followers', 'following_url': 'https://api.github.com/users/xuhdev/following{/other_user}', 'gists_url': 'https://api.github.com/users/xuhdev/gists{/gist_id}', 'starred_url': 'https://api.github.com/users/xuhdev/starred{/owner}{/repo}', 'subscriptions_url': 'https://api.github.com/users/xuhdev/subscriptions', 'organizations_url': 'https://api.github.com/users/xuhdev/orgs', 'repos_url': 'https://api.github.com/users/xuhdev/repos', 'events_url': 'https://api.github.com/users/xuhdev/events{/privacy}', 'received_events_url': 'https://api.github.com/users/xuhdev/received_events', 'type': 'User', 'site_admin': False}",referenced,8aa4da3e36f69d44796067b178c5744fadaa4ca1,https://api.github.com/repos/pytorch/pytorch/commits/8aa4da3e36f69d44796067b178c5744fadaa4ca1,2019-09-26T20:40:18Z,68,18,50
24588,2674549877,"{'login': 'xuhdev', 'id': 325476, 'node_id': 'MDQ6VXNlcjMyNTQ3Ng==', 'avatar_url': 'https://avatars1.githubusercontent.com/u/325476?v=4', 'gravatar_id': '', 'url': 'https://api.github.com/users/xuhdev', 'html_url': 'https://github.com/xuhdev', 'followers_url': 'https://api.github.com/users/xuhdev/followers', 'following_url': 'https://api.github.com/users/xuhdev/following{/other_user}', 'gists_url': 'https://api.github.com/users/xuhdev/gists{/gist_id}', 'starred_url': 'https://api.github.com/users/xuhdev/starred{/owner}{/repo}', 'subscriptions_url': 'https://api.github.com/users/xuhdev/subscriptions', 'organizations_url': 'https://api.github.com/users/xuhdev/orgs', 'repos_url': 'https://api.github.com/users/xuhdev/repos', 'events_url': 'https://api.github.com/users/xuhdev/events{/privacy}', 'received_events_url': 'https://api.github.com/users/xuhdev/received_events', 'type': 'User', 'site_admin': False}",referenced,83fd63d9ef39a5172d1f50a66d974359e7bd98ab,https://api.github.com/repos/pytorch/pytorch/commits/83fd63d9ef39a5172d1f50a66d974359e7bd98ab,2019-09-30T19:40:11Z,68,18,50
24588,2674551485,"{'login': 'xuhdev', 'id': 325476, 'node_id': 'MDQ6VXNlcjMyNTQ3Ng==', 'avatar_url': 'https://avatars1.githubusercontent.com/u/325476?v=4', 'gravatar_id': '', 'url': 'https://api.github.com/users/xuhdev', 'html_url': 'https://github.com/xuhdev', 'followers_url': 'https://api.github.com/users/xuhdev/followers', 'following_url': 'https://api.github.com/users/xuhdev/following{/other_user}', 'gists_url': 'https://api.github.com/users/xuhdev/gists{/gist_id}', 'starred_url': 'https://api.github.com/users/xuhdev/starred{/owner}{/repo}', 'subscriptions_url': 'https://api.github.com/users/xuhdev/subscriptions', 'organizations_url': 'https://api.github.com/users/xuhdev/orgs', 'repos_url': 'https://api.github.com/users/xuhdev/repos', 'events_url': 'https://api.github.com/users/xuhdev/events{/privacy}', 'received_events_url': 'https://api.github.com/users/xuhdev/received_events', 'type': 'User', 'site_admin': False}",referenced,38ec4524631c119ead5cb23921d0ee9ffa50e006,https://api.github.com/repos/pytorch/pytorch/commits/38ec4524631c119ead5cb23921d0ee9ffa50e006,2019-09-30T19:40:40Z,14357,10937,3420
24588,2674582678,"{'login': 'xuhdev', 'id': 325476, 'node_id': 'MDQ6VXNlcjMyNTQ3Ng==', 'avatar_url': 'https://avatars1.githubusercontent.com/u/325476?v=4', 'gravatar_id': '', 'url': 'https://api.github.com/users/xuhdev', 'html_url': 'https://github.com/xuhdev', 'followers_url': 'https://api.github.com/users/xuhdev/followers', 'following_url': 'https://api.github.com/users/xuhdev/following{/other_user}', 'gists_url': 'https://api.github.com/users/xuhdev/gists{/gist_id}', 'starred_url': 'https://api.github.com/users/xuhdev/starred{/owner}{/repo}', 'subscriptions_url': 'https://api.github.com/users/xuhdev/subscriptions', 'organizations_url': 'https://api.github.com/users/xuhdev/orgs', 'repos_url': 'https://api.github.com/users/xuhdev/repos', 'events_url': 'https://api.github.com/users/xuhdev/events{/privacy}', 'received_events_url': 'https://api.github.com/users/xuhdev/received_events', 'type': 'User', 'site_admin': False}",referenced,31a8b79c3b587a50219e856ecd3ef801cf395587,https://api.github.com/repos/pytorch/pytorch/commits/31a8b79c3b587a50219e856ecd3ef801cf395587,2019-09-30T19:50:54Z,482,482,0
24588,2674582976,"{'login': 'xuhdev', 'id': 325476, 'node_id': 'MDQ6VXNlcjMyNTQ3Ng==', 'avatar_url': 'https://avatars1.githubusercontent.com/u/325476?v=4', 'gravatar_id': '', 'url': 'https://api.github.com/users/xuhdev', 'html_url': 'https://github.com/xuhdev', 'followers_url': 'https://api.github.com/users/xuhdev/followers', 'following_url': 'https://api.github.com/users/xuhdev/following{/other_user}', 'gists_url': 'https://api.github.com/users/xuhdev/gists{/gist_id}', 'starred_url': 'https://api.github.com/users/xuhdev/starred{/owner}{/repo}', 'subscriptions_url': 'https://api.github.com/users/xuhdev/subscriptions', 'organizations_url': 'https://api.github.com/users/xuhdev/orgs', 'repos_url': 'https://api.github.com/users/xuhdev/repos', 'events_url': 'https://api.github.com/users/xuhdev/events{/privacy}', 'received_events_url': 'https://api.github.com/users/xuhdev/received_events', 'type': 'User', 'site_admin': False}",referenced,325c318c9b45adaf4cb8c1d2460d11bcebbfb0bf,https://api.github.com/repos/pytorch/pytorch/commits/325c318c9b45adaf4cb8c1d2460d11bcebbfb0bf,2019-09-30T19:50:59Z,68,18,50
24588,2674671326,"{'login': 'xuhdev', 'id': 325476, 'node_id': 'MDQ6VXNlcjMyNTQ3Ng==', 'avatar_url': 'https://avatars1.githubusercontent.com/u/325476?v=4', 'gravatar_id': '', 'url': 'https://api.github.com/users/xuhdev', 'html_url': 'https://github.com/xuhdev', 'followers_url': 'https://api.github.com/users/xuhdev/followers', 'following_url': 'https://api.github.com/users/xuhdev/following{/other_user}', 'gists_url': 'https://api.github.com/users/xuhdev/gists{/gist_id}', 'starred_url': 'https://api.github.com/users/xuhdev/starred{/owner}{/repo}', 'subscriptions_url': 'https://api.github.com/users/xuhdev/subscriptions', 'organizations_url': 'https://api.github.com/users/xuhdev/orgs', 'repos_url': 'https://api.github.com/users/xuhdev/repos', 'events_url': 'https://api.github.com/users/xuhdev/events{/privacy}', 'received_events_url': 'https://api.github.com/users/xuhdev/received_events', 'type': 'User', 'site_admin': False}",referenced,3681e8f64add04bf039b5f66e7adbfd1559f2a00,https://api.github.com/repos/pytorch/pytorch/commits/3681e8f64add04bf039b5f66e7adbfd1559f2a00,2019-09-30T20:19:33Z,2,1,1
24588,2674671488,"{'login': 'xuhdev', 'id': 325476, 'node_id': 'MDQ6VXNlcjMyNTQ3Ng==', 'avatar_url': 'https://avatars1.githubusercontent.com/u/325476?v=4', 'gravatar_id': '', 'url': 'https://api.github.com/users/xuhdev', 'html_url': 'https://github.com/xuhdev', 'followers_url': 'https://api.github.com/users/xuhdev/followers', 'following_url': 'https://api.github.com/users/xuhdev/following{/other_user}', 'gists_url': 'https://api.github.com/users/xuhdev/gists{/gist_id}', 'starred_url': 'https://api.github.com/users/xuhdev/starred{/owner}{/repo}', 'subscriptions_url': 'https://api.github.com/users/xuhdev/subscriptions', 'organizations_url': 'https://api.github.com/users/xuhdev/orgs', 'repos_url': 'https://api.github.com/users/xuhdev/repos', 'events_url': 'https://api.github.com/users/xuhdev/events{/privacy}', 'received_events_url': 'https://api.github.com/users/xuhdev/received_events', 'type': 'User', 'site_admin': False}",referenced,88a3d935c9418b0d857f25f59539814ceacc477a,https://api.github.com/repos/pytorch/pytorch/commits/88a3d935c9418b0d857f25f59539814ceacc477a,2019-09-30T20:19:37Z,70,19,51
24588,2674722968,"{'login': 'xuhdev', 'id': 325476, 'node_id': 'MDQ6VXNlcjMyNTQ3Ng==', 'avatar_url': 'https://avatars1.githubusercontent.com/u/325476?v=4', 'gravatar_id': '', 'url': 'https://api.github.com/users/xuhdev', 'html_url': 'https://github.com/xuhdev', 'followers_url': 'https://api.github.com/users/xuhdev/followers', 'following_url': 'https://api.github.com/users/xuhdev/following{/other_user}', 'gists_url': 'https://api.github.com/users/xuhdev/gists{/gist_id}', 'starred_url': 'https://api.github.com/users/xuhdev/starred{/owner}{/repo}', 'subscriptions_url': 'https://api.github.com/users/xuhdev/subscriptions', 'organizations_url': 'https://api.github.com/users/xuhdev/orgs', 'repos_url': 'https://api.github.com/users/xuhdev/repos', 'events_url': 'https://api.github.com/users/xuhdev/events{/privacy}', 'received_events_url': 'https://api.github.com/users/xuhdev/received_events', 'type': 'User', 'site_admin': False}",referenced,4d0df58493ad34fdfaf568dadd624661f4947f2a,https://api.github.com/repos/pytorch/pytorch/commits/4d0df58493ad34fdfaf568dadd624661f4947f2a,2019-09-30T20:37:03Z,6,3,3
24588,2674723147,"{'login': 'xuhdev', 'id': 325476, 'node_id': 'MDQ6VXNlcjMyNTQ3Ng==', 'avatar_url': 'https://avatars1.githubusercontent.com/u/325476?v=4', 'gravatar_id': '', 'url': 'https://api.github.com/users/xuhdev', 'html_url': 'https://github.com/xuhdev', 'followers_url': 'https://api.github.com/users/xuhdev/followers', 'following_url': 'https://api.github.com/users/xuhdev/following{/other_user}', 'gists_url': 'https://api.github.com/users/xuhdev/gists{/gist_id}', 'starred_url': 'https://api.github.com/users/xuhdev/starred{/owner}{/repo}', 'subscriptions_url': 'https://api.github.com/users/xuhdev/subscriptions', 'organizations_url': 'https://api.github.com/users/xuhdev/orgs', 'repos_url': 'https://api.github.com/users/xuhdev/repos', 'events_url': 'https://api.github.com/users/xuhdev/events{/privacy}', 'received_events_url': 'https://api.github.com/users/xuhdev/received_events', 'type': 'User', 'site_admin': False}",referenced,f2d49e3369d548a6652f6d9e28ea252d97d91d23,https://api.github.com/repos/pytorch/pytorch/commits/f2d49e3369d548a6652f6d9e28ea252d97d91d23,2019-09-30T20:37:06Z,72,20,52
24588,2674803320,"{'login': 'xuhdev', 'id': 325476, 'node_id': 'MDQ6VXNlcjMyNTQ3Ng==', 'avatar_url': 'https://avatars1.githubusercontent.com/u/325476?v=4', 'gravatar_id': '', 'url': 'https://api.github.com/users/xuhdev', 'html_url': 'https://github.com/xuhdev', 'followers_url': 'https://api.github.com/users/xuhdev/followers', 'following_url': 'https://api.github.com/users/xuhdev/following{/other_user}', 'gists_url': 'https://api.github.com/users/xuhdev/gists{/gist_id}', 'starred_url': 'https://api.github.com/users/xuhdev/starred{/owner}{/repo}', 'subscriptions_url': 'https://api.github.com/users/xuhdev/subscriptions', 'organizations_url': 'https://api.github.com/users/xuhdev/orgs', 'repos_url': 'https://api.github.com/users/xuhdev/repos', 'events_url': 'https://api.github.com/users/xuhdev/events{/privacy}', 'received_events_url': 'https://api.github.com/users/xuhdev/received_events', 'type': 'User', 'site_admin': False}",referenced,1b7a63e0af7188f4a36075c608316821fdca577c,https://api.github.com/repos/pytorch/pytorch/commits/1b7a63e0af7188f4a36075c608316821fdca577c,2019-09-30T21:03:10Z,70,54,16
24588,2674803538,"{'login': 'xuhdev', 'id': 325476, 'node_id': 'MDQ6VXNlcjMyNTQ3Ng==', 'avatar_url': 'https://avatars1.githubusercontent.com/u/325476?v=4', 'gravatar_id': '', 'url': 'https://api.github.com/users/xuhdev', 'html_url': 'https://github.com/xuhdev', 'followers_url': 'https://api.github.com/users/xuhdev/followers', 'following_url': 'https://api.github.com/users/xuhdev/following{/other_user}', 'gists_url': 'https://api.github.com/users/xuhdev/gists{/gist_id}', 'starred_url': 'https://api.github.com/users/xuhdev/starred{/owner}{/repo}', 'subscriptions_url': 'https://api.github.com/users/xuhdev/subscriptions', 'organizations_url': 'https://api.github.com/users/xuhdev/orgs', 'repos_url': 'https://api.github.com/users/xuhdev/repos', 'events_url': 'https://api.github.com/users/xuhdev/events{/privacy}', 'received_events_url': 'https://api.github.com/users/xuhdev/received_events', 'type': 'User', 'site_admin': False}",referenced,5167f303b5a0e7e841c93f2aa42dafd9b440bd25,https://api.github.com/repos/pytorch/pytorch/commits/5167f303b5a0e7e841c93f2aa42dafd9b440bd25,2019-09-30T21:03:15Z,72,20,52
24588,2685627683,"{'login': 'xuhdev', 'id': 325476, 'node_id': 'MDQ6VXNlcjMyNTQ3Ng==', 'avatar_url': 'https://avatars1.githubusercontent.com/u/325476?v=4', 'gravatar_id': '', 'url': 'https://api.github.com/users/xuhdev', 'html_url': 'https://github.com/xuhdev', 'followers_url': 'https://api.github.com/users/xuhdev/followers', 'following_url': 'https://api.github.com/users/xuhdev/following{/other_user}', 'gists_url': 'https://api.github.com/users/xuhdev/gists{/gist_id}', 'starred_url': 'https://api.github.com/users/xuhdev/starred{/owner}{/repo}', 'subscriptions_url': 'https://api.github.com/users/xuhdev/subscriptions', 'organizations_url': 'https://api.github.com/users/xuhdev/orgs', 'repos_url': 'https://api.github.com/users/xuhdev/repos', 'events_url': 'https://api.github.com/users/xuhdev/events{/privacy}', 'received_events_url': 'https://api.github.com/users/xuhdev/received_events', 'type': 'User', 'site_admin': False}",referenced,f6424663a63419b967927b8a14deb25f0460b52a,https://api.github.com/repos/pytorch/pytorch/commits/f6424663a63419b967927b8a14deb25f0460b52a,2019-10-03T22:11:19Z,26999,13935,13064
24588,2685627831,"{'login': 'xuhdev', 'id': 325476, 'node_id': 'MDQ6VXNlcjMyNTQ3Ng==', 'avatar_url': 'https://avatars1.githubusercontent.com/u/325476?v=4', 'gravatar_id': '', 'url': 'https://api.github.com/users/xuhdev', 'html_url': 'https://github.com/xuhdev', 'followers_url': 'https://api.github.com/users/xuhdev/followers', 'following_url': 'https://api.github.com/users/xuhdev/following{/other_user}', 'gists_url': 'https://api.github.com/users/xuhdev/gists{/gist_id}', 'starred_url': 'https://api.github.com/users/xuhdev/starred{/owner}{/repo}', 'subscriptions_url': 'https://api.github.com/users/xuhdev/subscriptions', 'organizations_url': 'https://api.github.com/users/xuhdev/orgs', 'repos_url': 'https://api.github.com/users/xuhdev/repos', 'events_url': 'https://api.github.com/users/xuhdev/events{/privacy}', 'received_events_url': 'https://api.github.com/users/xuhdev/received_events', 'type': 'User', 'site_admin': False}",referenced,7656f66b8d1915a7a0f0231b5e4762f678472b7b,https://api.github.com/repos/pytorch/pytorch/commits/7656f66b8d1915a7a0f0231b5e4762f678472b7b,2019-10-03T22:11:21Z,72,20,52
24588,2685630608,"{'login': 'xuhdev', 'id': 325476, 'node_id': 'MDQ6VXNlcjMyNTQ3Ng==', 'avatar_url': 'https://avatars1.githubusercontent.com/u/325476?v=4', 'gravatar_id': '', 'url': 'https://api.github.com/users/xuhdev', 'html_url': 'https://github.com/xuhdev', 'followers_url': 'https://api.github.com/users/xuhdev/followers', 'following_url': 'https://api.github.com/users/xuhdev/following{/other_user}', 'gists_url': 'https://api.github.com/users/xuhdev/gists{/gist_id}', 'starred_url': 'https://api.github.com/users/xuhdev/starred{/owner}{/repo}', 'subscriptions_url': 'https://api.github.com/users/xuhdev/subscriptions', 'organizations_url': 'https://api.github.com/users/xuhdev/orgs', 'repos_url': 'https://api.github.com/users/xuhdev/repos', 'events_url': 'https://api.github.com/users/xuhdev/events{/privacy}', 'received_events_url': 'https://api.github.com/users/xuhdev/received_events', 'type': 'User', 'site_admin': False}",referenced,38868a208dfaa0bc509ae7bb6f6e129a44b9e6e5,https://api.github.com/repos/pytorch/pytorch/commits/38868a208dfaa0bc509ae7bb6f6e129a44b9e6e5,2019-10-03T22:12:39Z,2,1,1
24588,2685630761,"{'login': 'xuhdev', 'id': 325476, 'node_id': 'MDQ6VXNlcjMyNTQ3Ng==', 'avatar_url': 'https://avatars1.githubusercontent.com/u/325476?v=4', 'gravatar_id': '', 'url': 'https://api.github.com/users/xuhdev', 'html_url': 'https://github.com/xuhdev', 'followers_url': 'https://api.github.com/users/xuhdev/followers', 'following_url': 'https://api.github.com/users/xuhdev/following{/other_user}', 'gists_url': 'https://api.github.com/users/xuhdev/gists{/gist_id}', 'starred_url': 'https://api.github.com/users/xuhdev/starred{/owner}{/repo}', 'subscriptions_url': 'https://api.github.com/users/xuhdev/subscriptions', 'organizations_url': 'https://api.github.com/users/xuhdev/orgs', 'repos_url': 'https://api.github.com/users/xuhdev/repos', 'events_url': 'https://api.github.com/users/xuhdev/events{/privacy}', 'received_events_url': 'https://api.github.com/users/xuhdev/received_events', 'type': 'User', 'site_admin': False}",referenced,92112a59a8e0f7428ed454a939d31dbb0443eb3a,https://api.github.com/repos/pytorch/pytorch/commits/92112a59a8e0f7428ed454a939d31dbb0443eb3a,2019-10-03T22:12:43Z,72,20,52
24588,2696822218,"{'login': 'xuhdev', 'id': 325476, 'node_id': 'MDQ6VXNlcjMyNTQ3Ng==', 'avatar_url': 'https://avatars1.githubusercontent.com/u/325476?v=4', 'gravatar_id': '', 'url': 'https://api.github.com/users/xuhdev', 'html_url': 'https://github.com/xuhdev', 'followers_url': 'https://api.github.com/users/xuhdev/followers', 'following_url': 'https://api.github.com/users/xuhdev/following{/other_user}', 'gists_url': 'https://api.github.com/users/xuhdev/gists{/gist_id}', 'starred_url': 'https://api.github.com/users/xuhdev/starred{/owner}{/repo}', 'subscriptions_url': 'https://api.github.com/users/xuhdev/subscriptions', 'organizations_url': 'https://api.github.com/users/xuhdev/orgs', 'repos_url': 'https://api.github.com/users/xuhdev/repos', 'events_url': 'https://api.github.com/users/xuhdev/events{/privacy}', 'received_events_url': 'https://api.github.com/users/xuhdev/received_events', 'type': 'User', 'site_admin': False}",referenced,dafa865c2e68b4f717f2c34190143b325fe25e1d,https://api.github.com/repos/pytorch/pytorch/commits/dafa865c2e68b4f717f2c34190143b325fe25e1d,2019-10-08T20:43:50Z,32074,16788,15286
24588,2696894421,"{'login': 'xuhdev', 'id': 325476, 'node_id': 'MDQ6VXNlcjMyNTQ3Ng==', 'avatar_url': 'https://avatars1.githubusercontent.com/u/325476?v=4', 'gravatar_id': '', 'url': 'https://api.github.com/users/xuhdev', 'html_url': 'https://github.com/xuhdev', 'followers_url': 'https://api.github.com/users/xuhdev/followers', 'following_url': 'https://api.github.com/users/xuhdev/following{/other_user}', 'gists_url': 'https://api.github.com/users/xuhdev/gists{/gist_id}', 'starred_url': 'https://api.github.com/users/xuhdev/starred{/owner}{/repo}', 'subscriptions_url': 'https://api.github.com/users/xuhdev/subscriptions', 'organizations_url': 'https://api.github.com/users/xuhdev/orgs', 'repos_url': 'https://api.github.com/users/xuhdev/repos', 'events_url': 'https://api.github.com/users/xuhdev/events{/privacy}', 'received_events_url': 'https://api.github.com/users/xuhdev/received_events', 'type': 'User', 'site_admin': False}",referenced,088765e9115e9df4bea13daf00e3ba9b59dcbfee,https://api.github.com/repos/pytorch/pytorch/commits/088765e9115e9df4bea13daf00e3ba9b59dcbfee,2019-10-08T21:10:03Z,215,198,17
24588,2718712822,"{'login': 'xuhdev', 'id': 325476, 'node_id': 'MDQ6VXNlcjMyNTQ3Ng==', 'avatar_url': 'https://avatars1.githubusercontent.com/u/325476?v=4', 'gravatar_id': '', 'url': 'https://api.github.com/users/xuhdev', 'html_url': 'https://github.com/xuhdev', 'followers_url': 'https://api.github.com/users/xuhdev/followers', 'following_url': 'https://api.github.com/users/xuhdev/following{/other_user}', 'gists_url': 'https://api.github.com/users/xuhdev/gists{/gist_id}', 'starred_url': 'https://api.github.com/users/xuhdev/starred{/owner}{/repo}', 'subscriptions_url': 'https://api.github.com/users/xuhdev/subscriptions', 'organizations_url': 'https://api.github.com/users/xuhdev/orgs', 'repos_url': 'https://api.github.com/users/xuhdev/repos', 'events_url': 'https://api.github.com/users/xuhdev/events{/privacy}', 'received_events_url': 'https://api.github.com/users/xuhdev/received_events', 'type': 'User', 'site_admin': False}",referenced,a15e741b65f96ec6784296f4640bb1a33b02a6d8,https://api.github.com/repos/pytorch/pytorch/commits/a15e741b65f96ec6784296f4640bb1a33b02a6d8,2019-10-16T18:42:38Z,51052,31785,19267
24588,2722210349,"{'login': 'xuhdev', 'id': 325476, 'node_id': 'MDQ6VXNlcjMyNTQ3Ng==', 'avatar_url': 'https://avatars1.githubusercontent.com/u/325476?v=4', 'gravatar_id': '', 'url': 'https://api.github.com/users/xuhdev', 'html_url': 'https://github.com/xuhdev', 'followers_url': 'https://api.github.com/users/xuhdev/followers', 'following_url': 'https://api.github.com/users/xuhdev/following{/other_user}', 'gists_url': 'https://api.github.com/users/xuhdev/gists{/gist_id}', 'starred_url': 'https://api.github.com/users/xuhdev/starred{/owner}{/repo}', 'subscriptions_url': 'https://api.github.com/users/xuhdev/subscriptions', 'organizations_url': 'https://api.github.com/users/xuhdev/orgs', 'repos_url': 'https://api.github.com/users/xuhdev/repos', 'events_url': 'https://api.github.com/users/xuhdev/events{/privacy}', 'received_events_url': 'https://api.github.com/users/xuhdev/received_events', 'type': 'User', 'site_admin': False}",referenced,6c00a2b6b8a3eec77bc1957c5e45f05084681a9f,https://api.github.com/repos/pytorch/pytorch/commits/6c00a2b6b8a3eec77bc1957c5e45f05084681a9f,2019-10-17T17:52:24Z,3462,2247,1215
24588,2722210354,"{'login': 'xuhdev', 'id': 325476, 'node_id': 'MDQ6VXNlcjMyNTQ3Ng==', 'avatar_url': 'https://avatars1.githubusercontent.com/u/325476?v=4', 'gravatar_id': '', 'url': 'https://api.github.com/users/xuhdev', 'html_url': 'https://github.com/xuhdev', 'followers_url': 'https://api.github.com/users/xuhdev/followers', 'following_url': 'https://api.github.com/users/xuhdev/following{/other_user}', 'gists_url': 'https://api.github.com/users/xuhdev/gists{/gist_id}', 'starred_url': 'https://api.github.com/users/xuhdev/starred{/owner}{/repo}', 'subscriptions_url': 'https://api.github.com/users/xuhdev/subscriptions', 'organizations_url': 'https://api.github.com/users/xuhdev/orgs', 'repos_url': 'https://api.github.com/users/xuhdev/repos', 'events_url': 'https://api.github.com/users/xuhdev/events{/privacy}', 'received_events_url': 'https://api.github.com/users/xuhdev/received_events', 'type': 'User', 'site_admin': False}",referenced,a8a398e89d18244d99ce7b6fd8259a2f3c11f9f4,https://api.github.com/repos/pytorch/pytorch/commits/a8a398e89d18244d99ce7b6fd8259a2f3c11f9f4,2019-10-17T17:52:24Z,3462,2247,1215
24588,2722404392,"{'login': 'xuhdev', 'id': 325476, 'node_id': 'MDQ6VXNlcjMyNTQ3Ng==', 'avatar_url': 'https://avatars1.githubusercontent.com/u/325476?v=4', 'gravatar_id': '', 'url': 'https://api.github.com/users/xuhdev', 'html_url': 'https://github.com/xuhdev', 'followers_url': 'https://api.github.com/users/xuhdev/followers', 'following_url': 'https://api.github.com/users/xuhdev/following{/other_user}', 'gists_url': 'https://api.github.com/users/xuhdev/gists{/gist_id}', 'starred_url': 'https://api.github.com/users/xuhdev/starred{/owner}{/repo}', 'subscriptions_url': 'https://api.github.com/users/xuhdev/subscriptions', 'organizations_url': 'https://api.github.com/users/xuhdev/orgs', 'repos_url': 'https://api.github.com/users/xuhdev/repos', 'events_url': 'https://api.github.com/users/xuhdev/events{/privacy}', 'received_events_url': 'https://api.github.com/users/xuhdev/received_events', 'type': 'User', 'site_admin': False}",referenced,0dc82707b41de85b887e48ae2cc175c7f2f2df4d,https://api.github.com/repos/pytorch/pytorch/commits/0dc82707b41de85b887e48ae2cc175c7f2f2df4d,2019-10-17T18:58:01Z,541,450,91
24587,2659039029,"{'login': 'xuhdev', 'id': 325476, 'node_id': 'MDQ6VXNlcjMyNTQ3Ng==', 'avatar_url': 'https://avatars1.githubusercontent.com/u/325476?v=4', 'gravatar_id': '', 'url': 'https://api.github.com/users/xuhdev', 'html_url': 'https://github.com/xuhdev', 'followers_url': 'https://api.github.com/users/xuhdev/followers', 'following_url': 'https://api.github.com/users/xuhdev/following{/other_user}', 'gists_url': 'https://api.github.com/users/xuhdev/gists{/gist_id}', 'starred_url': 'https://api.github.com/users/xuhdev/starred{/owner}{/repo}', 'subscriptions_url': 'https://api.github.com/users/xuhdev/subscriptions', 'organizations_url': 'https://api.github.com/users/xuhdev/orgs', 'repos_url': 'https://api.github.com/users/xuhdev/repos', 'events_url': 'https://api.github.com/users/xuhdev/events{/privacy}', 'received_events_url': 'https://api.github.com/users/xuhdev/received_events', 'type': 'User', 'site_admin': False}",referenced,a458ea6b2eeb8a4e0955c6b038c731926fd72198,https://api.github.com/repos/pytorch/pytorch/commits/a458ea6b2eeb8a4e0955c6b038c731926fd72198,2019-09-24T18:07:51Z,61,17,44
24587,2659039943,"{'login': 'xuhdev', 'id': 325476, 'node_id': 'MDQ6VXNlcjMyNTQ3Ng==', 'avatar_url': 'https://avatars1.githubusercontent.com/u/325476?v=4', 'gravatar_id': '', 'url': 'https://api.github.com/users/xuhdev', 'html_url': 'https://github.com/xuhdev', 'followers_url': 'https://api.github.com/users/xuhdev/followers', 'following_url': 'https://api.github.com/users/xuhdev/following{/other_user}', 'gists_url': 'https://api.github.com/users/xuhdev/gists{/gist_id}', 'starred_url': 'https://api.github.com/users/xuhdev/starred{/owner}{/repo}', 'subscriptions_url': 'https://api.github.com/users/xuhdev/subscriptions', 'organizations_url': 'https://api.github.com/users/xuhdev/orgs', 'repos_url': 'https://api.github.com/users/xuhdev/repos', 'events_url': 'https://api.github.com/users/xuhdev/events{/privacy}', 'received_events_url': 'https://api.github.com/users/xuhdev/received_events', 'type': 'User', 'site_admin': False}",referenced,cf6fe2064298dcaf48a22f99d82687c602412beb,https://api.github.com/repos/pytorch/pytorch/commits/cf6fe2064298dcaf48a22f99d82687c602412beb,2019-09-24T18:08:09Z,61,17,44
24587,2659048514,"{'login': 'xuhdev', 'id': 325476, 'node_id': 'MDQ6VXNlcjMyNTQ3Ng==', 'avatar_url': 'https://avatars1.githubusercontent.com/u/325476?v=4', 'gravatar_id': '', 'url': 'https://api.github.com/users/xuhdev', 'html_url': 'https://github.com/xuhdev', 'followers_url': 'https://api.github.com/users/xuhdev/followers', 'following_url': 'https://api.github.com/users/xuhdev/following{/other_user}', 'gists_url': 'https://api.github.com/users/xuhdev/gists{/gist_id}', 'starred_url': 'https://api.github.com/users/xuhdev/starred{/owner}{/repo}', 'subscriptions_url': 'https://api.github.com/users/xuhdev/subscriptions', 'organizations_url': 'https://api.github.com/users/xuhdev/orgs', 'repos_url': 'https://api.github.com/users/xuhdev/repos', 'events_url': 'https://api.github.com/users/xuhdev/events{/privacy}', 'received_events_url': 'https://api.github.com/users/xuhdev/received_events', 'type': 'User', 'site_admin': False}",referenced,ed6ce12dc8f568755ba2247da4d88887d1d46396,https://api.github.com/repos/pytorch/pytorch/commits/ed6ce12dc8f568755ba2247da4d88887d1d46396,2019-09-24T18:11:08Z,1,0,1
24587,2659048714,"{'login': 'xuhdev', 'id': 325476, 'node_id': 'MDQ6VXNlcjMyNTQ3Ng==', 'avatar_url': 'https://avatars1.githubusercontent.com/u/325476?v=4', 'gravatar_id': '', 'url': 'https://api.github.com/users/xuhdev', 'html_url': 'https://github.com/xuhdev', 'followers_url': 'https://api.github.com/users/xuhdev/followers', 'following_url': 'https://api.github.com/users/xuhdev/following{/other_user}', 'gists_url': 'https://api.github.com/users/xuhdev/gists{/gist_id}', 'starred_url': 'https://api.github.com/users/xuhdev/starred{/owner}{/repo}', 'subscriptions_url': 'https://api.github.com/users/xuhdev/subscriptions', 'organizations_url': 'https://api.github.com/users/xuhdev/orgs', 'repos_url': 'https://api.github.com/users/xuhdev/repos', 'events_url': 'https://api.github.com/users/xuhdev/events{/privacy}', 'received_events_url': 'https://api.github.com/users/xuhdev/received_events', 'type': 'User', 'site_admin': False}",referenced,abe9a24c20e896049366c19984610ea5f4c4a91b,https://api.github.com/repos/pytorch/pytorch/commits/abe9a24c20e896049366c19984610ea5f4c4a91b,2019-09-24T18:11:13Z,62,17,45
24587,2659636017,"{'login': 'xuhdev', 'id': 325476, 'node_id': 'MDQ6VXNlcjMyNTQ3Ng==', 'avatar_url': 'https://avatars1.githubusercontent.com/u/325476?v=4', 'gravatar_id': '', 'url': 'https://api.github.com/users/xuhdev', 'html_url': 'https://github.com/xuhdev', 'followers_url': 'https://api.github.com/users/xuhdev/followers', 'following_url': 'https://api.github.com/users/xuhdev/following{/other_user}', 'gists_url': 'https://api.github.com/users/xuhdev/gists{/gist_id}', 'starred_url': 'https://api.github.com/users/xuhdev/starred{/owner}{/repo}', 'subscriptions_url': 'https://api.github.com/users/xuhdev/subscriptions', 'organizations_url': 'https://api.github.com/users/xuhdev/orgs', 'repos_url': 'https://api.github.com/users/xuhdev/repos', 'events_url': 'https://api.github.com/users/xuhdev/events{/privacy}', 'received_events_url': 'https://api.github.com/users/xuhdev/received_events', 'type': 'User', 'site_admin': False}",referenced,2d952014940a08a679cdf4fcdd68dfa84aeb9b39,https://api.github.com/repos/pytorch/pytorch/commits/2d952014940a08a679cdf4fcdd68dfa84aeb9b39,2019-09-24T21:41:24Z,40,1,39
24587,2659636220,"{'login': 'xuhdev', 'id': 325476, 'node_id': 'MDQ6VXNlcjMyNTQ3Ng==', 'avatar_url': 'https://avatars1.githubusercontent.com/u/325476?v=4', 'gravatar_id': '', 'url': 'https://api.github.com/users/xuhdev', 'html_url': 'https://github.com/xuhdev', 'followers_url': 'https://api.github.com/users/xuhdev/followers', 'following_url': 'https://api.github.com/users/xuhdev/following{/other_user}', 'gists_url': 'https://api.github.com/users/xuhdev/gists{/gist_id}', 'starred_url': 'https://api.github.com/users/xuhdev/starred{/owner}{/repo}', 'subscriptions_url': 'https://api.github.com/users/xuhdev/subscriptions', 'organizations_url': 'https://api.github.com/users/xuhdev/orgs', 'repos_url': 'https://api.github.com/users/xuhdev/repos', 'events_url': 'https://api.github.com/users/xuhdev/events{/privacy}', 'received_events_url': 'https://api.github.com/users/xuhdev/received_events', 'type': 'User', 'site_admin': False}",referenced,4a415639b6eb9c2816ba0b9585f4f42a213c0882,https://api.github.com/repos/pytorch/pytorch/commits/4a415639b6eb9c2816ba0b9585f4f42a213c0882,2019-09-24T21:41:29Z,62,17,45
24587,2659842675,"{'login': 'xuhdev', 'id': 325476, 'node_id': 'MDQ6VXNlcjMyNTQ3Ng==', 'avatar_url': 'https://avatars1.githubusercontent.com/u/325476?v=4', 'gravatar_id': '', 'url': 'https://api.github.com/users/xuhdev', 'html_url': 'https://github.com/xuhdev', 'followers_url': 'https://api.github.com/users/xuhdev/followers', 'following_url': 'https://api.github.com/users/xuhdev/following{/other_user}', 'gists_url': 'https://api.github.com/users/xuhdev/gists{/gist_id}', 'starred_url': 'https://api.github.com/users/xuhdev/starred{/owner}{/repo}', 'subscriptions_url': 'https://api.github.com/users/xuhdev/subscriptions', 'organizations_url': 'https://api.github.com/users/xuhdev/orgs', 'repos_url': 'https://api.github.com/users/xuhdev/repos', 'events_url': 'https://api.github.com/users/xuhdev/events{/privacy}', 'received_events_url': 'https://api.github.com/users/xuhdev/received_events', 'type': 'User', 'site_admin': False}",referenced,ae4fcb8538d081e1cb8ab8519f301db13bc02eb3,https://api.github.com/repos/pytorch/pytorch/commits/ae4fcb8538d081e1cb8ab8519f301db13bc02eb3,2019-09-24T23:34:04Z,811,481,330
24587,2659842793,"{'login': 'xuhdev', 'id': 325476, 'node_id': 'MDQ6VXNlcjMyNTQ3Ng==', 'avatar_url': 'https://avatars1.githubusercontent.com/u/325476?v=4', 'gravatar_id': '', 'url': 'https://api.github.com/users/xuhdev', 'html_url': 'https://github.com/xuhdev', 'followers_url': 'https://api.github.com/users/xuhdev/followers', 'following_url': 'https://api.github.com/users/xuhdev/following{/other_user}', 'gists_url': 'https://api.github.com/users/xuhdev/gists{/gist_id}', 'starred_url': 'https://api.github.com/users/xuhdev/starred{/owner}{/repo}', 'subscriptions_url': 'https://api.github.com/users/xuhdev/subscriptions', 'organizations_url': 'https://api.github.com/users/xuhdev/orgs', 'repos_url': 'https://api.github.com/users/xuhdev/repos', 'events_url': 'https://api.github.com/users/xuhdev/events{/privacy}', 'received_events_url': 'https://api.github.com/users/xuhdev/received_events', 'type': 'User', 'site_admin': False}",referenced,ce55ba431a24e8796f6c306bbc567b8bd1d2b98f,https://api.github.com/repos/pytorch/pytorch/commits/ce55ba431a24e8796f6c306bbc567b8bd1d2b98f,2019-09-24T23:34:08Z,62,17,45
24587,2659859639,"{'login': 'xuhdev', 'id': 325476, 'node_id': 'MDQ6VXNlcjMyNTQ3Ng==', 'avatar_url': 'https://avatars1.githubusercontent.com/u/325476?v=4', 'gravatar_id': '', 'url': 'https://api.github.com/users/xuhdev', 'html_url': 'https://github.com/xuhdev', 'followers_url': 'https://api.github.com/users/xuhdev/followers', 'following_url': 'https://api.github.com/users/xuhdev/following{/other_user}', 'gists_url': 'https://api.github.com/users/xuhdev/gists{/gist_id}', 'starred_url': 'https://api.github.com/users/xuhdev/starred{/owner}{/repo}', 'subscriptions_url': 'https://api.github.com/users/xuhdev/subscriptions', 'organizations_url': 'https://api.github.com/users/xuhdev/orgs', 'repos_url': 'https://api.github.com/users/xuhdev/repos', 'events_url': 'https://api.github.com/users/xuhdev/events{/privacy}', 'received_events_url': 'https://api.github.com/users/xuhdev/received_events', 'type': 'User', 'site_admin': False}",referenced,f9309301bc7757744f5dea3ce000c1910622b9b8,https://api.github.com/repos/pytorch/pytorch/commits/f9309301bc7757744f5dea3ce000c1910622b9b8,2019-09-24T23:45:26Z,2,0,2
24587,2659859766,"{'login': 'xuhdev', 'id': 325476, 'node_id': 'MDQ6VXNlcjMyNTQ3Ng==', 'avatar_url': 'https://avatars1.githubusercontent.com/u/325476?v=4', 'gravatar_id': '', 'url': 'https://api.github.com/users/xuhdev', 'html_url': 'https://github.com/xuhdev', 'followers_url': 'https://api.github.com/users/xuhdev/followers', 'following_url': 'https://api.github.com/users/xuhdev/following{/other_user}', 'gists_url': 'https://api.github.com/users/xuhdev/gists{/gist_id}', 'starred_url': 'https://api.github.com/users/xuhdev/starred{/owner}{/repo}', 'subscriptions_url': 'https://api.github.com/users/xuhdev/subscriptions', 'organizations_url': 'https://api.github.com/users/xuhdev/orgs', 'repos_url': 'https://api.github.com/users/xuhdev/repos', 'events_url': 'https://api.github.com/users/xuhdev/events{/privacy}', 'received_events_url': 'https://api.github.com/users/xuhdev/received_events', 'type': 'User', 'site_admin': False}",referenced,417dcdaa3a523bbfefc1f5069934c7c5d12a55f7,https://api.github.com/repos/pytorch/pytorch/commits/417dcdaa3a523bbfefc1f5069934c7c5d12a55f7,2019-09-24T23:45:31Z,63,17,46
24587,2659862559,"{'login': 'xuhdev', 'id': 325476, 'node_id': 'MDQ6VXNlcjMyNTQ3Ng==', 'avatar_url': 'https://avatars1.githubusercontent.com/u/325476?v=4', 'gravatar_id': '', 'url': 'https://api.github.com/users/xuhdev', 'html_url': 'https://github.com/xuhdev', 'followers_url': 'https://api.github.com/users/xuhdev/followers', 'following_url': 'https://api.github.com/users/xuhdev/following{/other_user}', 'gists_url': 'https://api.github.com/users/xuhdev/gists{/gist_id}', 'starred_url': 'https://api.github.com/users/xuhdev/starred{/owner}{/repo}', 'subscriptions_url': 'https://api.github.com/users/xuhdev/subscriptions', 'organizations_url': 'https://api.github.com/users/xuhdev/orgs', 'repos_url': 'https://api.github.com/users/xuhdev/repos', 'events_url': 'https://api.github.com/users/xuhdev/events{/privacy}', 'received_events_url': 'https://api.github.com/users/xuhdev/received_events', 'type': 'User', 'site_admin': False}",referenced,f178443b32cb6de4522eab93f3ba4f3451940dfa,https://api.github.com/repos/pytorch/pytorch/commits/f178443b32cb6de4522eab93f3ba4f3451940dfa,2019-09-24T23:47:23Z,68,43,25
24587,2659862673,"{'login': 'xuhdev', 'id': 325476, 'node_id': 'MDQ6VXNlcjMyNTQ3Ng==', 'avatar_url': 'https://avatars1.githubusercontent.com/u/325476?v=4', 'gravatar_id': '', 'url': 'https://api.github.com/users/xuhdev', 'html_url': 'https://github.com/xuhdev', 'followers_url': 'https://api.github.com/users/xuhdev/followers', 'following_url': 'https://api.github.com/users/xuhdev/following{/other_user}', 'gists_url': 'https://api.github.com/users/xuhdev/gists{/gist_id}', 'starred_url': 'https://api.github.com/users/xuhdev/starred{/owner}{/repo}', 'subscriptions_url': 'https://api.github.com/users/xuhdev/subscriptions', 'organizations_url': 'https://api.github.com/users/xuhdev/orgs', 'repos_url': 'https://api.github.com/users/xuhdev/repos', 'events_url': 'https://api.github.com/users/xuhdev/events{/privacy}', 'received_events_url': 'https://api.github.com/users/xuhdev/received_events', 'type': 'User', 'site_admin': False}",referenced,51cb4c0f628b1af8c07027bf9bbec2c7c5951bb4,https://api.github.com/repos/pytorch/pytorch/commits/51cb4c0f628b1af8c07027bf9bbec2c7c5951bb4,2019-09-24T23:47:29Z,64,17,47
24587,2662598634,"{'login': 'xuhdev', 'id': 325476, 'node_id': 'MDQ6VXNlcjMyNTQ3Ng==', 'avatar_url': 'https://avatars1.githubusercontent.com/u/325476?v=4', 'gravatar_id': '', 'url': 'https://api.github.com/users/xuhdev', 'html_url': 'https://github.com/xuhdev', 'followers_url': 'https://api.github.com/users/xuhdev/followers', 'following_url': 'https://api.github.com/users/xuhdev/following{/other_user}', 'gists_url': 'https://api.github.com/users/xuhdev/gists{/gist_id}', 'starred_url': 'https://api.github.com/users/xuhdev/starred{/owner}{/repo}', 'subscriptions_url': 'https://api.github.com/users/xuhdev/subscriptions', 'organizations_url': 'https://api.github.com/users/xuhdev/orgs', 'repos_url': 'https://api.github.com/users/xuhdev/repos', 'events_url': 'https://api.github.com/users/xuhdev/events{/privacy}', 'received_events_url': 'https://api.github.com/users/xuhdev/received_events', 'type': 'User', 'site_admin': False}",referenced,3ff3bba2904e8b75142977233abe6b9267b1aebf,https://api.github.com/repos/pytorch/pytorch/commits/3ff3bba2904e8b75142977233abe6b9267b1aebf,2019-09-25T17:54:04Z,2254,1709,545
24587,2662672314,"{'login': 'xuhdev', 'id': 325476, 'node_id': 'MDQ6VXNlcjMyNTQ3Ng==', 'avatar_url': 'https://avatars1.githubusercontent.com/u/325476?v=4', 'gravatar_id': '', 'url': 'https://api.github.com/users/xuhdev', 'html_url': 'https://github.com/xuhdev', 'followers_url': 'https://api.github.com/users/xuhdev/followers', 'following_url': 'https://api.github.com/users/xuhdev/following{/other_user}', 'gists_url': 'https://api.github.com/users/xuhdev/gists{/gist_id}', 'starred_url': 'https://api.github.com/users/xuhdev/starred{/owner}{/repo}', 'subscriptions_url': 'https://api.github.com/users/xuhdev/subscriptions', 'organizations_url': 'https://api.github.com/users/xuhdev/orgs', 'repos_url': 'https://api.github.com/users/xuhdev/repos', 'events_url': 'https://api.github.com/users/xuhdev/events{/privacy}', 'received_events_url': 'https://api.github.com/users/xuhdev/received_events', 'type': 'User', 'site_admin': False}",referenced,c56c6cc04f444b67e229f20fdade14515ca51b32,https://api.github.com/repos/pytorch/pytorch/commits/c56c6cc04f444b67e229f20fdade14515ca51b32,2019-09-25T18:18:23Z,479,397,82
24587,2663472542,"{'login': 'xuhdev', 'id': 325476, 'node_id': 'MDQ6VXNlcjMyNTQ3Ng==', 'avatar_url': 'https://avatars1.githubusercontent.com/u/325476?v=4', 'gravatar_id': '', 'url': 'https://api.github.com/users/xuhdev', 'html_url': 'https://github.com/xuhdev', 'followers_url': 'https://api.github.com/users/xuhdev/followers', 'following_url': 'https://api.github.com/users/xuhdev/following{/other_user}', 'gists_url': 'https://api.github.com/users/xuhdev/gists{/gist_id}', 'starred_url': 'https://api.github.com/users/xuhdev/starred{/owner}{/repo}', 'subscriptions_url': 'https://api.github.com/users/xuhdev/subscriptions', 'organizations_url': 'https://api.github.com/users/xuhdev/orgs', 'repos_url': 'https://api.github.com/users/xuhdev/repos', 'events_url': 'https://api.github.com/users/xuhdev/events{/privacy}', 'received_events_url': 'https://api.github.com/users/xuhdev/received_events', 'type': 'User', 'site_admin': False}",referenced,dbd44f0dde3544611404f704e0cbfc33457f7d63,https://api.github.com/repos/pytorch/pytorch/commits/dbd44f0dde3544611404f704e0cbfc33457f7d63,2019-09-25T23:49:31Z,2,1,1
24587,2666210142,"{'login': 'xuhdev', 'id': 325476, 'node_id': 'MDQ6VXNlcjMyNTQ3Ng==', 'avatar_url': 'https://avatars1.githubusercontent.com/u/325476?v=4', 'gravatar_id': '', 'url': 'https://api.github.com/users/xuhdev', 'html_url': 'https://github.com/xuhdev', 'followers_url': 'https://api.github.com/users/xuhdev/followers', 'following_url': 'https://api.github.com/users/xuhdev/following{/other_user}', 'gists_url': 'https://api.github.com/users/xuhdev/gists{/gist_id}', 'starred_url': 'https://api.github.com/users/xuhdev/starred{/owner}{/repo}', 'subscriptions_url': 'https://api.github.com/users/xuhdev/subscriptions', 'organizations_url': 'https://api.github.com/users/xuhdev/orgs', 'repos_url': 'https://api.github.com/users/xuhdev/repos', 'events_url': 'https://api.github.com/users/xuhdev/events{/privacy}', 'received_events_url': 'https://api.github.com/users/xuhdev/received_events', 'type': 'User', 'site_admin': False}",referenced,0b3f70bc73f7acc96db90df78c53d48830aeebf4,https://api.github.com/repos/pytorch/pytorch/commits/0b3f70bc73f7acc96db90df78c53d48830aeebf4,2019-09-26T18:06:03Z,6130,4512,1618
24587,2666210144,"{'login': 'xuhdev', 'id': 325476, 'node_id': 'MDQ6VXNlcjMyNTQ3Ng==', 'avatar_url': 'https://avatars1.githubusercontent.com/u/325476?v=4', 'gravatar_id': '', 'url': 'https://api.github.com/users/xuhdev', 'html_url': 'https://github.com/xuhdev', 'followers_url': 'https://api.github.com/users/xuhdev/followers', 'following_url': 'https://api.github.com/users/xuhdev/following{/other_user}', 'gists_url': 'https://api.github.com/users/xuhdev/gists{/gist_id}', 'starred_url': 'https://api.github.com/users/xuhdev/starred{/owner}{/repo}', 'subscriptions_url': 'https://api.github.com/users/xuhdev/subscriptions', 'organizations_url': 'https://api.github.com/users/xuhdev/orgs', 'repos_url': 'https://api.github.com/users/xuhdev/repos', 'events_url': 'https://api.github.com/users/xuhdev/events{/privacy}', 'received_events_url': 'https://api.github.com/users/xuhdev/received_events', 'type': 'User', 'site_admin': False}",referenced,79ca98c3a4d55131d35286c27b8488527f068aff,https://api.github.com/repos/pytorch/pytorch/commits/79ca98c3a4d55131d35286c27b8488527f068aff,2019-09-26T18:06:03Z,6130,4512,1618
24587,2666225605,"{'login': 'xuhdev', 'id': 325476, 'node_id': 'MDQ6VXNlcjMyNTQ3Ng==', 'avatar_url': 'https://avatars1.githubusercontent.com/u/325476?v=4', 'gravatar_id': '', 'url': 'https://api.github.com/users/xuhdev', 'html_url': 'https://github.com/xuhdev', 'followers_url': 'https://api.github.com/users/xuhdev/followers', 'following_url': 'https://api.github.com/users/xuhdev/following{/other_user}', 'gists_url': 'https://api.github.com/users/xuhdev/gists{/gist_id}', 'starred_url': 'https://api.github.com/users/xuhdev/starred{/owner}{/repo}', 'subscriptions_url': 'https://api.github.com/users/xuhdev/subscriptions', 'organizations_url': 'https://api.github.com/users/xuhdev/orgs', 'repos_url': 'https://api.github.com/users/xuhdev/repos', 'events_url': 'https://api.github.com/users/xuhdev/events{/privacy}', 'received_events_url': 'https://api.github.com/users/xuhdev/received_events', 'type': 'User', 'site_admin': False}",referenced,68b8e6748b307d342e5f45502e184149952baff4,https://api.github.com/repos/pytorch/pytorch/commits/68b8e6748b307d342e5f45502e184149952baff4,2019-09-26T18:11:29Z,0,0,0
24587,2666225638,"{'login': 'xuhdev', 'id': 325476, 'node_id': 'MDQ6VXNlcjMyNTQ3Ng==', 'avatar_url': 'https://avatars1.githubusercontent.com/u/325476?v=4', 'gravatar_id': '', 'url': 'https://api.github.com/users/xuhdev', 'html_url': 'https://github.com/xuhdev', 'followers_url': 'https://api.github.com/users/xuhdev/followers', 'following_url': 'https://api.github.com/users/xuhdev/following{/other_user}', 'gists_url': 'https://api.github.com/users/xuhdev/gists{/gist_id}', 'starred_url': 'https://api.github.com/users/xuhdev/starred{/owner}{/repo}', 'subscriptions_url': 'https://api.github.com/users/xuhdev/subscriptions', 'organizations_url': 'https://api.github.com/users/xuhdev/orgs', 'repos_url': 'https://api.github.com/users/xuhdev/repos', 'events_url': 'https://api.github.com/users/xuhdev/events{/privacy}', 'received_events_url': 'https://api.github.com/users/xuhdev/received_events', 'type': 'User', 'site_admin': False}",referenced,2b01e67eee4c9c2bf1f9ab0bdd992881b44916c5,https://api.github.com/repos/pytorch/pytorch/commits/2b01e67eee4c9c2bf1f9ab0bdd992881b44916c5,2019-09-26T18:11:30Z,2,1,1
24587,2674549699,"{'login': 'xuhdev', 'id': 325476, 'node_id': 'MDQ6VXNlcjMyNTQ3Ng==', 'avatar_url': 'https://avatars1.githubusercontent.com/u/325476?v=4', 'gravatar_id': '', 'url': 'https://api.github.com/users/xuhdev', 'html_url': 'https://github.com/xuhdev', 'followers_url': 'https://api.github.com/users/xuhdev/followers', 'following_url': 'https://api.github.com/users/xuhdev/following{/other_user}', 'gists_url': 'https://api.github.com/users/xuhdev/gists{/gist_id}', 'starred_url': 'https://api.github.com/users/xuhdev/starred{/owner}{/repo}', 'subscriptions_url': 'https://api.github.com/users/xuhdev/subscriptions', 'organizations_url': 'https://api.github.com/users/xuhdev/orgs', 'repos_url': 'https://api.github.com/users/xuhdev/repos', 'events_url': 'https://api.github.com/users/xuhdev/events{/privacy}', 'received_events_url': 'https://api.github.com/users/xuhdev/received_events', 'type': 'User', 'site_admin': False}",referenced,06d806b208d8e6bca9ec3cd71951a9a84626a6e1,https://api.github.com/repos/pytorch/pytorch/commits/06d806b208d8e6bca9ec3cd71951a9a84626a6e1,2019-09-30T19:40:07Z,14357,10937,3420
24587,2674549702,"{'login': 'xuhdev', 'id': 325476, 'node_id': 'MDQ6VXNlcjMyNTQ3Ng==', 'avatar_url': 'https://avatars1.githubusercontent.com/u/325476?v=4', 'gravatar_id': '', 'url': 'https://api.github.com/users/xuhdev', 'html_url': 'https://github.com/xuhdev', 'followers_url': 'https://api.github.com/users/xuhdev/followers', 'following_url': 'https://api.github.com/users/xuhdev/following{/other_user}', 'gists_url': 'https://api.github.com/users/xuhdev/gists{/gist_id}', 'starred_url': 'https://api.github.com/users/xuhdev/starred{/owner}{/repo}', 'subscriptions_url': 'https://api.github.com/users/xuhdev/subscriptions', 'organizations_url': 'https://api.github.com/users/xuhdev/orgs', 'repos_url': 'https://api.github.com/users/xuhdev/repos', 'events_url': 'https://api.github.com/users/xuhdev/events{/privacy}', 'received_events_url': 'https://api.github.com/users/xuhdev/received_events', 'type': 'User', 'site_admin': False}",referenced,fa3f93207a56536ccd39ac1e072df9b5f7d8026f,https://api.github.com/repos/pytorch/pytorch/commits/fa3f93207a56536ccd39ac1e072df9b5f7d8026f,2019-09-30T19:40:07Z,14357,10937,3420
24587,2674582328,"{'login': 'xuhdev', 'id': 325476, 'node_id': 'MDQ6VXNlcjMyNTQ3Ng==', 'avatar_url': 'https://avatars1.githubusercontent.com/u/325476?v=4', 'gravatar_id': '', 'url': 'https://api.github.com/users/xuhdev', 'html_url': 'https://github.com/xuhdev', 'followers_url': 'https://api.github.com/users/xuhdev/followers', 'following_url': 'https://api.github.com/users/xuhdev/following{/other_user}', 'gists_url': 'https://api.github.com/users/xuhdev/gists{/gist_id}', 'starred_url': 'https://api.github.com/users/xuhdev/starred{/owner}{/repo}', 'subscriptions_url': 'https://api.github.com/users/xuhdev/subscriptions', 'organizations_url': 'https://api.github.com/users/xuhdev/orgs', 'repos_url': 'https://api.github.com/users/xuhdev/repos', 'events_url': 'https://api.github.com/users/xuhdev/events{/privacy}', 'received_events_url': 'https://api.github.com/users/xuhdev/received_events', 'type': 'User', 'site_admin': False}",referenced,a9e497447e4de54067968fb824263a1228a751f4,https://api.github.com/repos/pytorch/pytorch/commits/a9e497447e4de54067968fb824263a1228a751f4,2019-09-30T19:50:48Z,482,482,0
24587,2674582381,"{'login': 'xuhdev', 'id': 325476, 'node_id': 'MDQ6VXNlcjMyNTQ3Ng==', 'avatar_url': 'https://avatars1.githubusercontent.com/u/325476?v=4', 'gravatar_id': '', 'url': 'https://api.github.com/users/xuhdev', 'html_url': 'https://github.com/xuhdev', 'followers_url': 'https://api.github.com/users/xuhdev/followers', 'following_url': 'https://api.github.com/users/xuhdev/following{/other_user}', 'gists_url': 'https://api.github.com/users/xuhdev/gists{/gist_id}', 'starred_url': 'https://api.github.com/users/xuhdev/starred{/owner}{/repo}', 'subscriptions_url': 'https://api.github.com/users/xuhdev/subscriptions', 'organizations_url': 'https://api.github.com/users/xuhdev/orgs', 'repos_url': 'https://api.github.com/users/xuhdev/repos', 'events_url': 'https://api.github.com/users/xuhdev/events{/privacy}', 'received_events_url': 'https://api.github.com/users/xuhdev/received_events', 'type': 'User', 'site_admin': False}",referenced,8a065a66312dd951cf67ca3fbe1e61e0a9b7f0e1,https://api.github.com/repos/pytorch/pytorch/commits/8a065a66312dd951cf67ca3fbe1e61e0a9b7f0e1,2019-09-30T19:50:49Z,482,482,0
24587,2674802959,"{'login': 'xuhdev', 'id': 325476, 'node_id': 'MDQ6VXNlcjMyNTQ3Ng==', 'avatar_url': 'https://avatars1.githubusercontent.com/u/325476?v=4', 'gravatar_id': '', 'url': 'https://api.github.com/users/xuhdev', 'html_url': 'https://github.com/xuhdev', 'followers_url': 'https://api.github.com/users/xuhdev/followers', 'following_url': 'https://api.github.com/users/xuhdev/following{/other_user}', 'gists_url': 'https://api.github.com/users/xuhdev/gists{/gist_id}', 'starred_url': 'https://api.github.com/users/xuhdev/starred{/owner}{/repo}', 'subscriptions_url': 'https://api.github.com/users/xuhdev/subscriptions', 'organizations_url': 'https://api.github.com/users/xuhdev/orgs', 'repos_url': 'https://api.github.com/users/xuhdev/repos', 'events_url': 'https://api.github.com/users/xuhdev/events{/privacy}', 'received_events_url': 'https://api.github.com/users/xuhdev/received_events', 'type': 'User', 'site_admin': False}",referenced,19defc453f7c9b842a0629531e988fbbe9466899,https://api.github.com/repos/pytorch/pytorch/commits/19defc453f7c9b842a0629531e988fbbe9466899,2019-09-30T21:03:01Z,66,52,14
24586,2648373782,"{'login': 'xuhdev', 'id': 325476, 'node_id': 'MDQ6VXNlcjMyNTQ3Ng==', 'avatar_url': 'https://avatars1.githubusercontent.com/u/325476?v=4', 'gravatar_id': '', 'url': 'https://api.github.com/users/xuhdev', 'html_url': 'https://github.com/xuhdev', 'followers_url': 'https://api.github.com/users/xuhdev/followers', 'following_url': 'https://api.github.com/users/xuhdev/following{/other_user}', 'gists_url': 'https://api.github.com/users/xuhdev/gists{/gist_id}', 'starred_url': 'https://api.github.com/users/xuhdev/starred{/owner}{/repo}', 'subscriptions_url': 'https://api.github.com/users/xuhdev/subscriptions', 'organizations_url': 'https://api.github.com/users/xuhdev/orgs', 'repos_url': 'https://api.github.com/users/xuhdev/repos', 'events_url': 'https://api.github.com/users/xuhdev/events{/privacy}', 'received_events_url': 'https://api.github.com/users/xuhdev/received_events', 'type': 'User', 'site_admin': False}",referenced,9ce5983eae21cc5d4a852111ab763bae40d469f5,https://api.github.com/repos/pytorch/pytorch/commits/9ce5983eae21cc5d4a852111ab763bae40d469f5,2019-09-19T20:49:43Z,59,21,38
24586,2648374150,"{'login': 'xuhdev', 'id': 325476, 'node_id': 'MDQ6VXNlcjMyNTQ3Ng==', 'avatar_url': 'https://avatars1.githubusercontent.com/u/325476?v=4', 'gravatar_id': '', 'url': 'https://api.github.com/users/xuhdev', 'html_url': 'https://github.com/xuhdev', 'followers_url': 'https://api.github.com/users/xuhdev/followers', 'following_url': 'https://api.github.com/users/xuhdev/following{/other_user}', 'gists_url': 'https://api.github.com/users/xuhdev/gists{/gist_id}', 'starred_url': 'https://api.github.com/users/xuhdev/starred{/owner}{/repo}', 'subscriptions_url': 'https://api.github.com/users/xuhdev/subscriptions', 'organizations_url': 'https://api.github.com/users/xuhdev/orgs', 'repos_url': 'https://api.github.com/users/xuhdev/repos', 'events_url': 'https://api.github.com/users/xuhdev/events{/privacy}', 'received_events_url': 'https://api.github.com/users/xuhdev/received_events', 'type': 'User', 'site_admin': False}",referenced,3efd1eb810152a75507ffe7a458728219155c870,https://api.github.com/repos/pytorch/pytorch/commits/3efd1eb810152a75507ffe7a458728219155c870,2019-09-19T20:49:53Z,59,21,38
24586,2648382214,"{'login': 'xuhdev', 'id': 325476, 'node_id': 'MDQ6VXNlcjMyNTQ3Ng==', 'avatar_url': 'https://avatars1.githubusercontent.com/u/325476?v=4', 'gravatar_id': '', 'url': 'https://api.github.com/users/xuhdev', 'html_url': 'https://github.com/xuhdev', 'followers_url': 'https://api.github.com/users/xuhdev/followers', 'following_url': 'https://api.github.com/users/xuhdev/following{/other_user}', 'gists_url': 'https://api.github.com/users/xuhdev/gists{/gist_id}', 'starred_url': 'https://api.github.com/users/xuhdev/starred{/owner}{/repo}', 'subscriptions_url': 'https://api.github.com/users/xuhdev/subscriptions', 'organizations_url': 'https://api.github.com/users/xuhdev/orgs', 'repos_url': 'https://api.github.com/users/xuhdev/repos', 'events_url': 'https://api.github.com/users/xuhdev/events{/privacy}', 'received_events_url': 'https://api.github.com/users/xuhdev/received_events', 'type': 'User', 'site_admin': False}",referenced,0b1d27db52ff570dc7759523db68431d6da2213a,https://api.github.com/repos/pytorch/pytorch/commits/0b1d27db52ff570dc7759523db68431d6da2213a,2019-09-19T20:53:05Z,8,4,4
24586,2648382398,"{'login': 'xuhdev', 'id': 325476, 'node_id': 'MDQ6VXNlcjMyNTQ3Ng==', 'avatar_url': 'https://avatars1.githubusercontent.com/u/325476?v=4', 'gravatar_id': '', 'url': 'https://api.github.com/users/xuhdev', 'html_url': 'https://github.com/xuhdev', 'followers_url': 'https://api.github.com/users/xuhdev/followers', 'following_url': 'https://api.github.com/users/xuhdev/following{/other_user}', 'gists_url': 'https://api.github.com/users/xuhdev/gists{/gist_id}', 'starred_url': 'https://api.github.com/users/xuhdev/starred{/owner}{/repo}', 'subscriptions_url': 'https://api.github.com/users/xuhdev/subscriptions', 'organizations_url': 'https://api.github.com/users/xuhdev/orgs', 'repos_url': 'https://api.github.com/users/xuhdev/repos', 'events_url': 'https://api.github.com/users/xuhdev/events{/privacy}', 'received_events_url': 'https://api.github.com/users/xuhdev/received_events', 'type': 'User', 'site_admin': False}",referenced,b73b59e5057ddc3ed83674c91a9c6a33ecf8c1c0,https://api.github.com/repos/pytorch/pytorch/commits/b73b59e5057ddc3ed83674c91a9c6a33ecf8c1c0,2019-09-19T20:53:10Z,59,21,38
24586,2648472106,"{'login': 'xuhdev', 'id': 325476, 'node_id': 'MDQ6VXNlcjMyNTQ3Ng==', 'avatar_url': 'https://avatars1.githubusercontent.com/u/325476?v=4', 'gravatar_id': '', 'url': 'https://api.github.com/users/xuhdev', 'html_url': 'https://github.com/xuhdev', 'followers_url': 'https://api.github.com/users/xuhdev/followers', 'following_url': 'https://api.github.com/users/xuhdev/following{/other_user}', 'gists_url': 'https://api.github.com/users/xuhdev/gists{/gist_id}', 'starred_url': 'https://api.github.com/users/xuhdev/starred{/owner}{/repo}', 'subscriptions_url': 'https://api.github.com/users/xuhdev/subscriptions', 'organizations_url': 'https://api.github.com/users/xuhdev/orgs', 'repos_url': 'https://api.github.com/users/xuhdev/repos', 'events_url': 'https://api.github.com/users/xuhdev/events{/privacy}', 'received_events_url': 'https://api.github.com/users/xuhdev/received_events', 'type': 'User', 'site_admin': False}",referenced,21f8746c5b6a6faf98f10ea185ff78297e897ef7,https://api.github.com/repos/pytorch/pytorch/commits/21f8746c5b6a6faf98f10ea185ff78297e897ef7,2019-09-19T21:30:11Z,4,2,2
24586,2648472263,"{'login': 'xuhdev', 'id': 325476, 'node_id': 'MDQ6VXNlcjMyNTQ3Ng==', 'avatar_url': 'https://avatars1.githubusercontent.com/u/325476?v=4', 'gravatar_id': '', 'url': 'https://api.github.com/users/xuhdev', 'html_url': 'https://github.com/xuhdev', 'followers_url': 'https://api.github.com/users/xuhdev/followers', 'following_url': 'https://api.github.com/users/xuhdev/following{/other_user}', 'gists_url': 'https://api.github.com/users/xuhdev/gists{/gist_id}', 'starred_url': 'https://api.github.com/users/xuhdev/starred{/owner}{/repo}', 'subscriptions_url': 'https://api.github.com/users/xuhdev/subscriptions', 'organizations_url': 'https://api.github.com/users/xuhdev/orgs', 'repos_url': 'https://api.github.com/users/xuhdev/repos', 'events_url': 'https://api.github.com/users/xuhdev/events{/privacy}', 'received_events_url': 'https://api.github.com/users/xuhdev/received_events', 'type': 'User', 'site_admin': False}",referenced,ec7b9c50db4728bc90cc260694eb9cfabc9eccdf,https://api.github.com/repos/pytorch/pytorch/commits/ec7b9c50db4728bc90cc260694eb9cfabc9eccdf,2019-09-19T21:30:16Z,63,23,40
24586,2648478578,"{'login': 'xuhdev', 'id': 325476, 'node_id': 'MDQ6VXNlcjMyNTQ3Ng==', 'avatar_url': 'https://avatars1.githubusercontent.com/u/325476?v=4', 'gravatar_id': '', 'url': 'https://api.github.com/users/xuhdev', 'html_url': 'https://github.com/xuhdev', 'followers_url': 'https://api.github.com/users/xuhdev/followers', 'following_url': 'https://api.github.com/users/xuhdev/following{/other_user}', 'gists_url': 'https://api.github.com/users/xuhdev/gists{/gist_id}', 'starred_url': 'https://api.github.com/users/xuhdev/starred{/owner}{/repo}', 'subscriptions_url': 'https://api.github.com/users/xuhdev/subscriptions', 'organizations_url': 'https://api.github.com/users/xuhdev/orgs', 'repos_url': 'https://api.github.com/users/xuhdev/repos', 'events_url': 'https://api.github.com/users/xuhdev/events{/privacy}', 'received_events_url': 'https://api.github.com/users/xuhdev/received_events', 'type': 'User', 'site_admin': False}",referenced,189ad07817b96e01bcd453dd634ffaf534805b4c,https://api.github.com/repos/pytorch/pytorch/commits/189ad07817b96e01bcd453dd634ffaf534805b4c,2019-09-19T21:32:56Z,2,1,1
24586,2648478707,"{'login': 'xuhdev', 'id': 325476, 'node_id': 'MDQ6VXNlcjMyNTQ3Ng==', 'avatar_url': 'https://avatars1.githubusercontent.com/u/325476?v=4', 'gravatar_id': '', 'url': 'https://api.github.com/users/xuhdev', 'html_url': 'https://github.com/xuhdev', 'followers_url': 'https://api.github.com/users/xuhdev/followers', 'following_url': 'https://api.github.com/users/xuhdev/following{/other_user}', 'gists_url': 'https://api.github.com/users/xuhdev/gists{/gist_id}', 'starred_url': 'https://api.github.com/users/xuhdev/starred{/owner}{/repo}', 'subscriptions_url': 'https://api.github.com/users/xuhdev/subscriptions', 'organizations_url': 'https://api.github.com/users/xuhdev/orgs', 'repos_url': 'https://api.github.com/users/xuhdev/repos', 'events_url': 'https://api.github.com/users/xuhdev/events{/privacy}', 'received_events_url': 'https://api.github.com/users/xuhdev/received_events', 'type': 'User', 'site_admin': False}",referenced,13e701f861732b2a1feaa153ab85408087ffb1fa,https://api.github.com/repos/pytorch/pytorch/commits/13e701f861732b2a1feaa153ab85408087ffb1fa,2019-09-19T21:32:59Z,63,23,40
24586,2648541303,"{'login': 'xuhdev', 'id': 325476, 'node_id': 'MDQ6VXNlcjMyNTQ3Ng==', 'avatar_url': 'https://avatars1.githubusercontent.com/u/325476?v=4', 'gravatar_id': '', 'url': 'https://api.github.com/users/xuhdev', 'html_url': 'https://github.com/xuhdev', 'followers_url': 'https://api.github.com/users/xuhdev/followers', 'following_url': 'https://api.github.com/users/xuhdev/following{/other_user}', 'gists_url': 'https://api.github.com/users/xuhdev/gists{/gist_id}', 'starred_url': 'https://api.github.com/users/xuhdev/starred{/owner}{/repo}', 'subscriptions_url': 'https://api.github.com/users/xuhdev/subscriptions', 'organizations_url': 'https://api.github.com/users/xuhdev/orgs', 'repos_url': 'https://api.github.com/users/xuhdev/repos', 'events_url': 'https://api.github.com/users/xuhdev/events{/privacy}', 'received_events_url': 'https://api.github.com/users/xuhdev/received_events', 'type': 'User', 'site_admin': False}",referenced,f1c6ec704e8ca647f13ad8a60dbc05a830452a5c,https://api.github.com/repos/pytorch/pytorch/commits/f1c6ec704e8ca647f13ad8a60dbc05a830452a5c,2019-09-19T22:02:28Z,4,2,2
24586,2648541436,"{'login': 'xuhdev', 'id': 325476, 'node_id': 'MDQ6VXNlcjMyNTQ3Ng==', 'avatar_url': 'https://avatars1.githubusercontent.com/u/325476?v=4', 'gravatar_id': '', 'url': 'https://api.github.com/users/xuhdev', 'html_url': 'https://github.com/xuhdev', 'followers_url': 'https://api.github.com/users/xuhdev/followers', 'following_url': 'https://api.github.com/users/xuhdev/following{/other_user}', 'gists_url': 'https://api.github.com/users/xuhdev/gists{/gist_id}', 'starred_url': 'https://api.github.com/users/xuhdev/starred{/owner}{/repo}', 'subscriptions_url': 'https://api.github.com/users/xuhdev/subscriptions', 'organizations_url': 'https://api.github.com/users/xuhdev/orgs', 'repos_url': 'https://api.github.com/users/xuhdev/repos', 'events_url': 'https://api.github.com/users/xuhdev/events{/privacy}', 'received_events_url': 'https://api.github.com/users/xuhdev/received_events', 'type': 'User', 'site_admin': False}",referenced,bb846a66ed79e20d9802d07b0980ec129ff46cd4,https://api.github.com/repos/pytorch/pytorch/commits/bb846a66ed79e20d9802d07b0980ec129ff46cd4,2019-09-19T22:02:31Z,63,23,40
24586,2648659682,"{'login': 'xuhdev', 'id': 325476, 'node_id': 'MDQ6VXNlcjMyNTQ3Ng==', 'avatar_url': 'https://avatars1.githubusercontent.com/u/325476?v=4', 'gravatar_id': '', 'url': 'https://api.github.com/users/xuhdev', 'html_url': 'https://github.com/xuhdev', 'followers_url': 'https://api.github.com/users/xuhdev/followers', 'following_url': 'https://api.github.com/users/xuhdev/following{/other_user}', 'gists_url': 'https://api.github.com/users/xuhdev/gists{/gist_id}', 'starred_url': 'https://api.github.com/users/xuhdev/starred{/owner}{/repo}', 'subscriptions_url': 'https://api.github.com/users/xuhdev/subscriptions', 'organizations_url': 'https://api.github.com/users/xuhdev/orgs', 'repos_url': 'https://api.github.com/users/xuhdev/repos', 'events_url': 'https://api.github.com/users/xuhdev/events{/privacy}', 'received_events_url': 'https://api.github.com/users/xuhdev/received_events', 'type': 'User', 'site_admin': False}",referenced,14ad50af752d64cc7e2f346fd1ddca8877da3663,https://api.github.com/repos/pytorch/pytorch/commits/14ad50af752d64cc7e2f346fd1ddca8877da3663,2019-09-19T23:13:10Z,2,1,1
24586,2648659799,"{'login': 'xuhdev', 'id': 325476, 'node_id': 'MDQ6VXNlcjMyNTQ3Ng==', 'avatar_url': 'https://avatars1.githubusercontent.com/u/325476?v=4', 'gravatar_id': '', 'url': 'https://api.github.com/users/xuhdev', 'html_url': 'https://github.com/xuhdev', 'followers_url': 'https://api.github.com/users/xuhdev/followers', 'following_url': 'https://api.github.com/users/xuhdev/following{/other_user}', 'gists_url': 'https://api.github.com/users/xuhdev/gists{/gist_id}', 'starred_url': 'https://api.github.com/users/xuhdev/starred{/owner}{/repo}', 'subscriptions_url': 'https://api.github.com/users/xuhdev/subscriptions', 'organizations_url': 'https://api.github.com/users/xuhdev/orgs', 'repos_url': 'https://api.github.com/users/xuhdev/repos', 'events_url': 'https://api.github.com/users/xuhdev/events{/privacy}', 'received_events_url': 'https://api.github.com/users/xuhdev/received_events', 'type': 'User', 'site_admin': False}",referenced,f0f93efacaf836632d7e4beeee65b8e9e41803ca,https://api.github.com/repos/pytorch/pytorch/commits/f0f93efacaf836632d7e4beeee65b8e9e41803ca,2019-09-19T23:13:16Z,63,23,40
24586,2648662181,"{'login': 'xuhdev', 'id': 325476, 'node_id': 'MDQ6VXNlcjMyNTQ3Ng==', 'avatar_url': 'https://avatars1.githubusercontent.com/u/325476?v=4', 'gravatar_id': '', 'url': 'https://api.github.com/users/xuhdev', 'html_url': 'https://github.com/xuhdev', 'followers_url': 'https://api.github.com/users/xuhdev/followers', 'following_url': 'https://api.github.com/users/xuhdev/following{/other_user}', 'gists_url': 'https://api.github.com/users/xuhdev/gists{/gist_id}', 'starred_url': 'https://api.github.com/users/xuhdev/starred{/owner}{/repo}', 'subscriptions_url': 'https://api.github.com/users/xuhdev/subscriptions', 'organizations_url': 'https://api.github.com/users/xuhdev/orgs', 'repos_url': 'https://api.github.com/users/xuhdev/repos', 'events_url': 'https://api.github.com/users/xuhdev/events{/privacy}', 'received_events_url': 'https://api.github.com/users/xuhdev/received_events', 'type': 'User', 'site_admin': False}",referenced,b6a27c6b3bf92d89026948342bf8d8418b3c85e8,https://api.github.com/repos/pytorch/pytorch/commits/b6a27c6b3bf92d89026948342bf8d8418b3c85e8,2019-09-19T23:14:55Z,63,23,40
24586,2648662200,"{'login': 'xuhdev', 'id': 325476, 'node_id': 'MDQ6VXNlcjMyNTQ3Ng==', 'avatar_url': 'https://avatars1.githubusercontent.com/u/325476?v=4', 'gravatar_id': '', 'url': 'https://api.github.com/users/xuhdev', 'html_url': 'https://github.com/xuhdev', 'followers_url': 'https://api.github.com/users/xuhdev/followers', 'following_url': 'https://api.github.com/users/xuhdev/following{/other_user}', 'gists_url': 'https://api.github.com/users/xuhdev/gists{/gist_id}', 'starred_url': 'https://api.github.com/users/xuhdev/starred{/owner}{/repo}', 'subscriptions_url': 'https://api.github.com/users/xuhdev/subscriptions', 'organizations_url': 'https://api.github.com/users/xuhdev/orgs', 'repos_url': 'https://api.github.com/users/xuhdev/repos', 'events_url': 'https://api.github.com/users/xuhdev/events{/privacy}', 'received_events_url': 'https://api.github.com/users/xuhdev/received_events', 'type': 'User', 'site_admin': False}",referenced,52842622f397086b86cf12348f410e3614779fcc,https://api.github.com/repos/pytorch/pytorch/commits/52842622f397086b86cf12348f410e3614779fcc,2019-09-19T23:14:56Z,1797,1165,632
24586,2655451354,"{'login': 'xuhdev', 'id': 325476, 'node_id': 'MDQ6VXNlcjMyNTQ3Ng==', 'avatar_url': 'https://avatars1.githubusercontent.com/u/325476?v=4', 'gravatar_id': '', 'url': 'https://api.github.com/users/xuhdev', 'html_url': 'https://github.com/xuhdev', 'followers_url': 'https://api.github.com/users/xuhdev/followers', 'following_url': 'https://api.github.com/users/xuhdev/following{/other_user}', 'gists_url': 'https://api.github.com/users/xuhdev/gists{/gist_id}', 'starred_url': 'https://api.github.com/users/xuhdev/starred{/owner}{/repo}', 'subscriptions_url': 'https://api.github.com/users/xuhdev/subscriptions', 'organizations_url': 'https://api.github.com/users/xuhdev/orgs', 'repos_url': 'https://api.github.com/users/xuhdev/repos', 'events_url': 'https://api.github.com/users/xuhdev/events{/privacy}', 'received_events_url': 'https://api.github.com/users/xuhdev/received_events', 'type': 'User', 'site_admin': False}",referenced,b08acd3e85dd31e79a2afccf2b47ac4c42cf3af5,https://api.github.com/repos/pytorch/pytorch/commits/b08acd3e85dd31e79a2afccf2b47ac4c42cf3af5,2019-09-23T18:26:07Z,63,23,40
24586,2655451889,"{'login': 'xuhdev', 'id': 325476, 'node_id': 'MDQ6VXNlcjMyNTQ3Ng==', 'avatar_url': 'https://avatars1.githubusercontent.com/u/325476?v=4', 'gravatar_id': '', 'url': 'https://api.github.com/users/xuhdev', 'html_url': 'https://github.com/xuhdev', 'followers_url': 'https://api.github.com/users/xuhdev/followers', 'following_url': 'https://api.github.com/users/xuhdev/following{/other_user}', 'gists_url': 'https://api.github.com/users/xuhdev/gists{/gist_id}', 'starred_url': 'https://api.github.com/users/xuhdev/starred{/owner}{/repo}', 'subscriptions_url': 'https://api.github.com/users/xuhdev/subscriptions', 'organizations_url': 'https://api.github.com/users/xuhdev/orgs', 'repos_url': 'https://api.github.com/users/xuhdev/repos', 'events_url': 'https://api.github.com/users/xuhdev/events{/privacy}', 'received_events_url': 'https://api.github.com/users/xuhdev/received_events', 'type': 'User', 'site_admin': False}",referenced,02685efd31a6bf67139983a1c48c2311ec5d35f0,https://api.github.com/repos/pytorch/pytorch/commits/02685efd31a6bf67139983a1c48c2311ec5d35f0,2019-09-23T18:26:18Z,13104,8130,4974
24586,2658984101,"{'login': 'xuhdev', 'id': 325476, 'node_id': 'MDQ6VXNlcjMyNTQ3Ng==', 'avatar_url': 'https://avatars1.githubusercontent.com/u/325476?v=4', 'gravatar_id': '', 'url': 'https://api.github.com/users/xuhdev', 'html_url': 'https://github.com/xuhdev', 'followers_url': 'https://api.github.com/users/xuhdev/followers', 'following_url': 'https://api.github.com/users/xuhdev/following{/other_user}', 'gists_url': 'https://api.github.com/users/xuhdev/gists{/gist_id}', 'starred_url': 'https://api.github.com/users/xuhdev/starred{/owner}{/repo}', 'subscriptions_url': 'https://api.github.com/users/xuhdev/subscriptions', 'organizations_url': 'https://api.github.com/users/xuhdev/orgs', 'repos_url': 'https://api.github.com/users/xuhdev/repos', 'events_url': 'https://api.github.com/users/xuhdev/events{/privacy}', 'received_events_url': 'https://api.github.com/users/xuhdev/received_events', 'type': 'User', 'site_admin': False}",referenced,a4c3a501e0d5e21321cf8fa578fed50e92df8496,https://api.github.com/repos/pytorch/pytorch/commits/a4c3a501e0d5e21321cf8fa578fed50e92df8496,2019-09-24T17:50:10Z,63,23,40
24586,2658984216,"{'login': 'xuhdev', 'id': 325476, 'node_id': 'MDQ6VXNlcjMyNTQ3Ng==', 'avatar_url': 'https://avatars1.githubusercontent.com/u/325476?v=4', 'gravatar_id': '', 'url': 'https://api.github.com/users/xuhdev', 'html_url': 'https://github.com/xuhdev', 'followers_url': 'https://api.github.com/users/xuhdev/followers', 'following_url': 'https://api.github.com/users/xuhdev/following{/other_user}', 'gists_url': 'https://api.github.com/users/xuhdev/gists{/gist_id}', 'starred_url': 'https://api.github.com/users/xuhdev/starred{/owner}{/repo}', 'subscriptions_url': 'https://api.github.com/users/xuhdev/subscriptions', 'organizations_url': 'https://api.github.com/users/xuhdev/orgs', 'repos_url': 'https://api.github.com/users/xuhdev/repos', 'events_url': 'https://api.github.com/users/xuhdev/events{/privacy}', 'received_events_url': 'https://api.github.com/users/xuhdev/received_events', 'type': 'User', 'site_admin': False}",referenced,0ce1161917a6278a240f3840620d110f9de46517,https://api.github.com/repos/pytorch/pytorch/commits/0ce1161917a6278a240f3840620d110f9de46517,2019-09-24T17:50:12Z,6111,3847,2264
24586,2659039671,"{'login': 'xuhdev', 'id': 325476, 'node_id': 'MDQ6VXNlcjMyNTQ3Ng==', 'avatar_url': 'https://avatars1.githubusercontent.com/u/325476?v=4', 'gravatar_id': '', 'url': 'https://api.github.com/users/xuhdev', 'html_url': 'https://github.com/xuhdev', 'followers_url': 'https://api.github.com/users/xuhdev/followers', 'following_url': 'https://api.github.com/users/xuhdev/following{/other_user}', 'gists_url': 'https://api.github.com/users/xuhdev/gists{/gist_id}', 'starred_url': 'https://api.github.com/users/xuhdev/starred{/owner}{/repo}', 'subscriptions_url': 'https://api.github.com/users/xuhdev/subscriptions', 'organizations_url': 'https://api.github.com/users/xuhdev/orgs', 'repos_url': 'https://api.github.com/users/xuhdev/repos', 'events_url': 'https://api.github.com/users/xuhdev/events{/privacy}', 'received_events_url': 'https://api.github.com/users/xuhdev/received_events', 'type': 'User', 'site_admin': False}",referenced,37ab3e24e7d77a7ec1ce41363db7e611b7031156,https://api.github.com/repos/pytorch/pytorch/commits/37ab3e24e7d77a7ec1ce41363db7e611b7031156,2019-09-24T18:08:03Z,1,0,1
24586,2659635842,"{'login': 'xuhdev', 'id': 325476, 'node_id': 'MDQ6VXNlcjMyNTQ3Ng==', 'avatar_url': 'https://avatars1.githubusercontent.com/u/325476?v=4', 'gravatar_id': '', 'url': 'https://api.github.com/users/xuhdev', 'html_url': 'https://github.com/xuhdev', 'followers_url': 'https://api.github.com/users/xuhdev/followers', 'following_url': 'https://api.github.com/users/xuhdev/following{/other_user}', 'gists_url': 'https://api.github.com/users/xuhdev/gists{/gist_id}', 'starred_url': 'https://api.github.com/users/xuhdev/starred{/owner}{/repo}', 'subscriptions_url': 'https://api.github.com/users/xuhdev/subscriptions', 'organizations_url': 'https://api.github.com/users/xuhdev/orgs', 'repos_url': 'https://api.github.com/users/xuhdev/repos', 'events_url': 'https://api.github.com/users/xuhdev/events{/privacy}', 'received_events_url': 'https://api.github.com/users/xuhdev/received_events', 'type': 'User', 'site_admin': False}",referenced,7bfb0e98b157c837d13b53b0fb170315445884d3,https://api.github.com/repos/pytorch/pytorch/commits/7bfb0e98b157c837d13b53b0fb170315445884d3,2019-09-24T21:41:20Z,40,1,39
24586,2659842586,"{'login': 'xuhdev', 'id': 325476, 'node_id': 'MDQ6VXNlcjMyNTQ3Ng==', 'avatar_url': 'https://avatars1.githubusercontent.com/u/325476?v=4', 'gravatar_id': '', 'url': 'https://api.github.com/users/xuhdev', 'html_url': 'https://github.com/xuhdev', 'followers_url': 'https://api.github.com/users/xuhdev/followers', 'following_url': 'https://api.github.com/users/xuhdev/following{/other_user}', 'gists_url': 'https://api.github.com/users/xuhdev/gists{/gist_id}', 'starred_url': 'https://api.github.com/users/xuhdev/starred{/owner}{/repo}', 'subscriptions_url': 'https://api.github.com/users/xuhdev/subscriptions', 'organizations_url': 'https://api.github.com/users/xuhdev/orgs', 'repos_url': 'https://api.github.com/users/xuhdev/repos', 'events_url': 'https://api.github.com/users/xuhdev/events{/privacy}', 'received_events_url': 'https://api.github.com/users/xuhdev/received_events', 'type': 'User', 'site_admin': False}",referenced,a2cdfa33dc90870edf9992296197b722330bc3fd,https://api.github.com/repos/pytorch/pytorch/commits/a2cdfa33dc90870edf9992296197b722330bc3fd,2019-09-24T23:34:00Z,811,481,330
24586,2659842628,"{'login': 'xuhdev', 'id': 325476, 'node_id': 'MDQ6VXNlcjMyNTQ3Ng==', 'avatar_url': 'https://avatars1.githubusercontent.com/u/325476?v=4', 'gravatar_id': '', 'url': 'https://api.github.com/users/xuhdev', 'html_url': 'https://github.com/xuhdev', 'followers_url': 'https://api.github.com/users/xuhdev/followers', 'following_url': 'https://api.github.com/users/xuhdev/following{/other_user}', 'gists_url': 'https://api.github.com/users/xuhdev/gists{/gist_id}', 'starred_url': 'https://api.github.com/users/xuhdev/starred{/owner}{/repo}', 'subscriptions_url': 'https://api.github.com/users/xuhdev/subscriptions', 'organizations_url': 'https://api.github.com/users/xuhdev/orgs', 'repos_url': 'https://api.github.com/users/xuhdev/repos', 'events_url': 'https://api.github.com/users/xuhdev/events{/privacy}', 'received_events_url': 'https://api.github.com/users/xuhdev/received_events', 'type': 'User', 'site_admin': False}",referenced,504d16706edfe3c4d6e6a9de4565609c47044c0c,https://api.github.com/repos/pytorch/pytorch/commits/504d16706edfe3c4d6e6a9de4565609c47044c0c,2019-09-24T23:34:01Z,811,481,330
24586,2659859542,"{'login': 'xuhdev', 'id': 325476, 'node_id': 'MDQ6VXNlcjMyNTQ3Ng==', 'avatar_url': 'https://avatars1.githubusercontent.com/u/325476?v=4', 'gravatar_id': '', 'url': 'https://api.github.com/users/xuhdev', 'html_url': 'https://github.com/xuhdev', 'followers_url': 'https://api.github.com/users/xuhdev/followers', 'following_url': 'https://api.github.com/users/xuhdev/following{/other_user}', 'gists_url': 'https://api.github.com/users/xuhdev/gists{/gist_id}', 'starred_url': 'https://api.github.com/users/xuhdev/starred{/owner}{/repo}', 'subscriptions_url': 'https://api.github.com/users/xuhdev/subscriptions', 'organizations_url': 'https://api.github.com/users/xuhdev/orgs', 'repos_url': 'https://api.github.com/users/xuhdev/repos', 'events_url': 'https://api.github.com/users/xuhdev/events{/privacy}', 'received_events_url': 'https://api.github.com/users/xuhdev/received_events', 'type': 'User', 'site_admin': False}",referenced,5c847a6f0230e49380082a4922b8d46059acdcc9,https://api.github.com/repos/pytorch/pytorch/commits/5c847a6f0230e49380082a4922b8d46059acdcc9,2019-09-24T23:45:22Z,0,0,0
24586,2659859544,"{'login': 'xuhdev', 'id': 325476, 'node_id': 'MDQ6VXNlcjMyNTQ3Ng==', 'avatar_url': 'https://avatars1.githubusercontent.com/u/325476?v=4', 'gravatar_id': '', 'url': 'https://api.github.com/users/xuhdev', 'html_url': 'https://github.com/xuhdev', 'followers_url': 'https://api.github.com/users/xuhdev/followers', 'following_url': 'https://api.github.com/users/xuhdev/following{/other_user}', 'gists_url': 'https://api.github.com/users/xuhdev/gists{/gist_id}', 'starred_url': 'https://api.github.com/users/xuhdev/starred{/owner}{/repo}', 'subscriptions_url': 'https://api.github.com/users/xuhdev/subscriptions', 'organizations_url': 'https://api.github.com/users/xuhdev/orgs', 'repos_url': 'https://api.github.com/users/xuhdev/repos', 'events_url': 'https://api.github.com/users/xuhdev/events{/privacy}', 'received_events_url': 'https://api.github.com/users/xuhdev/received_events', 'type': 'User', 'site_admin': False}",referenced,aefc0b2e15960b89073b418a075a7865f1620392,https://api.github.com/repos/pytorch/pytorch/commits/aefc0b2e15960b89073b418a075a7865f1620392,2019-09-24T23:45:23Z,1,0,1
24585,2654967601,"{'login': 'facebook-github-bot', 'id': 6422482, 'node_id': 'MDQ6VXNlcjY0MjI0ODI=', 'avatar_url': 'https://avatars3.githubusercontent.com/u/6422482?v=4', 'gravatar_id': '', 'url': 'https://api.github.com/users/facebook-github-bot', 'html_url': 'https://github.com/facebook-github-bot', 'followers_url': 'https://api.github.com/users/facebook-github-bot/followers', 'following_url': 'https://api.github.com/users/facebook-github-bot/following{/other_user}', 'gists_url': 'https://api.github.com/users/facebook-github-bot/gists{/gist_id}', 'starred_url': 'https://api.github.com/users/facebook-github-bot/starred{/owner}{/repo}', 'subscriptions_url': 'https://api.github.com/users/facebook-github-bot/subscriptions', 'organizations_url': 'https://api.github.com/users/facebook-github-bot/orgs', 'repos_url': 'https://api.github.com/users/facebook-github-bot/repos', 'events_url': 'https://api.github.com/users/facebook-github-bot/events{/privacy}', 'received_events_url': 'https://api.github.com/users/facebook-github-bot/received_events', 'type': 'User', 'site_admin': False}",referenced,786d225968b1eced3cb83b2d5b9cbc30acc14aa3,https://api.github.com/repos/pytorch/pytorch/commits/786d225968b1eced3cb83b2d5b9cbc30acc14aa3,2019-09-23T15:46:57Z,55,14,41
24584,2895065990,"{'login': 'facebook-github-bot', 'id': 6422482, 'node_id': 'MDQ6VXNlcjY0MjI0ODI=', 'avatar_url': 'https://avatars3.githubusercontent.com/u/6422482?v=4', 'gravatar_id': '', 'url': 'https://api.github.com/users/facebook-github-bot', 'html_url': 'https://github.com/facebook-github-bot', 'followers_url': 'https://api.github.com/users/facebook-github-bot/followers', 'following_url': 'https://api.github.com/users/facebook-github-bot/following{/other_user}', 'gists_url': 'https://api.github.com/users/facebook-github-bot/gists{/gist_id}', 'starred_url': 'https://api.github.com/users/facebook-github-bot/starred{/owner}{/repo}', 'subscriptions_url': 'https://api.github.com/users/facebook-github-bot/subscriptions', 'organizations_url': 'https://api.github.com/users/facebook-github-bot/orgs', 'repos_url': 'https://api.github.com/users/facebook-github-bot/repos', 'events_url': 'https://api.github.com/users/facebook-github-bot/events{/privacy}', 'received_events_url': 'https://api.github.com/users/facebook-github-bot/received_events', 'type': 'User', 'site_admin': False}",referenced,7cf8b9bada11fcdf81fe709fd7fba7cd5e9f1bb8,https://api.github.com/repos/pytorch/pytorch/commits/7cf8b9bada11fcdf81fe709fd7fba7cd5e9f1bb8,2019-12-18T21:14:21Z,357,114,243
24583,2895066014,"{'login': 'facebook-github-bot', 'id': 6422482, 'node_id': 'MDQ6VXNlcjY0MjI0ODI=', 'avatar_url': 'https://avatars3.githubusercontent.com/u/6422482?v=4', 'gravatar_id': '', 'url': 'https://api.github.com/users/facebook-github-bot', 'html_url': 'https://github.com/facebook-github-bot', 'followers_url': 'https://api.github.com/users/facebook-github-bot/followers', 'following_url': 'https://api.github.com/users/facebook-github-bot/following{/other_user}', 'gists_url': 'https://api.github.com/users/facebook-github-bot/gists{/gist_id}', 'starred_url': 'https://api.github.com/users/facebook-github-bot/starred{/owner}{/repo}', 'subscriptions_url': 'https://api.github.com/users/facebook-github-bot/subscriptions', 'organizations_url': 'https://api.github.com/users/facebook-github-bot/orgs', 'repos_url': 'https://api.github.com/users/facebook-github-bot/repos', 'events_url': 'https://api.github.com/users/facebook-github-bot/events{/privacy}', 'received_events_url': 'https://api.github.com/users/facebook-github-bot/received_events', 'type': 'User', 'site_admin': False}",closed,7cf8b9bada11fcdf81fe709fd7fba7cd5e9f1bb8,https://api.github.com/repos/pytorch/pytorch/commits/7cf8b9bada11fcdf81fe709fd7fba7cd5e9f1bb8,2019-12-18T21:14:22Z,357,114,243
24582,2670200188,"{'login': 'facebook-github-bot', 'id': 6422482, 'node_id': 'MDQ6VXNlcjY0MjI0ODI=', 'avatar_url': 'https://avatars3.githubusercontent.com/u/6422482?v=4', 'gravatar_id': '', 'url': 'https://api.github.com/users/facebook-github-bot', 'html_url': 'https://github.com/facebook-github-bot', 'followers_url': 'https://api.github.com/users/facebook-github-bot/followers', 'following_url': 'https://api.github.com/users/facebook-github-bot/following{/other_user}', 'gists_url': 'https://api.github.com/users/facebook-github-bot/gists{/gist_id}', 'starred_url': 'https://api.github.com/users/facebook-github-bot/starred{/owner}{/repo}', 'subscriptions_url': 'https://api.github.com/users/facebook-github-bot/subscriptions', 'organizations_url': 'https://api.github.com/users/facebook-github-bot/orgs', 'repos_url': 'https://api.github.com/users/facebook-github-bot/repos', 'events_url': 'https://api.github.com/users/facebook-github-bot/events{/privacy}', 'received_events_url': 'https://api.github.com/users/facebook-github-bot/received_events', 'type': 'User', 'site_admin': False}",referenced,541de7e140e35eced300c8b0f31218bb6320d183,https://api.github.com/repos/pytorch/pytorch/commits/541de7e140e35eced300c8b0f31218bb6320d183,2019-09-28T00:29:07Z,1553,335,1218
24573,2670200179,"{'login': 'facebook-github-bot', 'id': 6422482, 'node_id': 'MDQ6VXNlcjY0MjI0ODI=', 'avatar_url': 'https://avatars3.githubusercontent.com/u/6422482?v=4', 'gravatar_id': '', 'url': 'https://api.github.com/users/facebook-github-bot', 'html_url': 'https://github.com/facebook-github-bot', 'followers_url': 'https://api.github.com/users/facebook-github-bot/followers', 'following_url': 'https://api.github.com/users/facebook-github-bot/following{/other_user}', 'gists_url': 'https://api.github.com/users/facebook-github-bot/gists{/gist_id}', 'starred_url': 'https://api.github.com/users/facebook-github-bot/starred{/owner}{/repo}', 'subscriptions_url': 'https://api.github.com/users/facebook-github-bot/subscriptions', 'organizations_url': 'https://api.github.com/users/facebook-github-bot/orgs', 'repos_url': 'https://api.github.com/users/facebook-github-bot/repos', 'events_url': 'https://api.github.com/users/facebook-github-bot/events{/privacy}', 'received_events_url': 'https://api.github.com/users/facebook-github-bot/received_events', 'type': 'User', 'site_admin': False}",referenced,541de7e140e35eced300c8b0f31218bb6320d183,https://api.github.com/repos/pytorch/pytorch/commits/541de7e140e35eced300c8b0f31218bb6320d183,2019-09-28T00:29:07Z,1553,335,1218
24568,2670200185,"{'login': 'facebook-github-bot', 'id': 6422482, 'node_id': 'MDQ6VXNlcjY0MjI0ODI=', 'avatar_url': 'https://avatars3.githubusercontent.com/u/6422482?v=4', 'gravatar_id': '', 'url': 'https://api.github.com/users/facebook-github-bot', 'html_url': 'https://github.com/facebook-github-bot', 'followers_url': 'https://api.github.com/users/facebook-github-bot/followers', 'following_url': 'https://api.github.com/users/facebook-github-bot/following{/other_user}', 'gists_url': 'https://api.github.com/users/facebook-github-bot/gists{/gist_id}', 'starred_url': 'https://api.github.com/users/facebook-github-bot/starred{/owner}{/repo}', 'subscriptions_url': 'https://api.github.com/users/facebook-github-bot/subscriptions', 'organizations_url': 'https://api.github.com/users/facebook-github-bot/orgs', 'repos_url': 'https://api.github.com/users/facebook-github-bot/repos', 'events_url': 'https://api.github.com/users/facebook-github-bot/events{/privacy}', 'received_events_url': 'https://api.github.com/users/facebook-github-bot/received_events', 'type': 'User', 'site_admin': False}",referenced,541de7e140e35eced300c8b0f31218bb6320d183,https://api.github.com/repos/pytorch/pytorch/commits/541de7e140e35eced300c8b0f31218bb6320d183,2019-09-28T00:29:07Z,1553,335,1218
24566,2758547990,"{'login': 'xuhdev', 'id': 325476, 'node_id': 'MDQ6VXNlcjMyNTQ3Ng==', 'avatar_url': 'https://avatars1.githubusercontent.com/u/325476?v=4', 'gravatar_id': '', 'url': 'https://api.github.com/users/xuhdev', 'html_url': 'https://github.com/xuhdev', 'followers_url': 'https://api.github.com/users/xuhdev/followers', 'following_url': 'https://api.github.com/users/xuhdev/following{/other_user}', 'gists_url': 'https://api.github.com/users/xuhdev/gists{/gist_id}', 'starred_url': 'https://api.github.com/users/xuhdev/starred{/owner}{/repo}', 'subscriptions_url': 'https://api.github.com/users/xuhdev/subscriptions', 'organizations_url': 'https://api.github.com/users/xuhdev/orgs', 'repos_url': 'https://api.github.com/users/xuhdev/repos', 'events_url': 'https://api.github.com/users/xuhdev/events{/privacy}', 'received_events_url': 'https://api.github.com/users/xuhdev/received_events', 'type': 'User', 'site_admin': False}",referenced,4a5421e3d711238291f29bc5c88eeb7dde28a88d,https://api.github.com/repos/pytorch/pytorch/commits/4a5421e3d711238291f29bc5c88eeb7dde28a88d,2019-10-31T06:00:09Z,81,16,65
24566,2758548318,"{'login': 'xuhdev', 'id': 325476, 'node_id': 'MDQ6VXNlcjMyNTQ3Ng==', 'avatar_url': 'https://avatars1.githubusercontent.com/u/325476?v=4', 'gravatar_id': '', 'url': 'https://api.github.com/users/xuhdev', 'html_url': 'https://github.com/xuhdev', 'followers_url': 'https://api.github.com/users/xuhdev/followers', 'following_url': 'https://api.github.com/users/xuhdev/following{/other_user}', 'gists_url': 'https://api.github.com/users/xuhdev/gists{/gist_id}', 'starred_url': 'https://api.github.com/users/xuhdev/starred{/owner}{/repo}', 'subscriptions_url': 'https://api.github.com/users/xuhdev/subscriptions', 'organizations_url': 'https://api.github.com/users/xuhdev/orgs', 'repos_url': 'https://api.github.com/users/xuhdev/repos', 'events_url': 'https://api.github.com/users/xuhdev/events{/privacy}', 'received_events_url': 'https://api.github.com/users/xuhdev/received_events', 'type': 'User', 'site_admin': False}",referenced,26a7abda2ed5004aa8caf6c5a8c3ddafb84344b7,https://api.github.com/repos/pytorch/pytorch/commits/26a7abda2ed5004aa8caf6c5a8c3ddafb84344b7,2019-10-31T06:00:22Z,81,16,65
24566,2760863317,"{'login': 'xuhdev', 'id': 325476, 'node_id': 'MDQ6VXNlcjMyNTQ3Ng==', 'avatar_url': 'https://avatars1.githubusercontent.com/u/325476?v=4', 'gravatar_id': '', 'url': 'https://api.github.com/users/xuhdev', 'html_url': 'https://github.com/xuhdev', 'followers_url': 'https://api.github.com/users/xuhdev/followers', 'following_url': 'https://api.github.com/users/xuhdev/following{/other_user}', 'gists_url': 'https://api.github.com/users/xuhdev/gists{/gist_id}', 'starred_url': 'https://api.github.com/users/xuhdev/starred{/owner}{/repo}', 'subscriptions_url': 'https://api.github.com/users/xuhdev/subscriptions', 'organizations_url': 'https://api.github.com/users/xuhdev/orgs', 'repos_url': 'https://api.github.com/users/xuhdev/repos', 'events_url': 'https://api.github.com/users/xuhdev/events{/privacy}', 'received_events_url': 'https://api.github.com/users/xuhdev/received_events', 'type': 'User', 'site_admin': False}",referenced,7dcf0c3d4bbc772b9ab992da9a5049a5a7655ab9,https://api.github.com/repos/pytorch/pytorch/commits/7dcf0c3d4bbc772b9ab992da9a5049a5a7655ab9,2019-10-31T18:01:12Z,2,1,1
24566,2760863600,"{'login': 'xuhdev', 'id': 325476, 'node_id': 'MDQ6VXNlcjMyNTQ3Ng==', 'avatar_url': 'https://avatars1.githubusercontent.com/u/325476?v=4', 'gravatar_id': '', 'url': 'https://api.github.com/users/xuhdev', 'html_url': 'https://github.com/xuhdev', 'followers_url': 'https://api.github.com/users/xuhdev/followers', 'following_url': 'https://api.github.com/users/xuhdev/following{/other_user}', 'gists_url': 'https://api.github.com/users/xuhdev/gists{/gist_id}', 'starred_url': 'https://api.github.com/users/xuhdev/starred{/owner}{/repo}', 'subscriptions_url': 'https://api.github.com/users/xuhdev/subscriptions', 'organizations_url': 'https://api.github.com/users/xuhdev/orgs', 'repos_url': 'https://api.github.com/users/xuhdev/repos', 'events_url': 'https://api.github.com/users/xuhdev/events{/privacy}', 'received_events_url': 'https://api.github.com/users/xuhdev/received_events', 'type': 'User', 'site_admin': False}",referenced,1f9f7833f1f1031ae855f90628aee8d43ad35686,https://api.github.com/repos/pytorch/pytorch/commits/1f9f7833f1f1031ae855f90628aee8d43ad35686,2019-10-31T18:01:17Z,81,16,65
24566,2776840542,"{'login': 'xuhdev', 'id': 325476, 'node_id': 'MDQ6VXNlcjMyNTQ3Ng==', 'avatar_url': 'https://avatars1.githubusercontent.com/u/325476?v=4', 'gravatar_id': '', 'url': 'https://api.github.com/users/xuhdev', 'html_url': 'https://github.com/xuhdev', 'followers_url': 'https://api.github.com/users/xuhdev/followers', 'following_url': 'https://api.github.com/users/xuhdev/following{/other_user}', 'gists_url': 'https://api.github.com/users/xuhdev/gists{/gist_id}', 'starred_url': 'https://api.github.com/users/xuhdev/starred{/owner}{/repo}', 'subscriptions_url': 'https://api.github.com/users/xuhdev/subscriptions', 'organizations_url': 'https://api.github.com/users/xuhdev/orgs', 'repos_url': 'https://api.github.com/users/xuhdev/repos', 'events_url': 'https://api.github.com/users/xuhdev/events{/privacy}', 'received_events_url': 'https://api.github.com/users/xuhdev/received_events', 'type': 'User', 'site_admin': False}",referenced,d5ddfb85cfca0dd1bc371acd112b9cdf525d03dd,https://api.github.com/repos/pytorch/pytorch/commits/d5ddfb85cfca0dd1bc371acd112b9cdf525d03dd,2019-11-06T20:52:29Z,15861,11411,4450
24566,2776840748,"{'login': 'xuhdev', 'id': 325476, 'node_id': 'MDQ6VXNlcjMyNTQ3Ng==', 'avatar_url': 'https://avatars1.githubusercontent.com/u/325476?v=4', 'gravatar_id': '', 'url': 'https://api.github.com/users/xuhdev', 'html_url': 'https://github.com/xuhdev', 'followers_url': 'https://api.github.com/users/xuhdev/followers', 'following_url': 'https://api.github.com/users/xuhdev/following{/other_user}', 'gists_url': 'https://api.github.com/users/xuhdev/gists{/gist_id}', 'starred_url': 'https://api.github.com/users/xuhdev/starred{/owner}{/repo}', 'subscriptions_url': 'https://api.github.com/users/xuhdev/subscriptions', 'organizations_url': 'https://api.github.com/users/xuhdev/orgs', 'repos_url': 'https://api.github.com/users/xuhdev/repos', 'events_url': 'https://api.github.com/users/xuhdev/events{/privacy}', 'received_events_url': 'https://api.github.com/users/xuhdev/received_events', 'type': 'User', 'site_admin': False}",referenced,a01375bbfbefe0c2a0510a02a4cabfee8348fe98,https://api.github.com/repos/pytorch/pytorch/commits/a01375bbfbefe0c2a0510a02a4cabfee8348fe98,2019-11-06T20:52:33Z,15861,11411,4450
24566,2777031033,"{'login': 'xuhdev', 'id': 325476, 'node_id': 'MDQ6VXNlcjMyNTQ3Ng==', 'avatar_url': 'https://avatars1.githubusercontent.com/u/325476?v=4', 'gravatar_id': '', 'url': 'https://api.github.com/users/xuhdev', 'html_url': 'https://github.com/xuhdev', 'followers_url': 'https://api.github.com/users/xuhdev/followers', 'following_url': 'https://api.github.com/users/xuhdev/following{/other_user}', 'gists_url': 'https://api.github.com/users/xuhdev/gists{/gist_id}', 'starred_url': 'https://api.github.com/users/xuhdev/starred{/owner}{/repo}', 'subscriptions_url': 'https://api.github.com/users/xuhdev/subscriptions', 'organizations_url': 'https://api.github.com/users/xuhdev/orgs', 'repos_url': 'https://api.github.com/users/xuhdev/repos', 'events_url': 'https://api.github.com/users/xuhdev/events{/privacy}', 'received_events_url': 'https://api.github.com/users/xuhdev/received_events', 'type': 'User', 'site_admin': False}",referenced,7ba40eaaf8a35df4fe444cf13a44be221b74539a,https://api.github.com/repos/pytorch/pytorch/commits/7ba40eaaf8a35df4fe444cf13a44be221b74539a,2019-11-06T21:58:09Z,5178,2636,2542
24566,2777031038,"{'login': 'xuhdev', 'id': 325476, 'node_id': 'MDQ6VXNlcjMyNTQ3Ng==', 'avatar_url': 'https://avatars1.githubusercontent.com/u/325476?v=4', 'gravatar_id': '', 'url': 'https://api.github.com/users/xuhdev', 'html_url': 'https://github.com/xuhdev', 'followers_url': 'https://api.github.com/users/xuhdev/followers', 'following_url': 'https://api.github.com/users/xuhdev/following{/other_user}', 'gists_url': 'https://api.github.com/users/xuhdev/gists{/gist_id}', 'starred_url': 'https://api.github.com/users/xuhdev/starred{/owner}{/repo}', 'subscriptions_url': 'https://api.github.com/users/xuhdev/subscriptions', 'organizations_url': 'https://api.github.com/users/xuhdev/orgs', 'repos_url': 'https://api.github.com/users/xuhdev/repos', 'events_url': 'https://api.github.com/users/xuhdev/events{/privacy}', 'received_events_url': 'https://api.github.com/users/xuhdev/received_events', 'type': 'User', 'site_admin': False}",referenced,8577819fb1eb6d5be0a92d544395507cf24006c2,https://api.github.com/repos/pytorch/pytorch/commits/8577819fb1eb6d5be0a92d544395507cf24006c2,2019-11-06T21:58:09Z,5177,2636,2541
24566,2781135580,"{'login': 'xuhdev', 'id': 325476, 'node_id': 'MDQ6VXNlcjMyNTQ3Ng==', 'avatar_url': 'https://avatars1.githubusercontent.com/u/325476?v=4', 'gravatar_id': '', 'url': 'https://api.github.com/users/xuhdev', 'html_url': 'https://github.com/xuhdev', 'followers_url': 'https://api.github.com/users/xuhdev/followers', 'following_url': 'https://api.github.com/users/xuhdev/following{/other_user}', 'gists_url': 'https://api.github.com/users/xuhdev/gists{/gist_id}', 'starred_url': 'https://api.github.com/users/xuhdev/starred{/owner}{/repo}', 'subscriptions_url': 'https://api.github.com/users/xuhdev/subscriptions', 'organizations_url': 'https://api.github.com/users/xuhdev/orgs', 'repos_url': 'https://api.github.com/users/xuhdev/repos', 'events_url': 'https://api.github.com/users/xuhdev/events{/privacy}', 'received_events_url': 'https://api.github.com/users/xuhdev/received_events', 'type': 'User', 'site_admin': False}",referenced,4d4f4e46177b7af00ebb13249371b12bb7bec939,https://api.github.com/repos/pytorch/pytorch/commits/4d4f4e46177b7af00ebb13249371b12bb7bec939,2019-11-07T22:54:55Z,5442,3576,1866
24566,2781135583,"{'login': 'xuhdev', 'id': 325476, 'node_id': 'MDQ6VXNlcjMyNTQ3Ng==', 'avatar_url': 'https://avatars1.githubusercontent.com/u/325476?v=4', 'gravatar_id': '', 'url': 'https://api.github.com/users/xuhdev', 'html_url': 'https://github.com/xuhdev', 'followers_url': 'https://api.github.com/users/xuhdev/followers', 'following_url': 'https://api.github.com/users/xuhdev/following{/other_user}', 'gists_url': 'https://api.github.com/users/xuhdev/gists{/gist_id}', 'starred_url': 'https://api.github.com/users/xuhdev/starred{/owner}{/repo}', 'subscriptions_url': 'https://api.github.com/users/xuhdev/subscriptions', 'organizations_url': 'https://api.github.com/users/xuhdev/orgs', 'repos_url': 'https://api.github.com/users/xuhdev/repos', 'events_url': 'https://api.github.com/users/xuhdev/events{/privacy}', 'received_events_url': 'https://api.github.com/users/xuhdev/received_events', 'type': 'User', 'site_admin': False}",referenced,7a009c2434ad424f8d66550f6de12bed6f3aee7b,https://api.github.com/repos/pytorch/pytorch/commits/7a009c2434ad424f8d66550f6de12bed6f3aee7b,2019-11-07T22:54:55Z,5442,3576,1866
24566,2785487275,"{'login': 'facebook-github-bot', 'id': 6422482, 'node_id': 'MDQ6VXNlcjY0MjI0ODI=', 'avatar_url': 'https://avatars3.githubusercontent.com/u/6422482?v=4', 'gravatar_id': '', 'url': 'https://api.github.com/users/facebook-github-bot', 'html_url': 'https://github.com/facebook-github-bot', 'followers_url': 'https://api.github.com/users/facebook-github-bot/followers', 'following_url': 'https://api.github.com/users/facebook-github-bot/following{/other_user}', 'gists_url': 'https://api.github.com/users/facebook-github-bot/gists{/gist_id}', 'starred_url': 'https://api.github.com/users/facebook-github-bot/starred{/owner}{/repo}', 'subscriptions_url': 'https://api.github.com/users/facebook-github-bot/subscriptions', 'organizations_url': 'https://api.github.com/users/facebook-github-bot/orgs', 'repos_url': 'https://api.github.com/users/facebook-github-bot/repos', 'events_url': 'https://api.github.com/users/facebook-github-bot/events{/privacy}', 'received_events_url': 'https://api.github.com/users/facebook-github-bot/received_events', 'type': 'User', 'site_admin': False}",closed,4606deb2beb818ce53fe291d1afce917498df181,https://api.github.com/repos/pytorch/pytorch/commits/4606deb2beb818ce53fe291d1afce917498df181,2019-11-09T17:12:07Z,80,16,64
24562,2662654282,"{'login': 'facebook-github-bot', 'id': 6422482, 'node_id': 'MDQ6VXNlcjY0MjI0ODI=', 'avatar_url': 'https://avatars3.githubusercontent.com/u/6422482?v=4', 'gravatar_id': '', 'url': 'https://api.github.com/users/facebook-github-bot', 'html_url': 'https://github.com/facebook-github-bot', 'followers_url': 'https://api.github.com/users/facebook-github-bot/followers', 'following_url': 'https://api.github.com/users/facebook-github-bot/following{/other_user}', 'gists_url': 'https://api.github.com/users/facebook-github-bot/gists{/gist_id}', 'starred_url': 'https://api.github.com/users/facebook-github-bot/starred{/owner}{/repo}', 'subscriptions_url': 'https://api.github.com/users/facebook-github-bot/subscriptions', 'organizations_url': 'https://api.github.com/users/facebook-github-bot/orgs', 'repos_url': 'https://api.github.com/users/facebook-github-bot/repos', 'events_url': 'https://api.github.com/users/facebook-github-bot/events{/privacy}', 'received_events_url': 'https://api.github.com/users/facebook-github-bot/received_events', 'type': 'User', 'site_admin': False}",closed,aaf30cdf36839bc3f21b1622fb91ff3e2983e8ea,https://api.github.com/repos/pytorch/pytorch/commits/aaf30cdf36839bc3f21b1622fb91ff3e2983e8ea,2019-09-25T18:12:10Z,72,18,54
24560,2591179363,"{'login': 'facebook-github-bot', 'id': 6422482, 'node_id': 'MDQ6VXNlcjY0MjI0ODI=', 'avatar_url': 'https://avatars3.githubusercontent.com/u/6422482?v=4', 'gravatar_id': '', 'url': 'https://api.github.com/users/facebook-github-bot', 'html_url': 'https://github.com/facebook-github-bot', 'followers_url': 'https://api.github.com/users/facebook-github-bot/followers', 'following_url': 'https://api.github.com/users/facebook-github-bot/following{/other_user}', 'gists_url': 'https://api.github.com/users/facebook-github-bot/gists{/gist_id}', 'starred_url': 'https://api.github.com/users/facebook-github-bot/starred{/owner}{/repo}', 'subscriptions_url': 'https://api.github.com/users/facebook-github-bot/subscriptions', 'organizations_url': 'https://api.github.com/users/facebook-github-bot/orgs', 'repos_url': 'https://api.github.com/users/facebook-github-bot/repos', 'events_url': 'https://api.github.com/users/facebook-github-bot/events{/privacy}', 'received_events_url': 'https://api.github.com/users/facebook-github-bot/received_events', 'type': 'User', 'site_admin': False}",referenced,afb7a162fbc95901f569d2108d9807887e2299aa,https://api.github.com/repos/pytorch/pytorch/commits/afb7a162fbc95901f569d2108d9807887e2299aa,2019-08-28T16:30:20Z,108,46,62
24556,2670200183,"{'login': 'facebook-github-bot', 'id': 6422482, 'node_id': 'MDQ6VXNlcjY0MjI0ODI=', 'avatar_url': 'https://avatars3.githubusercontent.com/u/6422482?v=4', 'gravatar_id': '', 'url': 'https://api.github.com/users/facebook-github-bot', 'html_url': 'https://github.com/facebook-github-bot', 'followers_url': 'https://api.github.com/users/facebook-github-bot/followers', 'following_url': 'https://api.github.com/users/facebook-github-bot/following{/other_user}', 'gists_url': 'https://api.github.com/users/facebook-github-bot/gists{/gist_id}', 'starred_url': 'https://api.github.com/users/facebook-github-bot/starred{/owner}{/repo}', 'subscriptions_url': 'https://api.github.com/users/facebook-github-bot/subscriptions', 'organizations_url': 'https://api.github.com/users/facebook-github-bot/orgs', 'repos_url': 'https://api.github.com/users/facebook-github-bot/repos', 'events_url': 'https://api.github.com/users/facebook-github-bot/events{/privacy}', 'received_events_url': 'https://api.github.com/users/facebook-github-bot/received_events', 'type': 'User', 'site_admin': False}",referenced,541de7e140e35eced300c8b0f31218bb6320d183,https://api.github.com/repos/pytorch/pytorch/commits/541de7e140e35eced300c8b0f31218bb6320d183,2019-09-28T00:29:07Z,1553,335,1218
24550,2590977702,"{'login': 'facebook-github-bot', 'id': 6422482, 'node_id': 'MDQ6VXNlcjY0MjI0ODI=', 'avatar_url': 'https://avatars3.githubusercontent.com/u/6422482?v=4', 'gravatar_id': '', 'url': 'https://api.github.com/users/facebook-github-bot', 'html_url': 'https://github.com/facebook-github-bot', 'followers_url': 'https://api.github.com/users/facebook-github-bot/followers', 'following_url': 'https://api.github.com/users/facebook-github-bot/following{/other_user}', 'gists_url': 'https://api.github.com/users/facebook-github-bot/gists{/gist_id}', 'starred_url': 'https://api.github.com/users/facebook-github-bot/starred{/owner}{/repo}', 'subscriptions_url': 'https://api.github.com/users/facebook-github-bot/subscriptions', 'organizations_url': 'https://api.github.com/users/facebook-github-bot/orgs', 'repos_url': 'https://api.github.com/users/facebook-github-bot/repos', 'events_url': 'https://api.github.com/users/facebook-github-bot/events{/privacy}', 'received_events_url': 'https://api.github.com/users/facebook-github-bot/received_events', 'type': 'User', 'site_admin': False}",referenced,9b1097958e8f72167711ce1b447e1d8b9d77c0ff,https://api.github.com/repos/pytorch/pytorch/commits/9b1097958e8f72167711ce1b447e1d8b9d77c0ff,2019-08-28T15:29:24Z,453,219,234
24550,2612995447,"{'login': 'facebook-github-bot', 'id': 6422482, 'node_id': 'MDQ6VXNlcjY0MjI0ODI=', 'avatar_url': 'https://avatars3.githubusercontent.com/u/6422482?v=4', 'gravatar_id': '', 'url': 'https://api.github.com/users/facebook-github-bot', 'html_url': 'https://github.com/facebook-github-bot', 'followers_url': 'https://api.github.com/users/facebook-github-bot/followers', 'following_url': 'https://api.github.com/users/facebook-github-bot/following{/other_user}', 'gists_url': 'https://api.github.com/users/facebook-github-bot/gists{/gist_id}', 'starred_url': 'https://api.github.com/users/facebook-github-bot/starred{/owner}{/repo}', 'subscriptions_url': 'https://api.github.com/users/facebook-github-bot/subscriptions', 'organizations_url': 'https://api.github.com/users/facebook-github-bot/orgs', 'repos_url': 'https://api.github.com/users/facebook-github-bot/repos', 'events_url': 'https://api.github.com/users/facebook-github-bot/events{/privacy}', 'received_events_url': 'https://api.github.com/users/facebook-github-bot/received_events', 'type': 'User', 'site_admin': False}",closed,d939ee2d85412f86b148f3f83c6cdc9c9567bef7,https://api.github.com/repos/pytorch/pytorch/commits/d939ee2d85412f86b148f3f83c6cdc9c9567bef7,2019-09-06T02:49:44Z,383,128,255
24542,2567725204,"{'login': 'xuhdev', 'id': 325476, 'node_id': 'MDQ6VXNlcjMyNTQ3Ng==', 'avatar_url': 'https://avatars1.githubusercontent.com/u/325476?v=4', 'gravatar_id': '', 'url': 'https://api.github.com/users/xuhdev', 'html_url': 'https://github.com/xuhdev', 'followers_url': 'https://api.github.com/users/xuhdev/followers', 'following_url': 'https://api.github.com/users/xuhdev/following{/other_user}', 'gists_url': 'https://api.github.com/users/xuhdev/gists{/gist_id}', 'starred_url': 'https://api.github.com/users/xuhdev/starred{/owner}{/repo}', 'subscriptions_url': 'https://api.github.com/users/xuhdev/subscriptions', 'organizations_url': 'https://api.github.com/users/xuhdev/orgs', 'repos_url': 'https://api.github.com/users/xuhdev/repos', 'events_url': 'https://api.github.com/users/xuhdev/events{/privacy}', 'received_events_url': 'https://api.github.com/users/xuhdev/received_events', 'type': 'User', 'site_admin': False}",referenced,52f1a4f4e0fc7e51df6ff401e526c43fc2bfdc25,https://api.github.com/repos/pytorch/pytorch/commits/52f1a4f4e0fc7e51df6ff401e526c43fc2bfdc25,2019-08-19T21:25:46Z,52,27,25
24542,2567725480,"{'login': 'xuhdev', 'id': 325476, 'node_id': 'MDQ6VXNlcjMyNTQ3Ng==', 'avatar_url': 'https://avatars1.githubusercontent.com/u/325476?v=4', 'gravatar_id': '', 'url': 'https://api.github.com/users/xuhdev', 'html_url': 'https://github.com/xuhdev', 'followers_url': 'https://api.github.com/users/xuhdev/followers', 'following_url': 'https://api.github.com/users/xuhdev/following{/other_user}', 'gists_url': 'https://api.github.com/users/xuhdev/gists{/gist_id}', 'starred_url': 'https://api.github.com/users/xuhdev/starred{/owner}{/repo}', 'subscriptions_url': 'https://api.github.com/users/xuhdev/subscriptions', 'organizations_url': 'https://api.github.com/users/xuhdev/orgs', 'repos_url': 'https://api.github.com/users/xuhdev/repos', 'events_url': 'https://api.github.com/users/xuhdev/events{/privacy}', 'received_events_url': 'https://api.github.com/users/xuhdev/received_events', 'type': 'User', 'site_admin': False}",referenced,25f2012bc488b9a8e18d5d11d82d3b7a5aaa4c43,https://api.github.com/repos/pytorch/pytorch/commits/25f2012bc488b9a8e18d5d11d82d3b7a5aaa4c43,2019-08-19T21:25:53Z,52,27,25
24542,2567744099,"{'login': 'xuhdev', 'id': 325476, 'node_id': 'MDQ6VXNlcjMyNTQ3Ng==', 'avatar_url': 'https://avatars1.githubusercontent.com/u/325476?v=4', 'gravatar_id': '', 'url': 'https://api.github.com/users/xuhdev', 'html_url': 'https://github.com/xuhdev', 'followers_url': 'https://api.github.com/users/xuhdev/followers', 'following_url': 'https://api.github.com/users/xuhdev/following{/other_user}', 'gists_url': 'https://api.github.com/users/xuhdev/gists{/gist_id}', 'starred_url': 'https://api.github.com/users/xuhdev/starred{/owner}{/repo}', 'subscriptions_url': 'https://api.github.com/users/xuhdev/subscriptions', 'organizations_url': 'https://api.github.com/users/xuhdev/orgs', 'repos_url': 'https://api.github.com/users/xuhdev/repos', 'events_url': 'https://api.github.com/users/xuhdev/events{/privacy}', 'received_events_url': 'https://api.github.com/users/xuhdev/received_events', 'type': 'User', 'site_admin': False}",referenced,9ae297c5a62e8661be16f261382e6e1c10daf315,https://api.github.com/repos/pytorch/pytorch/commits/9ae297c5a62e8661be16f261382e6e1c10daf315,2019-08-19T21:34:10Z,28,17,11
24542,2567744279,"{'login': 'xuhdev', 'id': 325476, 'node_id': 'MDQ6VXNlcjMyNTQ3Ng==', 'avatar_url': 'https://avatars1.githubusercontent.com/u/325476?v=4', 'gravatar_id': '', 'url': 'https://api.github.com/users/xuhdev', 'html_url': 'https://github.com/xuhdev', 'followers_url': 'https://api.github.com/users/xuhdev/followers', 'following_url': 'https://api.github.com/users/xuhdev/following{/other_user}', 'gists_url': 'https://api.github.com/users/xuhdev/gists{/gist_id}', 'starred_url': 'https://api.github.com/users/xuhdev/starred{/owner}{/repo}', 'subscriptions_url': 'https://api.github.com/users/xuhdev/subscriptions', 'organizations_url': 'https://api.github.com/users/xuhdev/orgs', 'repos_url': 'https://api.github.com/users/xuhdev/repos', 'events_url': 'https://api.github.com/users/xuhdev/events{/privacy}', 'received_events_url': 'https://api.github.com/users/xuhdev/received_events', 'type': 'User', 'site_admin': False}",referenced,1a2acd67f63609014e60d2b81aba31f66d6ab736,https://api.github.com/repos/pytorch/pytorch/commits/1a2acd67f63609014e60d2b81aba31f66d6ab736,2019-08-19T21:34:14Z,52,27,25
24542,2568031284,"{'login': 'xuhdev', 'id': 325476, 'node_id': 'MDQ6VXNlcjMyNTQ3Ng==', 'avatar_url': 'https://avatars1.githubusercontent.com/u/325476?v=4', 'gravatar_id': '', 'url': 'https://api.github.com/users/xuhdev', 'html_url': 'https://github.com/xuhdev', 'followers_url': 'https://api.github.com/users/xuhdev/followers', 'following_url': 'https://api.github.com/users/xuhdev/following{/other_user}', 'gists_url': 'https://api.github.com/users/xuhdev/gists{/gist_id}', 'starred_url': 'https://api.github.com/users/xuhdev/starred{/owner}{/repo}', 'subscriptions_url': 'https://api.github.com/users/xuhdev/subscriptions', 'organizations_url': 'https://api.github.com/users/xuhdev/orgs', 'repos_url': 'https://api.github.com/users/xuhdev/repos', 'events_url': 'https://api.github.com/users/xuhdev/events{/privacy}', 'received_events_url': 'https://api.github.com/users/xuhdev/received_events', 'type': 'User', 'site_admin': False}",referenced,fd0294d73e125afce0994da59146503bb9eb65f4,https://api.github.com/repos/pytorch/pytorch/commits/fd0294d73e125afce0994da59146503bb9eb65f4,2019-08-20T00:26:27Z,1237,810,427
24542,2568148259,"{'login': 'xuhdev', 'id': 325476, 'node_id': 'MDQ6VXNlcjMyNTQ3Ng==', 'avatar_url': 'https://avatars1.githubusercontent.com/u/325476?v=4', 'gravatar_id': '', 'url': 'https://api.github.com/users/xuhdev', 'html_url': 'https://github.com/xuhdev', 'followers_url': 'https://api.github.com/users/xuhdev/followers', 'following_url': 'https://api.github.com/users/xuhdev/following{/other_user}', 'gists_url': 'https://api.github.com/users/xuhdev/gists{/gist_id}', 'starred_url': 'https://api.github.com/users/xuhdev/starred{/owner}{/repo}', 'subscriptions_url': 'https://api.github.com/users/xuhdev/subscriptions', 'organizations_url': 'https://api.github.com/users/xuhdev/orgs', 'repos_url': 'https://api.github.com/users/xuhdev/repos', 'events_url': 'https://api.github.com/users/xuhdev/events{/privacy}', 'received_events_url': 'https://api.github.com/users/xuhdev/received_events', 'type': 'User', 'site_admin': False}",referenced,dcea42493549021734b968c22aa1a995bd52c298,https://api.github.com/repos/pytorch/pytorch/commits/dcea42493549021734b968c22aa1a995bd52c298,2019-08-20T02:00:56Z,266,193,73
24542,2570590955,"{'login': 'xuhdev', 'id': 325476, 'node_id': 'MDQ6VXNlcjMyNTQ3Ng==', 'avatar_url': 'https://avatars1.githubusercontent.com/u/325476?v=4', 'gravatar_id': '', 'url': 'https://api.github.com/users/xuhdev', 'html_url': 'https://github.com/xuhdev', 'followers_url': 'https://api.github.com/users/xuhdev/followers', 'following_url': 'https://api.github.com/users/xuhdev/following{/other_user}', 'gists_url': 'https://api.github.com/users/xuhdev/gists{/gist_id}', 'starred_url': 'https://api.github.com/users/xuhdev/starred{/owner}{/repo}', 'subscriptions_url': 'https://api.github.com/users/xuhdev/subscriptions', 'organizations_url': 'https://api.github.com/users/xuhdev/orgs', 'repos_url': 'https://api.github.com/users/xuhdev/repos', 'events_url': 'https://api.github.com/users/xuhdev/events{/privacy}', 'received_events_url': 'https://api.github.com/users/xuhdev/received_events', 'type': 'User', 'site_admin': False}",referenced,23f01e9a36de54e3d25db20fcf0513a10c1c0490,https://api.github.com/repos/pytorch/pytorch/commits/23f01e9a36de54e3d25db20fcf0513a10c1c0490,2019-08-20T18:06:00Z,2729,1247,1482
24542,2571031344,"{'login': 'xuhdev', 'id': 325476, 'node_id': 'MDQ6VXNlcjMyNTQ3Ng==', 'avatar_url': 'https://avatars1.githubusercontent.com/u/325476?v=4', 'gravatar_id': '', 'url': 'https://api.github.com/users/xuhdev', 'html_url': 'https://github.com/xuhdev', 'followers_url': 'https://api.github.com/users/xuhdev/followers', 'following_url': 'https://api.github.com/users/xuhdev/following{/other_user}', 'gists_url': 'https://api.github.com/users/xuhdev/gists{/gist_id}', 'starred_url': 'https://api.github.com/users/xuhdev/starred{/owner}{/repo}', 'subscriptions_url': 'https://api.github.com/users/xuhdev/subscriptions', 'organizations_url': 'https://api.github.com/users/xuhdev/orgs', 'repos_url': 'https://api.github.com/users/xuhdev/repos', 'events_url': 'https://api.github.com/users/xuhdev/events{/privacy}', 'received_events_url': 'https://api.github.com/users/xuhdev/received_events', 'type': 'User', 'site_admin': False}",referenced,0025a81aefc3d305695b444ff5f1ada56408da6c,https://api.github.com/repos/pytorch/pytorch/commits/0025a81aefc3d305695b444ff5f1ada56408da6c,2019-08-20T20:50:03Z,4118,3683,435
24542,2571061121,"{'login': 'xuhdev', 'id': 325476, 'node_id': 'MDQ6VXNlcjMyNTQ3Ng==', 'avatar_url': 'https://avatars1.githubusercontent.com/u/325476?v=4', 'gravatar_id': '', 'url': 'https://api.github.com/users/xuhdev', 'html_url': 'https://github.com/xuhdev', 'followers_url': 'https://api.github.com/users/xuhdev/followers', 'following_url': 'https://api.github.com/users/xuhdev/following{/other_user}', 'gists_url': 'https://api.github.com/users/xuhdev/gists{/gist_id}', 'starred_url': 'https://api.github.com/users/xuhdev/starred{/owner}{/repo}', 'subscriptions_url': 'https://api.github.com/users/xuhdev/subscriptions', 'organizations_url': 'https://api.github.com/users/xuhdev/orgs', 'repos_url': 'https://api.github.com/users/xuhdev/repos', 'events_url': 'https://api.github.com/users/xuhdev/events{/privacy}', 'received_events_url': 'https://api.github.com/users/xuhdev/received_events', 'type': 'User', 'site_admin': False}",referenced,75a0c22115b9046330e09458a8d96d284f5282c0,https://api.github.com/repos/pytorch/pytorch/commits/75a0c22115b9046330e09458a8d96d284f5282c0,2019-08-20T21:00:48Z,106,3,103
24542,2571061226,"{'login': 'xuhdev', 'id': 325476, 'node_id': 'MDQ6VXNlcjMyNTQ3Ng==', 'avatar_url': 'https://avatars1.githubusercontent.com/u/325476?v=4', 'gravatar_id': '', 'url': 'https://api.github.com/users/xuhdev', 'html_url': 'https://github.com/xuhdev', 'followers_url': 'https://api.github.com/users/xuhdev/followers', 'following_url': 'https://api.github.com/users/xuhdev/following{/other_user}', 'gists_url': 'https://api.github.com/users/xuhdev/gists{/gist_id}', 'starred_url': 'https://api.github.com/users/xuhdev/starred{/owner}{/repo}', 'subscriptions_url': 'https://api.github.com/users/xuhdev/subscriptions', 'organizations_url': 'https://api.github.com/users/xuhdev/orgs', 'repos_url': 'https://api.github.com/users/xuhdev/repos', 'events_url': 'https://api.github.com/users/xuhdev/events{/privacy}', 'received_events_url': 'https://api.github.com/users/xuhdev/received_events', 'type': 'User', 'site_admin': False}",referenced,12a6c69dd23e33f308eeaa8ae0a54cb279a978a4,https://api.github.com/repos/pytorch/pytorch/commits/12a6c69dd23e33f308eeaa8ae0a54cb279a978a4,2019-08-20T21:00:49Z,106,3,103
24542,2571081064,"{'login': 'xuhdev', 'id': 325476, 'node_id': 'MDQ6VXNlcjMyNTQ3Ng==', 'avatar_url': 'https://avatars1.githubusercontent.com/u/325476?v=4', 'gravatar_id': '', 'url': 'https://api.github.com/users/xuhdev', 'html_url': 'https://github.com/xuhdev', 'followers_url': 'https://api.github.com/users/xuhdev/followers', 'following_url': 'https://api.github.com/users/xuhdev/following{/other_user}', 'gists_url': 'https://api.github.com/users/xuhdev/gists{/gist_id}', 'starred_url': 'https://api.github.com/users/xuhdev/starred{/owner}{/repo}', 'subscriptions_url': 'https://api.github.com/users/xuhdev/subscriptions', 'organizations_url': 'https://api.github.com/users/xuhdev/orgs', 'repos_url': 'https://api.github.com/users/xuhdev/repos', 'events_url': 'https://api.github.com/users/xuhdev/events{/privacy}', 'received_events_url': 'https://api.github.com/users/xuhdev/received_events', 'type': 'User', 'site_admin': False}",referenced,dfd9cb0584f092625ff1493deeca0a23c7644075,https://api.github.com/repos/pytorch/pytorch/commits/dfd9cb0584f092625ff1493deeca0a23c7644075,2019-08-20T21:08:23Z,4344,543,3801
24542,2571081115,"{'login': 'xuhdev', 'id': 325476, 'node_id': 'MDQ6VXNlcjMyNTQ3Ng==', 'avatar_url': 'https://avatars1.githubusercontent.com/u/325476?v=4', 'gravatar_id': '', 'url': 'https://api.github.com/users/xuhdev', 'html_url': 'https://github.com/xuhdev', 'followers_url': 'https://api.github.com/users/xuhdev/followers', 'following_url': 'https://api.github.com/users/xuhdev/following{/other_user}', 'gists_url': 'https://api.github.com/users/xuhdev/gists{/gist_id}', 'starred_url': 'https://api.github.com/users/xuhdev/starred{/owner}{/repo}', 'subscriptions_url': 'https://api.github.com/users/xuhdev/subscriptions', 'organizations_url': 'https://api.github.com/users/xuhdev/orgs', 'repos_url': 'https://api.github.com/users/xuhdev/repos', 'events_url': 'https://api.github.com/users/xuhdev/events{/privacy}', 'received_events_url': 'https://api.github.com/users/xuhdev/received_events', 'type': 'User', 'site_admin': False}",referenced,579c667a1e7a63271f32e9147fb01792e7ad6e3a,https://api.github.com/repos/pytorch/pytorch/commits/579c667a1e7a63271f32e9147fb01792e7ad6e3a,2019-08-20T21:08:24Z,4344,543,3801
24542,2571396600,"{'login': 'xuhdev', 'id': 325476, 'node_id': 'MDQ6VXNlcjMyNTQ3Ng==', 'avatar_url': 'https://avatars1.githubusercontent.com/u/325476?v=4', 'gravatar_id': '', 'url': 'https://api.github.com/users/xuhdev', 'html_url': 'https://github.com/xuhdev', 'followers_url': 'https://api.github.com/users/xuhdev/followers', 'following_url': 'https://api.github.com/users/xuhdev/following{/other_user}', 'gists_url': 'https://api.github.com/users/xuhdev/gists{/gist_id}', 'starred_url': 'https://api.github.com/users/xuhdev/starred{/owner}{/repo}', 'subscriptions_url': 'https://api.github.com/users/xuhdev/subscriptions', 'organizations_url': 'https://api.github.com/users/xuhdev/orgs', 'repos_url': 'https://api.github.com/users/xuhdev/repos', 'events_url': 'https://api.github.com/users/xuhdev/events{/privacy}', 'received_events_url': 'https://api.github.com/users/xuhdev/received_events', 'type': 'User', 'site_admin': False}",referenced,5925a13eab5ccb9b9a2175e8b70c1a2b7710cc53,https://api.github.com/repos/pytorch/pytorch/commits/5925a13eab5ccb9b9a2175e8b70c1a2b7710cc53,2019-08-20T23:58:04Z,2417,963,1454
24542,2571396601,"{'login': 'xuhdev', 'id': 325476, 'node_id': 'MDQ6VXNlcjMyNTQ3Ng==', 'avatar_url': 'https://avatars1.githubusercontent.com/u/325476?v=4', 'gravatar_id': '', 'url': 'https://api.github.com/users/xuhdev', 'html_url': 'https://github.com/xuhdev', 'followers_url': 'https://api.github.com/users/xuhdev/followers', 'following_url': 'https://api.github.com/users/xuhdev/following{/other_user}', 'gists_url': 'https://api.github.com/users/xuhdev/gists{/gist_id}', 'starred_url': 'https://api.github.com/users/xuhdev/starred{/owner}{/repo}', 'subscriptions_url': 'https://api.github.com/users/xuhdev/subscriptions', 'organizations_url': 'https://api.github.com/users/xuhdev/orgs', 'repos_url': 'https://api.github.com/users/xuhdev/repos', 'events_url': 'https://api.github.com/users/xuhdev/events{/privacy}', 'received_events_url': 'https://api.github.com/users/xuhdev/received_events', 'type': 'User', 'site_admin': False}",referenced,70f58125fbfddaf4bc6cd06a48d25457e96436bb,https://api.github.com/repos/pytorch/pytorch/commits/70f58125fbfddaf4bc6cd06a48d25457e96436bb,2019-08-20T23:58:04Z,2417,963,1454
24542,2572093440,"{'login': 'xuhdev', 'id': 325476, 'node_id': 'MDQ6VXNlcjMyNTQ3Ng==', 'avatar_url': 'https://avatars1.githubusercontent.com/u/325476?v=4', 'gravatar_id': '', 'url': 'https://api.github.com/users/xuhdev', 'html_url': 'https://github.com/xuhdev', 'followers_url': 'https://api.github.com/users/xuhdev/followers', 'following_url': 'https://api.github.com/users/xuhdev/following{/other_user}', 'gists_url': 'https://api.github.com/users/xuhdev/gists{/gist_id}', 'starred_url': 'https://api.github.com/users/xuhdev/starred{/owner}{/repo}', 'subscriptions_url': 'https://api.github.com/users/xuhdev/subscriptions', 'organizations_url': 'https://api.github.com/users/xuhdev/orgs', 'repos_url': 'https://api.github.com/users/xuhdev/repos', 'events_url': 'https://api.github.com/users/xuhdev/events{/privacy}', 'received_events_url': 'https://api.github.com/users/xuhdev/received_events', 'type': 'User', 'site_admin': False}",referenced,19d8b0ca5dffdcf08938c239914810891631962b,https://api.github.com/repos/pytorch/pytorch/commits/19d8b0ca5dffdcf08938c239914810891631962b,2019-08-21T07:45:12Z,4566,4362,204
24542,2572093446,"{'login': 'xuhdev', 'id': 325476, 'node_id': 'MDQ6VXNlcjMyNTQ3Ng==', 'avatar_url': 'https://avatars1.githubusercontent.com/u/325476?v=4', 'gravatar_id': '', 'url': 'https://api.github.com/users/xuhdev', 'html_url': 'https://github.com/xuhdev', 'followers_url': 'https://api.github.com/users/xuhdev/followers', 'following_url': 'https://api.github.com/users/xuhdev/following{/other_user}', 'gists_url': 'https://api.github.com/users/xuhdev/gists{/gist_id}', 'starred_url': 'https://api.github.com/users/xuhdev/starred{/owner}{/repo}', 'subscriptions_url': 'https://api.github.com/users/xuhdev/subscriptions', 'organizations_url': 'https://api.github.com/users/xuhdev/orgs', 'repos_url': 'https://api.github.com/users/xuhdev/repos', 'events_url': 'https://api.github.com/users/xuhdev/events{/privacy}', 'received_events_url': 'https://api.github.com/users/xuhdev/received_events', 'type': 'User', 'site_admin': False}",referenced,507208dd1b9c72de860b88a8cd891e8d2cb96ed7,https://api.github.com/repos/pytorch/pytorch/commits/507208dd1b9c72de860b88a8cd891e8d2cb96ed7,2019-08-21T07:45:12Z,4568,4363,205
24542,2573838999,"{'login': 'xuhdev', 'id': 325476, 'node_id': 'MDQ6VXNlcjMyNTQ3Ng==', 'avatar_url': 'https://avatars1.githubusercontent.com/u/325476?v=4', 'gravatar_id': '', 'url': 'https://api.github.com/users/xuhdev', 'html_url': 'https://github.com/xuhdev', 'followers_url': 'https://api.github.com/users/xuhdev/followers', 'following_url': 'https://api.github.com/users/xuhdev/following{/other_user}', 'gists_url': 'https://api.github.com/users/xuhdev/gists{/gist_id}', 'starred_url': 'https://api.github.com/users/xuhdev/starred{/owner}{/repo}', 'subscriptions_url': 'https://api.github.com/users/xuhdev/subscriptions', 'organizations_url': 'https://api.github.com/users/xuhdev/orgs', 'repos_url': 'https://api.github.com/users/xuhdev/repos', 'events_url': 'https://api.github.com/users/xuhdev/events{/privacy}', 'received_events_url': 'https://api.github.com/users/xuhdev/received_events', 'type': 'User', 'site_admin': False}",referenced,299bed1eaa31192058e2591ce6c55f141fcc9337,https://api.github.com/repos/pytorch/pytorch/commits/299bed1eaa31192058e2591ce6c55f141fcc9337,2019-08-21T17:11:18Z,698,65,633
24542,2573839007,"{'login': 'xuhdev', 'id': 325476, 'node_id': 'MDQ6VXNlcjMyNTQ3Ng==', 'avatar_url': 'https://avatars1.githubusercontent.com/u/325476?v=4', 'gravatar_id': '', 'url': 'https://api.github.com/users/xuhdev', 'html_url': 'https://github.com/xuhdev', 'followers_url': 'https://api.github.com/users/xuhdev/followers', 'following_url': 'https://api.github.com/users/xuhdev/following{/other_user}', 'gists_url': 'https://api.github.com/users/xuhdev/gists{/gist_id}', 'starred_url': 'https://api.github.com/users/xuhdev/starred{/owner}{/repo}', 'subscriptions_url': 'https://api.github.com/users/xuhdev/subscriptions', 'organizations_url': 'https://api.github.com/users/xuhdev/orgs', 'repos_url': 'https://api.github.com/users/xuhdev/repos', 'events_url': 'https://api.github.com/users/xuhdev/events{/privacy}', 'received_events_url': 'https://api.github.com/users/xuhdev/received_events', 'type': 'User', 'site_admin': False}",referenced,b96734df39b3272547a043a6f408646f81fe712e,https://api.github.com/repos/pytorch/pytorch/commits/b96734df39b3272547a043a6f408646f81fe712e,2019-08-21T17:11:18Z,698,65,633
24542,2573887955,"{'login': 'xuhdev', 'id': 325476, 'node_id': 'MDQ6VXNlcjMyNTQ3Ng==', 'avatar_url': 'https://avatars1.githubusercontent.com/u/325476?v=4', 'gravatar_id': '', 'url': 'https://api.github.com/users/xuhdev', 'html_url': 'https://github.com/xuhdev', 'followers_url': 'https://api.github.com/users/xuhdev/followers', 'following_url': 'https://api.github.com/users/xuhdev/following{/other_user}', 'gists_url': 'https://api.github.com/users/xuhdev/gists{/gist_id}', 'starred_url': 'https://api.github.com/users/xuhdev/starred{/owner}{/repo}', 'subscriptions_url': 'https://api.github.com/users/xuhdev/subscriptions', 'organizations_url': 'https://api.github.com/users/xuhdev/orgs', 'repos_url': 'https://api.github.com/users/xuhdev/repos', 'events_url': 'https://api.github.com/users/xuhdev/events{/privacy}', 'received_events_url': 'https://api.github.com/users/xuhdev/received_events', 'type': 'User', 'site_admin': False}",referenced,656cb9e8c18e0a59762117b4ac4ff1b76f3c71db,https://api.github.com/repos/pytorch/pytorch/commits/656cb9e8c18e0a59762117b4ac4ff1b76f3c71db,2019-08-21T17:28:32Z,0,0,0
24542,2573887989,"{'login': 'xuhdev', 'id': 325476, 'node_id': 'MDQ6VXNlcjMyNTQ3Ng==', 'avatar_url': 'https://avatars1.githubusercontent.com/u/325476?v=4', 'gravatar_id': '', 'url': 'https://api.github.com/users/xuhdev', 'html_url': 'https://github.com/xuhdev', 'followers_url': 'https://api.github.com/users/xuhdev/followers', 'following_url': 'https://api.github.com/users/xuhdev/following{/other_user}', 'gists_url': 'https://api.github.com/users/xuhdev/gists{/gist_id}', 'starred_url': 'https://api.github.com/users/xuhdev/starred{/owner}{/repo}', 'subscriptions_url': 'https://api.github.com/users/xuhdev/subscriptions', 'organizations_url': 'https://api.github.com/users/xuhdev/orgs', 'repos_url': 'https://api.github.com/users/xuhdev/repos', 'events_url': 'https://api.github.com/users/xuhdev/events{/privacy}', 'received_events_url': 'https://api.github.com/users/xuhdev/received_events', 'type': 'User', 'site_admin': False}",referenced,232937ba88412a758e099a19f0dec5484e575633,https://api.github.com/repos/pytorch/pytorch/commits/232937ba88412a758e099a19f0dec5484e575633,2019-08-21T17:28:33Z,8,1,7
24542,2577665582,"{'login': 'xuhdev', 'id': 325476, 'node_id': 'MDQ6VXNlcjMyNTQ3Ng==', 'avatar_url': 'https://avatars1.githubusercontent.com/u/325476?v=4', 'gravatar_id': '', 'url': 'https://api.github.com/users/xuhdev', 'html_url': 'https://github.com/xuhdev', 'followers_url': 'https://api.github.com/users/xuhdev/followers', 'following_url': 'https://api.github.com/users/xuhdev/following{/other_user}', 'gists_url': 'https://api.github.com/users/xuhdev/gists{/gist_id}', 'starred_url': 'https://api.github.com/users/xuhdev/starred{/owner}{/repo}', 'subscriptions_url': 'https://api.github.com/users/xuhdev/subscriptions', 'organizations_url': 'https://api.github.com/users/xuhdev/orgs', 'repos_url': 'https://api.github.com/users/xuhdev/repos', 'events_url': 'https://api.github.com/users/xuhdev/events{/privacy}', 'received_events_url': 'https://api.github.com/users/xuhdev/received_events', 'type': 'User', 'site_admin': False}",referenced,4ce64594c759646bf81bd2d74f0c5674f082eebb,https://api.github.com/repos/pytorch/pytorch/commits/4ce64594c759646bf81bd2d74f0c5674f082eebb,2019-08-22T19:58:21Z,6885,4055,2830
24542,2577665586,"{'login': 'xuhdev', 'id': 325476, 'node_id': 'MDQ6VXNlcjMyNTQ3Ng==', 'avatar_url': 'https://avatars1.githubusercontent.com/u/325476?v=4', 'gravatar_id': '', 'url': 'https://api.github.com/users/xuhdev', 'html_url': 'https://github.com/xuhdev', 'followers_url': 'https://api.github.com/users/xuhdev/followers', 'following_url': 'https://api.github.com/users/xuhdev/following{/other_user}', 'gists_url': 'https://api.github.com/users/xuhdev/gists{/gist_id}', 'starred_url': 'https://api.github.com/users/xuhdev/starred{/owner}{/repo}', 'subscriptions_url': 'https://api.github.com/users/xuhdev/subscriptions', 'organizations_url': 'https://api.github.com/users/xuhdev/orgs', 'repos_url': 'https://api.github.com/users/xuhdev/repos', 'events_url': 'https://api.github.com/users/xuhdev/events{/privacy}', 'received_events_url': 'https://api.github.com/users/xuhdev/received_events', 'type': 'User', 'site_admin': False}",referenced,ba0ebf1e8e8c45ff7a6a36b0da027f1939e19f4d,https://api.github.com/repos/pytorch/pytorch/commits/ba0ebf1e8e8c45ff7a6a36b0da027f1939e19f4d,2019-08-22T19:58:21Z,6885,4055,2830
24542,2577975002,"{'login': 'xuhdev', 'id': 325476, 'node_id': 'MDQ6VXNlcjMyNTQ3Ng==', 'avatar_url': 'https://avatars1.githubusercontent.com/u/325476?v=4', 'gravatar_id': '', 'url': 'https://api.github.com/users/xuhdev', 'html_url': 'https://github.com/xuhdev', 'followers_url': 'https://api.github.com/users/xuhdev/followers', 'following_url': 'https://api.github.com/users/xuhdev/following{/other_user}', 'gists_url': 'https://api.github.com/users/xuhdev/gists{/gist_id}', 'starred_url': 'https://api.github.com/users/xuhdev/starred{/owner}{/repo}', 'subscriptions_url': 'https://api.github.com/users/xuhdev/subscriptions', 'organizations_url': 'https://api.github.com/users/xuhdev/orgs', 'repos_url': 'https://api.github.com/users/xuhdev/repos', 'events_url': 'https://api.github.com/users/xuhdev/events{/privacy}', 'received_events_url': 'https://api.github.com/users/xuhdev/received_events', 'type': 'User', 'site_admin': False}",referenced,d02ff261bb3eae13b725a8c6c4aa6acc6227c607,https://api.github.com/repos/pytorch/pytorch/commits/d02ff261bb3eae13b725a8c6c4aa6acc6227c607,2019-08-22T21:58:48Z,750,467,283
24542,2577975012,"{'login': 'xuhdev', 'id': 325476, 'node_id': 'MDQ6VXNlcjMyNTQ3Ng==', 'avatar_url': 'https://avatars1.githubusercontent.com/u/325476?v=4', 'gravatar_id': '', 'url': 'https://api.github.com/users/xuhdev', 'html_url': 'https://github.com/xuhdev', 'followers_url': 'https://api.github.com/users/xuhdev/followers', 'following_url': 'https://api.github.com/users/xuhdev/following{/other_user}', 'gists_url': 'https://api.github.com/users/xuhdev/gists{/gist_id}', 'starred_url': 'https://api.github.com/users/xuhdev/starred{/owner}{/repo}', 'subscriptions_url': 'https://api.github.com/users/xuhdev/subscriptions', 'organizations_url': 'https://api.github.com/users/xuhdev/orgs', 'repos_url': 'https://api.github.com/users/xuhdev/repos', 'events_url': 'https://api.github.com/users/xuhdev/events{/privacy}', 'received_events_url': 'https://api.github.com/users/xuhdev/received_events', 'type': 'User', 'site_admin': False}",referenced,d3f50f2029f8687e7ca99b0115f511e9ff84ae5f,https://api.github.com/repos/pytorch/pytorch/commits/d3f50f2029f8687e7ca99b0115f511e9ff84ae5f,2019-08-22T21:58:48Z,751,467,284
24537,2735288852,"{'login': 'xuhdev', 'id': 325476, 'node_id': 'MDQ6VXNlcjMyNTQ3Ng==', 'avatar_url': 'https://avatars1.githubusercontent.com/u/325476?v=4', 'gravatar_id': '', 'url': 'https://api.github.com/users/xuhdev', 'html_url': 'https://github.com/xuhdev', 'followers_url': 'https://api.github.com/users/xuhdev/followers', 'following_url': 'https://api.github.com/users/xuhdev/following{/other_user}', 'gists_url': 'https://api.github.com/users/xuhdev/gists{/gist_id}', 'starred_url': 'https://api.github.com/users/xuhdev/starred{/owner}{/repo}', 'subscriptions_url': 'https://api.github.com/users/xuhdev/subscriptions', 'organizations_url': 'https://api.github.com/users/xuhdev/orgs', 'repos_url': 'https://api.github.com/users/xuhdev/repos', 'events_url': 'https://api.github.com/users/xuhdev/events{/privacy}', 'received_events_url': 'https://api.github.com/users/xuhdev/received_events', 'type': 'User', 'site_admin': False}",referenced,9e8a8de40cd13522454f8e6dc84dfcc4c174a95f,https://api.github.com/repos/pytorch/pytorch/commits/9e8a8de40cd13522454f8e6dc84dfcc4c174a95f,2019-10-23T01:05:00Z,45,14,31
24537,2735289363,"{'login': 'xuhdev', 'id': 325476, 'node_id': 'MDQ6VXNlcjMyNTQ3Ng==', 'avatar_url': 'https://avatars1.githubusercontent.com/u/325476?v=4', 'gravatar_id': '', 'url': 'https://api.github.com/users/xuhdev', 'html_url': 'https://github.com/xuhdev', 'followers_url': 'https://api.github.com/users/xuhdev/followers', 'following_url': 'https://api.github.com/users/xuhdev/following{/other_user}', 'gists_url': 'https://api.github.com/users/xuhdev/gists{/gist_id}', 'starred_url': 'https://api.github.com/users/xuhdev/starred{/owner}{/repo}', 'subscriptions_url': 'https://api.github.com/users/xuhdev/subscriptions', 'organizations_url': 'https://api.github.com/users/xuhdev/orgs', 'repos_url': 'https://api.github.com/users/xuhdev/repos', 'events_url': 'https://api.github.com/users/xuhdev/events{/privacy}', 'received_events_url': 'https://api.github.com/users/xuhdev/received_events', 'type': 'User', 'site_admin': False}",referenced,d3d45da99892326f9f82ae1fef1ce4a263d4e293,https://api.github.com/repos/pytorch/pytorch/commits/d3d45da99892326f9f82ae1fef1ce4a263d4e293,2019-10-23T01:05:21Z,45,14,31
24537,2738089895,"{'login': 'xuhdev', 'id': 325476, 'node_id': 'MDQ6VXNlcjMyNTQ3Ng==', 'avatar_url': 'https://avatars1.githubusercontent.com/u/325476?v=4', 'gravatar_id': '', 'url': 'https://api.github.com/users/xuhdev', 'html_url': 'https://github.com/xuhdev', 'followers_url': 'https://api.github.com/users/xuhdev/followers', 'following_url': 'https://api.github.com/users/xuhdev/following{/other_user}', 'gists_url': 'https://api.github.com/users/xuhdev/gists{/gist_id}', 'starred_url': 'https://api.github.com/users/xuhdev/starred{/owner}{/repo}', 'subscriptions_url': 'https://api.github.com/users/xuhdev/subscriptions', 'organizations_url': 'https://api.github.com/users/xuhdev/orgs', 'repos_url': 'https://api.github.com/users/xuhdev/repos', 'events_url': 'https://api.github.com/users/xuhdev/events{/privacy}', 'received_events_url': 'https://api.github.com/users/xuhdev/received_events', 'type': 'User', 'site_admin': False}",referenced,4361aeb4bc451f395aef67d4799ab90de6a3e1cb,https://api.github.com/repos/pytorch/pytorch/commits/4361aeb4bc451f395aef67d4799ab90de6a3e1cb,2019-10-23T18:19:31Z,969,493,476
24537,2757069013,"{'login': 'facebook-github-bot', 'id': 6422482, 'node_id': 'MDQ6VXNlcjY0MjI0ODI=', 'avatar_url': 'https://avatars3.githubusercontent.com/u/6422482?v=4', 'gravatar_id': '', 'url': 'https://api.github.com/users/facebook-github-bot', 'html_url': 'https://github.com/facebook-github-bot', 'followers_url': 'https://api.github.com/users/facebook-github-bot/followers', 'following_url': 'https://api.github.com/users/facebook-github-bot/following{/other_user}', 'gists_url': 'https://api.github.com/users/facebook-github-bot/gists{/gist_id}', 'starred_url': 'https://api.github.com/users/facebook-github-bot/starred{/owner}{/repo}', 'subscriptions_url': 'https://api.github.com/users/facebook-github-bot/subscriptions', 'organizations_url': 'https://api.github.com/users/facebook-github-bot/orgs', 'repos_url': 'https://api.github.com/users/facebook-github-bot/repos', 'events_url': 'https://api.github.com/users/facebook-github-bot/events{/privacy}', 'received_events_url': 'https://api.github.com/users/facebook-github-bot/received_events', 'type': 'User', 'site_admin': False}",closed,a7166ae4489c6801f7cc3914feee28a3312d1859,https://api.github.com/repos/pytorch/pytorch/commits/a7166ae4489c6801f7cc3914feee28a3312d1859,2019-10-30T17:57:29Z,45,14,31
24532,2776839868,"{'login': 'xuhdev', 'id': 325476, 'node_id': 'MDQ6VXNlcjMyNTQ3Ng==', 'avatar_url': 'https://avatars1.githubusercontent.com/u/325476?v=4', 'gravatar_id': '', 'url': 'https://api.github.com/users/xuhdev', 'html_url': 'https://github.com/xuhdev', 'followers_url': 'https://api.github.com/users/xuhdev/followers', 'following_url': 'https://api.github.com/users/xuhdev/following{/other_user}', 'gists_url': 'https://api.github.com/users/xuhdev/gists{/gist_id}', 'starred_url': 'https://api.github.com/users/xuhdev/starred{/owner}{/repo}', 'subscriptions_url': 'https://api.github.com/users/xuhdev/subscriptions', 'organizations_url': 'https://api.github.com/users/xuhdev/orgs', 'repos_url': 'https://api.github.com/users/xuhdev/repos', 'events_url': 'https://api.github.com/users/xuhdev/events{/privacy}', 'received_events_url': 'https://api.github.com/users/xuhdev/received_events', 'type': 'User', 'site_admin': False}",referenced,cbae1b904e746314d6ef49dbd57abf56e3646fa0,https://api.github.com/repos/pytorch/pytorch/commits/cbae1b904e746314d6ef49dbd57abf56e3646fa0,2019-11-06T20:52:15Z,45,14,31
24532,2776840674,"{'login': 'xuhdev', 'id': 325476, 'node_id': 'MDQ6VXNlcjMyNTQ3Ng==', 'avatar_url': 'https://avatars1.githubusercontent.com/u/325476?v=4', 'gravatar_id': '', 'url': 'https://api.github.com/users/xuhdev', 'html_url': 'https://github.com/xuhdev', 'followers_url': 'https://api.github.com/users/xuhdev/followers', 'following_url': 'https://api.github.com/users/xuhdev/following{/other_user}', 'gists_url': 'https://api.github.com/users/xuhdev/gists{/gist_id}', 'starred_url': 'https://api.github.com/users/xuhdev/starred{/owner}{/repo}', 'subscriptions_url': 'https://api.github.com/users/xuhdev/subscriptions', 'organizations_url': 'https://api.github.com/users/xuhdev/orgs', 'repos_url': 'https://api.github.com/users/xuhdev/repos', 'events_url': 'https://api.github.com/users/xuhdev/events{/privacy}', 'received_events_url': 'https://api.github.com/users/xuhdev/received_events', 'type': 'User', 'site_admin': False}",referenced,fb2367f2c5759b533b7ae9d46d5a3ed26367ef5a,https://api.github.com/repos/pytorch/pytorch/commits/fb2367f2c5759b533b7ae9d46d5a3ed26367ef5a,2019-11-06T20:52:31Z,45,14,31
24532,2777031347,"{'login': 'xuhdev', 'id': 325476, 'node_id': 'MDQ6VXNlcjMyNTQ3Ng==', 'avatar_url': 'https://avatars1.githubusercontent.com/u/325476?v=4', 'gravatar_id': '', 'url': 'https://api.github.com/users/xuhdev', 'html_url': 'https://github.com/xuhdev', 'followers_url': 'https://api.github.com/users/xuhdev/followers', 'following_url': 'https://api.github.com/users/xuhdev/following{/other_user}', 'gists_url': 'https://api.github.com/users/xuhdev/gists{/gist_id}', 'starred_url': 'https://api.github.com/users/xuhdev/starred{/owner}{/repo}', 'subscriptions_url': 'https://api.github.com/users/xuhdev/subscriptions', 'organizations_url': 'https://api.github.com/users/xuhdev/orgs', 'repos_url': 'https://api.github.com/users/xuhdev/repos', 'events_url': 'https://api.github.com/users/xuhdev/events{/privacy}', 'received_events_url': 'https://api.github.com/users/xuhdev/received_events', 'type': 'User', 'site_admin': False}",referenced,57cb34ac511766abbfb01695b3917a1e10ff0a51,https://api.github.com/repos/pytorch/pytorch/commits/57cb34ac511766abbfb01695b3917a1e10ff0a51,2019-11-06T21:58:16Z,5177,2636,2541
24532,2777031389,"{'login': 'xuhdev', 'id': 325476, 'node_id': 'MDQ6VXNlcjMyNTQ3Ng==', 'avatar_url': 'https://avatars1.githubusercontent.com/u/325476?v=4', 'gravatar_id': '', 'url': 'https://api.github.com/users/xuhdev', 'html_url': 'https://github.com/xuhdev', 'followers_url': 'https://api.github.com/users/xuhdev/followers', 'following_url': 'https://api.github.com/users/xuhdev/following{/other_user}', 'gists_url': 'https://api.github.com/users/xuhdev/gists{/gist_id}', 'starred_url': 'https://api.github.com/users/xuhdev/starred{/owner}{/repo}', 'subscriptions_url': 'https://api.github.com/users/xuhdev/subscriptions', 'organizations_url': 'https://api.github.com/users/xuhdev/orgs', 'repos_url': 'https://api.github.com/users/xuhdev/repos', 'events_url': 'https://api.github.com/users/xuhdev/events{/privacy}', 'received_events_url': 'https://api.github.com/users/xuhdev/received_events', 'type': 'User', 'site_admin': False}",referenced,772e42ad66a551146814af8000e8b5a211257fd0,https://api.github.com/repos/pytorch/pytorch/commits/772e42ad66a551146814af8000e8b5a211257fd0,2019-11-06T21:58:16Z,45,14,31
24532,2781135725,"{'login': 'xuhdev', 'id': 325476, 'node_id': 'MDQ6VXNlcjMyNTQ3Ng==', 'avatar_url': 'https://avatars1.githubusercontent.com/u/325476?v=4', 'gravatar_id': '', 'url': 'https://api.github.com/users/xuhdev', 'html_url': 'https://github.com/xuhdev', 'followers_url': 'https://api.github.com/users/xuhdev/followers', 'following_url': 'https://api.github.com/users/xuhdev/following{/other_user}', 'gists_url': 'https://api.github.com/users/xuhdev/gists{/gist_id}', 'starred_url': 'https://api.github.com/users/xuhdev/starred{/owner}{/repo}', 'subscriptions_url': 'https://api.github.com/users/xuhdev/subscriptions', 'organizations_url': 'https://api.github.com/users/xuhdev/orgs', 'repos_url': 'https://api.github.com/users/xuhdev/repos', 'events_url': 'https://api.github.com/users/xuhdev/events{/privacy}', 'received_events_url': 'https://api.github.com/users/xuhdev/received_events', 'type': 'User', 'site_admin': False}",referenced,920ea217293fd5c524926f03f654800ac3abaad9,https://api.github.com/repos/pytorch/pytorch/commits/920ea217293fd5c524926f03f654800ac3abaad9,2019-11-07T22:54:59Z,5442,3576,1866
24532,2781135863,"{'login': 'xuhdev', 'id': 325476, 'node_id': 'MDQ6VXNlcjMyNTQ3Ng==', 'avatar_url': 'https://avatars1.githubusercontent.com/u/325476?v=4', 'gravatar_id': '', 'url': 'https://api.github.com/users/xuhdev', 'html_url': 'https://github.com/xuhdev', 'followers_url': 'https://api.github.com/users/xuhdev/followers', 'following_url': 'https://api.github.com/users/xuhdev/following{/other_user}', 'gists_url': 'https://api.github.com/users/xuhdev/gists{/gist_id}', 'starred_url': 'https://api.github.com/users/xuhdev/starred{/owner}{/repo}', 'subscriptions_url': 'https://api.github.com/users/xuhdev/subscriptions', 'organizations_url': 'https://api.github.com/users/xuhdev/orgs', 'repos_url': 'https://api.github.com/users/xuhdev/repos', 'events_url': 'https://api.github.com/users/xuhdev/events{/privacy}', 'received_events_url': 'https://api.github.com/users/xuhdev/received_events', 'type': 'User', 'site_admin': False}",referenced,4d18fd972d7164a3dcb29afa08fb22101ab467c4,https://api.github.com/repos/pytorch/pytorch/commits/4d18fd972d7164a3dcb29afa08fb22101ab467c4,2019-11-07T22:55:03Z,45,14,31
24532,2785487294,"{'login': 'facebook-github-bot', 'id': 6422482, 'node_id': 'MDQ6VXNlcjY0MjI0ODI=', 'avatar_url': 'https://avatars3.githubusercontent.com/u/6422482?v=4', 'gravatar_id': '', 'url': 'https://api.github.com/users/facebook-github-bot', 'html_url': 'https://github.com/facebook-github-bot', 'followers_url': 'https://api.github.com/users/facebook-github-bot/followers', 'following_url': 'https://api.github.com/users/facebook-github-bot/following{/other_user}', 'gists_url': 'https://api.github.com/users/facebook-github-bot/gists{/gist_id}', 'starred_url': 'https://api.github.com/users/facebook-github-bot/starred{/owner}{/repo}', 'subscriptions_url': 'https://api.github.com/users/facebook-github-bot/subscriptions', 'organizations_url': 'https://api.github.com/users/facebook-github-bot/orgs', 'repos_url': 'https://api.github.com/users/facebook-github-bot/repos', 'events_url': 'https://api.github.com/users/facebook-github-bot/events{/privacy}', 'received_events_url': 'https://api.github.com/users/facebook-github-bot/received_events', 'type': 'User', 'site_admin': False}",closed,6c020673c9428839a7aeac4d5276791e5cfa58e4,https://api.github.com/repos/pytorch/pytorch/commits/6c020673c9428839a7aeac4d5276791e5cfa58e4,2019-11-09T17:12:09Z,45,14,31
24531,2776984785,"{'login': 'facebook-github-bot', 'id': 6422482, 'node_id': 'MDQ6VXNlcjY0MjI0ODI=', 'avatar_url': 'https://avatars3.githubusercontent.com/u/6422482?v=4', 'gravatar_id': '', 'url': 'https://api.github.com/users/facebook-github-bot', 'html_url': 'https://github.com/facebook-github-bot', 'followers_url': 'https://api.github.com/users/facebook-github-bot/followers', 'following_url': 'https://api.github.com/users/facebook-github-bot/following{/other_user}', 'gists_url': 'https://api.github.com/users/facebook-github-bot/gists{/gist_id}', 'starred_url': 'https://api.github.com/users/facebook-github-bot/starred{/owner}{/repo}', 'subscriptions_url': 'https://api.github.com/users/facebook-github-bot/subscriptions', 'organizations_url': 'https://api.github.com/users/facebook-github-bot/orgs', 'repos_url': 'https://api.github.com/users/facebook-github-bot/repos', 'events_url': 'https://api.github.com/users/facebook-github-bot/events{/privacy}', 'received_events_url': 'https://api.github.com/users/facebook-github-bot/received_events', 'type': 'User', 'site_admin': False}",referenced,e51d937e91dff150a1507f80683a12ea76b05bf8,https://api.github.com/repos/pytorch/pytorch/commits/e51d937e91dff150a1507f80683a12ea76b05bf8,2019-11-06T21:41:48Z,103,34,69
24517,2793460931,"{'login': 'facebook-github-bot', 'id': 6422482, 'node_id': 'MDQ6VXNlcjY0MjI0ODI=', 'avatar_url': 'https://avatars3.githubusercontent.com/u/6422482?v=4', 'gravatar_id': '', 'url': 'https://api.github.com/users/facebook-github-bot', 'html_url': 'https://github.com/facebook-github-bot', 'followers_url': 'https://api.github.com/users/facebook-github-bot/followers', 'following_url': 'https://api.github.com/users/facebook-github-bot/following{/other_user}', 'gists_url': 'https://api.github.com/users/facebook-github-bot/gists{/gist_id}', 'starred_url': 'https://api.github.com/users/facebook-github-bot/starred{/owner}{/repo}', 'subscriptions_url': 'https://api.github.com/users/facebook-github-bot/subscriptions', 'organizations_url': 'https://api.github.com/users/facebook-github-bot/orgs', 'repos_url': 'https://api.github.com/users/facebook-github-bot/repos', 'events_url': 'https://api.github.com/users/facebook-github-bot/events{/privacy}', 'received_events_url': 'https://api.github.com/users/facebook-github-bot/received_events', 'type': 'User', 'site_admin': False}",closed,bd0394d47321c310bd6ff70d138e3ea648b79427,https://api.github.com/repos/pytorch/pytorch/commits/bd0394d47321c310bd6ff70d138e3ea648b79427,2019-11-13T00:14:16Z,355,186,169
24516,2939515852,"{'login': 'facebook-github-bot', 'id': 6422482, 'node_id': 'MDQ6VXNlcjY0MjI0ODI=', 'avatar_url': 'https://avatars3.githubusercontent.com/u/6422482?v=4', 'gravatar_id': '', 'url': 'https://api.github.com/users/facebook-github-bot', 'html_url': 'https://github.com/facebook-github-bot', 'followers_url': 'https://api.github.com/users/facebook-github-bot/followers', 'following_url': 'https://api.github.com/users/facebook-github-bot/following{/other_user}', 'gists_url': 'https://api.github.com/users/facebook-github-bot/gists{/gist_id}', 'starred_url': 'https://api.github.com/users/facebook-github-bot/starred{/owner}{/repo}', 'subscriptions_url': 'https://api.github.com/users/facebook-github-bot/subscriptions', 'organizations_url': 'https://api.github.com/users/facebook-github-bot/orgs', 'repos_url': 'https://api.github.com/users/facebook-github-bot/repos', 'events_url': 'https://api.github.com/users/facebook-github-bot/events{/privacy}', 'received_events_url': 'https://api.github.com/users/facebook-github-bot/received_events', 'type': 'User', 'site_admin': False}",referenced,8098ae455c82075acf78430b5d58c5067968b768,https://api.github.com/repos/pytorch/pytorch/commits/8098ae455c82075acf78430b5d58c5067968b768,2020-01-10T18:52:32Z,349,103,246
24515,2933043201,"{'login': 'facebook-github-bot', 'id': 6422482, 'node_id': 'MDQ6VXNlcjY0MjI0ODI=', 'avatar_url': 'https://avatars3.githubusercontent.com/u/6422482?v=4', 'gravatar_id': '', 'url': 'https://api.github.com/users/facebook-github-bot', 'html_url': 'https://github.com/facebook-github-bot', 'followers_url': 'https://api.github.com/users/facebook-github-bot/followers', 'following_url': 'https://api.github.com/users/facebook-github-bot/following{/other_user}', 'gists_url': 'https://api.github.com/users/facebook-github-bot/gists{/gist_id}', 'starred_url': 'https://api.github.com/users/facebook-github-bot/starred{/owner}{/repo}', 'subscriptions_url': 'https://api.github.com/users/facebook-github-bot/subscriptions', 'organizations_url': 'https://api.github.com/users/facebook-github-bot/orgs', 'repos_url': 'https://api.github.com/users/facebook-github-bot/repos', 'events_url': 'https://api.github.com/users/facebook-github-bot/events{/privacy}', 'received_events_url': 'https://api.github.com/users/facebook-github-bot/received_events', 'type': 'User', 'site_admin': False}",referenced,9ba6a768de929670c18a78f409c360543b240f09,https://api.github.com/repos/pytorch/pytorch/commits/9ba6a768de929670c18a78f409c360543b240f09,2020-01-08T23:08:39Z,399,191,208
24514,2935854542,"{'login': 'facebook-github-bot', 'id': 6422482, 'node_id': 'MDQ6VXNlcjY0MjI0ODI=', 'avatar_url': 'https://avatars3.githubusercontent.com/u/6422482?v=4', 'gravatar_id': '', 'url': 'https://api.github.com/users/facebook-github-bot', 'html_url': 'https://github.com/facebook-github-bot', 'followers_url': 'https://api.github.com/users/facebook-github-bot/followers', 'following_url': 'https://api.github.com/users/facebook-github-bot/following{/other_user}', 'gists_url': 'https://api.github.com/users/facebook-github-bot/gists{/gist_id}', 'starred_url': 'https://api.github.com/users/facebook-github-bot/starred{/owner}{/repo}', 'subscriptions_url': 'https://api.github.com/users/facebook-github-bot/subscriptions', 'organizations_url': 'https://api.github.com/users/facebook-github-bot/orgs', 'repos_url': 'https://api.github.com/users/facebook-github-bot/repos', 'events_url': 'https://api.github.com/users/facebook-github-bot/events{/privacy}', 'received_events_url': 'https://api.github.com/users/facebook-github-bot/received_events', 'type': 'User', 'site_admin': False}",referenced,5a76335aaac3435f763226da4b11406a9dce8c87,https://api.github.com/repos/pytorch/pytorch/commits/5a76335aaac3435f763226da4b11406a9dce8c87,2020-01-09T17:41:48Z,349,103,246
24513,2793460919,"{'login': 'facebook-github-bot', 'id': 6422482, 'node_id': 'MDQ6VXNlcjY0MjI0ODI=', 'avatar_url': 'https://avatars3.githubusercontent.com/u/6422482?v=4', 'gravatar_id': '', 'url': 'https://api.github.com/users/facebook-github-bot', 'html_url': 'https://github.com/facebook-github-bot', 'followers_url': 'https://api.github.com/users/facebook-github-bot/followers', 'following_url': 'https://api.github.com/users/facebook-github-bot/following{/other_user}', 'gists_url': 'https://api.github.com/users/facebook-github-bot/gists{/gist_id}', 'starred_url': 'https://api.github.com/users/facebook-github-bot/starred{/owner}{/repo}', 'subscriptions_url': 'https://api.github.com/users/facebook-github-bot/subscriptions', 'organizations_url': 'https://api.github.com/users/facebook-github-bot/orgs', 'repos_url': 'https://api.github.com/users/facebook-github-bot/repos', 'events_url': 'https://api.github.com/users/facebook-github-bot/events{/privacy}', 'received_events_url': 'https://api.github.com/users/facebook-github-bot/received_events', 'type': 'User', 'site_admin': False}",closed,bd0394d47321c310bd6ff70d138e3ea648b79427,https://api.github.com/repos/pytorch/pytorch/commits/bd0394d47321c310bd6ff70d138e3ea648b79427,2019-11-13T00:14:15Z,355,186,169
24512,2939515879,"{'login': 'facebook-github-bot', 'id': 6422482, 'node_id': 'MDQ6VXNlcjY0MjI0ODI=', 'avatar_url': 'https://avatars3.githubusercontent.com/u/6422482?v=4', 'gravatar_id': '', 'url': 'https://api.github.com/users/facebook-github-bot', 'html_url': 'https://github.com/facebook-github-bot', 'followers_url': 'https://api.github.com/users/facebook-github-bot/followers', 'following_url': 'https://api.github.com/users/facebook-github-bot/following{/other_user}', 'gists_url': 'https://api.github.com/users/facebook-github-bot/gists{/gist_id}', 'starred_url': 'https://api.github.com/users/facebook-github-bot/starred{/owner}{/repo}', 'subscriptions_url': 'https://api.github.com/users/facebook-github-bot/subscriptions', 'organizations_url': 'https://api.github.com/users/facebook-github-bot/orgs', 'repos_url': 'https://api.github.com/users/facebook-github-bot/repos', 'events_url': 'https://api.github.com/users/facebook-github-bot/events{/privacy}', 'received_events_url': 'https://api.github.com/users/facebook-github-bot/received_events', 'type': 'User', 'site_admin': False}",closed,8098ae455c82075acf78430b5d58c5067968b768,https://api.github.com/repos/pytorch/pytorch/commits/8098ae455c82075acf78430b5d58c5067968b768,2020-01-10T18:52:32Z,349,103,246
24511,2933043197,"{'login': 'facebook-github-bot', 'id': 6422482, 'node_id': 'MDQ6VXNlcjY0MjI0ODI=', 'avatar_url': 'https://avatars3.githubusercontent.com/u/6422482?v=4', 'gravatar_id': '', 'url': 'https://api.github.com/users/facebook-github-bot', 'html_url': 'https://github.com/facebook-github-bot', 'followers_url': 'https://api.github.com/users/facebook-github-bot/followers', 'following_url': 'https://api.github.com/users/facebook-github-bot/following{/other_user}', 'gists_url': 'https://api.github.com/users/facebook-github-bot/gists{/gist_id}', 'starred_url': 'https://api.github.com/users/facebook-github-bot/starred{/owner}{/repo}', 'subscriptions_url': 'https://api.github.com/users/facebook-github-bot/subscriptions', 'organizations_url': 'https://api.github.com/users/facebook-github-bot/orgs', 'repos_url': 'https://api.github.com/users/facebook-github-bot/repos', 'events_url': 'https://api.github.com/users/facebook-github-bot/events{/privacy}', 'received_events_url': 'https://api.github.com/users/facebook-github-bot/received_events', 'type': 'User', 'site_admin': False}",closed,9ba6a768de929670c18a78f409c360543b240f09,https://api.github.com/repos/pytorch/pytorch/commits/9ba6a768de929670c18a78f409c360543b240f09,2020-01-08T23:08:39Z,399,191,208
24509,2920907416,"{'login': 'facebook-github-bot', 'id': 6422482, 'node_id': 'MDQ6VXNlcjY0MjI0ODI=', 'avatar_url': 'https://avatars3.githubusercontent.com/u/6422482?v=4', 'gravatar_id': '', 'url': 'https://api.github.com/users/facebook-github-bot', 'html_url': 'https://github.com/facebook-github-bot', 'followers_url': 'https://api.github.com/users/facebook-github-bot/followers', 'following_url': 'https://api.github.com/users/facebook-github-bot/following{/other_user}', 'gists_url': 'https://api.github.com/users/facebook-github-bot/gists{/gist_id}', 'starred_url': 'https://api.github.com/users/facebook-github-bot/starred{/owner}{/repo}', 'subscriptions_url': 'https://api.github.com/users/facebook-github-bot/subscriptions', 'organizations_url': 'https://api.github.com/users/facebook-github-bot/orgs', 'repos_url': 'https://api.github.com/users/facebook-github-bot/repos', 'events_url': 'https://api.github.com/users/facebook-github-bot/events{/privacy}', 'received_events_url': 'https://api.github.com/users/facebook-github-bot/received_events', 'type': 'User', 'site_admin': False}",referenced,b47e9b97a236d96da89c606fd053d33484f2227c,https://api.github.com/repos/pytorch/pytorch/commits/b47e9b97a236d96da89c606fd053d33484f2227c,2020-01-03T18:32:50Z,404,182,222
24508,2920907411,"{'login': 'facebook-github-bot', 'id': 6422482, 'node_id': 'MDQ6VXNlcjY0MjI0ODI=', 'avatar_url': 'https://avatars3.githubusercontent.com/u/6422482?v=4', 'gravatar_id': '', 'url': 'https://api.github.com/users/facebook-github-bot', 'html_url': 'https://github.com/facebook-github-bot', 'followers_url': 'https://api.github.com/users/facebook-github-bot/followers', 'following_url': 'https://api.github.com/users/facebook-github-bot/following{/other_user}', 'gists_url': 'https://api.github.com/users/facebook-github-bot/gists{/gist_id}', 'starred_url': 'https://api.github.com/users/facebook-github-bot/starred{/owner}{/repo}', 'subscriptions_url': 'https://api.github.com/users/facebook-github-bot/subscriptions', 'organizations_url': 'https://api.github.com/users/facebook-github-bot/orgs', 'repos_url': 'https://api.github.com/users/facebook-github-bot/repos', 'events_url': 'https://api.github.com/users/facebook-github-bot/events{/privacy}', 'received_events_url': 'https://api.github.com/users/facebook-github-bot/received_events', 'type': 'User', 'site_admin': False}",closed,b47e9b97a236d96da89c606fd053d33484f2227c,https://api.github.com/repos/pytorch/pytorch/commits/b47e9b97a236d96da89c606fd053d33484f2227c,2020-01-03T18:32:50Z,404,182,222
24497,2598640030,"{'login': 'facebook-github-bot', 'id': 6422482, 'node_id': 'MDQ6VXNlcjY0MjI0ODI=', 'avatar_url': 'https://avatars3.githubusercontent.com/u/6422482?v=4', 'gravatar_id': '', 'url': 'https://api.github.com/users/facebook-github-bot', 'html_url': 'https://github.com/facebook-github-bot', 'followers_url': 'https://api.github.com/users/facebook-github-bot/followers', 'following_url': 'https://api.github.com/users/facebook-github-bot/following{/other_user}', 'gists_url': 'https://api.github.com/users/facebook-github-bot/gists{/gist_id}', 'starred_url': 'https://api.github.com/users/facebook-github-bot/starred{/owner}{/repo}', 'subscriptions_url': 'https://api.github.com/users/facebook-github-bot/subscriptions', 'organizations_url': 'https://api.github.com/users/facebook-github-bot/orgs', 'repos_url': 'https://api.github.com/users/facebook-github-bot/repos', 'events_url': 'https://api.github.com/users/facebook-github-bot/events{/privacy}', 'received_events_url': 'https://api.github.com/users/facebook-github-bot/received_events', 'type': 'User', 'site_admin': False}",referenced,60c4e74e49770ca7204b812006926ac0778d30df,https://api.github.com/repos/pytorch/pytorch/commits/60c4e74e49770ca7204b812006926ac0778d30df,2019-08-31T04:00:13Z,45,21,24
24486,2696997199,"{'login': 'facebook-github-bot', 'id': 6422482, 'node_id': 'MDQ6VXNlcjY0MjI0ODI=', 'avatar_url': 'https://avatars3.githubusercontent.com/u/6422482?v=4', 'gravatar_id': '', 'url': 'https://api.github.com/users/facebook-github-bot', 'html_url': 'https://github.com/facebook-github-bot', 'followers_url': 'https://api.github.com/users/facebook-github-bot/followers', 'following_url': 'https://api.github.com/users/facebook-github-bot/following{/other_user}', 'gists_url': 'https://api.github.com/users/facebook-github-bot/gists{/gist_id}', 'starred_url': 'https://api.github.com/users/facebook-github-bot/starred{/owner}{/repo}', 'subscriptions_url': 'https://api.github.com/users/facebook-github-bot/subscriptions', 'organizations_url': 'https://api.github.com/users/facebook-github-bot/orgs', 'repos_url': 'https://api.github.com/users/facebook-github-bot/repos', 'events_url': 'https://api.github.com/users/facebook-github-bot/events{/privacy}', 'received_events_url': 'https://api.github.com/users/facebook-github-bot/received_events', 'type': 'User', 'site_admin': False}",referenced,ff03f9bc94541f469307ba8ad77459c2ca56ffa0,https://api.github.com/repos/pytorch/pytorch/commits/ff03f9bc94541f469307ba8ad77459c2ca56ffa0,2019-10-08T21:51:17Z,64,41,23
24485,2696997200,"{'login': 'facebook-github-bot', 'id': 6422482, 'node_id': 'MDQ6VXNlcjY0MjI0ODI=', 'avatar_url': 'https://avatars3.githubusercontent.com/u/6422482?v=4', 'gravatar_id': '', 'url': 'https://api.github.com/users/facebook-github-bot', 'html_url': 'https://github.com/facebook-github-bot', 'followers_url': 'https://api.github.com/users/facebook-github-bot/followers', 'following_url': 'https://api.github.com/users/facebook-github-bot/following{/other_user}', 'gists_url': 'https://api.github.com/users/facebook-github-bot/gists{/gist_id}', 'starred_url': 'https://api.github.com/users/facebook-github-bot/starred{/owner}{/repo}', 'subscriptions_url': 'https://api.github.com/users/facebook-github-bot/subscriptions', 'organizations_url': 'https://api.github.com/users/facebook-github-bot/orgs', 'repos_url': 'https://api.github.com/users/facebook-github-bot/repos', 'events_url': 'https://api.github.com/users/facebook-github-bot/events{/privacy}', 'received_events_url': 'https://api.github.com/users/facebook-github-bot/received_events', 'type': 'User', 'site_admin': False}",referenced,ff03f9bc94541f469307ba8ad77459c2ca56ffa0,https://api.github.com/repos/pytorch/pytorch/commits/ff03f9bc94541f469307ba8ad77459c2ca56ffa0,2019-10-08T21:51:17Z,64,41,23
24484,2696997202,"{'login': 'facebook-github-bot', 'id': 6422482, 'node_id': 'MDQ6VXNlcjY0MjI0ODI=', 'avatar_url': 'https://avatars3.githubusercontent.com/u/6422482?v=4', 'gravatar_id': '', 'url': 'https://api.github.com/users/facebook-github-bot', 'html_url': 'https://github.com/facebook-github-bot', 'followers_url': 'https://api.github.com/users/facebook-github-bot/followers', 'following_url': 'https://api.github.com/users/facebook-github-bot/following{/other_user}', 'gists_url': 'https://api.github.com/users/facebook-github-bot/gists{/gist_id}', 'starred_url': 'https://api.github.com/users/facebook-github-bot/starred{/owner}{/repo}', 'subscriptions_url': 'https://api.github.com/users/facebook-github-bot/subscriptions', 'organizations_url': 'https://api.github.com/users/facebook-github-bot/orgs', 'repos_url': 'https://api.github.com/users/facebook-github-bot/repos', 'events_url': 'https://api.github.com/users/facebook-github-bot/events{/privacy}', 'received_events_url': 'https://api.github.com/users/facebook-github-bot/received_events', 'type': 'User', 'site_admin': False}",referenced,ff03f9bc94541f469307ba8ad77459c2ca56ffa0,https://api.github.com/repos/pytorch/pytorch/commits/ff03f9bc94541f469307ba8ad77459c2ca56ffa0,2019-10-08T21:51:17Z,64,41,23
24483,2696997203,"{'login': 'facebook-github-bot', 'id': 6422482, 'node_id': 'MDQ6VXNlcjY0MjI0ODI=', 'avatar_url': 'https://avatars3.githubusercontent.com/u/6422482?v=4', 'gravatar_id': '', 'url': 'https://api.github.com/users/facebook-github-bot', 'html_url': 'https://github.com/facebook-github-bot', 'followers_url': 'https://api.github.com/users/facebook-github-bot/followers', 'following_url': 'https://api.github.com/users/facebook-github-bot/following{/other_user}', 'gists_url': 'https://api.github.com/users/facebook-github-bot/gists{/gist_id}', 'starred_url': 'https://api.github.com/users/facebook-github-bot/starred{/owner}{/repo}', 'subscriptions_url': 'https://api.github.com/users/facebook-github-bot/subscriptions', 'organizations_url': 'https://api.github.com/users/facebook-github-bot/orgs', 'repos_url': 'https://api.github.com/users/facebook-github-bot/repos', 'events_url': 'https://api.github.com/users/facebook-github-bot/events{/privacy}', 'received_events_url': 'https://api.github.com/users/facebook-github-bot/received_events', 'type': 'User', 'site_admin': False}",referenced,ff03f9bc94541f469307ba8ad77459c2ca56ffa0,https://api.github.com/repos/pytorch/pytorch/commits/ff03f9bc94541f469307ba8ad77459c2ca56ffa0,2019-10-08T21:51:17Z,64,41,23
24482,2696997204,"{'login': 'facebook-github-bot', 'id': 6422482, 'node_id': 'MDQ6VXNlcjY0MjI0ODI=', 'avatar_url': 'https://avatars3.githubusercontent.com/u/6422482?v=4', 'gravatar_id': '', 'url': 'https://api.github.com/users/facebook-github-bot', 'html_url': 'https://github.com/facebook-github-bot', 'followers_url': 'https://api.github.com/users/facebook-github-bot/followers', 'following_url': 'https://api.github.com/users/facebook-github-bot/following{/other_user}', 'gists_url': 'https://api.github.com/users/facebook-github-bot/gists{/gist_id}', 'starred_url': 'https://api.github.com/users/facebook-github-bot/starred{/owner}{/repo}', 'subscriptions_url': 'https://api.github.com/users/facebook-github-bot/subscriptions', 'organizations_url': 'https://api.github.com/users/facebook-github-bot/orgs', 'repos_url': 'https://api.github.com/users/facebook-github-bot/repos', 'events_url': 'https://api.github.com/users/facebook-github-bot/events{/privacy}', 'received_events_url': 'https://api.github.com/users/facebook-github-bot/received_events', 'type': 'User', 'site_admin': False}",referenced,ff03f9bc94541f469307ba8ad77459c2ca56ffa0,https://api.github.com/repos/pytorch/pytorch/commits/ff03f9bc94541f469307ba8ad77459c2ca56ffa0,2019-10-08T21:51:17Z,64,41,23
24481,2696997205,"{'login': 'facebook-github-bot', 'id': 6422482, 'node_id': 'MDQ6VXNlcjY0MjI0ODI=', 'avatar_url': 'https://avatars3.githubusercontent.com/u/6422482?v=4', 'gravatar_id': '', 'url': 'https://api.github.com/users/facebook-github-bot', 'html_url': 'https://github.com/facebook-github-bot', 'followers_url': 'https://api.github.com/users/facebook-github-bot/followers', 'following_url': 'https://api.github.com/users/facebook-github-bot/following{/other_user}', 'gists_url': 'https://api.github.com/users/facebook-github-bot/gists{/gist_id}', 'starred_url': 'https://api.github.com/users/facebook-github-bot/starred{/owner}{/repo}', 'subscriptions_url': 'https://api.github.com/users/facebook-github-bot/subscriptions', 'organizations_url': 'https://api.github.com/users/facebook-github-bot/orgs', 'repos_url': 'https://api.github.com/users/facebook-github-bot/repos', 'events_url': 'https://api.github.com/users/facebook-github-bot/events{/privacy}', 'received_events_url': 'https://api.github.com/users/facebook-github-bot/received_events', 'type': 'User', 'site_admin': False}",referenced,ff03f9bc94541f469307ba8ad77459c2ca56ffa0,https://api.github.com/repos/pytorch/pytorch/commits/ff03f9bc94541f469307ba8ad77459c2ca56ffa0,2019-10-08T21:51:17Z,64,41,23
24480,2696997206,"{'login': 'facebook-github-bot', 'id': 6422482, 'node_id': 'MDQ6VXNlcjY0MjI0ODI=', 'avatar_url': 'https://avatars3.githubusercontent.com/u/6422482?v=4', 'gravatar_id': '', 'url': 'https://api.github.com/users/facebook-github-bot', 'html_url': 'https://github.com/facebook-github-bot', 'followers_url': 'https://api.github.com/users/facebook-github-bot/followers', 'following_url': 'https://api.github.com/users/facebook-github-bot/following{/other_user}', 'gists_url': 'https://api.github.com/users/facebook-github-bot/gists{/gist_id}', 'starred_url': 'https://api.github.com/users/facebook-github-bot/starred{/owner}{/repo}', 'subscriptions_url': 'https://api.github.com/users/facebook-github-bot/subscriptions', 'organizations_url': 'https://api.github.com/users/facebook-github-bot/orgs', 'repos_url': 'https://api.github.com/users/facebook-github-bot/repos', 'events_url': 'https://api.github.com/users/facebook-github-bot/events{/privacy}', 'received_events_url': 'https://api.github.com/users/facebook-github-bot/received_events', 'type': 'User', 'site_admin': False}",referenced,ff03f9bc94541f469307ba8ad77459c2ca56ffa0,https://api.github.com/repos/pytorch/pytorch/commits/ff03f9bc94541f469307ba8ad77459c2ca56ffa0,2019-10-08T21:51:17Z,64,41,23
24479,2696997211,"{'login': 'facebook-github-bot', 'id': 6422482, 'node_id': 'MDQ6VXNlcjY0MjI0ODI=', 'avatar_url': 'https://avatars3.githubusercontent.com/u/6422482?v=4', 'gravatar_id': '', 'url': 'https://api.github.com/users/facebook-github-bot', 'html_url': 'https://github.com/facebook-github-bot', 'followers_url': 'https://api.github.com/users/facebook-github-bot/followers', 'following_url': 'https://api.github.com/users/facebook-github-bot/following{/other_user}', 'gists_url': 'https://api.github.com/users/facebook-github-bot/gists{/gist_id}', 'starred_url': 'https://api.github.com/users/facebook-github-bot/starred{/owner}{/repo}', 'subscriptions_url': 'https://api.github.com/users/facebook-github-bot/subscriptions', 'organizations_url': 'https://api.github.com/users/facebook-github-bot/orgs', 'repos_url': 'https://api.github.com/users/facebook-github-bot/repos', 'events_url': 'https://api.github.com/users/facebook-github-bot/events{/privacy}', 'received_events_url': 'https://api.github.com/users/facebook-github-bot/received_events', 'type': 'User', 'site_admin': False}",referenced,ff03f9bc94541f469307ba8ad77459c2ca56ffa0,https://api.github.com/repos/pytorch/pytorch/commits/ff03f9bc94541f469307ba8ad77459c2ca56ffa0,2019-10-08T21:51:17Z,64,41,23
24472,2590961592,"{'login': 'facebook-github-bot', 'id': 6422482, 'node_id': 'MDQ6VXNlcjY0MjI0ODI=', 'avatar_url': 'https://avatars3.githubusercontent.com/u/6422482?v=4', 'gravatar_id': '', 'url': 'https://api.github.com/users/facebook-github-bot', 'html_url': 'https://github.com/facebook-github-bot', 'followers_url': 'https://api.github.com/users/facebook-github-bot/followers', 'following_url': 'https://api.github.com/users/facebook-github-bot/following{/other_user}', 'gists_url': 'https://api.github.com/users/facebook-github-bot/gists{/gist_id}', 'starred_url': 'https://api.github.com/users/facebook-github-bot/starred{/owner}{/repo}', 'subscriptions_url': 'https://api.github.com/users/facebook-github-bot/subscriptions', 'organizations_url': 'https://api.github.com/users/facebook-github-bot/orgs', 'repos_url': 'https://api.github.com/users/facebook-github-bot/repos', 'events_url': 'https://api.github.com/users/facebook-github-bot/events{/privacy}', 'received_events_url': 'https://api.github.com/users/facebook-github-bot/received_events', 'type': 'User', 'site_admin': False}",referenced,e123e24e7e721f4e7197a05604ee8855f0938bd1,https://api.github.com/repos/pytorch/pytorch/commits/e123e24e7e721f4e7197a05604ee8855f0938bd1,2019-08-28T15:24:55Z,81,81,0
24429,2571748547,"{'login': 'facebook-github-bot', 'id': 6422482, 'node_id': 'MDQ6VXNlcjY0MjI0ODI=', 'avatar_url': 'https://avatars3.githubusercontent.com/u/6422482?v=4', 'gravatar_id': '', 'url': 'https://api.github.com/users/facebook-github-bot', 'html_url': 'https://github.com/facebook-github-bot', 'followers_url': 'https://api.github.com/users/facebook-github-bot/followers', 'following_url': 'https://api.github.com/users/facebook-github-bot/following{/other_user}', 'gists_url': 'https://api.github.com/users/facebook-github-bot/gists{/gist_id}', 'starred_url': 'https://api.github.com/users/facebook-github-bot/starred{/owner}{/repo}', 'subscriptions_url': 'https://api.github.com/users/facebook-github-bot/subscriptions', 'organizations_url': 'https://api.github.com/users/facebook-github-bot/orgs', 'repos_url': 'https://api.github.com/users/facebook-github-bot/repos', 'events_url': 'https://api.github.com/users/facebook-github-bot/events{/privacy}', 'received_events_url': 'https://api.github.com/users/facebook-github-bot/received_events', 'type': 'User', 'site_admin': False}",referenced,1d53d0756668ce641e4f109200d9c65b003d05fa,https://api.github.com/repos/pytorch/pytorch/commits/1d53d0756668ce641e4f109200d9c65b003d05fa,2019-08-21T04:40:55Z,307,232,75
24403,2605356002,"{'login': 'facebook-github-bot', 'id': 6422482, 'node_id': 'MDQ6VXNlcjY0MjI0ODI=', 'avatar_url': 'https://avatars3.githubusercontent.com/u/6422482?v=4', 'gravatar_id': '', 'url': 'https://api.github.com/users/facebook-github-bot', 'html_url': 'https://github.com/facebook-github-bot', 'followers_url': 'https://api.github.com/users/facebook-github-bot/followers', 'following_url': 'https://api.github.com/users/facebook-github-bot/following{/other_user}', 'gists_url': 'https://api.github.com/users/facebook-github-bot/gists{/gist_id}', 'starred_url': 'https://api.github.com/users/facebook-github-bot/starred{/owner}{/repo}', 'subscriptions_url': 'https://api.github.com/users/facebook-github-bot/subscriptions', 'organizations_url': 'https://api.github.com/users/facebook-github-bot/orgs', 'repos_url': 'https://api.github.com/users/facebook-github-bot/repos', 'events_url': 'https://api.github.com/users/facebook-github-bot/events{/privacy}', 'received_events_url': 'https://api.github.com/users/facebook-github-bot/received_events', 'type': 'User', 'site_admin': False}",closed,d1e079e2e09fe811a1026d6b1372921a951a4247,https://api.github.com/repos/pytorch/pytorch/commits/d1e079e2e09fe811a1026d6b1372921a951a4247,2019-09-04T00:35:48Z,56,53,3
24394,2560273205,"{'login': 'z-a-f', 'id': 4216323, 'node_id': 'MDQ6VXNlcjQyMTYzMjM=', 'avatar_url': 'https://avatars2.githubusercontent.com/u/4216323?v=4', 'gravatar_id': '', 'url': 'https://api.github.com/users/z-a-f', 'html_url': 'https://github.com/z-a-f', 'followers_url': 'https://api.github.com/users/z-a-f/followers', 'following_url': 'https://api.github.com/users/z-a-f/following{/other_user}', 'gists_url': 'https://api.github.com/users/z-a-f/gists{/gist_id}', 'starred_url': 'https://api.github.com/users/z-a-f/starred{/owner}{/repo}', 'subscriptions_url': 'https://api.github.com/users/z-a-f/subscriptions', 'organizations_url': 'https://api.github.com/users/z-a-f/orgs', 'repos_url': 'https://api.github.com/users/z-a-f/repos', 'events_url': 'https://api.github.com/users/z-a-f/events{/privacy}', 'received_events_url': 'https://api.github.com/users/z-a-f/received_events', 'type': 'User', 'site_admin': False}",referenced,f06e84bf0f9c5c62c98d4b6a50474f4d121d9f7d,https://api.github.com/repos/pytorch/pytorch/commits/f06e84bf0f9c5c62c98d4b6a50474f4d121d9f7d,2019-08-15T18:12:37Z,10,5,5
24394,2560273508,"{'login': 'z-a-f', 'id': 4216323, 'node_id': 'MDQ6VXNlcjQyMTYzMjM=', 'avatar_url': 'https://avatars2.githubusercontent.com/u/4216323?v=4', 'gravatar_id': '', 'url': 'https://api.github.com/users/z-a-f', 'html_url': 'https://github.com/z-a-f', 'followers_url': 'https://api.github.com/users/z-a-f/followers', 'following_url': 'https://api.github.com/users/z-a-f/following{/other_user}', 'gists_url': 'https://api.github.com/users/z-a-f/gists{/gist_id}', 'starred_url': 'https://api.github.com/users/z-a-f/starred{/owner}{/repo}', 'subscriptions_url': 'https://api.github.com/users/z-a-f/subscriptions', 'organizations_url': 'https://api.github.com/users/z-a-f/orgs', 'repos_url': 'https://api.github.com/users/z-a-f/repos', 'events_url': 'https://api.github.com/users/z-a-f/events{/privacy}', 'received_events_url': 'https://api.github.com/users/z-a-f/received_events', 'type': 'User', 'site_admin': False}",referenced,ce98442dda5ded5b702a50b0bbe990bf54299016,https://api.github.com/repos/pytorch/pytorch/commits/ce98442dda5ded5b702a50b0bbe990bf54299016,2019-08-15T18:12:46Z,10,5,5
24394,2561021802,"{'login': 'facebook-github-bot', 'id': 6422482, 'node_id': 'MDQ6VXNlcjY0MjI0ODI=', 'avatar_url': 'https://avatars3.githubusercontent.com/u/6422482?v=4', 'gravatar_id': '', 'url': 'https://api.github.com/users/facebook-github-bot', 'html_url': 'https://github.com/facebook-github-bot', 'followers_url': 'https://api.github.com/users/facebook-github-bot/followers', 'following_url': 'https://api.github.com/users/facebook-github-bot/following{/other_user}', 'gists_url': 'https://api.github.com/users/facebook-github-bot/gists{/gist_id}', 'starred_url': 'https://api.github.com/users/facebook-github-bot/starred{/owner}{/repo}', 'subscriptions_url': 'https://api.github.com/users/facebook-github-bot/subscriptions', 'organizations_url': 'https://api.github.com/users/facebook-github-bot/orgs', 'repos_url': 'https://api.github.com/users/facebook-github-bot/repos', 'events_url': 'https://api.github.com/users/facebook-github-bot/events{/privacy}', 'received_events_url': 'https://api.github.com/users/facebook-github-bot/received_events', 'type': 'User', 'site_admin': False}",closed,1a74bd407de335019afdcb748a758107092a8019,https://api.github.com/repos/pytorch/pytorch/commits/1a74bd407de335019afdcb748a758107092a8019,2019-08-16T00:29:55Z,10,5,5
24369,2563350495,"{'login': 'facebook-github-bot', 'id': 6422482, 'node_id': 'MDQ6VXNlcjY0MjI0ODI=', 'avatar_url': 'https://avatars3.githubusercontent.com/u/6422482?v=4', 'gravatar_id': '', 'url': 'https://api.github.com/users/facebook-github-bot', 'html_url': 'https://github.com/facebook-github-bot', 'followers_url': 'https://api.github.com/users/facebook-github-bot/followers', 'following_url': 'https://api.github.com/users/facebook-github-bot/following{/other_user}', 'gists_url': 'https://api.github.com/users/facebook-github-bot/gists{/gist_id}', 'starred_url': 'https://api.github.com/users/facebook-github-bot/starred{/owner}{/repo}', 'subscriptions_url': 'https://api.github.com/users/facebook-github-bot/subscriptions', 'organizations_url': 'https://api.github.com/users/facebook-github-bot/orgs', 'repos_url': 'https://api.github.com/users/facebook-github-bot/repos', 'events_url': 'https://api.github.com/users/facebook-github-bot/events{/privacy}', 'received_events_url': 'https://api.github.com/users/facebook-github-bot/received_events', 'type': 'User', 'site_admin': False}",referenced,2e44630d35b652af7aa2ae91b00e5126619ff158,https://api.github.com/repos/pytorch/pytorch/commits/2e44630d35b652af7aa2ae91b00e5126619ff158,2019-08-16T20:29:32Z,29,28,1
24334,2748851598,"{'login': 'facebook-github-bot', 'id': 6422482, 'node_id': 'MDQ6VXNlcjY0MjI0ODI=', 'avatar_url': 'https://avatars3.githubusercontent.com/u/6422482?v=4', 'gravatar_id': '', 'url': 'https://api.github.com/users/facebook-github-bot', 'html_url': 'https://github.com/facebook-github-bot', 'followers_url': 'https://api.github.com/users/facebook-github-bot/followers', 'following_url': 'https://api.github.com/users/facebook-github-bot/following{/other_user}', 'gists_url': 'https://api.github.com/users/facebook-github-bot/gists{/gist_id}', 'starred_url': 'https://api.github.com/users/facebook-github-bot/starred{/owner}{/repo}', 'subscriptions_url': 'https://api.github.com/users/facebook-github-bot/subscriptions', 'organizations_url': 'https://api.github.com/users/facebook-github-bot/orgs', 'repos_url': 'https://api.github.com/users/facebook-github-bot/repos', 'events_url': 'https://api.github.com/users/facebook-github-bot/events{/privacy}', 'received_events_url': 'https://api.github.com/users/facebook-github-bot/received_events', 'type': 'User', 'site_admin': False}",closed,4cf7277d620abb8f07997ec4fa7e7acc3c36491f,https://api.github.com/repos/pytorch/pytorch/commits/4cf7277d620abb8f07997ec4fa7e7acc3c36491f,2019-10-28T15:01:08Z,3,2,1
24309,2594243713,"{'login': 'facebook-github-bot', 'id': 6422482, 'node_id': 'MDQ6VXNlcjY0MjI0ODI=', 'avatar_url': 'https://avatars3.githubusercontent.com/u/6422482?v=4', 'gravatar_id': '', 'url': 'https://api.github.com/users/facebook-github-bot', 'html_url': 'https://github.com/facebook-github-bot', 'followers_url': 'https://api.github.com/users/facebook-github-bot/followers', 'following_url': 'https://api.github.com/users/facebook-github-bot/following{/other_user}', 'gists_url': 'https://api.github.com/users/facebook-github-bot/gists{/gist_id}', 'starred_url': 'https://api.github.com/users/facebook-github-bot/starred{/owner}{/repo}', 'subscriptions_url': 'https://api.github.com/users/facebook-github-bot/subscriptions', 'organizations_url': 'https://api.github.com/users/facebook-github-bot/orgs', 'repos_url': 'https://api.github.com/users/facebook-github-bot/repos', 'events_url': 'https://api.github.com/users/facebook-github-bot/events{/privacy}', 'received_events_url': 'https://api.github.com/users/facebook-github-bot/received_events', 'type': 'User', 'site_admin': False}",closed,c845984271a551ac1c61b9eb06a17fb57aafbd7e,https://api.github.com/repos/pytorch/pytorch/commits/c845984271a551ac1c61b9eb06a17fb57aafbd7e,2019-08-29T14:39:07Z,43,38,5
24268,2560388164,"{'login': 'facebook-github-bot', 'id': 6422482, 'node_id': 'MDQ6VXNlcjY0MjI0ODI=', 'avatar_url': 'https://avatars3.githubusercontent.com/u/6422482?v=4', 'gravatar_id': '', 'url': 'https://api.github.com/users/facebook-github-bot', 'html_url': 'https://github.com/facebook-github-bot', 'followers_url': 'https://api.github.com/users/facebook-github-bot/followers', 'following_url': 'https://api.github.com/users/facebook-github-bot/following{/other_user}', 'gists_url': 'https://api.github.com/users/facebook-github-bot/gists{/gist_id}', 'starred_url': 'https://api.github.com/users/facebook-github-bot/starred{/owner}{/repo}', 'subscriptions_url': 'https://api.github.com/users/facebook-github-bot/subscriptions', 'organizations_url': 'https://api.github.com/users/facebook-github-bot/orgs', 'repos_url': 'https://api.github.com/users/facebook-github-bot/repos', 'events_url': 'https://api.github.com/users/facebook-github-bot/events{/privacy}', 'received_events_url': 'https://api.github.com/users/facebook-github-bot/received_events', 'type': 'User', 'site_admin': False}",referenced,83bfd76b2f7a9b388537eb00022622d9c6989890,https://api.github.com/repos/pytorch/pytorch/commits/83bfd76b2f7a9b388537eb00022622d9c6989890,2019-08-15T18:58:37Z,4,2,2
24256,2577232479,"{'login': 'facebook-github-bot', 'id': 6422482, 'node_id': 'MDQ6VXNlcjY0MjI0ODI=', 'avatar_url': 'https://avatars3.githubusercontent.com/u/6422482?v=4', 'gravatar_id': '', 'url': 'https://api.github.com/users/facebook-github-bot', 'html_url': 'https://github.com/facebook-github-bot', 'followers_url': 'https://api.github.com/users/facebook-github-bot/followers', 'following_url': 'https://api.github.com/users/facebook-github-bot/following{/other_user}', 'gists_url': 'https://api.github.com/users/facebook-github-bot/gists{/gist_id}', 'starred_url': 'https://api.github.com/users/facebook-github-bot/starred{/owner}{/repo}', 'subscriptions_url': 'https://api.github.com/users/facebook-github-bot/subscriptions', 'organizations_url': 'https://api.github.com/users/facebook-github-bot/orgs', 'repos_url': 'https://api.github.com/users/facebook-github-bot/repos', 'events_url': 'https://api.github.com/users/facebook-github-bot/events{/privacy}', 'received_events_url': 'https://api.github.com/users/facebook-github-bot/received_events', 'type': 'User', 'site_admin': False}",referenced,e8ea44796e168eaac8d4133283439245d886fba5,https://api.github.com/repos/pytorch/pytorch/commits/e8ea44796e168eaac8d4133283439245d886fba5,2019-08-22T17:17:24Z,114,89,25
24247,2651614682,"{'login': 'rohan-varma', 'id': 8039770, 'node_id': 'MDQ6VXNlcjgwMzk3NzA=', 'avatar_url': 'https://avatars2.githubusercontent.com/u/8039770?v=4', 'gravatar_id': '', 'url': 'https://api.github.com/users/rohan-varma', 'html_url': 'https://github.com/rohan-varma', 'followers_url': 'https://api.github.com/users/rohan-varma/followers', 'following_url': 'https://api.github.com/users/rohan-varma/following{/other_user}', 'gists_url': 'https://api.github.com/users/rohan-varma/gists{/gist_id}', 'starred_url': 'https://api.github.com/users/rohan-varma/starred{/owner}{/repo}', 'subscriptions_url': 'https://api.github.com/users/rohan-varma/subscriptions', 'organizations_url': 'https://api.github.com/users/rohan-varma/orgs', 'repos_url': 'https://api.github.com/users/rohan-varma/repos', 'events_url': 'https://api.github.com/users/rohan-varma/events{/privacy}', 'received_events_url': 'https://api.github.com/users/rohan-varma/received_events', 'type': 'User', 'site_admin': False}",referenced,05c86bf56c1d67a67349c58f2900d04c2d67bcb4,https://api.github.com/repos/pytorch/pytorch/commits/05c86bf56c1d67a67349c58f2900d04c2d67bcb4,2019-09-20T21:47:15Z,57,22,35
24247,2651618759,"{'login': 'rohan-varma', 'id': 8039770, 'node_id': 'MDQ6VXNlcjgwMzk3NzA=', 'avatar_url': 'https://avatars2.githubusercontent.com/u/8039770?v=4', 'gravatar_id': '', 'url': 'https://api.github.com/users/rohan-varma', 'html_url': 'https://github.com/rohan-varma', 'followers_url': 'https://api.github.com/users/rohan-varma/followers', 'following_url': 'https://api.github.com/users/rohan-varma/following{/other_user}', 'gists_url': 'https://api.github.com/users/rohan-varma/gists{/gist_id}', 'starred_url': 'https://api.github.com/users/rohan-varma/starred{/owner}{/repo}', 'subscriptions_url': 'https://api.github.com/users/rohan-varma/subscriptions', 'organizations_url': 'https://api.github.com/users/rohan-varma/orgs', 'repos_url': 'https://api.github.com/users/rohan-varma/repos', 'events_url': 'https://api.github.com/users/rohan-varma/events{/privacy}', 'received_events_url': 'https://api.github.com/users/rohan-varma/received_events', 'type': 'User', 'site_admin': False}",referenced,265c4c7fbb6b97122baf63b574c70f91e33df8b8,https://api.github.com/repos/pytorch/pytorch/commits/265c4c7fbb6b97122baf63b574c70f91e33df8b8,2019-09-20T21:49:38Z,4,2,2
24247,2651698204,"{'login': 'rohan-varma', 'id': 8039770, 'node_id': 'MDQ6VXNlcjgwMzk3NzA=', 'avatar_url': 'https://avatars2.githubusercontent.com/u/8039770?v=4', 'gravatar_id': '', 'url': 'https://api.github.com/users/rohan-varma', 'html_url': 'https://github.com/rohan-varma', 'followers_url': 'https://api.github.com/users/rohan-varma/followers', 'following_url': 'https://api.github.com/users/rohan-varma/following{/other_user}', 'gists_url': 'https://api.github.com/users/rohan-varma/gists{/gist_id}', 'starred_url': 'https://api.github.com/users/rohan-varma/starred{/owner}{/repo}', 'subscriptions_url': 'https://api.github.com/users/rohan-varma/subscriptions', 'organizations_url': 'https://api.github.com/users/rohan-varma/orgs', 'repos_url': 'https://api.github.com/users/rohan-varma/repos', 'events_url': 'https://api.github.com/users/rohan-varma/events{/privacy}', 'received_events_url': 'https://api.github.com/users/rohan-varma/received_events', 'type': 'User', 'site_admin': False}",referenced,312e124e829451a299d9434ab3ecbf46d8948593,https://api.github.com/repos/pytorch/pytorch/commits/312e124e829451a299d9434ab3ecbf46d8948593,2019-09-20T22:39:56Z,4,2,2
24247,2653465296,"{'login': 'rohan-varma', 'id': 8039770, 'node_id': 'MDQ6VXNlcjgwMzk3NzA=', 'avatar_url': 'https://avatars2.githubusercontent.com/u/8039770?v=4', 'gravatar_id': '', 'url': 'https://api.github.com/users/rohan-varma', 'html_url': 'https://github.com/rohan-varma', 'followers_url': 'https://api.github.com/users/rohan-varma/followers', 'following_url': 'https://api.github.com/users/rohan-varma/following{/other_user}', 'gists_url': 'https://api.github.com/users/rohan-varma/gists{/gist_id}', 'starred_url': 'https://api.github.com/users/rohan-varma/starred{/owner}{/repo}', 'subscriptions_url': 'https://api.github.com/users/rohan-varma/subscriptions', 'organizations_url': 'https://api.github.com/users/rohan-varma/orgs', 'repos_url': 'https://api.github.com/users/rohan-varma/repos', 'events_url': 'https://api.github.com/users/rohan-varma/events{/privacy}', 'received_events_url': 'https://api.github.com/users/rohan-varma/received_events', 'type': 'User', 'site_admin': False}",referenced,c7cb865ab1be3426b53d8b474c45755526bc2dfe,https://api.github.com/repos/pytorch/pytorch/commits/c7cb865ab1be3426b53d8b474c45755526bc2dfe,2019-09-23T07:36:14Z,10,5,5
24247,2656674257,"{'login': 'rohan-varma', 'id': 8039770, 'node_id': 'MDQ6VXNlcjgwMzk3NzA=', 'avatar_url': 'https://avatars2.githubusercontent.com/u/8039770?v=4', 'gravatar_id': '', 'url': 'https://api.github.com/users/rohan-varma', 'html_url': 'https://github.com/rohan-varma', 'followers_url': 'https://api.github.com/users/rohan-varma/followers', 'following_url': 'https://api.github.com/users/rohan-varma/following{/other_user}', 'gists_url': 'https://api.github.com/users/rohan-varma/gists{/gist_id}', 'starred_url': 'https://api.github.com/users/rohan-varma/starred{/owner}{/repo}', 'subscriptions_url': 'https://api.github.com/users/rohan-varma/subscriptions', 'organizations_url': 'https://api.github.com/users/rohan-varma/orgs', 'repos_url': 'https://api.github.com/users/rohan-varma/repos', 'events_url': 'https://api.github.com/users/rohan-varma/events{/privacy}', 'received_events_url': 'https://api.github.com/users/rohan-varma/received_events', 'type': 'User', 'site_admin': False}",referenced,8933b916211a5c434de94a6d1f514f3aaaa5a43b,https://api.github.com/repos/pytorch/pytorch/commits/8933b916211a5c434de94a6d1f514f3aaaa5a43b,2019-09-24T05:06:45Z,162,86,76
24247,2656691275,"{'login': 'rohan-varma', 'id': 8039770, 'node_id': 'MDQ6VXNlcjgwMzk3NzA=', 'avatar_url': 'https://avatars2.githubusercontent.com/u/8039770?v=4', 'gravatar_id': '', 'url': 'https://api.github.com/users/rohan-varma', 'html_url': 'https://github.com/rohan-varma', 'followers_url': 'https://api.github.com/users/rohan-varma/followers', 'following_url': 'https://api.github.com/users/rohan-varma/following{/other_user}', 'gists_url': 'https://api.github.com/users/rohan-varma/gists{/gist_id}', 'starred_url': 'https://api.github.com/users/rohan-varma/starred{/owner}{/repo}', 'subscriptions_url': 'https://api.github.com/users/rohan-varma/subscriptions', 'organizations_url': 'https://api.github.com/users/rohan-varma/orgs', 'repos_url': 'https://api.github.com/users/rohan-varma/repos', 'events_url': 'https://api.github.com/users/rohan-varma/events{/privacy}', 'received_events_url': 'https://api.github.com/users/rohan-varma/received_events', 'type': 'User', 'site_admin': False}",referenced,ed5db23c43b94205cc8bdc558689d1168dd211e1,https://api.github.com/repos/pytorch/pytorch/commits/ed5db23c43b94205cc8bdc558689d1168dd211e1,2019-09-24T05:18:12Z,6,2,4
24247,2656909409,"{'login': 'rohan-varma', 'id': 8039770, 'node_id': 'MDQ6VXNlcjgwMzk3NzA=', 'avatar_url': 'https://avatars2.githubusercontent.com/u/8039770?v=4', 'gravatar_id': '', 'url': 'https://api.github.com/users/rohan-varma', 'html_url': 'https://github.com/rohan-varma', 'followers_url': 'https://api.github.com/users/rohan-varma/followers', 'following_url': 'https://api.github.com/users/rohan-varma/following{/other_user}', 'gists_url': 'https://api.github.com/users/rohan-varma/gists{/gist_id}', 'starred_url': 'https://api.github.com/users/rohan-varma/starred{/owner}{/repo}', 'subscriptions_url': 'https://api.github.com/users/rohan-varma/subscriptions', 'organizations_url': 'https://api.github.com/users/rohan-varma/orgs', 'repos_url': 'https://api.github.com/users/rohan-varma/repos', 'events_url': 'https://api.github.com/users/rohan-varma/events{/privacy}', 'received_events_url': 'https://api.github.com/users/rohan-varma/received_events', 'type': 'User', 'site_admin': False}",referenced,1c05f0ed2b2ed1d6f63eac5961840fe28b0a1a13,https://api.github.com/repos/pytorch/pytorch/commits/1c05f0ed2b2ed1d6f63eac5961840fe28b0a1a13,2019-09-24T07:06:37Z,13950,8596,5354
24247,2659236916,"{'login': 'rohan-varma', 'id': 8039770, 'node_id': 'MDQ6VXNlcjgwMzk3NzA=', 'avatar_url': 'https://avatars2.githubusercontent.com/u/8039770?v=4', 'gravatar_id': '', 'url': 'https://api.github.com/users/rohan-varma', 'html_url': 'https://github.com/rohan-varma', 'followers_url': 'https://api.github.com/users/rohan-varma/followers', 'following_url': 'https://api.github.com/users/rohan-varma/following{/other_user}', 'gists_url': 'https://api.github.com/users/rohan-varma/gists{/gist_id}', 'starred_url': 'https://api.github.com/users/rohan-varma/starred{/owner}{/repo}', 'subscriptions_url': 'https://api.github.com/users/rohan-varma/subscriptions', 'organizations_url': 'https://api.github.com/users/rohan-varma/orgs', 'repos_url': 'https://api.github.com/users/rohan-varma/repos', 'events_url': 'https://api.github.com/users/rohan-varma/events{/privacy}', 'received_events_url': 'https://api.github.com/users/rohan-varma/received_events', 'type': 'User', 'site_admin': False}",referenced,fc1276e88ada096fa39d790fb2f53630a4f0b9f3,https://api.github.com/repos/pytorch/pytorch/commits/fc1276e88ada096fa39d790fb2f53630a4f0b9f3,2019-09-24T19:14:17Z,1285,722,563
24247,2659404821,"{'login': 'rohan-varma', 'id': 8039770, 'node_id': 'MDQ6VXNlcjgwMzk3NzA=', 'avatar_url': 'https://avatars2.githubusercontent.com/u/8039770?v=4', 'gravatar_id': '', 'url': 'https://api.github.com/users/rohan-varma', 'html_url': 'https://github.com/rohan-varma', 'followers_url': 'https://api.github.com/users/rohan-varma/followers', 'following_url': 'https://api.github.com/users/rohan-varma/following{/other_user}', 'gists_url': 'https://api.github.com/users/rohan-varma/gists{/gist_id}', 'starred_url': 'https://api.github.com/users/rohan-varma/starred{/owner}{/repo}', 'subscriptions_url': 'https://api.github.com/users/rohan-varma/subscriptions', 'organizations_url': 'https://api.github.com/users/rohan-varma/orgs', 'repos_url': 'https://api.github.com/users/rohan-varma/repos', 'events_url': 'https://api.github.com/users/rohan-varma/events{/privacy}', 'received_events_url': 'https://api.github.com/users/rohan-varma/received_events', 'type': 'User', 'site_admin': False}",referenced,31d2f4e8e81f0441184729ab3473c49e47d512e8,https://api.github.com/repos/pytorch/pytorch/commits/31d2f4e8e81f0441184729ab3473c49e47d512e8,2019-09-24T20:16:31Z,0,0,0
24239,2557498927,"{'login': 'facebook-github-bot', 'id': 6422482, 'node_id': 'MDQ6VXNlcjY0MjI0ODI=', 'avatar_url': 'https://avatars3.githubusercontent.com/u/6422482?v=4', 'gravatar_id': '', 'url': 'https://api.github.com/users/facebook-github-bot', 'html_url': 'https://github.com/facebook-github-bot', 'followers_url': 'https://api.github.com/users/facebook-github-bot/followers', 'following_url': 'https://api.github.com/users/facebook-github-bot/following{/other_user}', 'gists_url': 'https://api.github.com/users/facebook-github-bot/gists{/gist_id}', 'starred_url': 'https://api.github.com/users/facebook-github-bot/starred{/owner}{/repo}', 'subscriptions_url': 'https://api.github.com/users/facebook-github-bot/subscriptions', 'organizations_url': 'https://api.github.com/users/facebook-github-bot/orgs', 'repos_url': 'https://api.github.com/users/facebook-github-bot/repos', 'events_url': 'https://api.github.com/users/facebook-github-bot/events{/privacy}', 'received_events_url': 'https://api.github.com/users/facebook-github-bot/received_events', 'type': 'User', 'site_admin': False}",referenced,abadf0079fd1a21bb6c311bf3aaa61937936a069,https://api.github.com/repos/pytorch/pytorch/commits/abadf0079fd1a21bb6c311bf3aaa61937936a069,2019-08-14T18:23:09Z,47,30,17
24200,2590842059,"{'login': 'facebook-github-bot', 'id': 6422482, 'node_id': 'MDQ6VXNlcjY0MjI0ODI=', 'avatar_url': 'https://avatars3.githubusercontent.com/u/6422482?v=4', 'gravatar_id': '', 'url': 'https://api.github.com/users/facebook-github-bot', 'html_url': 'https://github.com/facebook-github-bot', 'followers_url': 'https://api.github.com/users/facebook-github-bot/followers', 'following_url': 'https://api.github.com/users/facebook-github-bot/following{/other_user}', 'gists_url': 'https://api.github.com/users/facebook-github-bot/gists{/gist_id}', 'starred_url': 'https://api.github.com/users/facebook-github-bot/starred{/owner}{/repo}', 'subscriptions_url': 'https://api.github.com/users/facebook-github-bot/subscriptions', 'organizations_url': 'https://api.github.com/users/facebook-github-bot/orgs', 'repos_url': 'https://api.github.com/users/facebook-github-bot/repos', 'events_url': 'https://api.github.com/users/facebook-github-bot/events{/privacy}', 'received_events_url': 'https://api.github.com/users/facebook-github-bot/received_events', 'type': 'User', 'site_admin': False}",closed,6c9410ffd13e68cfd00942c9e8a4f888408cb3de,https://api.github.com/repos/pytorch/pytorch/commits/6c9410ffd13e68cfd00942c9e8a4f888408cb3de,2019-08-28T14:52:11Z,3,2,1
24192,2669244399,"{'login': 'facebook-github-bot', 'id': 6422482, 'node_id': 'MDQ6VXNlcjY0MjI0ODI=', 'avatar_url': 'https://avatars3.githubusercontent.com/u/6422482?v=4', 'gravatar_id': '', 'url': 'https://api.github.com/users/facebook-github-bot', 'html_url': 'https://github.com/facebook-github-bot', 'followers_url': 'https://api.github.com/users/facebook-github-bot/followers', 'following_url': 'https://api.github.com/users/facebook-github-bot/following{/other_user}', 'gists_url': 'https://api.github.com/users/facebook-github-bot/gists{/gist_id}', 'starred_url': 'https://api.github.com/users/facebook-github-bot/starred{/owner}{/repo}', 'subscriptions_url': 'https://api.github.com/users/facebook-github-bot/subscriptions', 'organizations_url': 'https://api.github.com/users/facebook-github-bot/orgs', 'repos_url': 'https://api.github.com/users/facebook-github-bot/repos', 'events_url': 'https://api.github.com/users/facebook-github-bot/events{/privacy}', 'received_events_url': 'https://api.github.com/users/facebook-github-bot/received_events', 'type': 'User', 'site_admin': False}",closed,3acbcb96d418bfce434b964eb5cb85e1ba6010e9,https://api.github.com/repos/pytorch/pytorch/commits/3acbcb96d418bfce434b964eb5cb85e1ba6010e9,2019-09-27T16:37:36Z,96,95,1
24177,2591712208,"{'login': 'facebook-github-bot', 'id': 6422482, 'node_id': 'MDQ6VXNlcjY0MjI0ODI=', 'avatar_url': 'https://avatars3.githubusercontent.com/u/6422482?v=4', 'gravatar_id': '', 'url': 'https://api.github.com/users/facebook-github-bot', 'html_url': 'https://github.com/facebook-github-bot', 'followers_url': 'https://api.github.com/users/facebook-github-bot/followers', 'following_url': 'https://api.github.com/users/facebook-github-bot/following{/other_user}', 'gists_url': 'https://api.github.com/users/facebook-github-bot/gists{/gist_id}', 'starred_url': 'https://api.github.com/users/facebook-github-bot/starred{/owner}{/repo}', 'subscriptions_url': 'https://api.github.com/users/facebook-github-bot/subscriptions', 'organizations_url': 'https://api.github.com/users/facebook-github-bot/orgs', 'repos_url': 'https://api.github.com/users/facebook-github-bot/repos', 'events_url': 'https://api.github.com/users/facebook-github-bot/events{/privacy}', 'received_events_url': 'https://api.github.com/users/facebook-github-bot/received_events', 'type': 'User', 'site_admin': False}",referenced,0cc92de447962ea9fdcaacb2f4101190f1d5cd8c,https://api.github.com/repos/pytorch/pytorch/commits/0cc92de447962ea9fdcaacb2f4101190f1d5cd8c,2019-08-28T19:40:01Z,215,207,8
24175,2555302389,"{'login': 'facebook-github-bot', 'id': 6422482, 'node_id': 'MDQ6VXNlcjY0MjI0ODI=', 'avatar_url': 'https://avatars3.githubusercontent.com/u/6422482?v=4', 'gravatar_id': '', 'url': 'https://api.github.com/users/facebook-github-bot', 'html_url': 'https://github.com/facebook-github-bot', 'followers_url': 'https://api.github.com/users/facebook-github-bot/followers', 'following_url': 'https://api.github.com/users/facebook-github-bot/following{/other_user}', 'gists_url': 'https://api.github.com/users/facebook-github-bot/gists{/gist_id}', 'starred_url': 'https://api.github.com/users/facebook-github-bot/starred{/owner}{/repo}', 'subscriptions_url': 'https://api.github.com/users/facebook-github-bot/subscriptions', 'organizations_url': 'https://api.github.com/users/facebook-github-bot/orgs', 'repos_url': 'https://api.github.com/users/facebook-github-bot/repos', 'events_url': 'https://api.github.com/users/facebook-github-bot/events{/privacy}', 'received_events_url': 'https://api.github.com/users/facebook-github-bot/received_events', 'type': 'User', 'site_admin': False}",closed,c771d50ca26048647e7bfeb70f597c33769030bc,https://api.github.com/repos/pytorch/pytorch/commits/c771d50ca26048647e7bfeb70f597c33769030bc,2019-08-14T03:36:06Z,3,1,2
24173,2875417166,"{'login': 'facebook-github-bot', 'id': 6422482, 'node_id': 'MDQ6VXNlcjY0MjI0ODI=', 'avatar_url': 'https://avatars3.githubusercontent.com/u/6422482?v=4', 'gravatar_id': '', 'url': 'https://api.github.com/users/facebook-github-bot', 'html_url': 'https://github.com/facebook-github-bot', 'followers_url': 'https://api.github.com/users/facebook-github-bot/followers', 'following_url': 'https://api.github.com/users/facebook-github-bot/following{/other_user}', 'gists_url': 'https://api.github.com/users/facebook-github-bot/gists{/gist_id}', 'starred_url': 'https://api.github.com/users/facebook-github-bot/starred{/owner}{/repo}', 'subscriptions_url': 'https://api.github.com/users/facebook-github-bot/subscriptions', 'organizations_url': 'https://api.github.com/users/facebook-github-bot/orgs', 'repos_url': 'https://api.github.com/users/facebook-github-bot/repos', 'events_url': 'https://api.github.com/users/facebook-github-bot/events{/privacy}', 'received_events_url': 'https://api.github.com/users/facebook-github-bot/received_events', 'type': 'User', 'site_admin': False}",closed,1f87e823b8c93af0ef5ad19a6270e93533007ffa,https://api.github.com/repos/pytorch/pytorch/commits/1f87e823b8c93af0ef5ad19a6270e93533007ffa,2019-12-11T18:57:46Z,67,42,25
24164,2567958002,"{'login': 'facebook-github-bot', 'id': 6422482, 'node_id': 'MDQ6VXNlcjY0MjI0ODI=', 'avatar_url': 'https://avatars3.githubusercontent.com/u/6422482?v=4', 'gravatar_id': '', 'url': 'https://api.github.com/users/facebook-github-bot', 'html_url': 'https://github.com/facebook-github-bot', 'followers_url': 'https://api.github.com/users/facebook-github-bot/followers', 'following_url': 'https://api.github.com/users/facebook-github-bot/following{/other_user}', 'gists_url': 'https://api.github.com/users/facebook-github-bot/gists{/gist_id}', 'starred_url': 'https://api.github.com/users/facebook-github-bot/starred{/owner}{/repo}', 'subscriptions_url': 'https://api.github.com/users/facebook-github-bot/subscriptions', 'organizations_url': 'https://api.github.com/users/facebook-github-bot/orgs', 'repos_url': 'https://api.github.com/users/facebook-github-bot/repos', 'events_url': 'https://api.github.com/users/facebook-github-bot/events{/privacy}', 'received_events_url': 'https://api.github.com/users/facebook-github-bot/received_events', 'type': 'User', 'site_admin': False}",closed,e0e5813b72fd3eaa336f3f2c23ca3b2ee708d041,https://api.github.com/repos/pytorch/pytorch/commits/e0e5813b72fd3eaa336f3f2c23ca3b2ee708d041,2019-08-19T23:33:31Z,41,24,17
24140,2578188762,"{'login': 'wanchaol', 'id': 9443650, 'node_id': 'MDQ6VXNlcjk0NDM2NTA=', 'avatar_url': 'https://avatars2.githubusercontent.com/u/9443650?v=4', 'gravatar_id': '', 'url': 'https://api.github.com/users/wanchaol', 'html_url': 'https://github.com/wanchaol', 'followers_url': 'https://api.github.com/users/wanchaol/followers', 'following_url': 'https://api.github.com/users/wanchaol/following{/other_user}', 'gists_url': 'https://api.github.com/users/wanchaol/gists{/gist_id}', 'starred_url': 'https://api.github.com/users/wanchaol/starred{/owner}{/repo}', 'subscriptions_url': 'https://api.github.com/users/wanchaol/subscriptions', 'organizations_url': 'https://api.github.com/users/wanchaol/orgs', 'repos_url': 'https://api.github.com/users/wanchaol/repos', 'events_url': 'https://api.github.com/users/wanchaol/events{/privacy}', 'received_events_url': 'https://api.github.com/users/wanchaol/received_events', 'type': 'User', 'site_admin': False}",referenced,afb54109270f84c1f11eb0e374d8a472b9cf2345,https://api.github.com/repos/pytorch/pytorch/commits/afb54109270f84c1f11eb0e374d8a472b9cf2345,2019-08-23T00:18:37Z,8745,5706,3039
24140,2581016002,"{'login': 'facebook-github-bot', 'id': 6422482, 'node_id': 'MDQ6VXNlcjY0MjI0ODI=', 'avatar_url': 'https://avatars3.githubusercontent.com/u/6422482?v=4', 'gravatar_id': '', 'url': 'https://api.github.com/users/facebook-github-bot', 'html_url': 'https://github.com/facebook-github-bot', 'followers_url': 'https://api.github.com/users/facebook-github-bot/followers', 'following_url': 'https://api.github.com/users/facebook-github-bot/following{/other_user}', 'gists_url': 'https://api.github.com/users/facebook-github-bot/gists{/gist_id}', 'starred_url': 'https://api.github.com/users/facebook-github-bot/starred{/owner}{/repo}', 'subscriptions_url': 'https://api.github.com/users/facebook-github-bot/subscriptions', 'organizations_url': 'https://api.github.com/users/facebook-github-bot/orgs', 'repos_url': 'https://api.github.com/users/facebook-github-bot/repos', 'events_url': 'https://api.github.com/users/facebook-github-bot/events{/privacy}', 'received_events_url': 'https://api.github.com/users/facebook-github-bot/received_events', 'type': 'User', 'site_admin': False}",closed,5fd3251c50ec0b1d6c182dcf705aec18d88edac2,https://api.github.com/repos/pytorch/pytorch/commits/5fd3251c50ec0b1d6c182dcf705aec18d88edac2,2019-08-23T22:48:26Z,21,21,0
24132,2630323795,"{'login': 'smessmer', 'id': 2373925, 'node_id': 'MDQ6VXNlcjIzNzM5MjU=', 'avatar_url': 'https://avatars3.githubusercontent.com/u/2373925?v=4', 'gravatar_id': '', 'url': 'https://api.github.com/users/smessmer', 'html_url': 'https://github.com/smessmer', 'followers_url': 'https://api.github.com/users/smessmer/followers', 'following_url': 'https://api.github.com/users/smessmer/following{/other_user}', 'gists_url': 'https://api.github.com/users/smessmer/gists{/gist_id}', 'starred_url': 'https://api.github.com/users/smessmer/starred{/owner}{/repo}', 'subscriptions_url': 'https://api.github.com/users/smessmer/subscriptions', 'organizations_url': 'https://api.github.com/users/smessmer/orgs', 'repos_url': 'https://api.github.com/users/smessmer/repos', 'events_url': 'https://api.github.com/users/smessmer/events{/privacy}', 'received_events_url': 'https://api.github.com/users/smessmer/received_events', 'type': 'User', 'site_admin': False}",referenced,ef96139b5801f07b7a16bb005009c38d4fe639b3,https://api.github.com/repos/pytorch/pytorch/commits/ef96139b5801f07b7a16bb005009c38d4fe639b3,2019-09-12T19:34:10Z,292,201,91
24132,2630324702,"{'login': 'smessmer', 'id': 2373925, 'node_id': 'MDQ6VXNlcjIzNzM5MjU=', 'avatar_url': 'https://avatars3.githubusercontent.com/u/2373925?v=4', 'gravatar_id': '', 'url': 'https://api.github.com/users/smessmer', 'html_url': 'https://github.com/smessmer', 'followers_url': 'https://api.github.com/users/smessmer/followers', 'following_url': 'https://api.github.com/users/smessmer/following{/other_user}', 'gists_url': 'https://api.github.com/users/smessmer/gists{/gist_id}', 'starred_url': 'https://api.github.com/users/smessmer/starred{/owner}{/repo}', 'subscriptions_url': 'https://api.github.com/users/smessmer/subscriptions', 'organizations_url': 'https://api.github.com/users/smessmer/orgs', 'repos_url': 'https://api.github.com/users/smessmer/repos', 'events_url': 'https://api.github.com/users/smessmer/events{/privacy}', 'received_events_url': 'https://api.github.com/users/smessmer/received_events', 'type': 'User', 'site_admin': False}",referenced,e9146e2695b7b2ccf6e3bc10cbd2001029c3c56d,https://api.github.com/repos/pytorch/pytorch/commits/e9146e2695b7b2ccf6e3bc10cbd2001029c3c56d,2019-09-12T19:34:32Z,292,201,91
24132,2630595439,"{'login': 'smessmer', 'id': 2373925, 'node_id': 'MDQ6VXNlcjIzNzM5MjU=', 'avatar_url': 'https://avatars3.githubusercontent.com/u/2373925?v=4', 'gravatar_id': '', 'url': 'https://api.github.com/users/smessmer', 'html_url': 'https://github.com/smessmer', 'followers_url': 'https://api.github.com/users/smessmer/followers', 'following_url': 'https://api.github.com/users/smessmer/following{/other_user}', 'gists_url': 'https://api.github.com/users/smessmer/gists{/gist_id}', 'starred_url': 'https://api.github.com/users/smessmer/starred{/owner}{/repo}', 'subscriptions_url': 'https://api.github.com/users/smessmer/subscriptions', 'organizations_url': 'https://api.github.com/users/smessmer/orgs', 'repos_url': 'https://api.github.com/users/smessmer/repos', 'events_url': 'https://api.github.com/users/smessmer/events{/privacy}', 'received_events_url': 'https://api.github.com/users/smessmer/received_events', 'type': 'User', 'site_admin': False}",referenced,8079f9b619b689816490618da15d718295eea535,https://api.github.com/repos/pytorch/pytorch/commits/8079f9b619b689816490618da15d718295eea535,2019-09-12T21:16:51Z,6416,4709,1707
24132,2631386628,"{'login': 'smessmer', 'id': 2373925, 'node_id': 'MDQ6VXNlcjIzNzM5MjU=', 'avatar_url': 'https://avatars3.githubusercontent.com/u/2373925?v=4', 'gravatar_id': '', 'url': 'https://api.github.com/users/smessmer', 'html_url': 'https://github.com/smessmer', 'followers_url': 'https://api.github.com/users/smessmer/followers', 'following_url': 'https://api.github.com/users/smessmer/following{/other_user}', 'gists_url': 'https://api.github.com/users/smessmer/gists{/gist_id}', 'starred_url': 'https://api.github.com/users/smessmer/starred{/owner}{/repo}', 'subscriptions_url': 'https://api.github.com/users/smessmer/subscriptions', 'organizations_url': 'https://api.github.com/users/smessmer/orgs', 'repos_url': 'https://api.github.com/users/smessmer/repos', 'events_url': 'https://api.github.com/users/smessmer/events{/privacy}', 'received_events_url': 'https://api.github.com/users/smessmer/received_events', 'type': 'User', 'site_admin': False}",referenced,1c1d7c88e8086c9ea573e71d02dcabfda971cded,https://api.github.com/repos/pytorch/pytorch/commits/1c1d7c88e8086c9ea573e71d02dcabfda971cded,2019-09-13T07:03:21Z,14,7,7
24132,2633534563,"{'login': 'facebook-github-bot', 'id': 6422482, 'node_id': 'MDQ6VXNlcjY0MjI0ODI=', 'avatar_url': 'https://avatars3.githubusercontent.com/u/6422482?v=4', 'gravatar_id': '', 'url': 'https://api.github.com/users/facebook-github-bot', 'html_url': 'https://github.com/facebook-github-bot', 'followers_url': 'https://api.github.com/users/facebook-github-bot/followers', 'following_url': 'https://api.github.com/users/facebook-github-bot/following{/other_user}', 'gists_url': 'https://api.github.com/users/facebook-github-bot/gists{/gist_id}', 'starred_url': 'https://api.github.com/users/facebook-github-bot/starred{/owner}{/repo}', 'subscriptions_url': 'https://api.github.com/users/facebook-github-bot/subscriptions', 'organizations_url': 'https://api.github.com/users/facebook-github-bot/orgs', 'repos_url': 'https://api.github.com/users/facebook-github-bot/repos', 'events_url': 'https://api.github.com/users/facebook-github-bot/events{/privacy}', 'received_events_url': 'https://api.github.com/users/facebook-github-bot/received_events', 'type': 'User', 'site_admin': False}",referenced,b01520ac9c23499d1c9ed5f411950a0c6cb54ca9,https://api.github.com/repos/pytorch/pytorch/commits/b01520ac9c23499d1c9ed5f411950a0c6cb54ca9,2019-09-13T20:52:51Z,302,206,96
24088,2567801409,"{'login': 'facebook-github-bot', 'id': 6422482, 'node_id': 'MDQ6VXNlcjY0MjI0ODI=', 'avatar_url': 'https://avatars3.githubusercontent.com/u/6422482?v=4', 'gravatar_id': '', 'url': 'https://api.github.com/users/facebook-github-bot', 'html_url': 'https://github.com/facebook-github-bot', 'followers_url': 'https://api.github.com/users/facebook-github-bot/followers', 'following_url': 'https://api.github.com/users/facebook-github-bot/following{/other_user}', 'gists_url': 'https://api.github.com/users/facebook-github-bot/gists{/gist_id}', 'starred_url': 'https://api.github.com/users/facebook-github-bot/starred{/owner}{/repo}', 'subscriptions_url': 'https://api.github.com/users/facebook-github-bot/subscriptions', 'organizations_url': 'https://api.github.com/users/facebook-github-bot/orgs', 'repos_url': 'https://api.github.com/users/facebook-github-bot/repos', 'events_url': 'https://api.github.com/users/facebook-github-bot/events{/privacy}', 'received_events_url': 'https://api.github.com/users/facebook-github-bot/received_events', 'type': 'User', 'site_admin': False}",closed,f849ebf1feecff391618c7091deaf7f079a5b2af,https://api.github.com/repos/pytorch/pytorch/commits/f849ebf1feecff391618c7091deaf7f079a5b2af,2019-08-19T21:59:48Z,21,16,5
24080,2666716941,"{'login': 'facebook-github-bot', 'id': 6422482, 'node_id': 'MDQ6VXNlcjY0MjI0ODI=', 'avatar_url': 'https://avatars3.githubusercontent.com/u/6422482?v=4', 'gravatar_id': '', 'url': 'https://api.github.com/users/facebook-github-bot', 'html_url': 'https://github.com/facebook-github-bot', 'followers_url': 'https://api.github.com/users/facebook-github-bot/followers', 'following_url': 'https://api.github.com/users/facebook-github-bot/following{/other_user}', 'gists_url': 'https://api.github.com/users/facebook-github-bot/gists{/gist_id}', 'starred_url': 'https://api.github.com/users/facebook-github-bot/starred{/owner}{/repo}', 'subscriptions_url': 'https://api.github.com/users/facebook-github-bot/subscriptions', 'organizations_url': 'https://api.github.com/users/facebook-github-bot/orgs', 'repos_url': 'https://api.github.com/users/facebook-github-bot/repos', 'events_url': 'https://api.github.com/users/facebook-github-bot/events{/privacy}', 'received_events_url': 'https://api.github.com/users/facebook-github-bot/received_events', 'type': 'User', 'site_admin': False}",closed,e425bdb832ae547f6486da84c51badeb2673e52a,https://api.github.com/repos/pytorch/pytorch/commits/e425bdb832ae547f6486da84c51badeb2673e52a,2019-09-26T21:11:56Z,12,9,3
24080,2686331807,"{'login': 'facebook-github-bot', 'id': 6422482, 'node_id': 'MDQ6VXNlcjY0MjI0ODI=', 'avatar_url': 'https://avatars3.githubusercontent.com/u/6422482?v=4', 'gravatar_id': '', 'url': 'https://api.github.com/users/facebook-github-bot', 'html_url': 'https://github.com/facebook-github-bot', 'followers_url': 'https://api.github.com/users/facebook-github-bot/followers', 'following_url': 'https://api.github.com/users/facebook-github-bot/following{/other_user}', 'gists_url': 'https://api.github.com/users/facebook-github-bot/gists{/gist_id}', 'starred_url': 'https://api.github.com/users/facebook-github-bot/starred{/owner}{/repo}', 'subscriptions_url': 'https://api.github.com/users/facebook-github-bot/subscriptions', 'organizations_url': 'https://api.github.com/users/facebook-github-bot/orgs', 'repos_url': 'https://api.github.com/users/facebook-github-bot/repos', 'events_url': 'https://api.github.com/users/facebook-github-bot/events{/privacy}', 'received_events_url': 'https://api.github.com/users/facebook-github-bot/received_events', 'type': 'User', 'site_admin': False}",closed,d0a4b2f586e0901c3c65f1f0e0bae15364e28821,https://api.github.com/repos/pytorch/pytorch/commits/d0a4b2f586e0901c3c65f1f0e0bae15364e28821,2019-10-04T06:31:50Z,8,7,1
24073,2548362798,"{'login': 'facebook-github-bot', 'id': 6422482, 'node_id': 'MDQ6VXNlcjY0MjI0ODI=', 'avatar_url': 'https://avatars3.githubusercontent.com/u/6422482?v=4', 'gravatar_id': '', 'url': 'https://api.github.com/users/facebook-github-bot', 'html_url': 'https://github.com/facebook-github-bot', 'followers_url': 'https://api.github.com/users/facebook-github-bot/followers', 'following_url': 'https://api.github.com/users/facebook-github-bot/following{/other_user}', 'gists_url': 'https://api.github.com/users/facebook-github-bot/gists{/gist_id}', 'starred_url': 'https://api.github.com/users/facebook-github-bot/starred{/owner}{/repo}', 'subscriptions_url': 'https://api.github.com/users/facebook-github-bot/subscriptions', 'organizations_url': 'https://api.github.com/users/facebook-github-bot/orgs', 'repos_url': 'https://api.github.com/users/facebook-github-bot/repos', 'events_url': 'https://api.github.com/users/facebook-github-bot/events{/privacy}', 'received_events_url': 'https://api.github.com/users/facebook-github-bot/received_events', 'type': 'User', 'site_admin': False}",closed,6be24be9ff7c7100e08971ca2031d4b720a139ac,https://api.github.com/repos/pytorch/pytorch/commits/6be24be9ff7c7100e08971ca2031d4b720a139ac,2019-08-10T21:53:07Z,6,3,3
24035,2567808292,"{'login': 'facebook-github-bot', 'id': 6422482, 'node_id': 'MDQ6VXNlcjY0MjI0ODI=', 'avatar_url': 'https://avatars3.githubusercontent.com/u/6422482?v=4', 'gravatar_id': '', 'url': 'https://api.github.com/users/facebook-github-bot', 'html_url': 'https://github.com/facebook-github-bot', 'followers_url': 'https://api.github.com/users/facebook-github-bot/followers', 'following_url': 'https://api.github.com/users/facebook-github-bot/following{/other_user}', 'gists_url': 'https://api.github.com/users/facebook-github-bot/gists{/gist_id}', 'starred_url': 'https://api.github.com/users/facebook-github-bot/starred{/owner}{/repo}', 'subscriptions_url': 'https://api.github.com/users/facebook-github-bot/subscriptions', 'organizations_url': 'https://api.github.com/users/facebook-github-bot/orgs', 'repos_url': 'https://api.github.com/users/facebook-github-bot/repos', 'events_url': 'https://api.github.com/users/facebook-github-bot/events{/privacy}', 'received_events_url': 'https://api.github.com/users/facebook-github-bot/received_events', 'type': 'User', 'site_admin': False}",closed,4358cbe01b55673556208ade69287acba64ca19b,https://api.github.com/repos/pytorch/pytorch/commits/4358cbe01b55673556208ade69287acba64ca19b,2019-08-19T22:03:12Z,32,20,12
24015,2854082054,"{'login': 'facebook-github-bot', 'id': 6422482, 'node_id': 'MDQ6VXNlcjY0MjI0ODI=', 'avatar_url': 'https://avatars3.githubusercontent.com/u/6422482?v=4', 'gravatar_id': '', 'url': 'https://api.github.com/users/facebook-github-bot', 'html_url': 'https://github.com/facebook-github-bot', 'followers_url': 'https://api.github.com/users/facebook-github-bot/followers', 'following_url': 'https://api.github.com/users/facebook-github-bot/following{/other_user}', 'gists_url': 'https://api.github.com/users/facebook-github-bot/gists{/gist_id}', 'starred_url': 'https://api.github.com/users/facebook-github-bot/starred{/owner}{/repo}', 'subscriptions_url': 'https://api.github.com/users/facebook-github-bot/subscriptions', 'organizations_url': 'https://api.github.com/users/facebook-github-bot/orgs', 'repos_url': 'https://api.github.com/users/facebook-github-bot/repos', 'events_url': 'https://api.github.com/users/facebook-github-bot/events{/privacy}', 'received_events_url': 'https://api.github.com/users/facebook-github-bot/received_events', 'type': 'User', 'site_admin': False}",closed,d12786b24fc7df0526c9fcd69efa776c53c34e3f,https://api.github.com/repos/pytorch/pytorch/commits/d12786b24fc7df0526c9fcd69efa776c53c34e3f,2019-12-04T13:57:13Z,2022,1961,61
24001,2546753737,"{'login': 'facebook-github-bot', 'id': 6422482, 'node_id': 'MDQ6VXNlcjY0MjI0ODI=', 'avatar_url': 'https://avatars3.githubusercontent.com/u/6422482?v=4', 'gravatar_id': '', 'url': 'https://api.github.com/users/facebook-github-bot', 'html_url': 'https://github.com/facebook-github-bot', 'followers_url': 'https://api.github.com/users/facebook-github-bot/followers', 'following_url': 'https://api.github.com/users/facebook-github-bot/following{/other_user}', 'gists_url': 'https://api.github.com/users/facebook-github-bot/gists{/gist_id}', 'starred_url': 'https://api.github.com/users/facebook-github-bot/starred{/owner}{/repo}', 'subscriptions_url': 'https://api.github.com/users/facebook-github-bot/subscriptions', 'organizations_url': 'https://api.github.com/users/facebook-github-bot/orgs', 'repos_url': 'https://api.github.com/users/facebook-github-bot/repos', 'events_url': 'https://api.github.com/users/facebook-github-bot/events{/privacy}', 'received_events_url': 'https://api.github.com/users/facebook-github-bot/received_events', 'type': 'User', 'site_admin': False}",closed,478c7930658a892b366e84ce46ccf56710206fbe,https://api.github.com/repos/pytorch/pytorch/commits/478c7930658a892b366e84ce46ccf56710206fbe,2019-08-09T14:57:56Z,1,0,1
24000,2598000746,"{'login': 'facebook-github-bot', 'id': 6422482, 'node_id': 'MDQ6VXNlcjY0MjI0ODI=', 'avatar_url': 'https://avatars3.githubusercontent.com/u/6422482?v=4', 'gravatar_id': '', 'url': 'https://api.github.com/users/facebook-github-bot', 'html_url': 'https://github.com/facebook-github-bot', 'followers_url': 'https://api.github.com/users/facebook-github-bot/followers', 'following_url': 'https://api.github.com/users/facebook-github-bot/following{/other_user}', 'gists_url': 'https://api.github.com/users/facebook-github-bot/gists{/gist_id}', 'starred_url': 'https://api.github.com/users/facebook-github-bot/starred{/owner}{/repo}', 'subscriptions_url': 'https://api.github.com/users/facebook-github-bot/subscriptions', 'organizations_url': 'https://api.github.com/users/facebook-github-bot/orgs', 'repos_url': 'https://api.github.com/users/facebook-github-bot/repos', 'events_url': 'https://api.github.com/users/facebook-github-bot/events{/privacy}', 'received_events_url': 'https://api.github.com/users/facebook-github-bot/received_events', 'type': 'User', 'site_admin': False}",referenced,d2a8435c08f9d87603d4d9a9179a989b632bc2cb,https://api.github.com/repos/pytorch/pytorch/commits/d2a8435c08f9d87603d4d9a9179a989b632bc2cb,2019-08-30T18:34:00Z,40,39,1
23982,2547162387,"{'login': 'facebook-github-bot', 'id': 6422482, 'node_id': 'MDQ6VXNlcjY0MjI0ODI=', 'avatar_url': 'https://avatars3.githubusercontent.com/u/6422482?v=4', 'gravatar_id': '', 'url': 'https://api.github.com/users/facebook-github-bot', 'html_url': 'https://github.com/facebook-github-bot', 'followers_url': 'https://api.github.com/users/facebook-github-bot/followers', 'following_url': 'https://api.github.com/users/facebook-github-bot/following{/other_user}', 'gists_url': 'https://api.github.com/users/facebook-github-bot/gists{/gist_id}', 'starred_url': 'https://api.github.com/users/facebook-github-bot/starred{/owner}{/repo}', 'subscriptions_url': 'https://api.github.com/users/facebook-github-bot/subscriptions', 'organizations_url': 'https://api.github.com/users/facebook-github-bot/orgs', 'repos_url': 'https://api.github.com/users/facebook-github-bot/repos', 'events_url': 'https://api.github.com/users/facebook-github-bot/events{/privacy}', 'received_events_url': 'https://api.github.com/users/facebook-github-bot/received_events', 'type': 'User', 'site_admin': False}",closed,bb41e62e3b7a0a20f954951b8da59e9167f2f3ba,https://api.github.com/repos/pytorch/pytorch/commits/bb41e62e3b7a0a20f954951b8da59e9167f2f3ba,2019-08-09T17:35:48Z,10,5,5
23965,2879457156,"{'login': 'facebook-github-bot', 'id': 6422482, 'node_id': 'MDQ6VXNlcjY0MjI0ODI=', 'avatar_url': 'https://avatars3.githubusercontent.com/u/6422482?v=4', 'gravatar_id': '', 'url': 'https://api.github.com/users/facebook-github-bot', 'html_url': 'https://github.com/facebook-github-bot', 'followers_url': 'https://api.github.com/users/facebook-github-bot/followers', 'following_url': 'https://api.github.com/users/facebook-github-bot/following{/other_user}', 'gists_url': 'https://api.github.com/users/facebook-github-bot/gists{/gist_id}', 'starred_url': 'https://api.github.com/users/facebook-github-bot/starred{/owner}{/repo}', 'subscriptions_url': 'https://api.github.com/users/facebook-github-bot/subscriptions', 'organizations_url': 'https://api.github.com/users/facebook-github-bot/orgs', 'repos_url': 'https://api.github.com/users/facebook-github-bot/repos', 'events_url': 'https://api.github.com/users/facebook-github-bot/events{/privacy}', 'received_events_url': 'https://api.github.com/users/facebook-github-bot/received_events', 'type': 'User', 'site_admin': False}",referenced,bee6344d4eb22c1cf9db2626ffd89c1b04db02e9,https://api.github.com/repos/pytorch/pytorch/commits/bee6344d4eb22c1cf9db2626ffd89c1b04db02e9,2019-12-12T21:34:04Z,257,4,253
23947,2551556540,"{'login': 'facebook-github-bot', 'id': 6422482, 'node_id': 'MDQ6VXNlcjY0MjI0ODI=', 'avatar_url': 'https://avatars3.githubusercontent.com/u/6422482?v=4', 'gravatar_id': '', 'url': 'https://api.github.com/users/facebook-github-bot', 'html_url': 'https://github.com/facebook-github-bot', 'followers_url': 'https://api.github.com/users/facebook-github-bot/followers', 'following_url': 'https://api.github.com/users/facebook-github-bot/following{/other_user}', 'gists_url': 'https://api.github.com/users/facebook-github-bot/gists{/gist_id}', 'starred_url': 'https://api.github.com/users/facebook-github-bot/starred{/owner}{/repo}', 'subscriptions_url': 'https://api.github.com/users/facebook-github-bot/subscriptions', 'organizations_url': 'https://api.github.com/users/facebook-github-bot/orgs', 'repos_url': 'https://api.github.com/users/facebook-github-bot/repos', 'events_url': 'https://api.github.com/users/facebook-github-bot/events{/privacy}', 'received_events_url': 'https://api.github.com/users/facebook-github-bot/received_events', 'type': 'User', 'site_admin': False}",closed,06c09a266b93dfaf2bc5542ac4501fd4b651e7b0,https://api.github.com/repos/pytorch/pytorch/commits/06c09a266b93dfaf2bc5542ac4501fd4b651e7b0,2019-08-12T21:24:07Z,1,1,0
23915,2547381981,"{'login': 'ZolotukhinM', 'id': 4588111, 'node_id': 'MDQ6VXNlcjQ1ODgxMTE=', 'avatar_url': 'https://avatars1.githubusercontent.com/u/4588111?v=4', 'gravatar_id': '', 'url': 'https://api.github.com/users/ZolotukhinM', 'html_url': 'https://github.com/ZolotukhinM', 'followers_url': 'https://api.github.com/users/ZolotukhinM/followers', 'following_url': 'https://api.github.com/users/ZolotukhinM/following{/other_user}', 'gists_url': 'https://api.github.com/users/ZolotukhinM/gists{/gist_id}', 'starred_url': 'https://api.github.com/users/ZolotukhinM/starred{/owner}{/repo}', 'subscriptions_url': 'https://api.github.com/users/ZolotukhinM/subscriptions', 'organizations_url': 'https://api.github.com/users/ZolotukhinM/orgs', 'repos_url': 'https://api.github.com/users/ZolotukhinM/repos', 'events_url': 'https://api.github.com/users/ZolotukhinM/events{/privacy}', 'received_events_url': 'https://api.github.com/users/ZolotukhinM/received_events', 'type': 'User', 'site_admin': False}",referenced,e1c71986c9600f9e5b12f273ae05e1ae79968b90,https://api.github.com/repos/pytorch/pytorch/commits/e1c71986c9600f9e5b12f273ae05e1ae79968b90,2019-08-09T19:10:38Z,2032,927,1105
23915,2547393529,"{'login': 'ZolotukhinM', 'id': 4588111, 'node_id': 'MDQ6VXNlcjQ1ODgxMTE=', 'avatar_url': 'https://avatars1.githubusercontent.com/u/4588111?v=4', 'gravatar_id': '', 'url': 'https://api.github.com/users/ZolotukhinM', 'html_url': 'https://github.com/ZolotukhinM', 'followers_url': 'https://api.github.com/users/ZolotukhinM/followers', 'following_url': 'https://api.github.com/users/ZolotukhinM/following{/other_user}', 'gists_url': 'https://api.github.com/users/ZolotukhinM/gists{/gist_id}', 'starred_url': 'https://api.github.com/users/ZolotukhinM/starred{/owner}{/repo}', 'subscriptions_url': 'https://api.github.com/users/ZolotukhinM/subscriptions', 'organizations_url': 'https://api.github.com/users/ZolotukhinM/orgs', 'repos_url': 'https://api.github.com/users/ZolotukhinM/repos', 'events_url': 'https://api.github.com/users/ZolotukhinM/events{/privacy}', 'received_events_url': 'https://api.github.com/users/ZolotukhinM/received_events', 'type': 'User', 'site_admin': False}",referenced,1fd91f76f86f1f84a8b0f2f6397ba16f7269b150,https://api.github.com/repos/pytorch/pytorch/commits/1fd91f76f86f1f84a8b0f2f6397ba16f7269b150,2019-08-09T19:15:59Z,30,15,15
23915,2547393732,"{'login': 'ZolotukhinM', 'id': 4588111, 'node_id': 'MDQ6VXNlcjQ1ODgxMTE=', 'avatar_url': 'https://avatars1.githubusercontent.com/u/4588111?v=4', 'gravatar_id': '', 'url': 'https://api.github.com/users/ZolotukhinM', 'html_url': 'https://github.com/ZolotukhinM', 'followers_url': 'https://api.github.com/users/ZolotukhinM/followers', 'following_url': 'https://api.github.com/users/ZolotukhinM/following{/other_user}', 'gists_url': 'https://api.github.com/users/ZolotukhinM/gists{/gist_id}', 'starred_url': 'https://api.github.com/users/ZolotukhinM/starred{/owner}{/repo}', 'subscriptions_url': 'https://api.github.com/users/ZolotukhinM/subscriptions', 'organizations_url': 'https://api.github.com/users/ZolotukhinM/orgs', 'repos_url': 'https://api.github.com/users/ZolotukhinM/repos', 'events_url': 'https://api.github.com/users/ZolotukhinM/events{/privacy}', 'received_events_url': 'https://api.github.com/users/ZolotukhinM/received_events', 'type': 'User', 'site_admin': False}",referenced,a2a8f0f517a80d5864ccba2b899c0af7889c9bf7,https://api.github.com/repos/pytorch/pytorch/commits/a2a8f0f517a80d5864ccba2b899c0af7889c9bf7,2019-08-09T19:16:04Z,86,42,44
23915,2547656457,"{'login': 'ZolotukhinM', 'id': 4588111, 'node_id': 'MDQ6VXNlcjQ1ODgxMTE=', 'avatar_url': 'https://avatars1.githubusercontent.com/u/4588111?v=4', 'gravatar_id': '', 'url': 'https://api.github.com/users/ZolotukhinM', 'html_url': 'https://github.com/ZolotukhinM', 'followers_url': 'https://api.github.com/users/ZolotukhinM/followers', 'following_url': 'https://api.github.com/users/ZolotukhinM/following{/other_user}', 'gists_url': 'https://api.github.com/users/ZolotukhinM/gists{/gist_id}', 'starred_url': 'https://api.github.com/users/ZolotukhinM/starred{/owner}{/repo}', 'subscriptions_url': 'https://api.github.com/users/ZolotukhinM/subscriptions', 'organizations_url': 'https://api.github.com/users/ZolotukhinM/orgs', 'repos_url': 'https://api.github.com/users/ZolotukhinM/repos', 'events_url': 'https://api.github.com/users/ZolotukhinM/events{/privacy}', 'received_events_url': 'https://api.github.com/users/ZolotukhinM/received_events', 'type': 'User', 'site_admin': False}",referenced,be9de9e77ba0fb8d9613093b2be0cbae85b772bd,https://api.github.com/repos/pytorch/pytorch/commits/be9de9e77ba0fb8d9613093b2be0cbae85b772bd,2019-08-09T21:23:40Z,393,197,196
23915,2547656618,"{'login': 'ZolotukhinM', 'id': 4588111, 'node_id': 'MDQ6VXNlcjQ1ODgxMTE=', 'avatar_url': 'https://avatars1.githubusercontent.com/u/4588111?v=4', 'gravatar_id': '', 'url': 'https://api.github.com/users/ZolotukhinM', 'html_url': 'https://github.com/ZolotukhinM', 'followers_url': 'https://api.github.com/users/ZolotukhinM/followers', 'following_url': 'https://api.github.com/users/ZolotukhinM/following{/other_user}', 'gists_url': 'https://api.github.com/users/ZolotukhinM/gists{/gist_id}', 'starred_url': 'https://api.github.com/users/ZolotukhinM/starred{/owner}{/repo}', 'subscriptions_url': 'https://api.github.com/users/ZolotukhinM/subscriptions', 'organizations_url': 'https://api.github.com/users/ZolotukhinM/orgs', 'repos_url': 'https://api.github.com/users/ZolotukhinM/repos', 'events_url': 'https://api.github.com/users/ZolotukhinM/events{/privacy}', 'received_events_url': 'https://api.github.com/users/ZolotukhinM/received_events', 'type': 'User', 'site_admin': False}",referenced,480da4115207b060f773b7a2b21d372085abc913,https://api.github.com/repos/pytorch/pytorch/commits/480da4115207b060f773b7a2b21d372085abc913,2019-08-09T21:23:44Z,86,42,44
23915,2547907466,"{'login': 'facebook-github-bot', 'id': 6422482, 'node_id': 'MDQ6VXNlcjY0MjI0ODI=', 'avatar_url': 'https://avatars3.githubusercontent.com/u/6422482?v=4', 'gravatar_id': '', 'url': 'https://api.github.com/users/facebook-github-bot', 'html_url': 'https://github.com/facebook-github-bot', 'followers_url': 'https://api.github.com/users/facebook-github-bot/followers', 'following_url': 'https://api.github.com/users/facebook-github-bot/following{/other_user}', 'gists_url': 'https://api.github.com/users/facebook-github-bot/gists{/gist_id}', 'starred_url': 'https://api.github.com/users/facebook-github-bot/starred{/owner}{/repo}', 'subscriptions_url': 'https://api.github.com/users/facebook-github-bot/subscriptions', 'organizations_url': 'https://api.github.com/users/facebook-github-bot/orgs', 'repos_url': 'https://api.github.com/users/facebook-github-bot/repos', 'events_url': 'https://api.github.com/users/facebook-github-bot/events{/privacy}', 'received_events_url': 'https://api.github.com/users/facebook-github-bot/received_events', 'type': 'User', 'site_admin': False}",closed,d3f6d5885d68d47d38a475d4fc9cf1611c91920c,https://api.github.com/repos/pytorch/pytorch/commits/d3f6d5885d68d47d38a475d4fc9cf1611c91920c,2019-08-10T01:28:10Z,86,42,44
23901,2546985803,"{'login': 'facebook-github-bot', 'id': 6422482, 'node_id': 'MDQ6VXNlcjY0MjI0ODI=', 'avatar_url': 'https://avatars3.githubusercontent.com/u/6422482?v=4', 'gravatar_id': '', 'url': 'https://api.github.com/users/facebook-github-bot', 'html_url': 'https://github.com/facebook-github-bot', 'followers_url': 'https://api.github.com/users/facebook-github-bot/followers', 'following_url': 'https://api.github.com/users/facebook-github-bot/following{/other_user}', 'gists_url': 'https://api.github.com/users/facebook-github-bot/gists{/gist_id}', 'starred_url': 'https://api.github.com/users/facebook-github-bot/starred{/owner}{/repo}', 'subscriptions_url': 'https://api.github.com/users/facebook-github-bot/subscriptions', 'organizations_url': 'https://api.github.com/users/facebook-github-bot/orgs', 'repos_url': 'https://api.github.com/users/facebook-github-bot/repos', 'events_url': 'https://api.github.com/users/facebook-github-bot/events{/privacy}', 'received_events_url': 'https://api.github.com/users/facebook-github-bot/received_events', 'type': 'User', 'site_admin': False}",referenced,be4e6aff126108a1e8e4657a5115c0fcc5ed3496,https://api.github.com/repos/pytorch/pytorch/commits/be4e6aff126108a1e8e4657a5115c0fcc5ed3496,2019-08-09T16:20:55Z,1381,690,691
23901,2550558153,"{'login': 'facebook-github-bot', 'id': 6422482, 'node_id': 'MDQ6VXNlcjY0MjI0ODI=', 'avatar_url': 'https://avatars3.githubusercontent.com/u/6422482?v=4', 'gravatar_id': '', 'url': 'https://api.github.com/users/facebook-github-bot', 'html_url': 'https://github.com/facebook-github-bot', 'followers_url': 'https://api.github.com/users/facebook-github-bot/followers', 'following_url': 'https://api.github.com/users/facebook-github-bot/following{/other_user}', 'gists_url': 'https://api.github.com/users/facebook-github-bot/gists{/gist_id}', 'starred_url': 'https://api.github.com/users/facebook-github-bot/starred{/owner}{/repo}', 'subscriptions_url': 'https://api.github.com/users/facebook-github-bot/subscriptions', 'organizations_url': 'https://api.github.com/users/facebook-github-bot/orgs', 'repos_url': 'https://api.github.com/users/facebook-github-bot/repos', 'events_url': 'https://api.github.com/users/facebook-github-bot/events{/privacy}', 'received_events_url': 'https://api.github.com/users/facebook-github-bot/received_events', 'type': 'User', 'site_admin': False}",referenced,b9a006f947a1708baa118c070f95c8d14b4fdfc4,https://api.github.com/repos/pytorch/pytorch/commits/b9a006f947a1708baa118c070f95c8d14b4fdfc4,2019-08-12T15:15:27Z,1381,690,691
23882,2547419516,"{'login': 'facebook-github-bot', 'id': 6422482, 'node_id': 'MDQ6VXNlcjY0MjI0ODI=', 'avatar_url': 'https://avatars3.githubusercontent.com/u/6422482?v=4', 'gravatar_id': '', 'url': 'https://api.github.com/users/facebook-github-bot', 'html_url': 'https://github.com/facebook-github-bot', 'followers_url': 'https://api.github.com/users/facebook-github-bot/followers', 'following_url': 'https://api.github.com/users/facebook-github-bot/following{/other_user}', 'gists_url': 'https://api.github.com/users/facebook-github-bot/gists{/gist_id}', 'starred_url': 'https://api.github.com/users/facebook-github-bot/starred{/owner}{/repo}', 'subscriptions_url': 'https://api.github.com/users/facebook-github-bot/subscriptions', 'organizations_url': 'https://api.github.com/users/facebook-github-bot/orgs', 'repos_url': 'https://api.github.com/users/facebook-github-bot/repos', 'events_url': 'https://api.github.com/users/facebook-github-bot/events{/privacy}', 'received_events_url': 'https://api.github.com/users/facebook-github-bot/received_events', 'type': 'User', 'site_admin': False}",referenced,e81f29680784bbae53b2354851c4ae4cec84c2a0,https://api.github.com/repos/pytorch/pytorch/commits/e81f29680784bbae53b2354851c4ae4cec84c2a0,2019-08-09T19:28:09Z,60,43,17
23881,2546985948,"{'login': 'facebook-github-bot', 'id': 6422482, 'node_id': 'MDQ6VXNlcjY0MjI0ODI=', 'avatar_url': 'https://avatars3.githubusercontent.com/u/6422482?v=4', 'gravatar_id': '', 'url': 'https://api.github.com/users/facebook-github-bot', 'html_url': 'https://github.com/facebook-github-bot', 'followers_url': 'https://api.github.com/users/facebook-github-bot/followers', 'following_url': 'https://api.github.com/users/facebook-github-bot/following{/other_user}', 'gists_url': 'https://api.github.com/users/facebook-github-bot/gists{/gist_id}', 'starred_url': 'https://api.github.com/users/facebook-github-bot/starred{/owner}{/repo}', 'subscriptions_url': 'https://api.github.com/users/facebook-github-bot/subscriptions', 'organizations_url': 'https://api.github.com/users/facebook-github-bot/orgs', 'repos_url': 'https://api.github.com/users/facebook-github-bot/repos', 'events_url': 'https://api.github.com/users/facebook-github-bot/events{/privacy}', 'received_events_url': 'https://api.github.com/users/facebook-github-bot/received_events', 'type': 'User', 'site_admin': False}",closed,a0556782a04ab269265e05131f861be76edf556b,https://api.github.com/repos/pytorch/pytorch/commits/a0556782a04ab269265e05131f861be76edf556b,2019-08-09T16:20:58Z,22,0,22
23836,2535022328,"{'login': 'xuhdev', 'id': 325476, 'node_id': 'MDQ6VXNlcjMyNTQ3Ng==', 'avatar_url': 'https://avatars1.githubusercontent.com/u/325476?v=4', 'gravatar_id': '', 'url': 'https://api.github.com/users/xuhdev', 'html_url': 'https://github.com/xuhdev', 'followers_url': 'https://api.github.com/users/xuhdev/followers', 'following_url': 'https://api.github.com/users/xuhdev/following{/other_user}', 'gists_url': 'https://api.github.com/users/xuhdev/gists{/gist_id}', 'starred_url': 'https://api.github.com/users/xuhdev/starred{/owner}{/repo}', 'subscriptions_url': 'https://api.github.com/users/xuhdev/subscriptions', 'organizations_url': 'https://api.github.com/users/xuhdev/orgs', 'repos_url': 'https://api.github.com/users/xuhdev/repos', 'events_url': 'https://api.github.com/users/xuhdev/events{/privacy}', 'received_events_url': 'https://api.github.com/users/xuhdev/received_events', 'type': 'User', 'site_admin': False}",referenced,1a8136f385781d97e9313e068a16f695ff96608b,https://api.github.com/repos/pytorch/pytorch/commits/1a8136f385781d97e9313e068a16f695ff96608b,2019-08-05T23:21:33Z,144,144,0
23836,2535022479,"{'login': 'xuhdev', 'id': 325476, 'node_id': 'MDQ6VXNlcjMyNTQ3Ng==', 'avatar_url': 'https://avatars1.githubusercontent.com/u/325476?v=4', 'gravatar_id': '', 'url': 'https://api.github.com/users/xuhdev', 'html_url': 'https://github.com/xuhdev', 'followers_url': 'https://api.github.com/users/xuhdev/followers', 'following_url': 'https://api.github.com/users/xuhdev/following{/other_user}', 'gists_url': 'https://api.github.com/users/xuhdev/gists{/gist_id}', 'starred_url': 'https://api.github.com/users/xuhdev/starred{/owner}{/repo}', 'subscriptions_url': 'https://api.github.com/users/xuhdev/subscriptions', 'organizations_url': 'https://api.github.com/users/xuhdev/orgs', 'repos_url': 'https://api.github.com/users/xuhdev/repos', 'events_url': 'https://api.github.com/users/xuhdev/events{/privacy}', 'received_events_url': 'https://api.github.com/users/xuhdev/received_events', 'type': 'User', 'site_admin': False}",referenced,0c4959fed496cb989555ebb64c2eb6e6c0094e11,https://api.github.com/repos/pytorch/pytorch/commits/0c4959fed496cb989555ebb64c2eb6e6c0094e11,2019-08-05T23:21:41Z,144,144,0
23836,2535136998,"{'login': 'xuhdev', 'id': 325476, 'node_id': 'MDQ6VXNlcjMyNTQ3Ng==', 'avatar_url': 'https://avatars1.githubusercontent.com/u/325476?v=4', 'gravatar_id': '', 'url': 'https://api.github.com/users/xuhdev', 'html_url': 'https://github.com/xuhdev', 'followers_url': 'https://api.github.com/users/xuhdev/followers', 'following_url': 'https://api.github.com/users/xuhdev/following{/other_user}', 'gists_url': 'https://api.github.com/users/xuhdev/gists{/gist_id}', 'starred_url': 'https://api.github.com/users/xuhdev/starred{/owner}{/repo}', 'subscriptions_url': 'https://api.github.com/users/xuhdev/subscriptions', 'organizations_url': 'https://api.github.com/users/xuhdev/orgs', 'repos_url': 'https://api.github.com/users/xuhdev/repos', 'events_url': 'https://api.github.com/users/xuhdev/events{/privacy}', 'received_events_url': 'https://api.github.com/users/xuhdev/received_events', 'type': 'User', 'site_admin': False}",referenced,fc50491b72b94ee907c8a357d14bcffc4ab7ad4c,https://api.github.com/repos/pytorch/pytorch/commits/fc50491b72b94ee907c8a357d14bcffc4ab7ad4c,2019-08-06T00:56:20Z,113,113,0
23836,2535137351,"{'login': 'xuhdev', 'id': 325476, 'node_id': 'MDQ6VXNlcjMyNTQ3Ng==', 'avatar_url': 'https://avatars1.githubusercontent.com/u/325476?v=4', 'gravatar_id': '', 'url': 'https://api.github.com/users/xuhdev', 'html_url': 'https://github.com/xuhdev', 'followers_url': 'https://api.github.com/users/xuhdev/followers', 'following_url': 'https://api.github.com/users/xuhdev/following{/other_user}', 'gists_url': 'https://api.github.com/users/xuhdev/gists{/gist_id}', 'starred_url': 'https://api.github.com/users/xuhdev/starred{/owner}{/repo}', 'subscriptions_url': 'https://api.github.com/users/xuhdev/subscriptions', 'organizations_url': 'https://api.github.com/users/xuhdev/orgs', 'repos_url': 'https://api.github.com/users/xuhdev/repos', 'events_url': 'https://api.github.com/users/xuhdev/events{/privacy}', 'received_events_url': 'https://api.github.com/users/xuhdev/received_events', 'type': 'User', 'site_admin': False}",referenced,a1de881a2250d3af75a1a8b076f6963bf26d2bc4,https://api.github.com/repos/pytorch/pytorch/commits/a1de881a2250d3af75a1a8b076f6963bf26d2bc4,2019-08-06T00:56:35Z,648,502,146
23836,2535137403,"{'login': 'xuhdev', 'id': 325476, 'node_id': 'MDQ6VXNlcjMyNTQ3Ng==', 'avatar_url': 'https://avatars1.githubusercontent.com/u/325476?v=4', 'gravatar_id': '', 'url': 'https://api.github.com/users/xuhdev', 'html_url': 'https://github.com/xuhdev', 'followers_url': 'https://api.github.com/users/xuhdev/followers', 'following_url': 'https://api.github.com/users/xuhdev/following{/other_user}', 'gists_url': 'https://api.github.com/users/xuhdev/gists{/gist_id}', 'starred_url': 'https://api.github.com/users/xuhdev/starred{/owner}{/repo}', 'subscriptions_url': 'https://api.github.com/users/xuhdev/subscriptions', 'organizations_url': 'https://api.github.com/users/xuhdev/orgs', 'repos_url': 'https://api.github.com/users/xuhdev/repos', 'events_url': 'https://api.github.com/users/xuhdev/events{/privacy}', 'received_events_url': 'https://api.github.com/users/xuhdev/received_events', 'type': 'User', 'site_admin': False}",referenced,40ce507f296bddf89c5b69c6ab8918129d5942f6,https://api.github.com/repos/pytorch/pytorch/commits/40ce507f296bddf89c5b69c6ab8918129d5942f6,2019-08-06T00:56:38Z,113,113,0
23836,2535365811,"{'login': 'xuhdev', 'id': 325476, 'node_id': 'MDQ6VXNlcjMyNTQ3Ng==', 'avatar_url': 'https://avatars1.githubusercontent.com/u/325476?v=4', 'gravatar_id': '', 'url': 'https://api.github.com/users/xuhdev', 'html_url': 'https://github.com/xuhdev', 'followers_url': 'https://api.github.com/users/xuhdev/followers', 'following_url': 'https://api.github.com/users/xuhdev/following{/other_user}', 'gists_url': 'https://api.github.com/users/xuhdev/gists{/gist_id}', 'starred_url': 'https://api.github.com/users/xuhdev/starred{/owner}{/repo}', 'subscriptions_url': 'https://api.github.com/users/xuhdev/subscriptions', 'organizations_url': 'https://api.github.com/users/xuhdev/orgs', 'repos_url': 'https://api.github.com/users/xuhdev/repos', 'events_url': 'https://api.github.com/users/xuhdev/events{/privacy}', 'received_events_url': 'https://api.github.com/users/xuhdev/received_events', 'type': 'User', 'site_admin': False}",referenced,2bd5beed7b8217013ef692383dd21d1d70d79e18,https://api.github.com/repos/pytorch/pytorch/commits/2bd5beed7b8217013ef692383dd21d1d70d79e18,2019-08-06T03:59:30Z,26,21,5
23836,2535365867,"{'login': 'xuhdev', 'id': 325476, 'node_id': 'MDQ6VXNlcjMyNTQ3Ng==', 'avatar_url': 'https://avatars1.githubusercontent.com/u/325476?v=4', 'gravatar_id': '', 'url': 'https://api.github.com/users/xuhdev', 'html_url': 'https://github.com/xuhdev', 'followers_url': 'https://api.github.com/users/xuhdev/followers', 'following_url': 'https://api.github.com/users/xuhdev/following{/other_user}', 'gists_url': 'https://api.github.com/users/xuhdev/gists{/gist_id}', 'starred_url': 'https://api.github.com/users/xuhdev/starred{/owner}{/repo}', 'subscriptions_url': 'https://api.github.com/users/xuhdev/subscriptions', 'organizations_url': 'https://api.github.com/users/xuhdev/orgs', 'repos_url': 'https://api.github.com/users/xuhdev/repos', 'events_url': 'https://api.github.com/users/xuhdev/events{/privacy}', 'received_events_url': 'https://api.github.com/users/xuhdev/received_events', 'type': 'User', 'site_admin': False}",referenced,60fd78568513fa5abd60e1ebc5f201dbf567bb45,https://api.github.com/repos/pytorch/pytorch/commits/60fd78568513fa5abd60e1ebc5f201dbf567bb45,2019-08-06T03:59:32Z,129,129,0
23836,2535573994,"{'login': 'xuhdev', 'id': 325476, 'node_id': 'MDQ6VXNlcjMyNTQ3Ng==', 'avatar_url': 'https://avatars1.githubusercontent.com/u/325476?v=4', 'gravatar_id': '', 'url': 'https://api.github.com/users/xuhdev', 'html_url': 'https://github.com/xuhdev', 'followers_url': 'https://api.github.com/users/xuhdev/followers', 'following_url': 'https://api.github.com/users/xuhdev/following{/other_user}', 'gists_url': 'https://api.github.com/users/xuhdev/gists{/gist_id}', 'starred_url': 'https://api.github.com/users/xuhdev/starred{/owner}{/repo}', 'subscriptions_url': 'https://api.github.com/users/xuhdev/subscriptions', 'organizations_url': 'https://api.github.com/users/xuhdev/orgs', 'repos_url': 'https://api.github.com/users/xuhdev/repos', 'events_url': 'https://api.github.com/users/xuhdev/events{/privacy}', 'received_events_url': 'https://api.github.com/users/xuhdev/received_events', 'type': 'User', 'site_admin': False}",referenced,5c74a92c930bc218b4e8a637e6b57d4c216f3951,https://api.github.com/repos/pytorch/pytorch/commits/5c74a92c930bc218b4e8a637e6b57d4c216f3951,2019-08-06T06:17:40Z,506,244,262
23836,2535574005,"{'login': 'xuhdev', 'id': 325476, 'node_id': 'MDQ6VXNlcjMyNTQ3Ng==', 'avatar_url': 'https://avatars1.githubusercontent.com/u/325476?v=4', 'gravatar_id': '', 'url': 'https://api.github.com/users/xuhdev', 'html_url': 'https://github.com/xuhdev', 'followers_url': 'https://api.github.com/users/xuhdev/followers', 'following_url': 'https://api.github.com/users/xuhdev/following{/other_user}', 'gists_url': 'https://api.github.com/users/xuhdev/gists{/gist_id}', 'starred_url': 'https://api.github.com/users/xuhdev/starred{/owner}{/repo}', 'subscriptions_url': 'https://api.github.com/users/xuhdev/subscriptions', 'organizations_url': 'https://api.github.com/users/xuhdev/orgs', 'repos_url': 'https://api.github.com/users/xuhdev/repos', 'events_url': 'https://api.github.com/users/xuhdev/events{/privacy}', 'received_events_url': 'https://api.github.com/users/xuhdev/received_events', 'type': 'User', 'site_admin': False}",referenced,e7bee774d9d8e7b666e0d385ce49087231fc91e7,https://api.github.com/repos/pytorch/pytorch/commits/e7bee774d9d8e7b666e0d385ce49087231fc91e7,2019-08-06T06:17:40Z,506,244,262
23836,2535574093,"{'login': 'xuhdev', 'id': 325476, 'node_id': 'MDQ6VXNlcjMyNTQ3Ng==', 'avatar_url': 'https://avatars1.githubusercontent.com/u/325476?v=4', 'gravatar_id': '', 'url': 'https://api.github.com/users/xuhdev', 'html_url': 'https://github.com/xuhdev', 'followers_url': 'https://api.github.com/users/xuhdev/followers', 'following_url': 'https://api.github.com/users/xuhdev/following{/other_user}', 'gists_url': 'https://api.github.com/users/xuhdev/gists{/gist_id}', 'starred_url': 'https://api.github.com/users/xuhdev/starred{/owner}{/repo}', 'subscriptions_url': 'https://api.github.com/users/xuhdev/subscriptions', 'organizations_url': 'https://api.github.com/users/xuhdev/orgs', 'repos_url': 'https://api.github.com/users/xuhdev/repos', 'events_url': 'https://api.github.com/users/xuhdev/events{/privacy}', 'received_events_url': 'https://api.github.com/users/xuhdev/received_events', 'type': 'User', 'site_admin': False}",referenced,bca3184c70f951ff3fcb445050f7730eb6c0a7a7,https://api.github.com/repos/pytorch/pytorch/commits/bca3184c70f951ff3fcb445050f7730eb6c0a7a7,2019-08-06T06:17:43Z,129,129,0
23836,2537604396,"{'login': 'xuhdev', 'id': 325476, 'node_id': 'MDQ6VXNlcjMyNTQ3Ng==', 'avatar_url': 'https://avatars1.githubusercontent.com/u/325476?v=4', 'gravatar_id': '', 'url': 'https://api.github.com/users/xuhdev', 'html_url': 'https://github.com/xuhdev', 'followers_url': 'https://api.github.com/users/xuhdev/followers', 'following_url': 'https://api.github.com/users/xuhdev/following{/other_user}', 'gists_url': 'https://api.github.com/users/xuhdev/gists{/gist_id}', 'starred_url': 'https://api.github.com/users/xuhdev/starred{/owner}{/repo}', 'subscriptions_url': 'https://api.github.com/users/xuhdev/subscriptions', 'organizations_url': 'https://api.github.com/users/xuhdev/orgs', 'repos_url': 'https://api.github.com/users/xuhdev/repos', 'events_url': 'https://api.github.com/users/xuhdev/events{/privacy}', 'received_events_url': 'https://api.github.com/users/xuhdev/received_events', 'type': 'User', 'site_admin': False}",referenced,7e70d128c5734bf32831d69e16d7cb8d1b0b5967,https://api.github.com/repos/pytorch/pytorch/commits/7e70d128c5734bf32831d69e16d7cb8d1b0b5967,2019-08-06T17:49:18Z,65,25,40
23836,2537604401,"{'login': 'xuhdev', 'id': 325476, 'node_id': 'MDQ6VXNlcjMyNTQ3Ng==', 'avatar_url': 'https://avatars1.githubusercontent.com/u/325476?v=4', 'gravatar_id': '', 'url': 'https://api.github.com/users/xuhdev', 'html_url': 'https://github.com/xuhdev', 'followers_url': 'https://api.github.com/users/xuhdev/followers', 'following_url': 'https://api.github.com/users/xuhdev/following{/other_user}', 'gists_url': 'https://api.github.com/users/xuhdev/gists{/gist_id}', 'starred_url': 'https://api.github.com/users/xuhdev/starred{/owner}{/repo}', 'subscriptions_url': 'https://api.github.com/users/xuhdev/subscriptions', 'organizations_url': 'https://api.github.com/users/xuhdev/orgs', 'repos_url': 'https://api.github.com/users/xuhdev/repos', 'events_url': 'https://api.github.com/users/xuhdev/events{/privacy}', 'received_events_url': 'https://api.github.com/users/xuhdev/received_events', 'type': 'User', 'site_admin': False}",referenced,9872590265befa48b1fbc47dacf8e353417ab16d,https://api.github.com/repos/pytorch/pytorch/commits/9872590265befa48b1fbc47dacf8e353417ab16d,2019-08-06T17:49:18Z,71,28,43
23836,2537604573,"{'login': 'xuhdev', 'id': 325476, 'node_id': 'MDQ6VXNlcjMyNTQ3Ng==', 'avatar_url': 'https://avatars1.githubusercontent.com/u/325476?v=4', 'gravatar_id': '', 'url': 'https://api.github.com/users/xuhdev', 'html_url': 'https://github.com/xuhdev', 'followers_url': 'https://api.github.com/users/xuhdev/followers', 'following_url': 'https://api.github.com/users/xuhdev/following{/other_user}', 'gists_url': 'https://api.github.com/users/xuhdev/gists{/gist_id}', 'starred_url': 'https://api.github.com/users/xuhdev/starred{/owner}{/repo}', 'subscriptions_url': 'https://api.github.com/users/xuhdev/subscriptions', 'organizations_url': 'https://api.github.com/users/xuhdev/orgs', 'repos_url': 'https://api.github.com/users/xuhdev/repos', 'events_url': 'https://api.github.com/users/xuhdev/events{/privacy}', 'received_events_url': 'https://api.github.com/users/xuhdev/received_events', 'type': 'User', 'site_admin': False}",referenced,b2ed8362c2c06e5e7850202cb6343c27aa4c15ca,https://api.github.com/repos/pytorch/pytorch/commits/b2ed8362c2c06e5e7850202cb6343c27aa4c15ca,2019-08-06T17:49:21Z,71,28,43
23836,2537662002,"{'login': 'xuhdev', 'id': 325476, 'node_id': 'MDQ6VXNlcjMyNTQ3Ng==', 'avatar_url': 'https://avatars1.githubusercontent.com/u/325476?v=4', 'gravatar_id': '', 'url': 'https://api.github.com/users/xuhdev', 'html_url': 'https://github.com/xuhdev', 'followers_url': 'https://api.github.com/users/xuhdev/followers', 'following_url': 'https://api.github.com/users/xuhdev/following{/other_user}', 'gists_url': 'https://api.github.com/users/xuhdev/gists{/gist_id}', 'starred_url': 'https://api.github.com/users/xuhdev/starred{/owner}{/repo}', 'subscriptions_url': 'https://api.github.com/users/xuhdev/subscriptions', 'organizations_url': 'https://api.github.com/users/xuhdev/orgs', 'repos_url': 'https://api.github.com/users/xuhdev/repos', 'events_url': 'https://api.github.com/users/xuhdev/events{/privacy}', 'received_events_url': 'https://api.github.com/users/xuhdev/received_events', 'type': 'User', 'site_admin': False}",referenced,8dbb70bc0804793ad9de3423cf35b584b8098c37,https://api.github.com/repos/pytorch/pytorch/commits/8dbb70bc0804793ad9de3423cf35b584b8098c37,2019-08-06T18:10:24Z,57,37,20
23836,2537662012,"{'login': 'xuhdev', 'id': 325476, 'node_id': 'MDQ6VXNlcjMyNTQ3Ng==', 'avatar_url': 'https://avatars1.githubusercontent.com/u/325476?v=4', 'gravatar_id': '', 'url': 'https://api.github.com/users/xuhdev', 'html_url': 'https://github.com/xuhdev', 'followers_url': 'https://api.github.com/users/xuhdev/followers', 'following_url': 'https://api.github.com/users/xuhdev/following{/other_user}', 'gists_url': 'https://api.github.com/users/xuhdev/gists{/gist_id}', 'starred_url': 'https://api.github.com/users/xuhdev/starred{/owner}{/repo}', 'subscriptions_url': 'https://api.github.com/users/xuhdev/subscriptions', 'organizations_url': 'https://api.github.com/users/xuhdev/orgs', 'repos_url': 'https://api.github.com/users/xuhdev/repos', 'events_url': 'https://api.github.com/users/xuhdev/events{/privacy}', 'received_events_url': 'https://api.github.com/users/xuhdev/received_events', 'type': 'User', 'site_admin': False}",referenced,1c3c1c6f05ab34a5c031a260d718e4dc519469d4,https://api.github.com/repos/pytorch/pytorch/commits/1c3c1c6f05ab34a5c031a260d718e4dc519469d4,2019-08-06T18:10:24Z,57,37,20
23836,2537662017,"{'login': 'xuhdev', 'id': 325476, 'node_id': 'MDQ6VXNlcjMyNTQ3Ng==', 'avatar_url': 'https://avatars1.githubusercontent.com/u/325476?v=4', 'gravatar_id': '', 'url': 'https://api.github.com/users/xuhdev', 'html_url': 'https://github.com/xuhdev', 'followers_url': 'https://api.github.com/users/xuhdev/followers', 'following_url': 'https://api.github.com/users/xuhdev/following{/other_user}', 'gists_url': 'https://api.github.com/users/xuhdev/gists{/gist_id}', 'starred_url': 'https://api.github.com/users/xuhdev/starred{/owner}{/repo}', 'subscriptions_url': 'https://api.github.com/users/xuhdev/subscriptions', 'organizations_url': 'https://api.github.com/users/xuhdev/orgs', 'repos_url': 'https://api.github.com/users/xuhdev/repos', 'events_url': 'https://api.github.com/users/xuhdev/events{/privacy}', 'received_events_url': 'https://api.github.com/users/xuhdev/received_events', 'type': 'User', 'site_admin': False}",referenced,d6502cff967f581fc0096ae661bbc5296194cbec,https://api.github.com/repos/pytorch/pytorch/commits/d6502cff967f581fc0096ae661bbc5296194cbec,2019-08-06T18:10:25Z,57,37,20
23836,2537662294,"{'login': 'xuhdev', 'id': 325476, 'node_id': 'MDQ6VXNlcjMyNTQ3Ng==', 'avatar_url': 'https://avatars1.githubusercontent.com/u/325476?v=4', 'gravatar_id': '', 'url': 'https://api.github.com/users/xuhdev', 'html_url': 'https://github.com/xuhdev', 'followers_url': 'https://api.github.com/users/xuhdev/followers', 'following_url': 'https://api.github.com/users/xuhdev/following{/other_user}', 'gists_url': 'https://api.github.com/users/xuhdev/gists{/gist_id}', 'starred_url': 'https://api.github.com/users/xuhdev/starred{/owner}{/repo}', 'subscriptions_url': 'https://api.github.com/users/xuhdev/subscriptions', 'organizations_url': 'https://api.github.com/users/xuhdev/orgs', 'repos_url': 'https://api.github.com/users/xuhdev/repos', 'events_url': 'https://api.github.com/users/xuhdev/events{/privacy}', 'received_events_url': 'https://api.github.com/users/xuhdev/received_events', 'type': 'User', 'site_admin': False}",referenced,38f46a875a0d85f4272639e3a93dd7cfc1282f87,https://api.github.com/repos/pytorch/pytorch/commits/38f46a875a0d85f4272639e3a93dd7cfc1282f87,2019-08-06T18:10:30Z,57,37,20
23836,2537689504,"{'login': 'xuhdev', 'id': 325476, 'node_id': 'MDQ6VXNlcjMyNTQ3Ng==', 'avatar_url': 'https://avatars1.githubusercontent.com/u/325476?v=4', 'gravatar_id': '', 'url': 'https://api.github.com/users/xuhdev', 'html_url': 'https://github.com/xuhdev', 'followers_url': 'https://api.github.com/users/xuhdev/followers', 'following_url': 'https://api.github.com/users/xuhdev/following{/other_user}', 'gists_url': 'https://api.github.com/users/xuhdev/gists{/gist_id}', 'starred_url': 'https://api.github.com/users/xuhdev/starred{/owner}{/repo}', 'subscriptions_url': 'https://api.github.com/users/xuhdev/subscriptions', 'organizations_url': 'https://api.github.com/users/xuhdev/orgs', 'repos_url': 'https://api.github.com/users/xuhdev/repos', 'events_url': 'https://api.github.com/users/xuhdev/events{/privacy}', 'received_events_url': 'https://api.github.com/users/xuhdev/received_events', 'type': 'User', 'site_admin': False}",referenced,27443655d778ac83570462165066707a18ac8a01,https://api.github.com/repos/pytorch/pytorch/commits/27443655d778ac83570462165066707a18ac8a01,2019-08-06T18:20:16Z,0,0,0
23836,2537689516,"{'login': 'xuhdev', 'id': 325476, 'node_id': 'MDQ6VXNlcjMyNTQ3Ng==', 'avatar_url': 'https://avatars1.githubusercontent.com/u/325476?v=4', 'gravatar_id': '', 'url': 'https://api.github.com/users/xuhdev', 'html_url': 'https://github.com/xuhdev', 'followers_url': 'https://api.github.com/users/xuhdev/followers', 'following_url': 'https://api.github.com/users/xuhdev/following{/other_user}', 'gists_url': 'https://api.github.com/users/xuhdev/gists{/gist_id}', 'starred_url': 'https://api.github.com/users/xuhdev/starred{/owner}{/repo}', 'subscriptions_url': 'https://api.github.com/users/xuhdev/subscriptions', 'organizations_url': 'https://api.github.com/users/xuhdev/orgs', 'repos_url': 'https://api.github.com/users/xuhdev/repos', 'events_url': 'https://api.github.com/users/xuhdev/events{/privacy}', 'received_events_url': 'https://api.github.com/users/xuhdev/received_events', 'type': 'User', 'site_admin': False}",referenced,b79ea724d6bc66fe9f70720bba13249d6d7012af,https://api.github.com/repos/pytorch/pytorch/commits/b79ea724d6bc66fe9f70720bba13249d6d7012af,2019-08-06T18:20:16Z,17,0,17
23836,2537689596,"{'login': 'xuhdev', 'id': 325476, 'node_id': 'MDQ6VXNlcjMyNTQ3Ng==', 'avatar_url': 'https://avatars1.githubusercontent.com/u/325476?v=4', 'gravatar_id': '', 'url': 'https://api.github.com/users/xuhdev', 'html_url': 'https://github.com/xuhdev', 'followers_url': 'https://api.github.com/users/xuhdev/followers', 'following_url': 'https://api.github.com/users/xuhdev/following{/other_user}', 'gists_url': 'https://api.github.com/users/xuhdev/gists{/gist_id}', 'starred_url': 'https://api.github.com/users/xuhdev/starred{/owner}{/repo}', 'subscriptions_url': 'https://api.github.com/users/xuhdev/subscriptions', 'organizations_url': 'https://api.github.com/users/xuhdev/orgs', 'repos_url': 'https://api.github.com/users/xuhdev/repos', 'events_url': 'https://api.github.com/users/xuhdev/events{/privacy}', 'received_events_url': 'https://api.github.com/users/xuhdev/received_events', 'type': 'User', 'site_admin': False}",referenced,6ff0e9d056bc27461e60da0f246be4febffcf44f,https://api.github.com/repos/pytorch/pytorch/commits/6ff0e9d056bc27461e60da0f246be4febffcf44f,2019-08-06T18:20:18Z,17,0,17
23836,2537689703,"{'login': 'xuhdev', 'id': 325476, 'node_id': 'MDQ6VXNlcjMyNTQ3Ng==', 'avatar_url': 'https://avatars1.githubusercontent.com/u/325476?v=4', 'gravatar_id': '', 'url': 'https://api.github.com/users/xuhdev', 'html_url': 'https://github.com/xuhdev', 'followers_url': 'https://api.github.com/users/xuhdev/followers', 'following_url': 'https://api.github.com/users/xuhdev/following{/other_user}', 'gists_url': 'https://api.github.com/users/xuhdev/gists{/gist_id}', 'starred_url': 'https://api.github.com/users/xuhdev/starred{/owner}{/repo}', 'subscriptions_url': 'https://api.github.com/users/xuhdev/subscriptions', 'organizations_url': 'https://api.github.com/users/xuhdev/orgs', 'repos_url': 'https://api.github.com/users/xuhdev/repos', 'events_url': 'https://api.github.com/users/xuhdev/events{/privacy}', 'received_events_url': 'https://api.github.com/users/xuhdev/received_events', 'type': 'User', 'site_admin': False}",referenced,c970e9cc6bf0068ac84b6b8a3e9424ed2b843062,https://api.github.com/repos/pytorch/pytorch/commits/c970e9cc6bf0068ac84b6b8a3e9424ed2b843062,2019-08-06T18:20:21Z,17,0,17
23836,2537759376,"{'login': 'xuhdev', 'id': 325476, 'node_id': 'MDQ6VXNlcjMyNTQ3Ng==', 'avatar_url': 'https://avatars1.githubusercontent.com/u/325476?v=4', 'gravatar_id': '', 'url': 'https://api.github.com/users/xuhdev', 'html_url': 'https://github.com/xuhdev', 'followers_url': 'https://api.github.com/users/xuhdev/followers', 'following_url': 'https://api.github.com/users/xuhdev/following{/other_user}', 'gists_url': 'https://api.github.com/users/xuhdev/gists{/gist_id}', 'starred_url': 'https://api.github.com/users/xuhdev/starred{/owner}{/repo}', 'subscriptions_url': 'https://api.github.com/users/xuhdev/subscriptions', 'organizations_url': 'https://api.github.com/users/xuhdev/orgs', 'repos_url': 'https://api.github.com/users/xuhdev/repos', 'events_url': 'https://api.github.com/users/xuhdev/events{/privacy}', 'received_events_url': 'https://api.github.com/users/xuhdev/received_events', 'type': 'User', 'site_admin': False}",referenced,90ac728580a993a145ec765556cdfe507a9f4e06,https://api.github.com/repos/pytorch/pytorch/commits/90ac728580a993a145ec765556cdfe507a9f4e06,2019-08-06T18:45:43Z,0,0,0
23836,2537759422,"{'login': 'xuhdev', 'id': 325476, 'node_id': 'MDQ6VXNlcjMyNTQ3Ng==', 'avatar_url': 'https://avatars1.githubusercontent.com/u/325476?v=4', 'gravatar_id': '', 'url': 'https://api.github.com/users/xuhdev', 'html_url': 'https://github.com/xuhdev', 'followers_url': 'https://api.github.com/users/xuhdev/followers', 'following_url': 'https://api.github.com/users/xuhdev/following{/other_user}', 'gists_url': 'https://api.github.com/users/xuhdev/gists{/gist_id}', 'starred_url': 'https://api.github.com/users/xuhdev/starred{/owner}{/repo}', 'subscriptions_url': 'https://api.github.com/users/xuhdev/subscriptions', 'organizations_url': 'https://api.github.com/users/xuhdev/orgs', 'repos_url': 'https://api.github.com/users/xuhdev/repos', 'events_url': 'https://api.github.com/users/xuhdev/events{/privacy}', 'received_events_url': 'https://api.github.com/users/xuhdev/received_events', 'type': 'User', 'site_admin': False}",referenced,52327d9d4059242c4ebe00995326f21c937b56ba,https://api.github.com/repos/pytorch/pytorch/commits/52327d9d4059242c4ebe00995326f21c937b56ba,2019-08-06T18:45:44Z,24,8,16
23815,2730765914,"{'login': 'facebook-github-bot', 'id': 6422482, 'node_id': 'MDQ6VXNlcjY0MjI0ODI=', 'avatar_url': 'https://avatars3.githubusercontent.com/u/6422482?v=4', 'gravatar_id': '', 'url': 'https://api.github.com/users/facebook-github-bot', 'html_url': 'https://github.com/facebook-github-bot', 'followers_url': 'https://api.github.com/users/facebook-github-bot/followers', 'following_url': 'https://api.github.com/users/facebook-github-bot/following{/other_user}', 'gists_url': 'https://api.github.com/users/facebook-github-bot/gists{/gist_id}', 'starred_url': 'https://api.github.com/users/facebook-github-bot/starred{/owner}{/repo}', 'subscriptions_url': 'https://api.github.com/users/facebook-github-bot/subscriptions', 'organizations_url': 'https://api.github.com/users/facebook-github-bot/orgs', 'repos_url': 'https://api.github.com/users/facebook-github-bot/repos', 'events_url': 'https://api.github.com/users/facebook-github-bot/events{/privacy}', 'received_events_url': 'https://api.github.com/users/facebook-github-bot/received_events', 'type': 'User', 'site_admin': False}",referenced,bc57967e07ce0c1ad1e0b494373250da245b6921,https://api.github.com/repos/pytorch/pytorch/commits/bc57967e07ce0c1ad1e0b494373250da245b6921,2019-10-21T18:28:24Z,396,326,70
23796,2659106030,"{'login': 'vincentqb', 'id': 3047868, 'node_id': 'MDQ6VXNlcjMwNDc4Njg=', 'avatar_url': 'https://avatars0.githubusercontent.com/u/3047868?v=4', 'gravatar_id': '', 'url': 'https://api.github.com/users/vincentqb', 'html_url': 'https://github.com/vincentqb', 'followers_url': 'https://api.github.com/users/vincentqb/followers', 'following_url': 'https://api.github.com/users/vincentqb/following{/other_user}', 'gists_url': 'https://api.github.com/users/vincentqb/gists{/gist_id}', 'starred_url': 'https://api.github.com/users/vincentqb/starred{/owner}{/repo}', 'subscriptions_url': 'https://api.github.com/users/vincentqb/subscriptions', 'organizations_url': 'https://api.github.com/users/vincentqb/orgs', 'repos_url': 'https://api.github.com/users/vincentqb/repos', 'events_url': 'https://api.github.com/users/vincentqb/events{/privacy}', 'received_events_url': 'https://api.github.com/users/vincentqb/received_events', 'type': 'User', 'site_admin': False}",referenced,12dcaf13e651a9f60e44990a3c6e39f9e6e98c0e,https://api.github.com/repos/pytorch/pytorch/commits/12dcaf13e651a9f60e44990a3c6e39f9e6e98c0e,2019-09-24T18:30:06Z,3,3,0
23796,2659106663,"{'login': 'vincentqb', 'id': 3047868, 'node_id': 'MDQ6VXNlcjMwNDc4Njg=', 'avatar_url': 'https://avatars0.githubusercontent.com/u/3047868?v=4', 'gravatar_id': '', 'url': 'https://api.github.com/users/vincentqb', 'html_url': 'https://github.com/vincentqb', 'followers_url': 'https://api.github.com/users/vincentqb/followers', 'following_url': 'https://api.github.com/users/vincentqb/following{/other_user}', 'gists_url': 'https://api.github.com/users/vincentqb/gists{/gist_id}', 'starred_url': 'https://api.github.com/users/vincentqb/starred{/owner}{/repo}', 'subscriptions_url': 'https://api.github.com/users/vincentqb/subscriptions', 'organizations_url': 'https://api.github.com/users/vincentqb/orgs', 'repos_url': 'https://api.github.com/users/vincentqb/repos', 'events_url': 'https://api.github.com/users/vincentqb/events{/privacy}', 'received_events_url': 'https://api.github.com/users/vincentqb/received_events', 'type': 'User', 'site_admin': False}",referenced,beb6608e6a8967d4ab2ef08a53bd480b7fce540c,https://api.github.com/repos/pytorch/pytorch/commits/beb6608e6a8967d4ab2ef08a53bd480b7fce540c,2019-09-24T18:30:16Z,3,3,0
23796,2659114326,"{'login': 'vincentqb', 'id': 3047868, 'node_id': 'MDQ6VXNlcjMwNDc4Njg=', 'avatar_url': 'https://avatars0.githubusercontent.com/u/3047868?v=4', 'gravatar_id': '', 'url': 'https://api.github.com/users/vincentqb', 'html_url': 'https://github.com/vincentqb', 'followers_url': 'https://api.github.com/users/vincentqb/followers', 'following_url': 'https://api.github.com/users/vincentqb/following{/other_user}', 'gists_url': 'https://api.github.com/users/vincentqb/gists{/gist_id}', 'starred_url': 'https://api.github.com/users/vincentqb/starred{/owner}{/repo}', 'subscriptions_url': 'https://api.github.com/users/vincentqb/subscriptions', 'organizations_url': 'https://api.github.com/users/vincentqb/orgs', 'repos_url': 'https://api.github.com/users/vincentqb/repos', 'events_url': 'https://api.github.com/users/vincentqb/events{/privacy}', 'received_events_url': 'https://api.github.com/users/vincentqb/received_events', 'type': 'User', 'site_admin': False}",referenced,bbe85afcc98f9de9bab487af3589040ca5c5b7d4,https://api.github.com/repos/pytorch/pytorch/commits/bbe85afcc98f9de9bab487af3589040ca5c5b7d4,2019-09-24T18:32:37Z,3,3,0
23796,2659643222,"{'login': 'vincentqb', 'id': 3047868, 'node_id': 'MDQ6VXNlcjMwNDc4Njg=', 'avatar_url': 'https://avatars0.githubusercontent.com/u/3047868?v=4', 'gravatar_id': '', 'url': 'https://api.github.com/users/vincentqb', 'html_url': 'https://github.com/vincentqb', 'followers_url': 'https://api.github.com/users/vincentqb/followers', 'following_url': 'https://api.github.com/users/vincentqb/following{/other_user}', 'gists_url': 'https://api.github.com/users/vincentqb/gists{/gist_id}', 'starred_url': 'https://api.github.com/users/vincentqb/starred{/owner}{/repo}', 'subscriptions_url': 'https://api.github.com/users/vincentqb/subscriptions', 'organizations_url': 'https://api.github.com/users/vincentqb/orgs', 'repos_url': 'https://api.github.com/users/vincentqb/repos', 'events_url': 'https://api.github.com/users/vincentqb/events{/privacy}', 'received_events_url': 'https://api.github.com/users/vincentqb/received_events', 'type': 'User', 'site_admin': False}",referenced,e4a3bae8781892abbbb401dfb9d05119d3eb1514,https://api.github.com/repos/pytorch/pytorch/commits/e4a3bae8781892abbbb401dfb9d05119d3eb1514,2019-09-24T21:44:39Z,8,7,1
23796,2661711842,"{'login': 'vincentqb', 'id': 3047868, 'node_id': 'MDQ6VXNlcjMwNDc4Njg=', 'avatar_url': 'https://avatars0.githubusercontent.com/u/3047868?v=4', 'gravatar_id': '', 'url': 'https://api.github.com/users/vincentqb', 'html_url': 'https://github.com/vincentqb', 'followers_url': 'https://api.github.com/users/vincentqb/followers', 'following_url': 'https://api.github.com/users/vincentqb/following{/other_user}', 'gists_url': 'https://api.github.com/users/vincentqb/gists{/gist_id}', 'starred_url': 'https://api.github.com/users/vincentqb/starred{/owner}{/repo}', 'subscriptions_url': 'https://api.github.com/users/vincentqb/subscriptions', 'organizations_url': 'https://api.github.com/users/vincentqb/orgs', 'repos_url': 'https://api.github.com/users/vincentqb/repos', 'events_url': 'https://api.github.com/users/vincentqb/events{/privacy}', 'received_events_url': 'https://api.github.com/users/vincentqb/received_events', 'type': 'User', 'site_admin': False}",referenced,014019d518d5705ca5605f036df504c7e464ca07,https://api.github.com/repos/pytorch/pytorch/commits/014019d518d5705ca5605f036df504c7e464ca07,2019-09-25T13:34:48Z,8,7,1
23763,2531538989,"{'login': 'jamesr66a', 'id': 4685384, 'node_id': 'MDQ6VXNlcjQ2ODUzODQ=', 'avatar_url': 'https://avatars2.githubusercontent.com/u/4685384?v=4', 'gravatar_id': '', 'url': 'https://api.github.com/users/jamesr66a', 'html_url': 'https://github.com/jamesr66a', 'followers_url': 'https://api.github.com/users/jamesr66a/followers', 'following_url': 'https://api.github.com/users/jamesr66a/following{/other_user}', 'gists_url': 'https://api.github.com/users/jamesr66a/gists{/gist_id}', 'starred_url': 'https://api.github.com/users/jamesr66a/starred{/owner}{/repo}', 'subscriptions_url': 'https://api.github.com/users/jamesr66a/subscriptions', 'organizations_url': 'https://api.github.com/users/jamesr66a/orgs', 'repos_url': 'https://api.github.com/users/jamesr66a/repos', 'events_url': 'https://api.github.com/users/jamesr66a/events{/privacy}', 'received_events_url': 'https://api.github.com/users/jamesr66a/received_events', 'type': 'User', 'site_admin': False}",referenced,01cde1515b0b8dd9882d9bf1c78eaa06516f58c8,https://api.github.com/repos/pytorch/pytorch/commits/01cde1515b0b8dd9882d9bf1c78eaa06516f58c8,2019-08-04T00:39:25Z,7,5,2
23763,2531544993,"{'login': 'jamesr66a', 'id': 4685384, 'node_id': 'MDQ6VXNlcjQ2ODUzODQ=', 'avatar_url': 'https://avatars2.githubusercontent.com/u/4685384?v=4', 'gravatar_id': '', 'url': 'https://api.github.com/users/jamesr66a', 'html_url': 'https://github.com/jamesr66a', 'followers_url': 'https://api.github.com/users/jamesr66a/followers', 'following_url': 'https://api.github.com/users/jamesr66a/following{/other_user}', 'gists_url': 'https://api.github.com/users/jamesr66a/gists{/gist_id}', 'starred_url': 'https://api.github.com/users/jamesr66a/starred{/owner}{/repo}', 'subscriptions_url': 'https://api.github.com/users/jamesr66a/subscriptions', 'organizations_url': 'https://api.github.com/users/jamesr66a/orgs', 'repos_url': 'https://api.github.com/users/jamesr66a/repos', 'events_url': 'https://api.github.com/users/jamesr66a/events{/privacy}', 'received_events_url': 'https://api.github.com/users/jamesr66a/received_events', 'type': 'User', 'site_admin': False}",referenced,7860153aaee07e5846931ffd66fa45d39d4c8ed6,https://api.github.com/repos/pytorch/pytorch/commits/7860153aaee07e5846931ffd66fa45d39d4c8ed6,2019-08-04T01:08:26Z,8,8,0
23763,2531546251,"{'login': 'jamesr66a', 'id': 4685384, 'node_id': 'MDQ6VXNlcjQ2ODUzODQ=', 'avatar_url': 'https://avatars2.githubusercontent.com/u/4685384?v=4', 'gravatar_id': '', 'url': 'https://api.github.com/users/jamesr66a', 'html_url': 'https://github.com/jamesr66a', 'followers_url': 'https://api.github.com/users/jamesr66a/followers', 'following_url': 'https://api.github.com/users/jamesr66a/following{/other_user}', 'gists_url': 'https://api.github.com/users/jamesr66a/gists{/gist_id}', 'starred_url': 'https://api.github.com/users/jamesr66a/starred{/owner}{/repo}', 'subscriptions_url': 'https://api.github.com/users/jamesr66a/subscriptions', 'organizations_url': 'https://api.github.com/users/jamesr66a/orgs', 'repos_url': 'https://api.github.com/users/jamesr66a/repos', 'events_url': 'https://api.github.com/users/jamesr66a/events{/privacy}', 'received_events_url': 'https://api.github.com/users/jamesr66a/received_events', 'type': 'User', 'site_admin': False}",referenced,8cf8771d967de5f5374fba7fbabd5b725a5ef6c4,https://api.github.com/repos/pytorch/pytorch/commits/8cf8771d967de5f5374fba7fbabd5b725a5ef6c4,2019-08-04T01:14:37Z,1,1,0
23763,2531580411,"{'login': 'jamesr66a', 'id': 4685384, 'node_id': 'MDQ6VXNlcjQ2ODUzODQ=', 'avatar_url': 'https://avatars2.githubusercontent.com/u/4685384?v=4', 'gravatar_id': '', 'url': 'https://api.github.com/users/jamesr66a', 'html_url': 'https://github.com/jamesr66a', 'followers_url': 'https://api.github.com/users/jamesr66a/followers', 'following_url': 'https://api.github.com/users/jamesr66a/following{/other_user}', 'gists_url': 'https://api.github.com/users/jamesr66a/gists{/gist_id}', 'starred_url': 'https://api.github.com/users/jamesr66a/starred{/owner}{/repo}', 'subscriptions_url': 'https://api.github.com/users/jamesr66a/subscriptions', 'organizations_url': 'https://api.github.com/users/jamesr66a/orgs', 'repos_url': 'https://api.github.com/users/jamesr66a/repos', 'events_url': 'https://api.github.com/users/jamesr66a/events{/privacy}', 'received_events_url': 'https://api.github.com/users/jamesr66a/received_events', 'type': 'User', 'site_admin': False}",referenced,e93b9746cd1ec9fcdfdcf33258c276e67cb792a8,https://api.github.com/repos/pytorch/pytorch/commits/e93b9746cd1ec9fcdfdcf33258c276e67cb792a8,2019-08-04T03:49:17Z,1,1,0
23763,2532035564,"{'login': 'jamesr66a', 'id': 4685384, 'node_id': 'MDQ6VXNlcjQ2ODUzODQ=', 'avatar_url': 'https://avatars2.githubusercontent.com/u/4685384?v=4', 'gravatar_id': '', 'url': 'https://api.github.com/users/jamesr66a', 'html_url': 'https://github.com/jamesr66a', 'followers_url': 'https://api.github.com/users/jamesr66a/followers', 'following_url': 'https://api.github.com/users/jamesr66a/following{/other_user}', 'gists_url': 'https://api.github.com/users/jamesr66a/gists{/gist_id}', 'starred_url': 'https://api.github.com/users/jamesr66a/starred{/owner}{/repo}', 'subscriptions_url': 'https://api.github.com/users/jamesr66a/subscriptions', 'organizations_url': 'https://api.github.com/users/jamesr66a/orgs', 'repos_url': 'https://api.github.com/users/jamesr66a/repos', 'events_url': 'https://api.github.com/users/jamesr66a/events{/privacy}', 'received_events_url': 'https://api.github.com/users/jamesr66a/received_events', 'type': 'User', 'site_admin': False}",referenced,f82e2ce67e251e20ce214b831ae7314a5d4ac1e9,https://api.github.com/repos/pytorch/pytorch/commits/f82e2ce67e251e20ce214b831ae7314a5d4ac1e9,2019-08-05T00:09:13Z,22,11,11
23763,2534984563,"{'login': 'jamesr66a', 'id': 4685384, 'node_id': 'MDQ6VXNlcjQ2ODUzODQ=', 'avatar_url': 'https://avatars2.githubusercontent.com/u/4685384?v=4', 'gravatar_id': '', 'url': 'https://api.github.com/users/jamesr66a', 'html_url': 'https://github.com/jamesr66a', 'followers_url': 'https://api.github.com/users/jamesr66a/followers', 'following_url': 'https://api.github.com/users/jamesr66a/following{/other_user}', 'gists_url': 'https://api.github.com/users/jamesr66a/gists{/gist_id}', 'starred_url': 'https://api.github.com/users/jamesr66a/starred{/owner}{/repo}', 'subscriptions_url': 'https://api.github.com/users/jamesr66a/subscriptions', 'organizations_url': 'https://api.github.com/users/jamesr66a/orgs', 'repos_url': 'https://api.github.com/users/jamesr66a/repos', 'events_url': 'https://api.github.com/users/jamesr66a/events{/privacy}', 'received_events_url': 'https://api.github.com/users/jamesr66a/received_events', 'type': 'User', 'site_admin': False}",referenced,21165fa8be6e91fba7c320e34d87789adeb7a75e,https://api.github.com/repos/pytorch/pytorch/commits/21165fa8be6e91fba7c320e34d87789adeb7a75e,2019-08-05T22:55:18Z,185,109,76
23763,2534988052,"{'login': 'jamesr66a', 'id': 4685384, 'node_id': 'MDQ6VXNlcjQ2ODUzODQ=', 'avatar_url': 'https://avatars2.githubusercontent.com/u/4685384?v=4', 'gravatar_id': '', 'url': 'https://api.github.com/users/jamesr66a', 'html_url': 'https://github.com/jamesr66a', 'followers_url': 'https://api.github.com/users/jamesr66a/followers', 'following_url': 'https://api.github.com/users/jamesr66a/following{/other_user}', 'gists_url': 'https://api.github.com/users/jamesr66a/gists{/gist_id}', 'starred_url': 'https://api.github.com/users/jamesr66a/starred{/owner}{/repo}', 'subscriptions_url': 'https://api.github.com/users/jamesr66a/subscriptions', 'organizations_url': 'https://api.github.com/users/jamesr66a/orgs', 'repos_url': 'https://api.github.com/users/jamesr66a/repos', 'events_url': 'https://api.github.com/users/jamesr66a/events{/privacy}', 'received_events_url': 'https://api.github.com/users/jamesr66a/received_events', 'type': 'User', 'site_admin': False}",referenced,20aabb0e11e89351d885c5ec9e32c9668ae80f53,https://api.github.com/repos/pytorch/pytorch/commits/20aabb0e11e89351d885c5ec9e32c9668ae80f53,2019-08-05T22:57:38Z,18,18,0
23763,2534989871,"{'login': 'jamesr66a', 'id': 4685384, 'node_id': 'MDQ6VXNlcjQ2ODUzODQ=', 'avatar_url': 'https://avatars2.githubusercontent.com/u/4685384?v=4', 'gravatar_id': '', 'url': 'https://api.github.com/users/jamesr66a', 'html_url': 'https://github.com/jamesr66a', 'followers_url': 'https://api.github.com/users/jamesr66a/followers', 'following_url': 'https://api.github.com/users/jamesr66a/following{/other_user}', 'gists_url': 'https://api.github.com/users/jamesr66a/gists{/gist_id}', 'starred_url': 'https://api.github.com/users/jamesr66a/starred{/owner}{/repo}', 'subscriptions_url': 'https://api.github.com/users/jamesr66a/subscriptions', 'organizations_url': 'https://api.github.com/users/jamesr66a/orgs', 'repos_url': 'https://api.github.com/users/jamesr66a/repos', 'events_url': 'https://api.github.com/users/jamesr66a/events{/privacy}', 'received_events_url': 'https://api.github.com/users/jamesr66a/received_events', 'type': 'User', 'site_admin': False}",referenced,5be74ee1fe5b1cd1763f9bed4104d48e80d98bab,https://api.github.com/repos/pytorch/pytorch/commits/5be74ee1fe5b1cd1763f9bed4104d48e80d98bab,2019-08-05T22:58:49Z,0,0,0
23763,2535008273,"{'login': 'jamesr66a', 'id': 4685384, 'node_id': 'MDQ6VXNlcjQ2ODUzODQ=', 'avatar_url': 'https://avatars2.githubusercontent.com/u/4685384?v=4', 'gravatar_id': '', 'url': 'https://api.github.com/users/jamesr66a', 'html_url': 'https://github.com/jamesr66a', 'followers_url': 'https://api.github.com/users/jamesr66a/followers', 'following_url': 'https://api.github.com/users/jamesr66a/following{/other_user}', 'gists_url': 'https://api.github.com/users/jamesr66a/gists{/gist_id}', 'starred_url': 'https://api.github.com/users/jamesr66a/starred{/owner}{/repo}', 'subscriptions_url': 'https://api.github.com/users/jamesr66a/subscriptions', 'organizations_url': 'https://api.github.com/users/jamesr66a/orgs', 'repos_url': 'https://api.github.com/users/jamesr66a/repos', 'events_url': 'https://api.github.com/users/jamesr66a/events{/privacy}', 'received_events_url': 'https://api.github.com/users/jamesr66a/received_events', 'type': 'User', 'site_admin': False}",referenced,328ddd88d0bebc21364721dd54fa165e7acb9361,https://api.github.com/repos/pytorch/pytorch/commits/328ddd88d0bebc21364721dd54fa165e7acb9361,2019-08-05T23:11:52Z,32,17,15
23763,2535051995,"{'login': 'jamesr66a', 'id': 4685384, 'node_id': 'MDQ6VXNlcjQ2ODUzODQ=', 'avatar_url': 'https://avatars2.githubusercontent.com/u/4685384?v=4', 'gravatar_id': '', 'url': 'https://api.github.com/users/jamesr66a', 'html_url': 'https://github.com/jamesr66a', 'followers_url': 'https://api.github.com/users/jamesr66a/followers', 'following_url': 'https://api.github.com/users/jamesr66a/following{/other_user}', 'gists_url': 'https://api.github.com/users/jamesr66a/gists{/gist_id}', 'starred_url': 'https://api.github.com/users/jamesr66a/starred{/owner}{/repo}', 'subscriptions_url': 'https://api.github.com/users/jamesr66a/subscriptions', 'organizations_url': 'https://api.github.com/users/jamesr66a/orgs', 'repos_url': 'https://api.github.com/users/jamesr66a/repos', 'events_url': 'https://api.github.com/users/jamesr66a/events{/privacy}', 'received_events_url': 'https://api.github.com/users/jamesr66a/received_events', 'type': 'User', 'site_admin': False}",referenced,f363e7db16f7bc377140faef613378ddb50f12e2,https://api.github.com/repos/pytorch/pytorch/commits/f363e7db16f7bc377140faef613378ddb50f12e2,2019-08-05T23:43:33Z,3474,2933,541
23763,2535415682,"{'login': 'jamesr66a', 'id': 4685384, 'node_id': 'MDQ6VXNlcjQ2ODUzODQ=', 'avatar_url': 'https://avatars2.githubusercontent.com/u/4685384?v=4', 'gravatar_id': '', 'url': 'https://api.github.com/users/jamesr66a', 'html_url': 'https://github.com/jamesr66a', 'followers_url': 'https://api.github.com/users/jamesr66a/followers', 'following_url': 'https://api.github.com/users/jamesr66a/following{/other_user}', 'gists_url': 'https://api.github.com/users/jamesr66a/gists{/gist_id}', 'starred_url': 'https://api.github.com/users/jamesr66a/starred{/owner}{/repo}', 'subscriptions_url': 'https://api.github.com/users/jamesr66a/subscriptions', 'organizations_url': 'https://api.github.com/users/jamesr66a/orgs', 'repos_url': 'https://api.github.com/users/jamesr66a/repos', 'events_url': 'https://api.github.com/users/jamesr66a/events{/privacy}', 'received_events_url': 'https://api.github.com/users/jamesr66a/received_events', 'type': 'User', 'site_admin': False}",referenced,29ac74299aa59f0a45481a5501052d042c5360ad,https://api.github.com/repos/pytorch/pytorch/commits/29ac74299aa59f0a45481a5501052d042c5360ad,2019-08-06T04:39:16Z,29,20,9
23757,2540732163,"{'login': 'facebook-github-bot', 'id': 6422482, 'node_id': 'MDQ6VXNlcjY0MjI0ODI=', 'avatar_url': 'https://avatars3.githubusercontent.com/u/6422482?v=4', 'gravatar_id': '', 'url': 'https://api.github.com/users/facebook-github-bot', 'html_url': 'https://github.com/facebook-github-bot', 'followers_url': 'https://api.github.com/users/facebook-github-bot/followers', 'following_url': 'https://api.github.com/users/facebook-github-bot/following{/other_user}', 'gists_url': 'https://api.github.com/users/facebook-github-bot/gists{/gist_id}', 'starred_url': 'https://api.github.com/users/facebook-github-bot/starred{/owner}{/repo}', 'subscriptions_url': 'https://api.github.com/users/facebook-github-bot/subscriptions', 'organizations_url': 'https://api.github.com/users/facebook-github-bot/orgs', 'repos_url': 'https://api.github.com/users/facebook-github-bot/repos', 'events_url': 'https://api.github.com/users/facebook-github-bot/events{/privacy}', 'received_events_url': 'https://api.github.com/users/facebook-github-bot/received_events', 'type': 'User', 'site_admin': False}",closed,5411d1a27b59d86d2ffbb5a08e948b5c76c4d362,https://api.github.com/repos/pytorch/pytorch/commits/5411d1a27b59d86d2ffbb5a08e948b5c76c4d362,2019-08-07T16:45:14Z,2,1,1
23729,2562595644,"{'login': 'facebook-github-bot', 'id': 6422482, 'node_id': 'MDQ6VXNlcjY0MjI0ODI=', 'avatar_url': 'https://avatars3.githubusercontent.com/u/6422482?v=4', 'gravatar_id': '', 'url': 'https://api.github.com/users/facebook-github-bot', 'html_url': 'https://github.com/facebook-github-bot', 'followers_url': 'https://api.github.com/users/facebook-github-bot/followers', 'following_url': 'https://api.github.com/users/facebook-github-bot/following{/other_user}', 'gists_url': 'https://api.github.com/users/facebook-github-bot/gists{/gist_id}', 'starred_url': 'https://api.github.com/users/facebook-github-bot/starred{/owner}{/repo}', 'subscriptions_url': 'https://api.github.com/users/facebook-github-bot/subscriptions', 'organizations_url': 'https://api.github.com/users/facebook-github-bot/orgs', 'repos_url': 'https://api.github.com/users/facebook-github-bot/repos', 'events_url': 'https://api.github.com/users/facebook-github-bot/events{/privacy}', 'received_events_url': 'https://api.github.com/users/facebook-github-bot/received_events', 'type': 'User', 'site_admin': False}",referenced,e1668115987efa570f68a2bcd5b642749d177ea4,https://api.github.com/repos/pytorch/pytorch/commits/e1668115987efa570f68a2bcd5b642749d177ea4,2019-08-16T15:10:38Z,20,19,1
23688,2531111733,"{'login': 'facebook-github-bot', 'id': 6422482, 'node_id': 'MDQ6VXNlcjY0MjI0ODI=', 'avatar_url': 'https://avatars3.githubusercontent.com/u/6422482?v=4', 'gravatar_id': '', 'url': 'https://api.github.com/users/facebook-github-bot', 'html_url': 'https://github.com/facebook-github-bot', 'followers_url': 'https://api.github.com/users/facebook-github-bot/followers', 'following_url': 'https://api.github.com/users/facebook-github-bot/following{/other_user}', 'gists_url': 'https://api.github.com/users/facebook-github-bot/gists{/gist_id}', 'starred_url': 'https://api.github.com/users/facebook-github-bot/starred{/owner}{/repo}', 'subscriptions_url': 'https://api.github.com/users/facebook-github-bot/subscriptions', 'organizations_url': 'https://api.github.com/users/facebook-github-bot/orgs', 'repos_url': 'https://api.github.com/users/facebook-github-bot/repos', 'events_url': 'https://api.github.com/users/facebook-github-bot/events{/privacy}', 'received_events_url': 'https://api.github.com/users/facebook-github-bot/received_events', 'type': 'User', 'site_admin': False}",closed,8e2b9de8604824848747e4fd725c618aab7fd268,https://api.github.com/repos/pytorch/pytorch/commits/8e2b9de8604824848747e4fd725c618aab7fd268,2019-08-03T03:05:29Z,37,37,0
23670,2532046081,"{'login': 'facebook-github-bot', 'id': 6422482, 'node_id': 'MDQ6VXNlcjY0MjI0ODI=', 'avatar_url': 'https://avatars3.githubusercontent.com/u/6422482?v=4', 'gravatar_id': '', 'url': 'https://api.github.com/users/facebook-github-bot', 'html_url': 'https://github.com/facebook-github-bot', 'followers_url': 'https://api.github.com/users/facebook-github-bot/followers', 'following_url': 'https://api.github.com/users/facebook-github-bot/following{/other_user}', 'gists_url': 'https://api.github.com/users/facebook-github-bot/gists{/gist_id}', 'starred_url': 'https://api.github.com/users/facebook-github-bot/starred{/owner}{/repo}', 'subscriptions_url': 'https://api.github.com/users/facebook-github-bot/subscriptions', 'organizations_url': 'https://api.github.com/users/facebook-github-bot/orgs', 'repos_url': 'https://api.github.com/users/facebook-github-bot/repos', 'events_url': 'https://api.github.com/users/facebook-github-bot/events{/privacy}', 'received_events_url': 'https://api.github.com/users/facebook-github-bot/received_events', 'type': 'User', 'site_admin': False}",closed,6313d5e28bd47b03142d6142acbf019d92974db9,https://api.github.com/repos/pytorch/pytorch/commits/6313d5e28bd47b03142d6142acbf019d92974db9,2019-08-05T00:26:57Z,9,9,0
23642,2528031709,"{'login': 'facebook-github-bot', 'id': 6422482, 'node_id': 'MDQ6VXNlcjY0MjI0ODI=', 'avatar_url': 'https://avatars3.githubusercontent.com/u/6422482?v=4', 'gravatar_id': '', 'url': 'https://api.github.com/users/facebook-github-bot', 'html_url': 'https://github.com/facebook-github-bot', 'followers_url': 'https://api.github.com/users/facebook-github-bot/followers', 'following_url': 'https://api.github.com/users/facebook-github-bot/following{/other_user}', 'gists_url': 'https://api.github.com/users/facebook-github-bot/gists{/gist_id}', 'starred_url': 'https://api.github.com/users/facebook-github-bot/starred{/owner}{/repo}', 'subscriptions_url': 'https://api.github.com/users/facebook-github-bot/subscriptions', 'organizations_url': 'https://api.github.com/users/facebook-github-bot/orgs', 'repos_url': 'https://api.github.com/users/facebook-github-bot/repos', 'events_url': 'https://api.github.com/users/facebook-github-bot/events{/privacy}', 'received_events_url': 'https://api.github.com/users/facebook-github-bot/received_events', 'type': 'User', 'site_admin': False}",closed,0539462ca2966aa29657b58aeb17a85c21524d31,https://api.github.com/repos/pytorch/pytorch/commits/0539462ca2966aa29657b58aeb17a85c21524d31,2019-08-01T22:26:55Z,8,6,2
23631,2528390815,"{'login': 'jamesr66a', 'id': 4685384, 'node_id': 'MDQ6VXNlcjQ2ODUzODQ=', 'avatar_url': 'https://avatars2.githubusercontent.com/u/4685384?v=4', 'gravatar_id': '', 'url': 'https://api.github.com/users/jamesr66a', 'html_url': 'https://github.com/jamesr66a', 'followers_url': 'https://api.github.com/users/jamesr66a/followers', 'following_url': 'https://api.github.com/users/jamesr66a/following{/other_user}', 'gists_url': 'https://api.github.com/users/jamesr66a/gists{/gist_id}', 'starred_url': 'https://api.github.com/users/jamesr66a/starred{/owner}{/repo}', 'subscriptions_url': 'https://api.github.com/users/jamesr66a/subscriptions', 'organizations_url': 'https://api.github.com/users/jamesr66a/orgs', 'repos_url': 'https://api.github.com/users/jamesr66a/repos', 'events_url': 'https://api.github.com/users/jamesr66a/events{/privacy}', 'received_events_url': 'https://api.github.com/users/jamesr66a/received_events', 'type': 'User', 'site_admin': False}",referenced,20687449c081477dcfe7de7b766d07039288f4d5,https://api.github.com/repos/pytorch/pytorch/commits/20687449c081477dcfe7de7b766d07039288f4d5,2019-08-02T03:16:19Z,2,1,1
23631,2531078932,"{'login': 'jamesr66a', 'id': 4685384, 'node_id': 'MDQ6VXNlcjQ2ODUzODQ=', 'avatar_url': 'https://avatars2.githubusercontent.com/u/4685384?v=4', 'gravatar_id': '', 'url': 'https://api.github.com/users/jamesr66a', 'html_url': 'https://github.com/jamesr66a', 'followers_url': 'https://api.github.com/users/jamesr66a/followers', 'following_url': 'https://api.github.com/users/jamesr66a/following{/other_user}', 'gists_url': 'https://api.github.com/users/jamesr66a/gists{/gist_id}', 'starred_url': 'https://api.github.com/users/jamesr66a/starred{/owner}{/repo}', 'subscriptions_url': 'https://api.github.com/users/jamesr66a/subscriptions', 'organizations_url': 'https://api.github.com/users/jamesr66a/orgs', 'repos_url': 'https://api.github.com/users/jamesr66a/repos', 'events_url': 'https://api.github.com/users/jamesr66a/events{/privacy}', 'received_events_url': 'https://api.github.com/users/jamesr66a/received_events', 'type': 'User', 'site_admin': False}",referenced,eeaa08e54afb9530def0e7fe58afce1db7caf68e,https://api.github.com/repos/pytorch/pytorch/commits/eeaa08e54afb9530def0e7fe58afce1db7caf68e,2019-08-03T01:35:20Z,2560,1927,633
23631,2531079680,"{'login': 'jamesr66a', 'id': 4685384, 'node_id': 'MDQ6VXNlcjQ2ODUzODQ=', 'avatar_url': 'https://avatars2.githubusercontent.com/u/4685384?v=4', 'gravatar_id': '', 'url': 'https://api.github.com/users/jamesr66a', 'html_url': 'https://github.com/jamesr66a', 'followers_url': 'https://api.github.com/users/jamesr66a/followers', 'following_url': 'https://api.github.com/users/jamesr66a/following{/other_user}', 'gists_url': 'https://api.github.com/users/jamesr66a/gists{/gist_id}', 'starred_url': 'https://api.github.com/users/jamesr66a/starred{/owner}{/repo}', 'subscriptions_url': 'https://api.github.com/users/jamesr66a/subscriptions', 'organizations_url': 'https://api.github.com/users/jamesr66a/orgs', 'repos_url': 'https://api.github.com/users/jamesr66a/repos', 'events_url': 'https://api.github.com/users/jamesr66a/events{/privacy}', 'received_events_url': 'https://api.github.com/users/jamesr66a/received_events', 'type': 'User', 'site_admin': False}",referenced,e054a0526f3c4ce238ea1e22e139c1f1c5eb4dd9,https://api.github.com/repos/pytorch/pytorch/commits/e054a0526f3c4ce238ea1e22e139c1f1c5eb4dd9,2019-08-03T01:37:12Z,5,1,4
23631,2531079727,"{'login': 'jamesr66a', 'id': 4685384, 'node_id': 'MDQ6VXNlcjQ2ODUzODQ=', 'avatar_url': 'https://avatars2.githubusercontent.com/u/4685384?v=4', 'gravatar_id': '', 'url': 'https://api.github.com/users/jamesr66a', 'html_url': 'https://github.com/jamesr66a', 'followers_url': 'https://api.github.com/users/jamesr66a/followers', 'following_url': 'https://api.github.com/users/jamesr66a/following{/other_user}', 'gists_url': 'https://api.github.com/users/jamesr66a/gists{/gist_id}', 'starred_url': 'https://api.github.com/users/jamesr66a/starred{/owner}{/repo}', 'subscriptions_url': 'https://api.github.com/users/jamesr66a/subscriptions', 'organizations_url': 'https://api.github.com/users/jamesr66a/orgs', 'repos_url': 'https://api.github.com/users/jamesr66a/repos', 'events_url': 'https://api.github.com/users/jamesr66a/events{/privacy}', 'received_events_url': 'https://api.github.com/users/jamesr66a/received_events', 'type': 'User', 'site_admin': False}",referenced,4e500c9ae9a6e96c40d88b427bdfccf25f3cad67,https://api.github.com/repos/pytorch/pytorch/commits/4e500c9ae9a6e96c40d88b427bdfccf25f3cad67,2019-08-03T01:37:19Z,5,1,4
23631,2535262981,"{'login': 'facebook-github-bot', 'id': 6422482, 'node_id': 'MDQ6VXNlcjY0MjI0ODI=', 'avatar_url': 'https://avatars3.githubusercontent.com/u/6422482?v=4', 'gravatar_id': '', 'url': 'https://api.github.com/users/facebook-github-bot', 'html_url': 'https://github.com/facebook-github-bot', 'followers_url': 'https://api.github.com/users/facebook-github-bot/followers', 'following_url': 'https://api.github.com/users/facebook-github-bot/following{/other_user}', 'gists_url': 'https://api.github.com/users/facebook-github-bot/gists{/gist_id}', 'starred_url': 'https://api.github.com/users/facebook-github-bot/starred{/owner}{/repo}', 'subscriptions_url': 'https://api.github.com/users/facebook-github-bot/subscriptions', 'organizations_url': 'https://api.github.com/users/facebook-github-bot/orgs', 'repos_url': 'https://api.github.com/users/facebook-github-bot/repos', 'events_url': 'https://api.github.com/users/facebook-github-bot/events{/privacy}', 'received_events_url': 'https://api.github.com/users/facebook-github-bot/received_events', 'type': 'User', 'site_admin': False}",closed,489cc46686e7e689e7130e78b73fe77a9edac5ed,https://api.github.com/repos/pytorch/pytorch/commits/489cc46686e7e689e7130e78b73fe77a9edac5ed,2019-08-06T02:35:28Z,23,22,1
23607,2525025108,"{'login': 'facebook-github-bot', 'id': 6422482, 'node_id': 'MDQ6VXNlcjY0MjI0ODI=', 'avatar_url': 'https://avatars3.githubusercontent.com/u/6422482?v=4', 'gravatar_id': '', 'url': 'https://api.github.com/users/facebook-github-bot', 'html_url': 'https://github.com/facebook-github-bot', 'followers_url': 'https://api.github.com/users/facebook-github-bot/followers', 'following_url': 'https://api.github.com/users/facebook-github-bot/following{/other_user}', 'gists_url': 'https://api.github.com/users/facebook-github-bot/gists{/gist_id}', 'starred_url': 'https://api.github.com/users/facebook-github-bot/starred{/owner}{/repo}', 'subscriptions_url': 'https://api.github.com/users/facebook-github-bot/subscriptions', 'organizations_url': 'https://api.github.com/users/facebook-github-bot/orgs', 'repos_url': 'https://api.github.com/users/facebook-github-bot/repos', 'events_url': 'https://api.github.com/users/facebook-github-bot/events{/privacy}', 'received_events_url': 'https://api.github.com/users/facebook-github-bot/received_events', 'type': 'User', 'site_admin': False}",closed,0a12ff7c5b59cbd47dc865603e45178903f6dfa8,https://api.github.com/repos/pytorch/pytorch/commits/0a12ff7c5b59cbd47dc865603e45178903f6dfa8,2019-08-01T02:06:41Z,7,6,1
23607,2528455677,"{'login': 'soumith', 'id': 1310570, 'node_id': 'MDQ6VXNlcjEzMTA1NzA=', 'avatar_url': 'https://avatars0.githubusercontent.com/u/1310570?v=4', 'gravatar_id': '', 'url': 'https://api.github.com/users/soumith', 'html_url': 'https://github.com/soumith', 'followers_url': 'https://api.github.com/users/soumith/followers', 'following_url': 'https://api.github.com/users/soumith/following{/other_user}', 'gists_url': 'https://api.github.com/users/soumith/gists{/gist_id}', 'starred_url': 'https://api.github.com/users/soumith/starred{/owner}{/repo}', 'subscriptions_url': 'https://api.github.com/users/soumith/subscriptions', 'organizations_url': 'https://api.github.com/users/soumith/orgs', 'repos_url': 'https://api.github.com/users/soumith/repos', 'events_url': 'https://api.github.com/users/soumith/events{/privacy}', 'received_events_url': 'https://api.github.com/users/soumith/received_events', 'type': 'User', 'site_admin': False}",referenced,ccc7b5c22551c181429da28e07f5526fd6794a45,https://api.github.com/repos/pytorch/pytorch/commits/ccc7b5c22551c181429da28e07f5526fd6794a45,2019-08-02T04:14:36Z,7,6,1
23603,2540661954,"{'login': 'facebook-github-bot', 'id': 6422482, 'node_id': 'MDQ6VXNlcjY0MjI0ODI=', 'avatar_url': 'https://avatars3.githubusercontent.com/u/6422482?v=4', 'gravatar_id': '', 'url': 'https://api.github.com/users/facebook-github-bot', 'html_url': 'https://github.com/facebook-github-bot', 'followers_url': 'https://api.github.com/users/facebook-github-bot/followers', 'following_url': 'https://api.github.com/users/facebook-github-bot/following{/other_user}', 'gists_url': 'https://api.github.com/users/facebook-github-bot/gists{/gist_id}', 'starred_url': 'https://api.github.com/users/facebook-github-bot/starred{/owner}{/repo}', 'subscriptions_url': 'https://api.github.com/users/facebook-github-bot/subscriptions', 'organizations_url': 'https://api.github.com/users/facebook-github-bot/orgs', 'repos_url': 'https://api.github.com/users/facebook-github-bot/repos', 'events_url': 'https://api.github.com/users/facebook-github-bot/events{/privacy}', 'received_events_url': 'https://api.github.com/users/facebook-github-bot/received_events', 'type': 'User', 'site_admin': False}",closed,10b1254edd9bcb4d3ab6a47f2bab31edef6485d0,https://api.github.com/repos/pytorch/pytorch/commits/10b1254edd9bcb4d3ab6a47f2bab31edef6485d0,2019-08-07T16:19:20Z,14,13,1
23582,2588963043,"{'login': 'facebook-github-bot', 'id': 6422482, 'node_id': 'MDQ6VXNlcjY0MjI0ODI=', 'avatar_url': 'https://avatars3.githubusercontent.com/u/6422482?v=4', 'gravatar_id': '', 'url': 'https://api.github.com/users/facebook-github-bot', 'html_url': 'https://github.com/facebook-github-bot', 'followers_url': 'https://api.github.com/users/facebook-github-bot/followers', 'following_url': 'https://api.github.com/users/facebook-github-bot/following{/other_user}', 'gists_url': 'https://api.github.com/users/facebook-github-bot/gists{/gist_id}', 'starred_url': 'https://api.github.com/users/facebook-github-bot/starred{/owner}{/repo}', 'subscriptions_url': 'https://api.github.com/users/facebook-github-bot/subscriptions', 'organizations_url': 'https://api.github.com/users/facebook-github-bot/orgs', 'repos_url': 'https://api.github.com/users/facebook-github-bot/repos', 'events_url': 'https://api.github.com/users/facebook-github-bot/events{/privacy}', 'received_events_url': 'https://api.github.com/users/facebook-github-bot/received_events', 'type': 'User', 'site_admin': False}",referenced,f8852c947bf527a994002aa04f8e77b78ac75f01,https://api.github.com/repos/pytorch/pytorch/commits/f8852c947bf527a994002aa04f8e77b78ac75f01,2019-08-28T01:40:52Z,88,73,15
23580,2523860928,"{'login': 'facebook-github-bot', 'id': 6422482, 'node_id': 'MDQ6VXNlcjY0MjI0ODI=', 'avatar_url': 'https://avatars3.githubusercontent.com/u/6422482?v=4', 'gravatar_id': '', 'url': 'https://api.github.com/users/facebook-github-bot', 'html_url': 'https://github.com/facebook-github-bot', 'followers_url': 'https://api.github.com/users/facebook-github-bot/followers', 'following_url': 'https://api.github.com/users/facebook-github-bot/following{/other_user}', 'gists_url': 'https://api.github.com/users/facebook-github-bot/gists{/gist_id}', 'starred_url': 'https://api.github.com/users/facebook-github-bot/starred{/owner}{/repo}', 'subscriptions_url': 'https://api.github.com/users/facebook-github-bot/subscriptions', 'organizations_url': 'https://api.github.com/users/facebook-github-bot/orgs', 'repos_url': 'https://api.github.com/users/facebook-github-bot/repos', 'events_url': 'https://api.github.com/users/facebook-github-bot/events{/privacy}', 'received_events_url': 'https://api.github.com/users/facebook-github-bot/received_events', 'type': 'User', 'site_admin': False}",closed,02d5c62f34a921ef6a54bc33152e87938267c122,https://api.github.com/repos/pytorch/pytorch/commits/02d5c62f34a921ef6a54bc33152e87938267c122,2019-07-31T16:41:50Z,6,3,3
23580,2524948959,"{'login': 'soumith', 'id': 1310570, 'node_id': 'MDQ6VXNlcjEzMTA1NzA=', 'avatar_url': 'https://avatars0.githubusercontent.com/u/1310570?v=4', 'gravatar_id': '', 'url': 'https://api.github.com/users/soumith', 'html_url': 'https://github.com/soumith', 'followers_url': 'https://api.github.com/users/soumith/followers', 'following_url': 'https://api.github.com/users/soumith/following{/other_user}', 'gists_url': 'https://api.github.com/users/soumith/gists{/gist_id}', 'starred_url': 'https://api.github.com/users/soumith/starred{/owner}{/repo}', 'subscriptions_url': 'https://api.github.com/users/soumith/subscriptions', 'organizations_url': 'https://api.github.com/users/soumith/orgs', 'repos_url': 'https://api.github.com/users/soumith/repos', 'events_url': 'https://api.github.com/users/soumith/events{/privacy}', 'received_events_url': 'https://api.github.com/users/soumith/received_events', 'type': 'User', 'site_admin': False}",referenced,d6df9575f9d4e6f488dc698d0830f065597b6e1d,https://api.github.com/repos/pytorch/pytorch/commits/d6df9575f9d4e6f488dc698d0830f065597b6e1d,2019-08-01T01:04:06Z,6,3,3
23549,2678662069,"{'login': 'rohan-varma', 'id': 8039770, 'node_id': 'MDQ6VXNlcjgwMzk3NzA=', 'avatar_url': 'https://avatars2.githubusercontent.com/u/8039770?v=4', 'gravatar_id': '', 'url': 'https://api.github.com/users/rohan-varma', 'html_url': 'https://github.com/rohan-varma', 'followers_url': 'https://api.github.com/users/rohan-varma/followers', 'following_url': 'https://api.github.com/users/rohan-varma/following{/other_user}', 'gists_url': 'https://api.github.com/users/rohan-varma/gists{/gist_id}', 'starred_url': 'https://api.github.com/users/rohan-varma/starred{/owner}{/repo}', 'subscriptions_url': 'https://api.github.com/users/rohan-varma/subscriptions', 'organizations_url': 'https://api.github.com/users/rohan-varma/orgs', 'repos_url': 'https://api.github.com/users/rohan-varma/repos', 'events_url': 'https://api.github.com/users/rohan-varma/events{/privacy}', 'received_events_url': 'https://api.github.com/users/rohan-varma/received_events', 'type': 'User', 'site_admin': False}",referenced,3d17ce837485db9acf1d7d9306bc3fdf32610516,https://api.github.com/repos/pytorch/pytorch/commits/3d17ce837485db9acf1d7d9306bc3fdf32610516,2019-10-01T21:51:43Z,2894,2136,758
23549,2678670038,"{'login': 'rohan-varma', 'id': 8039770, 'node_id': 'MDQ6VXNlcjgwMzk3NzA=', 'avatar_url': 'https://avatars2.githubusercontent.com/u/8039770?v=4', 'gravatar_id': '', 'url': 'https://api.github.com/users/rohan-varma', 'html_url': 'https://github.com/rohan-varma', 'followers_url': 'https://api.github.com/users/rohan-varma/followers', 'following_url': 'https://api.github.com/users/rohan-varma/following{/other_user}', 'gists_url': 'https://api.github.com/users/rohan-varma/gists{/gist_id}', 'starred_url': 'https://api.github.com/users/rohan-varma/starred{/owner}{/repo}', 'subscriptions_url': 'https://api.github.com/users/rohan-varma/subscriptions', 'organizations_url': 'https://api.github.com/users/rohan-varma/orgs', 'repos_url': 'https://api.github.com/users/rohan-varma/repos', 'events_url': 'https://api.github.com/users/rohan-varma/events{/privacy}', 'received_events_url': 'https://api.github.com/users/rohan-varma/received_events', 'type': 'User', 'site_admin': False}",referenced,73b3d3277e10b3b4ce1eee892cc422a441c3f48f,https://api.github.com/repos/pytorch/pytorch/commits/73b3d3277e10b3b4ce1eee892cc422a441c3f48f,2019-10-01T21:55:08Z,413,264,149
23549,2681853121,"{'login': 'rohan-varma', 'id': 8039770, 'node_id': 'MDQ6VXNlcjgwMzk3NzA=', 'avatar_url': 'https://avatars2.githubusercontent.com/u/8039770?v=4', 'gravatar_id': '', 'url': 'https://api.github.com/users/rohan-varma', 'html_url': 'https://github.com/rohan-varma', 'followers_url': 'https://api.github.com/users/rohan-varma/followers', 'following_url': 'https://api.github.com/users/rohan-varma/following{/other_user}', 'gists_url': 'https://api.github.com/users/rohan-varma/gists{/gist_id}', 'starred_url': 'https://api.github.com/users/rohan-varma/starred{/owner}{/repo}', 'subscriptions_url': 'https://api.github.com/users/rohan-varma/subscriptions', 'organizations_url': 'https://api.github.com/users/rohan-varma/orgs', 'repos_url': 'https://api.github.com/users/rohan-varma/repos', 'events_url': 'https://api.github.com/users/rohan-varma/events{/privacy}', 'received_events_url': 'https://api.github.com/users/rohan-varma/received_events', 'type': 'User', 'site_admin': False}",referenced,fb55cfb2bbdeab6a4ef7d5a2e8655707974516f3,https://api.github.com/repos/pytorch/pytorch/commits/fb55cfb2bbdeab6a4ef7d5a2e8655707974516f3,2019-10-02T19:53:35Z,4609,2776,1833
23549,2685840509,"{'login': 'rohan-varma', 'id': 8039770, 'node_id': 'MDQ6VXNlcjgwMzk3NzA=', 'avatar_url': 'https://avatars2.githubusercontent.com/u/8039770?v=4', 'gravatar_id': '', 'url': 'https://api.github.com/users/rohan-varma', 'html_url': 'https://github.com/rohan-varma', 'followers_url': 'https://api.github.com/users/rohan-varma/followers', 'following_url': 'https://api.github.com/users/rohan-varma/following{/other_user}', 'gists_url': 'https://api.github.com/users/rohan-varma/gists{/gist_id}', 'starred_url': 'https://api.github.com/users/rohan-varma/starred{/owner}{/repo}', 'subscriptions_url': 'https://api.github.com/users/rohan-varma/subscriptions', 'organizations_url': 'https://api.github.com/users/rohan-varma/orgs', 'repos_url': 'https://api.github.com/users/rohan-varma/repos', 'events_url': 'https://api.github.com/users/rohan-varma/events{/privacy}', 'received_events_url': 'https://api.github.com/users/rohan-varma/received_events', 'type': 'User', 'site_admin': False}",referenced,b3e1cfa0ed5f55730a89322644cdd76c5c354def,https://api.github.com/repos/pytorch/pytorch/commits/b3e1cfa0ed5f55730a89322644cdd76c5c354def,2019-10-04T00:24:14Z,9180,4078,5102
23545,2523921806,"{'login': 'facebook-github-bot', 'id': 6422482, 'node_id': 'MDQ6VXNlcjY0MjI0ODI=', 'avatar_url': 'https://avatars3.githubusercontent.com/u/6422482?v=4', 'gravatar_id': '', 'url': 'https://api.github.com/users/facebook-github-bot', 'html_url': 'https://github.com/facebook-github-bot', 'followers_url': 'https://api.github.com/users/facebook-github-bot/followers', 'following_url': 'https://api.github.com/users/facebook-github-bot/following{/other_user}', 'gists_url': 'https://api.github.com/users/facebook-github-bot/gists{/gist_id}', 'starred_url': 'https://api.github.com/users/facebook-github-bot/starred{/owner}{/repo}', 'subscriptions_url': 'https://api.github.com/users/facebook-github-bot/subscriptions', 'organizations_url': 'https://api.github.com/users/facebook-github-bot/orgs', 'repos_url': 'https://api.github.com/users/facebook-github-bot/repos', 'events_url': 'https://api.github.com/users/facebook-github-bot/events{/privacy}', 'received_events_url': 'https://api.github.com/users/facebook-github-bot/received_events', 'type': 'User', 'site_admin': False}",referenced,9130ab380a4af0c67036ea8fce937156cfd0a8c8,https://api.github.com/repos/pytorch/pytorch/commits/9130ab380a4af0c67036ea8fce937156cfd0a8c8,2019-07-31T17:04:23Z,11,10,1
23545,2523921827,"{'login': 'facebook-github-bot', 'id': 6422482, 'node_id': 'MDQ6VXNlcjY0MjI0ODI=', 'avatar_url': 'https://avatars3.githubusercontent.com/u/6422482?v=4', 'gravatar_id': '', 'url': 'https://api.github.com/users/facebook-github-bot', 'html_url': 'https://github.com/facebook-github-bot', 'followers_url': 'https://api.github.com/users/facebook-github-bot/followers', 'following_url': 'https://api.github.com/users/facebook-github-bot/following{/other_user}', 'gists_url': 'https://api.github.com/users/facebook-github-bot/gists{/gist_id}', 'starred_url': 'https://api.github.com/users/facebook-github-bot/starred{/owner}{/repo}', 'subscriptions_url': 'https://api.github.com/users/facebook-github-bot/subscriptions', 'organizations_url': 'https://api.github.com/users/facebook-github-bot/orgs', 'repos_url': 'https://api.github.com/users/facebook-github-bot/repos', 'events_url': 'https://api.github.com/users/facebook-github-bot/events{/privacy}', 'received_events_url': 'https://api.github.com/users/facebook-github-bot/received_events', 'type': 'User', 'site_admin': False}",closed,9130ab380a4af0c67036ea8fce937156cfd0a8c8,https://api.github.com/repos/pytorch/pytorch/commits/9130ab380a4af0c67036ea8fce937156cfd0a8c8,2019-07-31T17:04:24Z,11,10,1
23480,2540252147,"{'login': 'facebook-github-bot', 'id': 6422482, 'node_id': 'MDQ6VXNlcjY0MjI0ODI=', 'avatar_url': 'https://avatars3.githubusercontent.com/u/6422482?v=4', 'gravatar_id': '', 'url': 'https://api.github.com/users/facebook-github-bot', 'html_url': 'https://github.com/facebook-github-bot', 'followers_url': 'https://api.github.com/users/facebook-github-bot/followers', 'following_url': 'https://api.github.com/users/facebook-github-bot/following{/other_user}', 'gists_url': 'https://api.github.com/users/facebook-github-bot/gists{/gist_id}', 'starred_url': 'https://api.github.com/users/facebook-github-bot/starred{/owner}{/repo}', 'subscriptions_url': 'https://api.github.com/users/facebook-github-bot/subscriptions', 'organizations_url': 'https://api.github.com/users/facebook-github-bot/orgs', 'repos_url': 'https://api.github.com/users/facebook-github-bot/repos', 'events_url': 'https://api.github.com/users/facebook-github-bot/events{/privacy}', 'received_events_url': 'https://api.github.com/users/facebook-github-bot/received_events', 'type': 'User', 'site_admin': False}",closed,fc82ec298bd9101d8de25b43f8823cdbae894252,https://api.github.com/repos/pytorch/pytorch/commits/fc82ec298bd9101d8de25b43f8823cdbae894252,2019-08-07T14:19:03Z,2,1,1
23480,2540878475,"{'login': 'soumith', 'id': 1310570, 'node_id': 'MDQ6VXNlcjEzMTA1NzA=', 'avatar_url': 'https://avatars0.githubusercontent.com/u/1310570?v=4', 'gravatar_id': '', 'url': 'https://api.github.com/users/soumith', 'html_url': 'https://github.com/soumith', 'followers_url': 'https://api.github.com/users/soumith/followers', 'following_url': 'https://api.github.com/users/soumith/following{/other_user}', 'gists_url': 'https://api.github.com/users/soumith/gists{/gist_id}', 'starred_url': 'https://api.github.com/users/soumith/starred{/owner}{/repo}', 'subscriptions_url': 'https://api.github.com/users/soumith/subscriptions', 'organizations_url': 'https://api.github.com/users/soumith/orgs', 'repos_url': 'https://api.github.com/users/soumith/repos', 'events_url': 'https://api.github.com/users/soumith/events{/privacy}', 'received_events_url': 'https://api.github.com/users/soumith/received_events', 'type': 'User', 'site_admin': False}",referenced,cdb032efeaf55ff780d0f592b1dd94ad5e481bbb,https://api.github.com/repos/pytorch/pytorch/commits/cdb032efeaf55ff780d0f592b1dd94ad5e481bbb,2019-08-07T17:39:29Z,2,1,1
23453,2513772191,"{'login': 'driazati', 'id': 9407960, 'node_id': 'MDQ6VXNlcjk0MDc5NjA=', 'avatar_url': 'https://avatars3.githubusercontent.com/u/9407960?v=4', 'gravatar_id': '', 'url': 'https://api.github.com/users/driazati', 'html_url': 'https://github.com/driazati', 'followers_url': 'https://api.github.com/users/driazati/followers', 'following_url': 'https://api.github.com/users/driazati/following{/other_user}', 'gists_url': 'https://api.github.com/users/driazati/gists{/gist_id}', 'starred_url': 'https://api.github.com/users/driazati/starred{/owner}{/repo}', 'subscriptions_url': 'https://api.github.com/users/driazati/subscriptions', 'organizations_url': 'https://api.github.com/users/driazati/orgs', 'repos_url': 'https://api.github.com/users/driazati/repos', 'events_url': 'https://api.github.com/users/driazati/events{/privacy}', 'received_events_url': 'https://api.github.com/users/driazati/received_events', 'type': 'User', 'site_admin': False}",referenced,d6aca8e676e8f9ffb50487d56c5412860b77e5f5,https://api.github.com/repos/pytorch/pytorch/commits/d6aca8e676e8f9ffb50487d56c5412860b77e5f5,2019-07-26T21:41:22Z,48,41,7
23453,2518210161,"{'login': 'facebook-github-bot', 'id': 6422482, 'node_id': 'MDQ6VXNlcjY0MjI0ODI=', 'avatar_url': 'https://avatars3.githubusercontent.com/u/6422482?v=4', 'gravatar_id': '', 'url': 'https://api.github.com/users/facebook-github-bot', 'html_url': 'https://github.com/facebook-github-bot', 'followers_url': 'https://api.github.com/users/facebook-github-bot/followers', 'following_url': 'https://api.github.com/users/facebook-github-bot/following{/other_user}', 'gists_url': 'https://api.github.com/users/facebook-github-bot/gists{/gist_id}', 'starred_url': 'https://api.github.com/users/facebook-github-bot/starred{/owner}{/repo}', 'subscriptions_url': 'https://api.github.com/users/facebook-github-bot/subscriptions', 'organizations_url': 'https://api.github.com/users/facebook-github-bot/orgs', 'repos_url': 'https://api.github.com/users/facebook-github-bot/repos', 'events_url': 'https://api.github.com/users/facebook-github-bot/events{/privacy}', 'received_events_url': 'https://api.github.com/users/facebook-github-bot/received_events', 'type': 'User', 'site_admin': False}",referenced,52b95fd4beaee2c170d96f0a847bd6d2f17982d1,https://api.github.com/repos/pytorch/pytorch/commits/52b95fd4beaee2c170d96f0a847bd6d2f17982d1,2019-07-30T01:02:38Z,53,47,6
23453,2521631797,"{'login': 'facebook-github-bot', 'id': 6422482, 'node_id': 'MDQ6VXNlcjY0MjI0ODI=', 'avatar_url': 'https://avatars3.githubusercontent.com/u/6422482?v=4', 'gravatar_id': '', 'url': 'https://api.github.com/users/facebook-github-bot', 'html_url': 'https://github.com/facebook-github-bot', 'followers_url': 'https://api.github.com/users/facebook-github-bot/followers', 'following_url': 'https://api.github.com/users/facebook-github-bot/following{/other_user}', 'gists_url': 'https://api.github.com/users/facebook-github-bot/gists{/gist_id}', 'starred_url': 'https://api.github.com/users/facebook-github-bot/starred{/owner}{/repo}', 'subscriptions_url': 'https://api.github.com/users/facebook-github-bot/subscriptions', 'organizations_url': 'https://api.github.com/users/facebook-github-bot/orgs', 'repos_url': 'https://api.github.com/users/facebook-github-bot/repos', 'events_url': 'https://api.github.com/users/facebook-github-bot/events{/privacy}', 'received_events_url': 'https://api.github.com/users/facebook-github-bot/received_events', 'type': 'User', 'site_admin': False}",referenced,756bdcbca4770b6ef5bd08daeeea24927b16a22a,https://api.github.com/repos/pytorch/pytorch/commits/756bdcbca4770b6ef5bd08daeeea24927b16a22a,2019-07-31T00:32:34Z,57,49,8
23401,2788354616,"{'login': 'facebook-github-bot', 'id': 6422482, 'node_id': 'MDQ6VXNlcjY0MjI0ODI=', 'avatar_url': 'https://avatars3.githubusercontent.com/u/6422482?v=4', 'gravatar_id': '', 'url': 'https://api.github.com/users/facebook-github-bot', 'html_url': 'https://github.com/facebook-github-bot', 'followers_url': 'https://api.github.com/users/facebook-github-bot/followers', 'following_url': 'https://api.github.com/users/facebook-github-bot/following{/other_user}', 'gists_url': 'https://api.github.com/users/facebook-github-bot/gists{/gist_id}', 'starred_url': 'https://api.github.com/users/facebook-github-bot/starred{/owner}{/repo}', 'subscriptions_url': 'https://api.github.com/users/facebook-github-bot/subscriptions', 'organizations_url': 'https://api.github.com/users/facebook-github-bot/orgs', 'repos_url': 'https://api.github.com/users/facebook-github-bot/repos', 'events_url': 'https://api.github.com/users/facebook-github-bot/events{/privacy}', 'received_events_url': 'https://api.github.com/users/facebook-github-bot/received_events', 'type': 'User', 'site_admin': False}",closed,bb119d957e331a1dbca91fbdf00f298088218e5b,https://api.github.com/repos/pytorch/pytorch/commits/bb119d957e331a1dbca91fbdf00f298088218e5b,2019-11-11T15:34:39Z,95,52,43
23311,2511237656,"{'login': 'facebook-github-bot', 'id': 6422482, 'node_id': 'MDQ6VXNlcjY0MjI0ODI=', 'avatar_url': 'https://avatars3.githubusercontent.com/u/6422482?v=4', 'gravatar_id': '', 'url': 'https://api.github.com/users/facebook-github-bot', 'html_url': 'https://github.com/facebook-github-bot', 'followers_url': 'https://api.github.com/users/facebook-github-bot/followers', 'following_url': 'https://api.github.com/users/facebook-github-bot/following{/other_user}', 'gists_url': 'https://api.github.com/users/facebook-github-bot/gists{/gist_id}', 'starred_url': 'https://api.github.com/users/facebook-github-bot/starred{/owner}{/repo}', 'subscriptions_url': 'https://api.github.com/users/facebook-github-bot/subscriptions', 'organizations_url': 'https://api.github.com/users/facebook-github-bot/orgs', 'repos_url': 'https://api.github.com/users/facebook-github-bot/repos', 'events_url': 'https://api.github.com/users/facebook-github-bot/events{/privacy}', 'received_events_url': 'https://api.github.com/users/facebook-github-bot/received_events', 'type': 'User', 'site_admin': False}",referenced,dd79d45c5aae2a93a458fe0f52af555020e34762,https://api.github.com/repos/pytorch/pytorch/commits/dd79d45c5aae2a93a458fe0f52af555020e34762,2019-07-26T01:35:44Z,18,18,0
23300,2508982675,"{'login': 'pietern', 'id': 9845, 'node_id': 'MDQ6VXNlcjk4NDU=', 'avatar_url': 'https://avatars3.githubusercontent.com/u/9845?v=4', 'gravatar_id': '', 'url': 'https://api.github.com/users/pietern', 'html_url': 'https://github.com/pietern', 'followers_url': 'https://api.github.com/users/pietern/followers', 'following_url': 'https://api.github.com/users/pietern/following{/other_user}', 'gists_url': 'https://api.github.com/users/pietern/gists{/gist_id}', 'starred_url': 'https://api.github.com/users/pietern/starred{/owner}{/repo}', 'subscriptions_url': 'https://api.github.com/users/pietern/subscriptions', 'organizations_url': 'https://api.github.com/users/pietern/orgs', 'repos_url': 'https://api.github.com/users/pietern/repos', 'events_url': 'https://api.github.com/users/pietern/events{/privacy}', 'received_events_url': 'https://api.github.com/users/pietern/received_events', 'type': 'User', 'site_admin': False}",referenced,8b07d67143de39ecaf3191f95b18d56c12ed18bc,https://api.github.com/repos/pytorch/pytorch/commits/8b07d67143de39ecaf3191f95b18d56c12ed18bc,2019-07-25T10:02:18Z,6,0,6
23300,2508982978,"{'login': 'pietern', 'id': 9845, 'node_id': 'MDQ6VXNlcjk4NDU=', 'avatar_url': 'https://avatars3.githubusercontent.com/u/9845?v=4', 'gravatar_id': '', 'url': 'https://api.github.com/users/pietern', 'html_url': 'https://github.com/pietern', 'followers_url': 'https://api.github.com/users/pietern/followers', 'following_url': 'https://api.github.com/users/pietern/following{/other_user}', 'gists_url': 'https://api.github.com/users/pietern/gists{/gist_id}', 'starred_url': 'https://api.github.com/users/pietern/starred{/owner}{/repo}', 'subscriptions_url': 'https://api.github.com/users/pietern/subscriptions', 'organizations_url': 'https://api.github.com/users/pietern/orgs', 'repos_url': 'https://api.github.com/users/pietern/repos', 'events_url': 'https://api.github.com/users/pietern/events{/privacy}', 'received_events_url': 'https://api.github.com/users/pietern/received_events', 'type': 'User', 'site_admin': False}",referenced,a8c63b826c7f69dccf52c152a8fad1dc65933483,https://api.github.com/repos/pytorch/pytorch/commits/a8c63b826c7f69dccf52c152a8fad1dc65933483,2019-07-25T10:02:25Z,6,0,6
23300,2509094183,"{'login': 'pietern', 'id': 9845, 'node_id': 'MDQ6VXNlcjk4NDU=', 'avatar_url': 'https://avatars3.githubusercontent.com/u/9845?v=4', 'gravatar_id': '', 'url': 'https://api.github.com/users/pietern', 'html_url': 'https://github.com/pietern', 'followers_url': 'https://api.github.com/users/pietern/followers', 'following_url': 'https://api.github.com/users/pietern/following{/other_user}', 'gists_url': 'https://api.github.com/users/pietern/gists{/gist_id}', 'starred_url': 'https://api.github.com/users/pietern/starred{/owner}{/repo}', 'subscriptions_url': 'https://api.github.com/users/pietern/subscriptions', 'organizations_url': 'https://api.github.com/users/pietern/orgs', 'repos_url': 'https://api.github.com/users/pietern/repos', 'events_url': 'https://api.github.com/users/pietern/events{/privacy}', 'received_events_url': 'https://api.github.com/users/pietern/received_events', 'type': 'User', 'site_admin': False}",referenced,fcf4fbce92475cd117521e409008b7bf18edd54b,https://api.github.com/repos/pytorch/pytorch/commits/fcf4fbce92475cd117521e409008b7bf18edd54b,2019-07-25T10:47:11Z,3,3,0
23300,2509094343,"{'login': 'pietern', 'id': 9845, 'node_id': 'MDQ6VXNlcjk4NDU=', 'avatar_url': 'https://avatars3.githubusercontent.com/u/9845?v=4', 'gravatar_id': '', 'url': 'https://api.github.com/users/pietern', 'html_url': 'https://github.com/pietern', 'followers_url': 'https://api.github.com/users/pietern/followers', 'following_url': 'https://api.github.com/users/pietern/following{/other_user}', 'gists_url': 'https://api.github.com/users/pietern/gists{/gist_id}', 'starred_url': 'https://api.github.com/users/pietern/starred{/owner}{/repo}', 'subscriptions_url': 'https://api.github.com/users/pietern/subscriptions', 'organizations_url': 'https://api.github.com/users/pietern/orgs', 'repos_url': 'https://api.github.com/users/pietern/repos', 'events_url': 'https://api.github.com/users/pietern/events{/privacy}', 'received_events_url': 'https://api.github.com/users/pietern/received_events', 'type': 'User', 'site_admin': False}",referenced,b9e1280afd9b4c9b42014499a84406c4e089af6b,https://api.github.com/repos/pytorch/pytorch/commits/b9e1280afd9b4c9b42014499a84406c4e089af6b,2019-07-25T10:47:15Z,3,0,3
23300,2510442431,"{'login': 'facebook-github-bot', 'id': 6422482, 'node_id': 'MDQ6VXNlcjY0MjI0ODI=', 'avatar_url': 'https://avatars3.githubusercontent.com/u/6422482?v=4', 'gravatar_id': '', 'url': 'https://api.github.com/users/facebook-github-bot', 'html_url': 'https://github.com/facebook-github-bot', 'followers_url': 'https://api.github.com/users/facebook-github-bot/followers', 'following_url': 'https://api.github.com/users/facebook-github-bot/following{/other_user}', 'gists_url': 'https://api.github.com/users/facebook-github-bot/gists{/gist_id}', 'starred_url': 'https://api.github.com/users/facebook-github-bot/starred{/owner}{/repo}', 'subscriptions_url': 'https://api.github.com/users/facebook-github-bot/subscriptions', 'organizations_url': 'https://api.github.com/users/facebook-github-bot/orgs', 'repos_url': 'https://api.github.com/users/facebook-github-bot/repos', 'events_url': 'https://api.github.com/users/facebook-github-bot/events{/privacy}', 'received_events_url': 'https://api.github.com/users/facebook-github-bot/received_events', 'type': 'User', 'site_admin': False}",closed,7c383ba4a05a3fe1e6cc1738481a8f14631a0c75,https://api.github.com/repos/pytorch/pytorch/commits/7c383ba4a05a3fe1e6cc1738481a8f14631a0c75,2019-07-25T18:29:34Z,3,0,3
23140,2505048138,"{'login': 'facebook-github-bot', 'id': 6422482, 'node_id': 'MDQ6VXNlcjY0MjI0ODI=', 'avatar_url': 'https://avatars3.githubusercontent.com/u/6422482?v=4', 'gravatar_id': '', 'url': 'https://api.github.com/users/facebook-github-bot', 'html_url': 'https://github.com/facebook-github-bot', 'followers_url': 'https://api.github.com/users/facebook-github-bot/followers', 'following_url': 'https://api.github.com/users/facebook-github-bot/following{/other_user}', 'gists_url': 'https://api.github.com/users/facebook-github-bot/gists{/gist_id}', 'starred_url': 'https://api.github.com/users/facebook-github-bot/starred{/owner}{/repo}', 'subscriptions_url': 'https://api.github.com/users/facebook-github-bot/subscriptions', 'organizations_url': 'https://api.github.com/users/facebook-github-bot/orgs', 'repos_url': 'https://api.github.com/users/facebook-github-bot/repos', 'events_url': 'https://api.github.com/users/facebook-github-bot/events{/privacy}', 'received_events_url': 'https://api.github.com/users/facebook-github-bot/received_events', 'type': 'User', 'site_admin': False}",closed,8a770982475a4843176cfe85d846d710e2bbe7a5,https://api.github.com/repos/pytorch/pytorch/commits/8a770982475a4843176cfe85d846d710e2bbe7a5,2019-07-24T04:21:14Z,85,36,49
23063,2558513527,"{'login': 'facebook-github-bot', 'id': 6422482, 'node_id': 'MDQ6VXNlcjY0MjI0ODI=', 'avatar_url': 'https://avatars3.githubusercontent.com/u/6422482?v=4', 'gravatar_id': '', 'url': 'https://api.github.com/users/facebook-github-bot', 'html_url': 'https://github.com/facebook-github-bot', 'followers_url': 'https://api.github.com/users/facebook-github-bot/followers', 'following_url': 'https://api.github.com/users/facebook-github-bot/following{/other_user}', 'gists_url': 'https://api.github.com/users/facebook-github-bot/gists{/gist_id}', 'starred_url': 'https://api.github.com/users/facebook-github-bot/starred{/owner}{/repo}', 'subscriptions_url': 'https://api.github.com/users/facebook-github-bot/subscriptions', 'organizations_url': 'https://api.github.com/users/facebook-github-bot/orgs', 'repos_url': 'https://api.github.com/users/facebook-github-bot/repos', 'events_url': 'https://api.github.com/users/facebook-github-bot/events{/privacy}', 'received_events_url': 'https://api.github.com/users/facebook-github-bot/received_events', 'type': 'User', 'site_admin': False}",referenced,064d156511068035ed486d09342c4258e8479ece,https://api.github.com/repos/pytorch/pytorch/commits/064d156511068035ed486d09342c4258e8479ece,2019-08-15T04:14:57Z,54,44,10
23039,2509254967,"{'login': 'facebook-github-bot', 'id': 6422482, 'node_id': 'MDQ6VXNlcjY0MjI0ODI=', 'avatar_url': 'https://avatars3.githubusercontent.com/u/6422482?v=4', 'gravatar_id': '', 'url': 'https://api.github.com/users/facebook-github-bot', 'html_url': 'https://github.com/facebook-github-bot', 'followers_url': 'https://api.github.com/users/facebook-github-bot/followers', 'following_url': 'https://api.github.com/users/facebook-github-bot/following{/other_user}', 'gists_url': 'https://api.github.com/users/facebook-github-bot/gists{/gist_id}', 'starred_url': 'https://api.github.com/users/facebook-github-bot/starred{/owner}{/repo}', 'subscriptions_url': 'https://api.github.com/users/facebook-github-bot/subscriptions', 'organizations_url': 'https://api.github.com/users/facebook-github-bot/orgs', 'repos_url': 'https://api.github.com/users/facebook-github-bot/repos', 'events_url': 'https://api.github.com/users/facebook-github-bot/events{/privacy}', 'received_events_url': 'https://api.github.com/users/facebook-github-bot/received_events', 'type': 'User', 'site_admin': False}",closed,0842624d5001a48f34c1fbed2bf90e3262c7793f,https://api.github.com/repos/pytorch/pytorch/commits/0842624d5001a48f34c1fbed2bf90e3262c7793f,2019-07-25T11:55:24Z,4,3,1
23016,2502911722,"{'login': 'facebook-github-bot', 'id': 6422482, 'node_id': 'MDQ6VXNlcjY0MjI0ODI=', 'avatar_url': 'https://avatars3.githubusercontent.com/u/6422482?v=4', 'gravatar_id': '', 'url': 'https://api.github.com/users/facebook-github-bot', 'html_url': 'https://github.com/facebook-github-bot', 'followers_url': 'https://api.github.com/users/facebook-github-bot/followers', 'following_url': 'https://api.github.com/users/facebook-github-bot/following{/other_user}', 'gists_url': 'https://api.github.com/users/facebook-github-bot/gists{/gist_id}', 'starred_url': 'https://api.github.com/users/facebook-github-bot/starred{/owner}{/repo}', 'subscriptions_url': 'https://api.github.com/users/facebook-github-bot/subscriptions', 'organizations_url': 'https://api.github.com/users/facebook-github-bot/orgs', 'repos_url': 'https://api.github.com/users/facebook-github-bot/repos', 'events_url': 'https://api.github.com/users/facebook-github-bot/events{/privacy}', 'received_events_url': 'https://api.github.com/users/facebook-github-bot/received_events', 'type': 'User', 'site_admin': False}",closed,c9e62f6988c2ac8a6ca6b288621b0df6d26b82b6,https://api.github.com/repos/pytorch/pytorch/commits/c9e62f6988c2ac8a6ca6b288621b0df6d26b82b6,2019-07-23T12:38:19Z,2,1,1
22970,2576876517,"{'login': 'facebook-github-bot', 'id': 6422482, 'node_id': 'MDQ6VXNlcjY0MjI0ODI=', 'avatar_url': 'https://avatars3.githubusercontent.com/u/6422482?v=4', 'gravatar_id': '', 'url': 'https://api.github.com/users/facebook-github-bot', 'html_url': 'https://github.com/facebook-github-bot', 'followers_url': 'https://api.github.com/users/facebook-github-bot/followers', 'following_url': 'https://api.github.com/users/facebook-github-bot/following{/other_user}', 'gists_url': 'https://api.github.com/users/facebook-github-bot/gists{/gist_id}', 'starred_url': 'https://api.github.com/users/facebook-github-bot/starred{/owner}{/repo}', 'subscriptions_url': 'https://api.github.com/users/facebook-github-bot/subscriptions', 'organizations_url': 'https://api.github.com/users/facebook-github-bot/orgs', 'repos_url': 'https://api.github.com/users/facebook-github-bot/repos', 'events_url': 'https://api.github.com/users/facebook-github-bot/events{/privacy}', 'received_events_url': 'https://api.github.com/users/facebook-github-bot/received_events', 'type': 'User', 'site_admin': False}",closed,632aeb034dd57c0586fc3e979e65c362b936396a,https://api.github.com/repos/pytorch/pytorch/commits/632aeb034dd57c0586fc3e979e65c362b936396a,2019-08-22T15:19:52Z,15,10,5
22963,2597320396,"{'login': 'CamiWilliams', 'id': 5103945, 'node_id': 'MDQ6VXNlcjUxMDM5NDU=', 'avatar_url': 'https://avatars1.githubusercontent.com/u/5103945?v=4', 'gravatar_id': '', 'url': 'https://api.github.com/users/CamiWilliams', 'html_url': 'https://github.com/CamiWilliams', 'followers_url': 'https://api.github.com/users/CamiWilliams/followers', 'following_url': 'https://api.github.com/users/CamiWilliams/following{/other_user}', 'gists_url': 'https://api.github.com/users/CamiWilliams/gists{/gist_id}', 'starred_url': 'https://api.github.com/users/CamiWilliams/starred{/owner}{/repo}', 'subscriptions_url': 'https://api.github.com/users/CamiWilliams/subscriptions', 'organizations_url': 'https://api.github.com/users/CamiWilliams/orgs', 'repos_url': 'https://api.github.com/users/CamiWilliams/repos', 'events_url': 'https://api.github.com/users/CamiWilliams/events{/privacy}', 'received_events_url': 'https://api.github.com/users/CamiWilliams/received_events', 'type': 'User', 'site_admin': False}",referenced,4db3a1d8122b8817eec32d45ef734956830a685d,https://api.github.com/repos/pytorch/pytorch/commits/4db3a1d8122b8817eec32d45ef734956830a685d,2019-08-30T14:13:36Z,20,19,1
22963,2597619492,"{'login': 'facebook-github-bot', 'id': 6422482, 'node_id': 'MDQ6VXNlcjY0MjI0ODI=', 'avatar_url': 'https://avatars3.githubusercontent.com/u/6422482?v=4', 'gravatar_id': '', 'url': 'https://api.github.com/users/facebook-github-bot', 'html_url': 'https://github.com/facebook-github-bot', 'followers_url': 'https://api.github.com/users/facebook-github-bot/followers', 'following_url': 'https://api.github.com/users/facebook-github-bot/following{/other_user}', 'gists_url': 'https://api.github.com/users/facebook-github-bot/gists{/gist_id}', 'starred_url': 'https://api.github.com/users/facebook-github-bot/starred{/owner}{/repo}', 'subscriptions_url': 'https://api.github.com/users/facebook-github-bot/subscriptions', 'organizations_url': 'https://api.github.com/users/facebook-github-bot/orgs', 'repos_url': 'https://api.github.com/users/facebook-github-bot/repos', 'events_url': 'https://api.github.com/users/facebook-github-bot/events{/privacy}', 'received_events_url': 'https://api.github.com/users/facebook-github-bot/received_events', 'type': 'User', 'site_admin': False}",closed,329757a9074157b41a4176a4966a5b7582db383c,https://api.github.com/repos/pytorch/pytorch/commits/329757a9074157b41a4176a4966a5b7582db383c,2019-08-30T15:53:20Z,20,19,1
22844,2486845504,"{'login': 'facebook-github-bot', 'id': 6422482, 'node_id': 'MDQ6VXNlcjY0MjI0ODI=', 'avatar_url': 'https://avatars3.githubusercontent.com/u/6422482?v=4', 'gravatar_id': '', 'url': 'https://api.github.com/users/facebook-github-bot', 'html_url': 'https://github.com/facebook-github-bot', 'followers_url': 'https://api.github.com/users/facebook-github-bot/followers', 'following_url': 'https://api.github.com/users/facebook-github-bot/following{/other_user}', 'gists_url': 'https://api.github.com/users/facebook-github-bot/gists{/gist_id}', 'starred_url': 'https://api.github.com/users/facebook-github-bot/starred{/owner}{/repo}', 'subscriptions_url': 'https://api.github.com/users/facebook-github-bot/subscriptions', 'organizations_url': 'https://api.github.com/users/facebook-github-bot/orgs', 'repos_url': 'https://api.github.com/users/facebook-github-bot/repos', 'events_url': 'https://api.github.com/users/facebook-github-bot/events{/privacy}', 'received_events_url': 'https://api.github.com/users/facebook-github-bot/received_events', 'type': 'User', 'site_admin': False}",referenced,0ea8e61f0338a08ed5e8476c768970284efcbbf9,https://api.github.com/repos/pytorch/pytorch/commits/0ea8e61f0338a08ed5e8476c768970284efcbbf9,2019-07-16T16:58:33Z,34,17,17
22843,2496864764,"{'login': 'ezyang', 'id': 13564, 'node_id': 'MDQ6VXNlcjEzNTY0', 'avatar_url': 'https://avatars0.githubusercontent.com/u/13564?v=4', 'gravatar_id': '', 'url': 'https://api.github.com/users/ezyang', 'html_url': 'https://github.com/ezyang', 'followers_url': 'https://api.github.com/users/ezyang/followers', 'following_url': 'https://api.github.com/users/ezyang/following{/other_user}', 'gists_url': 'https://api.github.com/users/ezyang/gists{/gist_id}', 'starred_url': 'https://api.github.com/users/ezyang/starred{/owner}{/repo}', 'subscriptions_url': 'https://api.github.com/users/ezyang/subscriptions', 'organizations_url': 'https://api.github.com/users/ezyang/orgs', 'repos_url': 'https://api.github.com/users/ezyang/repos', 'events_url': 'https://api.github.com/users/ezyang/events{/privacy}', 'received_events_url': 'https://api.github.com/users/ezyang/received_events', 'type': 'User', 'site_admin': False}",referenced,6d071f40c297f309c652e1664dd2352cee4a5dac,https://api.github.com/repos/pytorch/pytorch/commits/6d071f40c297f309c652e1664dd2352cee4a5dac,2019-07-19T19:59:58Z,671,231,440
22843,2496864949,"{'login': 'ezyang', 'id': 13564, 'node_id': 'MDQ6VXNlcjEzNTY0', 'avatar_url': 'https://avatars0.githubusercontent.com/u/13564?v=4', 'gravatar_id': '', 'url': 'https://api.github.com/users/ezyang', 'html_url': 'https://github.com/ezyang', 'followers_url': 'https://api.github.com/users/ezyang/followers', 'following_url': 'https://api.github.com/users/ezyang/following{/other_user}', 'gists_url': 'https://api.github.com/users/ezyang/gists{/gist_id}', 'starred_url': 'https://api.github.com/users/ezyang/starred{/owner}{/repo}', 'subscriptions_url': 'https://api.github.com/users/ezyang/subscriptions', 'organizations_url': 'https://api.github.com/users/ezyang/orgs', 'repos_url': 'https://api.github.com/users/ezyang/repos', 'events_url': 'https://api.github.com/users/ezyang/events{/privacy}', 'received_events_url': 'https://api.github.com/users/ezyang/received_events', 'type': 'User', 'site_admin': False}",referenced,e0c77e9316d62b91ff42c212470959077c147406,https://api.github.com/repos/pytorch/pytorch/commits/e0c77e9316d62b91ff42c212470959077c147406,2019-07-19T20:00:04Z,671,231,440
22843,2497553167,"{'login': 'facebook-github-bot', 'id': 6422482, 'node_id': 'MDQ6VXNlcjY0MjI0ODI=', 'avatar_url': 'https://avatars3.githubusercontent.com/u/6422482?v=4', 'gravatar_id': '', 'url': 'https://api.github.com/users/facebook-github-bot', 'html_url': 'https://github.com/facebook-github-bot', 'followers_url': 'https://api.github.com/users/facebook-github-bot/followers', 'following_url': 'https://api.github.com/users/facebook-github-bot/following{/other_user}', 'gists_url': 'https://api.github.com/users/facebook-github-bot/gists{/gist_id}', 'starred_url': 'https://api.github.com/users/facebook-github-bot/starred{/owner}{/repo}', 'subscriptions_url': 'https://api.github.com/users/facebook-github-bot/subscriptions', 'organizations_url': 'https://api.github.com/users/facebook-github-bot/orgs', 'repos_url': 'https://api.github.com/users/facebook-github-bot/repos', 'events_url': 'https://api.github.com/users/facebook-github-bot/events{/privacy}', 'received_events_url': 'https://api.github.com/users/facebook-github-bot/received_events', 'type': 'User', 'site_admin': False}",closed,4e5f70089f136d277b3850d4218d4fbaa6976e6a,https://api.github.com/repos/pytorch/pytorch/commits/4e5f70089f136d277b3850d4218d4fbaa6976e6a,2019-07-20T13:20:32Z,11,10,1
22833,2510010219,"{'login': 'facebook-github-bot', 'id': 6422482, 'node_id': 'MDQ6VXNlcjY0MjI0ODI=', 'avatar_url': 'https://avatars3.githubusercontent.com/u/6422482?v=4', 'gravatar_id': '', 'url': 'https://api.github.com/users/facebook-github-bot', 'html_url': 'https://github.com/facebook-github-bot', 'followers_url': 'https://api.github.com/users/facebook-github-bot/followers', 'following_url': 'https://api.github.com/users/facebook-github-bot/following{/other_user}', 'gists_url': 'https://api.github.com/users/facebook-github-bot/gists{/gist_id}', 'starred_url': 'https://api.github.com/users/facebook-github-bot/starred{/owner}{/repo}', 'subscriptions_url': 'https://api.github.com/users/facebook-github-bot/subscriptions', 'organizations_url': 'https://api.github.com/users/facebook-github-bot/orgs', 'repos_url': 'https://api.github.com/users/facebook-github-bot/repos', 'events_url': 'https://api.github.com/users/facebook-github-bot/events{/privacy}', 'received_events_url': 'https://api.github.com/users/facebook-github-bot/received_events', 'type': 'User', 'site_admin': False}",closed,cf50249bde47b9ad0168ac4d8c142cfe5fffb22c,https://api.github.com/repos/pytorch/pytorch/commits/cf50249bde47b9ad0168ac4d8c142cfe5fffb22c,2019-07-25T15:58:31Z,238,5,233
22832,2496686975,"{'login': 'facebook-github-bot', 'id': 6422482, 'node_id': 'MDQ6VXNlcjY0MjI0ODI=', 'avatar_url': 'https://avatars3.githubusercontent.com/u/6422482?v=4', 'gravatar_id': '', 'url': 'https://api.github.com/users/facebook-github-bot', 'html_url': 'https://github.com/facebook-github-bot', 'followers_url': 'https://api.github.com/users/facebook-github-bot/followers', 'following_url': 'https://api.github.com/users/facebook-github-bot/following{/other_user}', 'gists_url': 'https://api.github.com/users/facebook-github-bot/gists{/gist_id}', 'starred_url': 'https://api.github.com/users/facebook-github-bot/starred{/owner}{/repo}', 'subscriptions_url': 'https://api.github.com/users/facebook-github-bot/subscriptions', 'organizations_url': 'https://api.github.com/users/facebook-github-bot/orgs', 'repos_url': 'https://api.github.com/users/facebook-github-bot/repos', 'events_url': 'https://api.github.com/users/facebook-github-bot/events{/privacy}', 'received_events_url': 'https://api.github.com/users/facebook-github-bot/received_events', 'type': 'User', 'site_admin': False}",closed,6dfecc7e01842bb7e5024794fdce94480de7bb3a,https://api.github.com/repos/pytorch/pytorch/commits/6dfecc7e01842bb7e5024794fdce94480de7bb3a,2019-07-19T18:46:00Z,484,1,483
22809,2497039073,"{'login': 'facebook-github-bot', 'id': 6422482, 'node_id': 'MDQ6VXNlcjY0MjI0ODI=', 'avatar_url': 'https://avatars3.githubusercontent.com/u/6422482?v=4', 'gravatar_id': '', 'url': 'https://api.github.com/users/facebook-github-bot', 'html_url': 'https://github.com/facebook-github-bot', 'followers_url': 'https://api.github.com/users/facebook-github-bot/followers', 'following_url': 'https://api.github.com/users/facebook-github-bot/following{/other_user}', 'gists_url': 'https://api.github.com/users/facebook-github-bot/gists{/gist_id}', 'starred_url': 'https://api.github.com/users/facebook-github-bot/starred{/owner}{/repo}', 'subscriptions_url': 'https://api.github.com/users/facebook-github-bot/subscriptions', 'organizations_url': 'https://api.github.com/users/facebook-github-bot/orgs', 'repos_url': 'https://api.github.com/users/facebook-github-bot/repos', 'events_url': 'https://api.github.com/users/facebook-github-bot/events{/privacy}', 'received_events_url': 'https://api.github.com/users/facebook-github-bot/received_events', 'type': 'User', 'site_admin': False}",referenced,f2f3e8ad8c7c99503138c5f1e41036610e147d75,https://api.github.com/repos/pytorch/pytorch/commits/f2f3e8ad8c7c99503138c5f1e41036610e147d75,2019-07-19T21:22:34Z,30,30,0
22806,2588992084,"{'login': 'facebook-github-bot', 'id': 6422482, 'node_id': 'MDQ6VXNlcjY0MjI0ODI=', 'avatar_url': 'https://avatars3.githubusercontent.com/u/6422482?v=4', 'gravatar_id': '', 'url': 'https://api.github.com/users/facebook-github-bot', 'html_url': 'https://github.com/facebook-github-bot', 'followers_url': 'https://api.github.com/users/facebook-github-bot/followers', 'following_url': 'https://api.github.com/users/facebook-github-bot/following{/other_user}', 'gists_url': 'https://api.github.com/users/facebook-github-bot/gists{/gist_id}', 'starred_url': 'https://api.github.com/users/facebook-github-bot/starred{/owner}{/repo}', 'subscriptions_url': 'https://api.github.com/users/facebook-github-bot/subscriptions', 'organizations_url': 'https://api.github.com/users/facebook-github-bot/orgs', 'repos_url': 'https://api.github.com/users/facebook-github-bot/repos', 'events_url': 'https://api.github.com/users/facebook-github-bot/events{/privacy}', 'received_events_url': 'https://api.github.com/users/facebook-github-bot/received_events', 'type': 'User', 'site_admin': False}",referenced,2c220763421af817ad0d523806f60f47e2ed4f58,https://api.github.com/repos/pytorch/pytorch/commits/2c220763421af817ad0d523806f60f47e2ed4f58,2019-08-28T02:01:46Z,291,142,149
22753,2533753492,"{'login': 'facebook-github-bot', 'id': 6422482, 'node_id': 'MDQ6VXNlcjY0MjI0ODI=', 'avatar_url': 'https://avatars3.githubusercontent.com/u/6422482?v=4', 'gravatar_id': '', 'url': 'https://api.github.com/users/facebook-github-bot', 'html_url': 'https://github.com/facebook-github-bot', 'followers_url': 'https://api.github.com/users/facebook-github-bot/followers', 'following_url': 'https://api.github.com/users/facebook-github-bot/following{/other_user}', 'gists_url': 'https://api.github.com/users/facebook-github-bot/gists{/gist_id}', 'starred_url': 'https://api.github.com/users/facebook-github-bot/starred{/owner}{/repo}', 'subscriptions_url': 'https://api.github.com/users/facebook-github-bot/subscriptions', 'organizations_url': 'https://api.github.com/users/facebook-github-bot/orgs', 'repos_url': 'https://api.github.com/users/facebook-github-bot/repos', 'events_url': 'https://api.github.com/users/facebook-github-bot/events{/privacy}', 'received_events_url': 'https://api.github.com/users/facebook-github-bot/received_events', 'type': 'User', 'site_admin': False}",closed,520982d1df0cf62b464fa4bf5a3ae58327d96d4d,https://api.github.com/repos/pytorch/pytorch/commits/520982d1df0cf62b464fa4bf5a3ae58327d96d4d,2019-08-05T14:39:53Z,12,12,0
22710,2517504137,"{'login': 'facebook-github-bot', 'id': 6422482, 'node_id': 'MDQ6VXNlcjY0MjI0ODI=', 'avatar_url': 'https://avatars3.githubusercontent.com/u/6422482?v=4', 'gravatar_id': '', 'url': 'https://api.github.com/users/facebook-github-bot', 'html_url': 'https://github.com/facebook-github-bot', 'followers_url': 'https://api.github.com/users/facebook-github-bot/followers', 'following_url': 'https://api.github.com/users/facebook-github-bot/following{/other_user}', 'gists_url': 'https://api.github.com/users/facebook-github-bot/gists{/gist_id}', 'starred_url': 'https://api.github.com/users/facebook-github-bot/starred{/owner}{/repo}', 'subscriptions_url': 'https://api.github.com/users/facebook-github-bot/subscriptions', 'organizations_url': 'https://api.github.com/users/facebook-github-bot/orgs', 'repos_url': 'https://api.github.com/users/facebook-github-bot/repos', 'events_url': 'https://api.github.com/users/facebook-github-bot/events{/privacy}', 'received_events_url': 'https://api.github.com/users/facebook-github-bot/received_events', 'type': 'User', 'site_admin': False}",closed,236149edc500830fb23a0e8a24adc051544e78fb,https://api.github.com/repos/pytorch/pytorch/commits/236149edc500830fb23a0e8a24adc051544e78fb,2019-07-29T19:01:51Z,30,26,4
22681,2721915591,"{'login': 'facebook-github-bot', 'id': 6422482, 'node_id': 'MDQ6VXNlcjY0MjI0ODI=', 'avatar_url': 'https://avatars3.githubusercontent.com/u/6422482?v=4', 'gravatar_id': '', 'url': 'https://api.github.com/users/facebook-github-bot', 'html_url': 'https://github.com/facebook-github-bot', 'followers_url': 'https://api.github.com/users/facebook-github-bot/followers', 'following_url': 'https://api.github.com/users/facebook-github-bot/following{/other_user}', 'gists_url': 'https://api.github.com/users/facebook-github-bot/gists{/gist_id}', 'starred_url': 'https://api.github.com/users/facebook-github-bot/starred{/owner}{/repo}', 'subscriptions_url': 'https://api.github.com/users/facebook-github-bot/subscriptions', 'organizations_url': 'https://api.github.com/users/facebook-github-bot/orgs', 'repos_url': 'https://api.github.com/users/facebook-github-bot/repos', 'events_url': 'https://api.github.com/users/facebook-github-bot/events{/privacy}', 'received_events_url': 'https://api.github.com/users/facebook-github-bot/received_events', 'type': 'User', 'site_admin': False}",referenced,c36552c4cbc8fd9c9346d213b11654c126615d5d,https://api.github.com/repos/pytorch/pytorch/commits/c36552c4cbc8fd9c9346d213b11654c126615d5d,2019-10-17T16:13:32Z,8,8,0
22615,2583466536,"{'login': 'facebook-github-bot', 'id': 6422482, 'node_id': 'MDQ6VXNlcjY0MjI0ODI=', 'avatar_url': 'https://avatars3.githubusercontent.com/u/6422482?v=4', 'gravatar_id': '', 'url': 'https://api.github.com/users/facebook-github-bot', 'html_url': 'https://github.com/facebook-github-bot', 'followers_url': 'https://api.github.com/users/facebook-github-bot/followers', 'following_url': 'https://api.github.com/users/facebook-github-bot/following{/other_user}', 'gists_url': 'https://api.github.com/users/facebook-github-bot/gists{/gist_id}', 'starred_url': 'https://api.github.com/users/facebook-github-bot/starred{/owner}{/repo}', 'subscriptions_url': 'https://api.github.com/users/facebook-github-bot/subscriptions', 'organizations_url': 'https://api.github.com/users/facebook-github-bot/orgs', 'repos_url': 'https://api.github.com/users/facebook-github-bot/repos', 'events_url': 'https://api.github.com/users/facebook-github-bot/events{/privacy}', 'received_events_url': 'https://api.github.com/users/facebook-github-bot/received_events', 'type': 'User', 'site_admin': False}",closed,30bc65271de884345e2d6fcf0622ff37c151631a,https://api.github.com/repos/pytorch/pytorch/commits/30bc65271de884345e2d6fcf0622ff37c151631a,2019-08-26T12:07:32Z,18,16,2
22581,2486881807,"{'login': 'facebook-github-bot', 'id': 6422482, 'node_id': 'MDQ6VXNlcjY0MjI0ODI=', 'avatar_url': 'https://avatars3.githubusercontent.com/u/6422482?v=4', 'gravatar_id': '', 'url': 'https://api.github.com/users/facebook-github-bot', 'html_url': 'https://github.com/facebook-github-bot', 'followers_url': 'https://api.github.com/users/facebook-github-bot/followers', 'following_url': 'https://api.github.com/users/facebook-github-bot/following{/other_user}', 'gists_url': 'https://api.github.com/users/facebook-github-bot/gists{/gist_id}', 'starred_url': 'https://api.github.com/users/facebook-github-bot/starred{/owner}{/repo}', 'subscriptions_url': 'https://api.github.com/users/facebook-github-bot/subscriptions', 'organizations_url': 'https://api.github.com/users/facebook-github-bot/orgs', 'repos_url': 'https://api.github.com/users/facebook-github-bot/repos', 'events_url': 'https://api.github.com/users/facebook-github-bot/events{/privacy}', 'received_events_url': 'https://api.github.com/users/facebook-github-bot/received_events', 'type': 'User', 'site_admin': False}",closed,f8ad65adb1b6e4d34b3e6544f9cfc4e2a8c24992,https://api.github.com/repos/pytorch/pytorch/commits/f8ad65adb1b6e4d34b3e6544f9cfc4e2a8c24992,2019-07-16T17:11:57Z,53,36,17
22572,2501240496,"{'login': 'facebook-github-bot', 'id': 6422482, 'node_id': 'MDQ6VXNlcjY0MjI0ODI=', 'avatar_url': 'https://avatars3.githubusercontent.com/u/6422482?v=4', 'gravatar_id': '', 'url': 'https://api.github.com/users/facebook-github-bot', 'html_url': 'https://github.com/facebook-github-bot', 'followers_url': 'https://api.github.com/users/facebook-github-bot/followers', 'following_url': 'https://api.github.com/users/facebook-github-bot/following{/other_user}', 'gists_url': 'https://api.github.com/users/facebook-github-bot/gists{/gist_id}', 'starred_url': 'https://api.github.com/users/facebook-github-bot/starred{/owner}{/repo}', 'subscriptions_url': 'https://api.github.com/users/facebook-github-bot/subscriptions', 'organizations_url': 'https://api.github.com/users/facebook-github-bot/orgs', 'repos_url': 'https://api.github.com/users/facebook-github-bot/repos', 'events_url': 'https://api.github.com/users/facebook-github-bot/events{/privacy}', 'received_events_url': 'https://api.github.com/users/facebook-github-bot/received_events', 'type': 'User', 'site_admin': False}",closed,b6d06d5496ecf2a93e5e90bf94785bc11ffc40d2,https://api.github.com/repos/pytorch/pytorch/commits/b6d06d5496ecf2a93e5e90bf94785bc11ffc40d2,2019-07-22T22:02:14Z,0,0,0
22570,2464842121,"{'login': 'facebook-github-bot', 'id': 6422482, 'node_id': 'MDQ6VXNlcjY0MjI0ODI=', 'avatar_url': 'https://avatars3.githubusercontent.com/u/6422482?v=4', 'gravatar_id': '', 'url': 'https://api.github.com/users/facebook-github-bot', 'html_url': 'https://github.com/facebook-github-bot', 'followers_url': 'https://api.github.com/users/facebook-github-bot/followers', 'following_url': 'https://api.github.com/users/facebook-github-bot/following{/other_user}', 'gists_url': 'https://api.github.com/users/facebook-github-bot/gists{/gist_id}', 'starred_url': 'https://api.github.com/users/facebook-github-bot/starred{/owner}{/repo}', 'subscriptions_url': 'https://api.github.com/users/facebook-github-bot/subscriptions', 'organizations_url': 'https://api.github.com/users/facebook-github-bot/orgs', 'repos_url': 'https://api.github.com/users/facebook-github-bot/repos', 'events_url': 'https://api.github.com/users/facebook-github-bot/events{/privacy}', 'received_events_url': 'https://api.github.com/users/facebook-github-bot/received_events', 'type': 'User', 'site_admin': False}",closed,d4464d3418cd02a09ac75f60b9661b6671e60b11,https://api.github.com/repos/pytorch/pytorch/commits/d4464d3418cd02a09ac75f60b9661b6671e60b11,2019-07-08T03:57:54Z,6,4,2
22553,2484935172,"{'login': 'driazati', 'id': 9407960, 'node_id': 'MDQ6VXNlcjk0MDc5NjA=', 'avatar_url': 'https://avatars3.githubusercontent.com/u/9407960?v=4', 'gravatar_id': '', 'url': 'https://api.github.com/users/driazati', 'html_url': 'https://github.com/driazati', 'followers_url': 'https://api.github.com/users/driazati/followers', 'following_url': 'https://api.github.com/users/driazati/following{/other_user}', 'gists_url': 'https://api.github.com/users/driazati/gists{/gist_id}', 'starred_url': 'https://api.github.com/users/driazati/starred{/owner}{/repo}', 'subscriptions_url': 'https://api.github.com/users/driazati/subscriptions', 'organizations_url': 'https://api.github.com/users/driazati/orgs', 'repos_url': 'https://api.github.com/users/driazati/repos', 'events_url': 'https://api.github.com/users/driazati/events{/privacy}', 'received_events_url': 'https://api.github.com/users/driazati/received_events', 'type': 'User', 'site_admin': False}",referenced,c7b151bb0ac6b455f5a927005b21c11fd98d8656,https://api.github.com/repos/pytorch/pytorch/commits/c7b151bb0ac6b455f5a927005b21c11fd98d8656,2019-07-16T05:26:01Z,4,1,3
22553,2486933912,"{'login': 'facebook-github-bot', 'id': 6422482, 'node_id': 'MDQ6VXNlcjY0MjI0ODI=', 'avatar_url': 'https://avatars3.githubusercontent.com/u/6422482?v=4', 'gravatar_id': '', 'url': 'https://api.github.com/users/facebook-github-bot', 'html_url': 'https://github.com/facebook-github-bot', 'followers_url': 'https://api.github.com/users/facebook-github-bot/followers', 'following_url': 'https://api.github.com/users/facebook-github-bot/following{/other_user}', 'gists_url': 'https://api.github.com/users/facebook-github-bot/gists{/gist_id}', 'starred_url': 'https://api.github.com/users/facebook-github-bot/starred{/owner}{/repo}', 'subscriptions_url': 'https://api.github.com/users/facebook-github-bot/subscriptions', 'organizations_url': 'https://api.github.com/users/facebook-github-bot/orgs', 'repos_url': 'https://api.github.com/users/facebook-github-bot/repos', 'events_url': 'https://api.github.com/users/facebook-github-bot/events{/privacy}', 'received_events_url': 'https://api.github.com/users/facebook-github-bot/received_events', 'type': 'User', 'site_admin': False}",closed,ba38445cfd3581934f870fd3b9c49ed3261d8de5,https://api.github.com/repos/pytorch/pytorch/commits/ba38445cfd3581934f870fd3b9c49ed3261d8de5,2019-07-16T17:31:04Z,4,1,3
22538,2567619739,"{'login': 'facebook-github-bot', 'id': 6422482, 'node_id': 'MDQ6VXNlcjY0MjI0ODI=', 'avatar_url': 'https://avatars3.githubusercontent.com/u/6422482?v=4', 'gravatar_id': '', 'url': 'https://api.github.com/users/facebook-github-bot', 'html_url': 'https://github.com/facebook-github-bot', 'followers_url': 'https://api.github.com/users/facebook-github-bot/followers', 'following_url': 'https://api.github.com/users/facebook-github-bot/following{/other_user}', 'gists_url': 'https://api.github.com/users/facebook-github-bot/gists{/gist_id}', 'starred_url': 'https://api.github.com/users/facebook-github-bot/starred{/owner}{/repo}', 'subscriptions_url': 'https://api.github.com/users/facebook-github-bot/subscriptions', 'organizations_url': 'https://api.github.com/users/facebook-github-bot/orgs', 'repos_url': 'https://api.github.com/users/facebook-github-bot/repos', 'events_url': 'https://api.github.com/users/facebook-github-bot/events{/privacy}', 'received_events_url': 'https://api.github.com/users/facebook-github-bot/received_events', 'type': 'User', 'site_admin': False}",closed,927fb56ee0307422bb9a49daff63f93b998d083b,https://api.github.com/repos/pytorch/pytorch/commits/927fb56ee0307422bb9a49daff63f93b998d083b,2019-08-19T20:43:54Z,22,12,10
22529,2466564201,"{'login': 'facebook-github-bot', 'id': 6422482, 'node_id': 'MDQ6VXNlcjY0MjI0ODI=', 'avatar_url': 'https://avatars3.githubusercontent.com/u/6422482?v=4', 'gravatar_id': '', 'url': 'https://api.github.com/users/facebook-github-bot', 'html_url': 'https://github.com/facebook-github-bot', 'followers_url': 'https://api.github.com/users/facebook-github-bot/followers', 'following_url': 'https://api.github.com/users/facebook-github-bot/following{/other_user}', 'gists_url': 'https://api.github.com/users/facebook-github-bot/gists{/gist_id}', 'starred_url': 'https://api.github.com/users/facebook-github-bot/starred{/owner}{/repo}', 'subscriptions_url': 'https://api.github.com/users/facebook-github-bot/subscriptions', 'organizations_url': 'https://api.github.com/users/facebook-github-bot/orgs', 'repos_url': 'https://api.github.com/users/facebook-github-bot/repos', 'events_url': 'https://api.github.com/users/facebook-github-bot/events{/privacy}', 'received_events_url': 'https://api.github.com/users/facebook-github-bot/received_events', 'type': 'User', 'site_admin': False}",closed,9bafe5d4da28fe127e95de924e34a4a44a0ba1d9,https://api.github.com/repos/pytorch/pytorch/commits/9bafe5d4da28fe127e95de924e34a4a44a0ba1d9,2019-07-08T15:30:21Z,106,58,48
22526,2758776493,"{'login': 'facebook-github-bot', 'id': 6422482, 'node_id': 'MDQ6VXNlcjY0MjI0ODI=', 'avatar_url': 'https://avatars3.githubusercontent.com/u/6422482?v=4', 'gravatar_id': '', 'url': 'https://api.github.com/users/facebook-github-bot', 'html_url': 'https://github.com/facebook-github-bot', 'followers_url': 'https://api.github.com/users/facebook-github-bot/followers', 'following_url': 'https://api.github.com/users/facebook-github-bot/following{/other_user}', 'gists_url': 'https://api.github.com/users/facebook-github-bot/gists{/gist_id}', 'starred_url': 'https://api.github.com/users/facebook-github-bot/starred{/owner}{/repo}', 'subscriptions_url': 'https://api.github.com/users/facebook-github-bot/subscriptions', 'organizations_url': 'https://api.github.com/users/facebook-github-bot/orgs', 'repos_url': 'https://api.github.com/users/facebook-github-bot/repos', 'events_url': 'https://api.github.com/users/facebook-github-bot/events{/privacy}', 'received_events_url': 'https://api.github.com/users/facebook-github-bot/received_events', 'type': 'User', 'site_admin': False}",closed,1b1e3d565c11b302b090735e6c4970ab7d9e17ab,https://api.github.com/repos/pytorch/pytorch/commits/1b1e3d565c11b302b090735e6c4970ab7d9e17ab,2019-10-31T08:01:01Z,37,29,8
22507,2466285321,"{'login': 'facebook-github-bot', 'id': 6422482, 'node_id': 'MDQ6VXNlcjY0MjI0ODI=', 'avatar_url': 'https://avatars3.githubusercontent.com/u/6422482?v=4', 'gravatar_id': '', 'url': 'https://api.github.com/users/facebook-github-bot', 'html_url': 'https://github.com/facebook-github-bot', 'followers_url': 'https://api.github.com/users/facebook-github-bot/followers', 'following_url': 'https://api.github.com/users/facebook-github-bot/following{/other_user}', 'gists_url': 'https://api.github.com/users/facebook-github-bot/gists{/gist_id}', 'starred_url': 'https://api.github.com/users/facebook-github-bot/starred{/owner}{/repo}', 'subscriptions_url': 'https://api.github.com/users/facebook-github-bot/subscriptions', 'organizations_url': 'https://api.github.com/users/facebook-github-bot/orgs', 'repos_url': 'https://api.github.com/users/facebook-github-bot/repos', 'events_url': 'https://api.github.com/users/facebook-github-bot/events{/privacy}', 'received_events_url': 'https://api.github.com/users/facebook-github-bot/received_events', 'type': 'User', 'site_admin': False}",closed,ce8c9d9bd5fa78392d5fb7028ef7f69d0c7a71dd,https://api.github.com/repos/pytorch/pytorch/commits/ce8c9d9bd5fa78392d5fb7028ef7f69d0c7a71dd,2019-07-08T14:09:58Z,56,24,32
22489,2464180622,"{'login': 'facebook-github-bot', 'id': 6422482, 'node_id': 'MDQ6VXNlcjY0MjI0ODI=', 'avatar_url': 'https://avatars3.githubusercontent.com/u/6422482?v=4', 'gravatar_id': '', 'url': 'https://api.github.com/users/facebook-github-bot', 'html_url': 'https://github.com/facebook-github-bot', 'followers_url': 'https://api.github.com/users/facebook-github-bot/followers', 'following_url': 'https://api.github.com/users/facebook-github-bot/following{/other_user}', 'gists_url': 'https://api.github.com/users/facebook-github-bot/gists{/gist_id}', 'starred_url': 'https://api.github.com/users/facebook-github-bot/starred{/owner}{/repo}', 'subscriptions_url': 'https://api.github.com/users/facebook-github-bot/subscriptions', 'organizations_url': 'https://api.github.com/users/facebook-github-bot/orgs', 'repos_url': 'https://api.github.com/users/facebook-github-bot/repos', 'events_url': 'https://api.github.com/users/facebook-github-bot/events{/privacy}', 'received_events_url': 'https://api.github.com/users/facebook-github-bot/received_events', 'type': 'User', 'site_admin': False}",closed,94bd5ddf7f3ff8b129fc193fe46ac5e09fb2df2b,https://api.github.com/repos/pytorch/pytorch/commits/94bd5ddf7f3ff8b129fc193fe46ac5e09fb2df2b,2019-07-07T02:32:20Z,15,9,6
22483,2663364125,"{'login': 'facebook-github-bot', 'id': 6422482, 'node_id': 'MDQ6VXNlcjY0MjI0ODI=', 'avatar_url': 'https://avatars3.githubusercontent.com/u/6422482?v=4', 'gravatar_id': '', 'url': 'https://api.github.com/users/facebook-github-bot', 'html_url': 'https://github.com/facebook-github-bot', 'followers_url': 'https://api.github.com/users/facebook-github-bot/followers', 'following_url': 'https://api.github.com/users/facebook-github-bot/following{/other_user}', 'gists_url': 'https://api.github.com/users/facebook-github-bot/gists{/gist_id}', 'starred_url': 'https://api.github.com/users/facebook-github-bot/starred{/owner}{/repo}', 'subscriptions_url': 'https://api.github.com/users/facebook-github-bot/subscriptions', 'organizations_url': 'https://api.github.com/users/facebook-github-bot/orgs', 'repos_url': 'https://api.github.com/users/facebook-github-bot/repos', 'events_url': 'https://api.github.com/users/facebook-github-bot/events{/privacy}', 'received_events_url': 'https://api.github.com/users/facebook-github-bot/received_events', 'type': 'User', 'site_admin': False}",closed,d43480d6d16f1a9009ac0d39d394e61c5e831d27,https://api.github.com/repos/pytorch/pytorch/commits/d43480d6d16f1a9009ac0d39d394e61c5e831d27,2019-09-25T22:41:44Z,95,74,21
22444,2725060398,"{'login': 'facebook-github-bot', 'id': 6422482, 'node_id': 'MDQ6VXNlcjY0MjI0ODI=', 'avatar_url': 'https://avatars3.githubusercontent.com/u/6422482?v=4', 'gravatar_id': '', 'url': 'https://api.github.com/users/facebook-github-bot', 'html_url': 'https://github.com/facebook-github-bot', 'followers_url': 'https://api.github.com/users/facebook-github-bot/followers', 'following_url': 'https://api.github.com/users/facebook-github-bot/following{/other_user}', 'gists_url': 'https://api.github.com/users/facebook-github-bot/gists{/gist_id}', 'starred_url': 'https://api.github.com/users/facebook-github-bot/starred{/owner}{/repo}', 'subscriptions_url': 'https://api.github.com/users/facebook-github-bot/subscriptions', 'organizations_url': 'https://api.github.com/users/facebook-github-bot/orgs', 'repos_url': 'https://api.github.com/users/facebook-github-bot/repos', 'events_url': 'https://api.github.com/users/facebook-github-bot/events{/privacy}', 'received_events_url': 'https://api.github.com/users/facebook-github-bot/received_events', 'type': 'User', 'site_admin': False}",closed,a1ac15081ea8f7ecd3704f3439305dbf86d7dbe5,https://api.github.com/repos/pytorch/pytorch/commits/a1ac15081ea8f7ecd3704f3439305dbf86d7dbe5,2019-10-18T14:18:21Z,3,2,1
22431,2507097040,"{'login': 'facebook-github-bot', 'id': 6422482, 'node_id': 'MDQ6VXNlcjY0MjI0ODI=', 'avatar_url': 'https://avatars3.githubusercontent.com/u/6422482?v=4', 'gravatar_id': '', 'url': 'https://api.github.com/users/facebook-github-bot', 'html_url': 'https://github.com/facebook-github-bot', 'followers_url': 'https://api.github.com/users/facebook-github-bot/followers', 'following_url': 'https://api.github.com/users/facebook-github-bot/following{/other_user}', 'gists_url': 'https://api.github.com/users/facebook-github-bot/gists{/gist_id}', 'starred_url': 'https://api.github.com/users/facebook-github-bot/starred{/owner}{/repo}', 'subscriptions_url': 'https://api.github.com/users/facebook-github-bot/subscriptions', 'organizations_url': 'https://api.github.com/users/facebook-github-bot/orgs', 'repos_url': 'https://api.github.com/users/facebook-github-bot/repos', 'events_url': 'https://api.github.com/users/facebook-github-bot/events{/privacy}', 'received_events_url': 'https://api.github.com/users/facebook-github-bot/received_events', 'type': 'User', 'site_admin': False}",closed,200cb836f1e31c877e9ac165c326927fa42a28fa,https://api.github.com/repos/pytorch/pytorch/commits/200cb836f1e31c877e9ac165c326927fa42a28fa,2019-07-24T17:34:20Z,129,68,61
22430,2507097031,"{'login': 'facebook-github-bot', 'id': 6422482, 'node_id': 'MDQ6VXNlcjY0MjI0ODI=', 'avatar_url': 'https://avatars3.githubusercontent.com/u/6422482?v=4', 'gravatar_id': '', 'url': 'https://api.github.com/users/facebook-github-bot', 'html_url': 'https://github.com/facebook-github-bot', 'followers_url': 'https://api.github.com/users/facebook-github-bot/followers', 'following_url': 'https://api.github.com/users/facebook-github-bot/following{/other_user}', 'gists_url': 'https://api.github.com/users/facebook-github-bot/gists{/gist_id}', 'starred_url': 'https://api.github.com/users/facebook-github-bot/starred{/owner}{/repo}', 'subscriptions_url': 'https://api.github.com/users/facebook-github-bot/subscriptions', 'organizations_url': 'https://api.github.com/users/facebook-github-bot/orgs', 'repos_url': 'https://api.github.com/users/facebook-github-bot/repos', 'events_url': 'https://api.github.com/users/facebook-github-bot/events{/privacy}', 'received_events_url': 'https://api.github.com/users/facebook-github-bot/received_events', 'type': 'User', 'site_admin': False}",referenced,200cb836f1e31c877e9ac165c326927fa42a28fa,https://api.github.com/repos/pytorch/pytorch/commits/200cb836f1e31c877e9ac165c326927fa42a28fa,2019-07-24T17:34:20Z,129,68,61
22389,2496938593,"{'login': 'facebook-github-bot', 'id': 6422482, 'node_id': 'MDQ6VXNlcjY0MjI0ODI=', 'avatar_url': 'https://avatars3.githubusercontent.com/u/6422482?v=4', 'gravatar_id': '', 'url': 'https://api.github.com/users/facebook-github-bot', 'html_url': 'https://github.com/facebook-github-bot', 'followers_url': 'https://api.github.com/users/facebook-github-bot/followers', 'following_url': 'https://api.github.com/users/facebook-github-bot/following{/other_user}', 'gists_url': 'https://api.github.com/users/facebook-github-bot/gists{/gist_id}', 'starred_url': 'https://api.github.com/users/facebook-github-bot/starred{/owner}{/repo}', 'subscriptions_url': 'https://api.github.com/users/facebook-github-bot/subscriptions', 'organizations_url': 'https://api.github.com/users/facebook-github-bot/orgs', 'repos_url': 'https://api.github.com/users/facebook-github-bot/repos', 'events_url': 'https://api.github.com/users/facebook-github-bot/events{/privacy}', 'received_events_url': 'https://api.github.com/users/facebook-github-bot/received_events', 'type': 'User', 'site_admin': False}",closed,818828e8a86a90c9f3fe23c7c1fba93ac81c87c8,https://api.github.com/repos/pytorch/pytorch/commits/818828e8a86a90c9f3fe23c7c1fba93ac81c87c8,2019-07-19T20:33:36Z,3,2,1
22353,2577451111,"{'login': 'facebook-github-bot', 'id': 6422482, 'node_id': 'MDQ6VXNlcjY0MjI0ODI=', 'avatar_url': 'https://avatars3.githubusercontent.com/u/6422482?v=4', 'gravatar_id': '', 'url': 'https://api.github.com/users/facebook-github-bot', 'html_url': 'https://github.com/facebook-github-bot', 'followers_url': 'https://api.github.com/users/facebook-github-bot/followers', 'following_url': 'https://api.github.com/users/facebook-github-bot/following{/other_user}', 'gists_url': 'https://api.github.com/users/facebook-github-bot/gists{/gist_id}', 'starred_url': 'https://api.github.com/users/facebook-github-bot/starred{/owner}{/repo}', 'subscriptions_url': 'https://api.github.com/users/facebook-github-bot/subscriptions', 'organizations_url': 'https://api.github.com/users/facebook-github-bot/orgs', 'repos_url': 'https://api.github.com/users/facebook-github-bot/repos', 'events_url': 'https://api.github.com/users/facebook-github-bot/events{/privacy}', 'received_events_url': 'https://api.github.com/users/facebook-github-bot/received_events', 'type': 'User', 'site_admin': False}",referenced,c33adf539c82fe26ed678a2aea4427fbbcbd7c97,https://api.github.com/repos/pytorch/pytorch/commits/c33adf539c82fe26ed678a2aea4427fbbcbd7c97,2019-08-22T18:36:48Z,69,46,23
22301,2666936664,"{'login': 'facebook-github-bot', 'id': 6422482, 'node_id': 'MDQ6VXNlcjY0MjI0ODI=', 'avatar_url': 'https://avatars3.githubusercontent.com/u/6422482?v=4', 'gravatar_id': '', 'url': 'https://api.github.com/users/facebook-github-bot', 'html_url': 'https://github.com/facebook-github-bot', 'followers_url': 'https://api.github.com/users/facebook-github-bot/followers', 'following_url': 'https://api.github.com/users/facebook-github-bot/following{/other_user}', 'gists_url': 'https://api.github.com/users/facebook-github-bot/gists{/gist_id}', 'starred_url': 'https://api.github.com/users/facebook-github-bot/starred{/owner}{/repo}', 'subscriptions_url': 'https://api.github.com/users/facebook-github-bot/subscriptions', 'organizations_url': 'https://api.github.com/users/facebook-github-bot/orgs', 'repos_url': 'https://api.github.com/users/facebook-github-bot/repos', 'events_url': 'https://api.github.com/users/facebook-github-bot/events{/privacy}', 'received_events_url': 'https://api.github.com/users/facebook-github-bot/received_events', 'type': 'User', 'site_admin': False}",closed,f99bc714c7bacf9a74c85514ef70b677415d4f0c,https://api.github.com/repos/pytorch/pytorch/commits/f99bc714c7bacf9a74c85514ef70b677415d4f0c,2019-09-26T23:05:50Z,462,264,198
22300,2447400249,"{'login': 'ezyang', 'id': 13564, 'node_id': 'MDQ6VXNlcjEzNTY0', 'avatar_url': 'https://avatars0.githubusercontent.com/u/13564?v=4', 'gravatar_id': '', 'url': 'https://api.github.com/users/ezyang', 'html_url': 'https://github.com/ezyang', 'followers_url': 'https://api.github.com/users/ezyang/followers', 'following_url': 'https://api.github.com/users/ezyang/following{/other_user}', 'gists_url': 'https://api.github.com/users/ezyang/gists{/gist_id}', 'starred_url': 'https://api.github.com/users/ezyang/starred{/owner}{/repo}', 'subscriptions_url': 'https://api.github.com/users/ezyang/subscriptions', 'organizations_url': 'https://api.github.com/users/ezyang/orgs', 'repos_url': 'https://api.github.com/users/ezyang/repos', 'events_url': 'https://api.github.com/users/ezyang/events{/privacy}', 'received_events_url': 'https://api.github.com/users/ezyang/received_events', 'type': 'User', 'site_admin': False}",referenced,b522efbaea11c46feed0f97d43cc1a7a2e17e5b1,https://api.github.com/repos/pytorch/pytorch/commits/b522efbaea11c46feed0f97d43cc1a7a2e17e5b1,2019-06-28T13:59:57Z,12,6,6
22300,2447400475,"{'login': 'ezyang', 'id': 13564, 'node_id': 'MDQ6VXNlcjEzNTY0', 'avatar_url': 'https://avatars0.githubusercontent.com/u/13564?v=4', 'gravatar_id': '', 'url': 'https://api.github.com/users/ezyang', 'html_url': 'https://github.com/ezyang', 'followers_url': 'https://api.github.com/users/ezyang/followers', 'following_url': 'https://api.github.com/users/ezyang/following{/other_user}', 'gists_url': 'https://api.github.com/users/ezyang/gists{/gist_id}', 'starred_url': 'https://api.github.com/users/ezyang/starred{/owner}{/repo}', 'subscriptions_url': 'https://api.github.com/users/ezyang/subscriptions', 'organizations_url': 'https://api.github.com/users/ezyang/orgs', 'repos_url': 'https://api.github.com/users/ezyang/repos', 'events_url': 'https://api.github.com/users/ezyang/events{/privacy}', 'received_events_url': 'https://api.github.com/users/ezyang/received_events', 'type': 'User', 'site_admin': False}",referenced,2bc932e75ed13723970a87b1e61ae92c8d6b33a8,https://api.github.com/repos/pytorch/pytorch/commits/2bc932e75ed13723970a87b1e61ae92c8d6b33a8,2019-06-28T14:00:01Z,12,6,6
22300,2466362726,"{'login': 'ezyang', 'id': 13564, 'node_id': 'MDQ6VXNlcjEzNTY0', 'avatar_url': 'https://avatars0.githubusercontent.com/u/13564?v=4', 'gravatar_id': '', 'url': 'https://api.github.com/users/ezyang', 'html_url': 'https://github.com/ezyang', 'followers_url': 'https://api.github.com/users/ezyang/followers', 'following_url': 'https://api.github.com/users/ezyang/following{/other_user}', 'gists_url': 'https://api.github.com/users/ezyang/gists{/gist_id}', 'starred_url': 'https://api.github.com/users/ezyang/starred{/owner}{/repo}', 'subscriptions_url': 'https://api.github.com/users/ezyang/subscriptions', 'organizations_url': 'https://api.github.com/users/ezyang/orgs', 'repos_url': 'https://api.github.com/users/ezyang/repos', 'events_url': 'https://api.github.com/users/ezyang/events{/privacy}', 'received_events_url': 'https://api.github.com/users/ezyang/received_events', 'type': 'User', 'site_admin': False}",referenced,9d1bd9d0008209e376b53e61406664b721b26aa5,https://api.github.com/repos/pytorch/pytorch/commits/9d1bd9d0008209e376b53e61406664b721b26aa5,2019-07-08T14:31:46Z,16,8,8
22300,2466362856,"{'login': 'ezyang', 'id': 13564, 'node_id': 'MDQ6VXNlcjEzNTY0', 'avatar_url': 'https://avatars0.githubusercontent.com/u/13564?v=4', 'gravatar_id': '', 'url': 'https://api.github.com/users/ezyang', 'html_url': 'https://github.com/ezyang', 'followers_url': 'https://api.github.com/users/ezyang/followers', 'following_url': 'https://api.github.com/users/ezyang/following{/other_user}', 'gists_url': 'https://api.github.com/users/ezyang/gists{/gist_id}', 'starred_url': 'https://api.github.com/users/ezyang/starred{/owner}{/repo}', 'subscriptions_url': 'https://api.github.com/users/ezyang/subscriptions', 'organizations_url': 'https://api.github.com/users/ezyang/orgs', 'repos_url': 'https://api.github.com/users/ezyang/repos', 'events_url': 'https://api.github.com/users/ezyang/events{/privacy}', 'received_events_url': 'https://api.github.com/users/ezyang/received_events', 'type': 'User', 'site_admin': False}",referenced,da8f54397e822c8613d546d3c500e39ba57ad0af,https://api.github.com/repos/pytorch/pytorch/commits/da8f54397e822c8613d546d3c500e39ba57ad0af,2019-07-08T14:31:48Z,16463,10019,6444
22300,2466560628,"{'login': 'ezyang', 'id': 13564, 'node_id': 'MDQ6VXNlcjEzNTY0', 'avatar_url': 'https://avatars0.githubusercontent.com/u/13564?v=4', 'gravatar_id': '', 'url': 'https://api.github.com/users/ezyang', 'html_url': 'https://github.com/ezyang', 'followers_url': 'https://api.github.com/users/ezyang/followers', 'following_url': 'https://api.github.com/users/ezyang/following{/other_user}', 'gists_url': 'https://api.github.com/users/ezyang/gists{/gist_id}', 'starred_url': 'https://api.github.com/users/ezyang/starred{/owner}{/repo}', 'subscriptions_url': 'https://api.github.com/users/ezyang/subscriptions', 'organizations_url': 'https://api.github.com/users/ezyang/orgs', 'repos_url': 'https://api.github.com/users/ezyang/repos', 'events_url': 'https://api.github.com/users/ezyang/events{/privacy}', 'received_events_url': 'https://api.github.com/users/ezyang/received_events', 'type': 'User', 'site_admin': False}",referenced,f86232f77515d287af656f7cb288055ae879bdec,https://api.github.com/repos/pytorch/pytorch/commits/f86232f77515d287af656f7cb288055ae879bdec,2019-07-08T15:29:17Z,2,1,1
22300,2466560956,"{'login': 'ezyang', 'id': 13564, 'node_id': 'MDQ6VXNlcjEzNTY0', 'avatar_url': 'https://avatars0.githubusercontent.com/u/13564?v=4', 'gravatar_id': '', 'url': 'https://api.github.com/users/ezyang', 'html_url': 'https://github.com/ezyang', 'followers_url': 'https://api.github.com/users/ezyang/followers', 'following_url': 'https://api.github.com/users/ezyang/following{/other_user}', 'gists_url': 'https://api.github.com/users/ezyang/gists{/gist_id}', 'starred_url': 'https://api.github.com/users/ezyang/starred{/owner}{/repo}', 'subscriptions_url': 'https://api.github.com/users/ezyang/subscriptions', 'organizations_url': 'https://api.github.com/users/ezyang/orgs', 'repos_url': 'https://api.github.com/users/ezyang/repos', 'events_url': 'https://api.github.com/users/ezyang/events{/privacy}', 'received_events_url': 'https://api.github.com/users/ezyang/received_events', 'type': 'User', 'site_admin': False}",referenced,fa2456fe728e41c23a4c27b262d25c25bc9608db,https://api.github.com/repos/pytorch/pytorch/commits/fa2456fe728e41c23a4c27b262d25c25bc9608db,2019-07-08T15:29:22Z,18,9,9
22300,2472979566,"{'login': 'ezyang', 'id': 13564, 'node_id': 'MDQ6VXNlcjEzNTY0', 'avatar_url': 'https://avatars0.githubusercontent.com/u/13564?v=4', 'gravatar_id': '', 'url': 'https://api.github.com/users/ezyang', 'html_url': 'https://github.com/ezyang', 'followers_url': 'https://api.github.com/users/ezyang/followers', 'following_url': 'https://api.github.com/users/ezyang/following{/other_user}', 'gists_url': 'https://api.github.com/users/ezyang/gists{/gist_id}', 'starred_url': 'https://api.github.com/users/ezyang/starred{/owner}{/repo}', 'subscriptions_url': 'https://api.github.com/users/ezyang/subscriptions', 'organizations_url': 'https://api.github.com/users/ezyang/orgs', 'repos_url': 'https://api.github.com/users/ezyang/repos', 'events_url': 'https://api.github.com/users/ezyang/events{/privacy}', 'received_events_url': 'https://api.github.com/users/ezyang/received_events', 'type': 'User', 'site_admin': False}",referenced,b3dab1fc8bc965bb06e03faf300eaa6ce0dfc260,https://api.github.com/repos/pytorch/pytorch/commits/b3dab1fc8bc965bb06e03faf300eaa6ce0dfc260,2019-07-10T15:26:32Z,26,13,13
22300,2472979662,"{'login': 'ezyang', 'id': 13564, 'node_id': 'MDQ6VXNlcjEzNTY0', 'avatar_url': 'https://avatars0.githubusercontent.com/u/13564?v=4', 'gravatar_id': '', 'url': 'https://api.github.com/users/ezyang', 'html_url': 'https://github.com/ezyang', 'followers_url': 'https://api.github.com/users/ezyang/followers', 'following_url': 'https://api.github.com/users/ezyang/following{/other_user}', 'gists_url': 'https://api.github.com/users/ezyang/gists{/gist_id}', 'starred_url': 'https://api.github.com/users/ezyang/starred{/owner}{/repo}', 'subscriptions_url': 'https://api.github.com/users/ezyang/subscriptions', 'organizations_url': 'https://api.github.com/users/ezyang/orgs', 'repos_url': 'https://api.github.com/users/ezyang/repos', 'events_url': 'https://api.github.com/users/ezyang/events{/privacy}', 'received_events_url': 'https://api.github.com/users/ezyang/received_events', 'type': 'User', 'site_admin': False}",referenced,ff46242df77874b014cd7614fb5edd38777e4864,https://api.github.com/repos/pytorch/pytorch/commits/ff46242df77874b014cd7614fb5edd38777e4864,2019-07-10T15:26:34Z,8,4,4
22300,2477169161,"{'login': 'ezyang', 'id': 13564, 'node_id': 'MDQ6VXNlcjEzNTY0', 'avatar_url': 'https://avatars0.githubusercontent.com/u/13564?v=4', 'gravatar_id': '', 'url': 'https://api.github.com/users/ezyang', 'html_url': 'https://github.com/ezyang', 'followers_url': 'https://api.github.com/users/ezyang/followers', 'following_url': 'https://api.github.com/users/ezyang/following{/other_user}', 'gists_url': 'https://api.github.com/users/ezyang/gists{/gist_id}', 'starred_url': 'https://api.github.com/users/ezyang/starred{/owner}{/repo}', 'subscriptions_url': 'https://api.github.com/users/ezyang/subscriptions', 'organizations_url': 'https://api.github.com/users/ezyang/orgs', 'repos_url': 'https://api.github.com/users/ezyang/repos', 'events_url': 'https://api.github.com/users/ezyang/events{/privacy}', 'received_events_url': 'https://api.github.com/users/ezyang/received_events', 'type': 'User', 'site_admin': False}",referenced,6166342df5321ade82a5daaa318fbf59b748fe95,https://api.github.com/repos/pytorch/pytorch/commits/6166342df5321ade82a5daaa318fbf59b748fe95,2019-07-11T20:29:31Z,0,0,0
22300,2479250727,"{'login': 'ezyang', 'id': 13564, 'node_id': 'MDQ6VXNlcjEzNTY0', 'avatar_url': 'https://avatars0.githubusercontent.com/u/13564?v=4', 'gravatar_id': '', 'url': 'https://api.github.com/users/ezyang', 'html_url': 'https://github.com/ezyang', 'followers_url': 'https://api.github.com/users/ezyang/followers', 'following_url': 'https://api.github.com/users/ezyang/following{/other_user}', 'gists_url': 'https://api.github.com/users/ezyang/gists{/gist_id}', 'starred_url': 'https://api.github.com/users/ezyang/starred{/owner}{/repo}', 'subscriptions_url': 'https://api.github.com/users/ezyang/subscriptions', 'organizations_url': 'https://api.github.com/users/ezyang/orgs', 'repos_url': 'https://api.github.com/users/ezyang/repos', 'events_url': 'https://api.github.com/users/ezyang/events{/privacy}', 'received_events_url': 'https://api.github.com/users/ezyang/received_events', 'type': 'User', 'site_admin': False}",referenced,fa881a9d7c65ccb772fd6f7e8443e480debab119,https://api.github.com/repos/pytorch/pytorch/commits/fa881a9d7c65ccb772fd6f7e8443e480debab119,2019-07-12T14:34:47Z,6623,5219,1404
22300,2479718309,"{'login': 'ezyang', 'id': 13564, 'node_id': 'MDQ6VXNlcjEzNTY0', 'avatar_url': 'https://avatars0.githubusercontent.com/u/13564?v=4', 'gravatar_id': '', 'url': 'https://api.github.com/users/ezyang', 'html_url': 'https://github.com/ezyang', 'followers_url': 'https://api.github.com/users/ezyang/followers', 'following_url': 'https://api.github.com/users/ezyang/following{/other_user}', 'gists_url': 'https://api.github.com/users/ezyang/gists{/gist_id}', 'starred_url': 'https://api.github.com/users/ezyang/starred{/owner}{/repo}', 'subscriptions_url': 'https://api.github.com/users/ezyang/subscriptions', 'organizations_url': 'https://api.github.com/users/ezyang/orgs', 'repos_url': 'https://api.github.com/users/ezyang/repos', 'events_url': 'https://api.github.com/users/ezyang/events{/privacy}', 'received_events_url': 'https://api.github.com/users/ezyang/received_events', 'type': 'User', 'site_admin': False}",referenced,2b653188e0f78eba01fe52a630574bc9eb1a66dc,https://api.github.com/repos/pytorch/pytorch/commits/2b653188e0f78eba01fe52a630574bc9eb1a66dc,2019-07-12T17:30:02Z,2,2,0
22300,2479735647,"{'login': 'ezyang', 'id': 13564, 'node_id': 'MDQ6VXNlcjEzNTY0', 'avatar_url': 'https://avatars0.githubusercontent.com/u/13564?v=4', 'gravatar_id': '', 'url': 'https://api.github.com/users/ezyang', 'html_url': 'https://github.com/ezyang', 'followers_url': 'https://api.github.com/users/ezyang/followers', 'following_url': 'https://api.github.com/users/ezyang/following{/other_user}', 'gists_url': 'https://api.github.com/users/ezyang/gists{/gist_id}', 'starred_url': 'https://api.github.com/users/ezyang/starred{/owner}{/repo}', 'subscriptions_url': 'https://api.github.com/users/ezyang/subscriptions', 'organizations_url': 'https://api.github.com/users/ezyang/orgs', 'repos_url': 'https://api.github.com/users/ezyang/repos', 'events_url': 'https://api.github.com/users/ezyang/events{/privacy}', 'received_events_url': 'https://api.github.com/users/ezyang/received_events', 'type': 'User', 'site_admin': False}",referenced,649fc95405fa8055748e9c1e748d17e682cad317,https://api.github.com/repos/pytorch/pytorch/commits/649fc95405fa8055748e9c1e748d17e682cad317,2019-07-12T17:37:19Z,0,0,0
22300,2479748292,"{'login': 'ezyang', 'id': 13564, 'node_id': 'MDQ6VXNlcjEzNTY0', 'avatar_url': 'https://avatars0.githubusercontent.com/u/13564?v=4', 'gravatar_id': '', 'url': 'https://api.github.com/users/ezyang', 'html_url': 'https://github.com/ezyang', 'followers_url': 'https://api.github.com/users/ezyang/followers', 'following_url': 'https://api.github.com/users/ezyang/following{/other_user}', 'gists_url': 'https://api.github.com/users/ezyang/gists{/gist_id}', 'starred_url': 'https://api.github.com/users/ezyang/starred{/owner}{/repo}', 'subscriptions_url': 'https://api.github.com/users/ezyang/subscriptions', 'organizations_url': 'https://api.github.com/users/ezyang/orgs', 'repos_url': 'https://api.github.com/users/ezyang/repos', 'events_url': 'https://api.github.com/users/ezyang/events{/privacy}', 'received_events_url': 'https://api.github.com/users/ezyang/received_events', 'type': 'User', 'site_admin': False}",referenced,6a8fadc7b3e5e85d0d2d641ad40f2767bff6d822,https://api.github.com/repos/pytorch/pytorch/commits/6a8fadc7b3e5e85d0d2d641ad40f2767bff6d822,2019-07-12T17:42:30Z,0,0,0
22262,2442386603,"{'login': 'xuhdev', 'id': 325476, 'node_id': 'MDQ6VXNlcjMyNTQ3Ng==', 'avatar_url': 'https://avatars1.githubusercontent.com/u/325476?v=4', 'gravatar_id': '', 'url': 'https://api.github.com/users/xuhdev', 'html_url': 'https://github.com/xuhdev', 'followers_url': 'https://api.github.com/users/xuhdev/followers', 'following_url': 'https://api.github.com/users/xuhdev/following{/other_user}', 'gists_url': 'https://api.github.com/users/xuhdev/gists{/gist_id}', 'starred_url': 'https://api.github.com/users/xuhdev/starred{/owner}{/repo}', 'subscriptions_url': 'https://api.github.com/users/xuhdev/subscriptions', 'organizations_url': 'https://api.github.com/users/xuhdev/orgs', 'repos_url': 'https://api.github.com/users/xuhdev/repos', 'events_url': 'https://api.github.com/users/xuhdev/events{/privacy}', 'received_events_url': 'https://api.github.com/users/xuhdev/received_events', 'type': 'User', 'site_admin': False}",referenced,3589d05816bad7109fb65be17e85f347d9b79e98,https://api.github.com/repos/pytorch/pytorch/commits/3589d05816bad7109fb65be17e85f347d9b79e98,2019-06-26T22:29:37Z,91,91,0
22262,2442386766,"{'login': 'xuhdev', 'id': 325476, 'node_id': 'MDQ6VXNlcjMyNTQ3Ng==', 'avatar_url': 'https://avatars1.githubusercontent.com/u/325476?v=4', 'gravatar_id': '', 'url': 'https://api.github.com/users/xuhdev', 'html_url': 'https://github.com/xuhdev', 'followers_url': 'https://api.github.com/users/xuhdev/followers', 'following_url': 'https://api.github.com/users/xuhdev/following{/other_user}', 'gists_url': 'https://api.github.com/users/xuhdev/gists{/gist_id}', 'starred_url': 'https://api.github.com/users/xuhdev/starred{/owner}{/repo}', 'subscriptions_url': 'https://api.github.com/users/xuhdev/subscriptions', 'organizations_url': 'https://api.github.com/users/xuhdev/orgs', 'repos_url': 'https://api.github.com/users/xuhdev/repos', 'events_url': 'https://api.github.com/users/xuhdev/events{/privacy}', 'received_events_url': 'https://api.github.com/users/xuhdev/received_events', 'type': 'User', 'site_admin': False}",referenced,26045b10cb0ee112013bba82ded012fbcd035519,https://api.github.com/repos/pytorch/pytorch/commits/26045b10cb0ee112013bba82ded012fbcd035519,2019-06-26T22:29:43Z,91,91,0
22262,2442387544,"{'login': 'xuhdev', 'id': 325476, 'node_id': 'MDQ6VXNlcjMyNTQ3Ng==', 'avatar_url': 'https://avatars1.githubusercontent.com/u/325476?v=4', 'gravatar_id': '', 'url': 'https://api.github.com/users/xuhdev', 'html_url': 'https://github.com/xuhdev', 'followers_url': 'https://api.github.com/users/xuhdev/followers', 'following_url': 'https://api.github.com/users/xuhdev/following{/other_user}', 'gists_url': 'https://api.github.com/users/xuhdev/gists{/gist_id}', 'starred_url': 'https://api.github.com/users/xuhdev/starred{/owner}{/repo}', 'subscriptions_url': 'https://api.github.com/users/xuhdev/subscriptions', 'organizations_url': 'https://api.github.com/users/xuhdev/orgs', 'repos_url': 'https://api.github.com/users/xuhdev/repos', 'events_url': 'https://api.github.com/users/xuhdev/events{/privacy}', 'received_events_url': 'https://api.github.com/users/xuhdev/received_events', 'type': 'User', 'site_admin': False}",referenced,4fc2b225bc2a0f56df968cc80caea30d280faebd,https://api.github.com/repos/pytorch/pytorch/commits/4fc2b225bc2a0f56df968cc80caea30d280faebd,2019-06-26T22:30:10Z,1337,552,785
22262,2442387640,"{'login': 'xuhdev', 'id': 325476, 'node_id': 'MDQ6VXNlcjMyNTQ3Ng==', 'avatar_url': 'https://avatars1.githubusercontent.com/u/325476?v=4', 'gravatar_id': '', 'url': 'https://api.github.com/users/xuhdev', 'html_url': 'https://github.com/xuhdev', 'followers_url': 'https://api.github.com/users/xuhdev/followers', 'following_url': 'https://api.github.com/users/xuhdev/following{/other_user}', 'gists_url': 'https://api.github.com/users/xuhdev/gists{/gist_id}', 'starred_url': 'https://api.github.com/users/xuhdev/starred{/owner}{/repo}', 'subscriptions_url': 'https://api.github.com/users/xuhdev/subscriptions', 'organizations_url': 'https://api.github.com/users/xuhdev/orgs', 'repos_url': 'https://api.github.com/users/xuhdev/repos', 'events_url': 'https://api.github.com/users/xuhdev/events{/privacy}', 'received_events_url': 'https://api.github.com/users/xuhdev/received_events', 'type': 'User', 'site_admin': False}",referenced,ac46fe6ad13af169af7244bab924e15f8d87042d,https://api.github.com/repos/pytorch/pytorch/commits/ac46fe6ad13af169af7244bab924e15f8d87042d,2019-06-26T22:30:14Z,91,91,0
22262,2442486519,"{'login': 'xuhdev', 'id': 325476, 'node_id': 'MDQ6VXNlcjMyNTQ3Ng==', 'avatar_url': 'https://avatars1.githubusercontent.com/u/325476?v=4', 'gravatar_id': '', 'url': 'https://api.github.com/users/xuhdev', 'html_url': 'https://github.com/xuhdev', 'followers_url': 'https://api.github.com/users/xuhdev/followers', 'following_url': 'https://api.github.com/users/xuhdev/following{/other_user}', 'gists_url': 'https://api.github.com/users/xuhdev/gists{/gist_id}', 'starred_url': 'https://api.github.com/users/xuhdev/starred{/owner}{/repo}', 'subscriptions_url': 'https://api.github.com/users/xuhdev/subscriptions', 'organizations_url': 'https://api.github.com/users/xuhdev/orgs', 'repos_url': 'https://api.github.com/users/xuhdev/repos', 'events_url': 'https://api.github.com/users/xuhdev/events{/privacy}', 'received_events_url': 'https://api.github.com/users/xuhdev/received_events', 'type': 'User', 'site_admin': False}",referenced,259ee6876969ac610f0ad880656d313f0167371c,https://api.github.com/repos/pytorch/pytorch/commits/259ee6876969ac610f0ad880656d313f0167371c,2019-06-26T23:36:34Z,25,20,5
22262,2442486596,"{'login': 'xuhdev', 'id': 325476, 'node_id': 'MDQ6VXNlcjMyNTQ3Ng==', 'avatar_url': 'https://avatars1.githubusercontent.com/u/325476?v=4', 'gravatar_id': '', 'url': 'https://api.github.com/users/xuhdev', 'html_url': 'https://github.com/xuhdev', 'followers_url': 'https://api.github.com/users/xuhdev/followers', 'following_url': 'https://api.github.com/users/xuhdev/following{/other_user}', 'gists_url': 'https://api.github.com/users/xuhdev/gists{/gist_id}', 'starred_url': 'https://api.github.com/users/xuhdev/starred{/owner}{/repo}', 'subscriptions_url': 'https://api.github.com/users/xuhdev/subscriptions', 'organizations_url': 'https://api.github.com/users/xuhdev/orgs', 'repos_url': 'https://api.github.com/users/xuhdev/repos', 'events_url': 'https://api.github.com/users/xuhdev/events{/privacy}', 'received_events_url': 'https://api.github.com/users/xuhdev/received_events', 'type': 'User', 'site_admin': False}",referenced,7fee59926d3f6fcd4aebecab3818024f2e196a1b,https://api.github.com/repos/pytorch/pytorch/commits/7fee59926d3f6fcd4aebecab3818024f2e196a1b,2019-06-26T23:36:37Z,106,106,0
22262,2442510727,"{'login': 'xuhdev', 'id': 325476, 'node_id': 'MDQ6VXNlcjMyNTQ3Ng==', 'avatar_url': 'https://avatars1.githubusercontent.com/u/325476?v=4', 'gravatar_id': '', 'url': 'https://api.github.com/users/xuhdev', 'html_url': 'https://github.com/xuhdev', 'followers_url': 'https://api.github.com/users/xuhdev/followers', 'following_url': 'https://api.github.com/users/xuhdev/following{/other_user}', 'gists_url': 'https://api.github.com/users/xuhdev/gists{/gist_id}', 'starred_url': 'https://api.github.com/users/xuhdev/starred{/owner}{/repo}', 'subscriptions_url': 'https://api.github.com/users/xuhdev/subscriptions', 'organizations_url': 'https://api.github.com/users/xuhdev/orgs', 'repos_url': 'https://api.github.com/users/xuhdev/repos', 'events_url': 'https://api.github.com/users/xuhdev/events{/privacy}', 'received_events_url': 'https://api.github.com/users/xuhdev/received_events', 'type': 'User', 'site_admin': False}",referenced,c0d693de9c74f4122556ae14586d3eae286c0479,https://api.github.com/repos/pytorch/pytorch/commits/c0d693de9c74f4122556ae14586d3eae286c0479,2019-06-26T23:56:16Z,1012,908,104
22262,2442510804,"{'login': 'xuhdev', 'id': 325476, 'node_id': 'MDQ6VXNlcjMyNTQ3Ng==', 'avatar_url': 'https://avatars1.githubusercontent.com/u/325476?v=4', 'gravatar_id': '', 'url': 'https://api.github.com/users/xuhdev', 'html_url': 'https://github.com/xuhdev', 'followers_url': 'https://api.github.com/users/xuhdev/followers', 'following_url': 'https://api.github.com/users/xuhdev/following{/other_user}', 'gists_url': 'https://api.github.com/users/xuhdev/gists{/gist_id}', 'starred_url': 'https://api.github.com/users/xuhdev/starred{/owner}{/repo}', 'subscriptions_url': 'https://api.github.com/users/xuhdev/subscriptions', 'organizations_url': 'https://api.github.com/users/xuhdev/orgs', 'repos_url': 'https://api.github.com/users/xuhdev/repos', 'events_url': 'https://api.github.com/users/xuhdev/events{/privacy}', 'received_events_url': 'https://api.github.com/users/xuhdev/received_events', 'type': 'User', 'site_admin': False}",referenced,0d6d02c136697c2faa2d471ea56c7f3b15a14275,https://api.github.com/repos/pytorch/pytorch/commits/0d6d02c136697c2faa2d471ea56c7f3b15a14275,2019-06-26T23:56:19Z,106,106,0
22262,2442622009,"{'login': 'xuhdev', 'id': 325476, 'node_id': 'MDQ6VXNlcjMyNTQ3Ng==', 'avatar_url': 'https://avatars1.githubusercontent.com/u/325476?v=4', 'gravatar_id': '', 'url': 'https://api.github.com/users/xuhdev', 'html_url': 'https://github.com/xuhdev', 'followers_url': 'https://api.github.com/users/xuhdev/followers', 'following_url': 'https://api.github.com/users/xuhdev/following{/other_user}', 'gists_url': 'https://api.github.com/users/xuhdev/gists{/gist_id}', 'starred_url': 'https://api.github.com/users/xuhdev/starred{/owner}{/repo}', 'subscriptions_url': 'https://api.github.com/users/xuhdev/subscriptions', 'organizations_url': 'https://api.github.com/users/xuhdev/orgs', 'repos_url': 'https://api.github.com/users/xuhdev/repos', 'events_url': 'https://api.github.com/users/xuhdev/events{/privacy}', 'received_events_url': 'https://api.github.com/users/xuhdev/received_events', 'type': 'User', 'site_admin': False}",referenced,f95d61715d9a0f6ce4f0b79bcce51ac62611d15d,https://api.github.com/repos/pytorch/pytorch/commits/f95d61715d9a0f6ce4f0b79bcce51ac62611d15d,2019-06-27T01:02:22Z,14,5,9
22262,2442622099,"{'login': 'xuhdev', 'id': 325476, 'node_id': 'MDQ6VXNlcjMyNTQ3Ng==', 'avatar_url': 'https://avatars1.githubusercontent.com/u/325476?v=4', 'gravatar_id': '', 'url': 'https://api.github.com/users/xuhdev', 'html_url': 'https://github.com/xuhdev', 'followers_url': 'https://api.github.com/users/xuhdev/followers', 'following_url': 'https://api.github.com/users/xuhdev/following{/other_user}', 'gists_url': 'https://api.github.com/users/xuhdev/gists{/gist_id}', 'starred_url': 'https://api.github.com/users/xuhdev/starred{/owner}{/repo}', 'subscriptions_url': 'https://api.github.com/users/xuhdev/subscriptions', 'organizations_url': 'https://api.github.com/users/xuhdev/orgs', 'repos_url': 'https://api.github.com/users/xuhdev/repos', 'events_url': 'https://api.github.com/users/xuhdev/events{/privacy}', 'received_events_url': 'https://api.github.com/users/xuhdev/received_events', 'type': 'User', 'site_admin': False}",referenced,37ae1f1a88bb58ca161c404140f3fdd348581cdc,https://api.github.com/repos/pytorch/pytorch/commits/37ae1f1a88bb58ca161c404140f3fdd348581cdc,2019-06-27T01:02:27Z,102,102,0
22262,2442677964,"{'login': 'xuhdev', 'id': 325476, 'node_id': 'MDQ6VXNlcjMyNTQ3Ng==', 'avatar_url': 'https://avatars1.githubusercontent.com/u/325476?v=4', 'gravatar_id': '', 'url': 'https://api.github.com/users/xuhdev', 'html_url': 'https://github.com/xuhdev', 'followers_url': 'https://api.github.com/users/xuhdev/followers', 'following_url': 'https://api.github.com/users/xuhdev/following{/other_user}', 'gists_url': 'https://api.github.com/users/xuhdev/gists{/gist_id}', 'starred_url': 'https://api.github.com/users/xuhdev/starred{/owner}{/repo}', 'subscriptions_url': 'https://api.github.com/users/xuhdev/subscriptions', 'organizations_url': 'https://api.github.com/users/xuhdev/orgs', 'repos_url': 'https://api.github.com/users/xuhdev/repos', 'events_url': 'https://api.github.com/users/xuhdev/events{/privacy}', 'received_events_url': 'https://api.github.com/users/xuhdev/received_events', 'type': 'User', 'site_admin': False}",referenced,185e61892e0d6555eec944381de8b028ed514869,https://api.github.com/repos/pytorch/pytorch/commits/185e61892e0d6555eec944381de8b028ed514869,2019-06-27T01:49:16Z,103,103,0
22262,2442677968,"{'login': 'xuhdev', 'id': 325476, 'node_id': 'MDQ6VXNlcjMyNTQ3Ng==', 'avatar_url': 'https://avatars1.githubusercontent.com/u/325476?v=4', 'gravatar_id': '', 'url': 'https://api.github.com/users/xuhdev', 'html_url': 'https://github.com/xuhdev', 'followers_url': 'https://api.github.com/users/xuhdev/followers', 'following_url': 'https://api.github.com/users/xuhdev/following{/other_user}', 'gists_url': 'https://api.github.com/users/xuhdev/gists{/gist_id}', 'starred_url': 'https://api.github.com/users/xuhdev/starred{/owner}{/repo}', 'subscriptions_url': 'https://api.github.com/users/xuhdev/subscriptions', 'organizations_url': 'https://api.github.com/users/xuhdev/orgs', 'repos_url': 'https://api.github.com/users/xuhdev/repos', 'events_url': 'https://api.github.com/users/xuhdev/events{/privacy}', 'received_events_url': 'https://api.github.com/users/xuhdev/received_events', 'type': 'User', 'site_admin': False}",referenced,89b293ac33a4576c356d580ead36bc63cbf342af,https://api.github.com/repos/pytorch/pytorch/commits/89b293ac33a4576c356d580ead36bc63cbf342af,2019-06-27T01:49:17Z,1,1,0
22262,2443432621,"{'login': 'xuhdev', 'id': 325476, 'node_id': 'MDQ6VXNlcjMyNTQ3Ng==', 'avatar_url': 'https://avatars1.githubusercontent.com/u/325476?v=4', 'gravatar_id': '', 'url': 'https://api.github.com/users/xuhdev', 'html_url': 'https://github.com/xuhdev', 'followers_url': 'https://api.github.com/users/xuhdev/followers', 'following_url': 'https://api.github.com/users/xuhdev/following{/other_user}', 'gists_url': 'https://api.github.com/users/xuhdev/gists{/gist_id}', 'starred_url': 'https://api.github.com/users/xuhdev/starred{/owner}{/repo}', 'subscriptions_url': 'https://api.github.com/users/xuhdev/subscriptions', 'organizations_url': 'https://api.github.com/users/xuhdev/orgs', 'repos_url': 'https://api.github.com/users/xuhdev/repos', 'events_url': 'https://api.github.com/users/xuhdev/events{/privacy}', 'received_events_url': 'https://api.github.com/users/xuhdev/received_events', 'type': 'User', 'site_admin': False}",referenced,197a22ff932e0b7dea3e8eed8e692510978d355c,https://api.github.com/repos/pytorch/pytorch/commits/197a22ff932e0b7dea3e8eed8e692510978d355c,2019-06-27T08:27:01Z,605,477,128
22262,2443432853,"{'login': 'xuhdev', 'id': 325476, 'node_id': 'MDQ6VXNlcjMyNTQ3Ng==', 'avatar_url': 'https://avatars1.githubusercontent.com/u/325476?v=4', 'gravatar_id': '', 'url': 'https://api.github.com/users/xuhdev', 'html_url': 'https://github.com/xuhdev', 'followers_url': 'https://api.github.com/users/xuhdev/followers', 'following_url': 'https://api.github.com/users/xuhdev/following{/other_user}', 'gists_url': 'https://api.github.com/users/xuhdev/gists{/gist_id}', 'starred_url': 'https://api.github.com/users/xuhdev/starred{/owner}{/repo}', 'subscriptions_url': 'https://api.github.com/users/xuhdev/subscriptions', 'organizations_url': 'https://api.github.com/users/xuhdev/orgs', 'repos_url': 'https://api.github.com/users/xuhdev/repos', 'events_url': 'https://api.github.com/users/xuhdev/events{/privacy}', 'received_events_url': 'https://api.github.com/users/xuhdev/received_events', 'type': 'User', 'site_admin': False}",referenced,8eda0cfb89538d9a35b524db85dc17b370845419,https://api.github.com/repos/pytorch/pytorch/commits/8eda0cfb89538d9a35b524db85dc17b370845419,2019-06-27T08:27:06Z,103,103,0
22262,2444906899,"{'login': 'xuhdev', 'id': 325476, 'node_id': 'MDQ6VXNlcjMyNTQ3Ng==', 'avatar_url': 'https://avatars1.githubusercontent.com/u/325476?v=4', 'gravatar_id': '', 'url': 'https://api.github.com/users/xuhdev', 'html_url': 'https://github.com/xuhdev', 'followers_url': 'https://api.github.com/users/xuhdev/followers', 'following_url': 'https://api.github.com/users/xuhdev/following{/other_user}', 'gists_url': 'https://api.github.com/users/xuhdev/gists{/gist_id}', 'starred_url': 'https://api.github.com/users/xuhdev/starred{/owner}{/repo}', 'subscriptions_url': 'https://api.github.com/users/xuhdev/subscriptions', 'organizations_url': 'https://api.github.com/users/xuhdev/orgs', 'repos_url': 'https://api.github.com/users/xuhdev/repos', 'events_url': 'https://api.github.com/users/xuhdev/events{/privacy}', 'received_events_url': 'https://api.github.com/users/xuhdev/received_events', 'type': 'User', 'site_admin': False}",referenced,af834bdd70956d86397894321bca51abc3ed855b,https://api.github.com/repos/pytorch/pytorch/commits/af834bdd70956d86397894321bca51abc3ed855b,2019-06-27T16:41:15Z,31,23,8
22262,2444907041,"{'login': 'xuhdev', 'id': 325476, 'node_id': 'MDQ6VXNlcjMyNTQ3Ng==', 'avatar_url': 'https://avatars1.githubusercontent.com/u/325476?v=4', 'gravatar_id': '', 'url': 'https://api.github.com/users/xuhdev', 'html_url': 'https://github.com/xuhdev', 'followers_url': 'https://api.github.com/users/xuhdev/followers', 'following_url': 'https://api.github.com/users/xuhdev/following{/other_user}', 'gists_url': 'https://api.github.com/users/xuhdev/gists{/gist_id}', 'starred_url': 'https://api.github.com/users/xuhdev/starred{/owner}{/repo}', 'subscriptions_url': 'https://api.github.com/users/xuhdev/subscriptions', 'organizations_url': 'https://api.github.com/users/xuhdev/orgs', 'repos_url': 'https://api.github.com/users/xuhdev/repos', 'events_url': 'https://api.github.com/users/xuhdev/events{/privacy}', 'received_events_url': 'https://api.github.com/users/xuhdev/received_events', 'type': 'User', 'site_admin': False}",referenced,707c40739efeda0f2e715770315164061e346e10,https://api.github.com/repos/pytorch/pytorch/commits/707c40739efeda0f2e715770315164061e346e10,2019-06-27T16:41:19Z,118,118,0
22262,2445290046,"{'login': 'xuhdev', 'id': 325476, 'node_id': 'MDQ6VXNlcjMyNTQ3Ng==', 'avatar_url': 'https://avatars1.githubusercontent.com/u/325476?v=4', 'gravatar_id': '', 'url': 'https://api.github.com/users/xuhdev', 'html_url': 'https://github.com/xuhdev', 'followers_url': 'https://api.github.com/users/xuhdev/followers', 'following_url': 'https://api.github.com/users/xuhdev/following{/other_user}', 'gists_url': 'https://api.github.com/users/xuhdev/gists{/gist_id}', 'starred_url': 'https://api.github.com/users/xuhdev/starred{/owner}{/repo}', 'subscriptions_url': 'https://api.github.com/users/xuhdev/subscriptions', 'organizations_url': 'https://api.github.com/users/xuhdev/orgs', 'repos_url': 'https://api.github.com/users/xuhdev/repos', 'events_url': 'https://api.github.com/users/xuhdev/events{/privacy}', 'received_events_url': 'https://api.github.com/users/xuhdev/received_events', 'type': 'User', 'site_admin': False}",referenced,97b13f1a249adeb6f19e743ee9b5d1f962ab239d,https://api.github.com/repos/pytorch/pytorch/commits/97b13f1a249adeb6f19e743ee9b5d1f962ab239d,2019-06-27T19:08:35Z,1619,1073,546
22262,2445290092,"{'login': 'xuhdev', 'id': 325476, 'node_id': 'MDQ6VXNlcjMyNTQ3Ng==', 'avatar_url': 'https://avatars1.githubusercontent.com/u/325476?v=4', 'gravatar_id': '', 'url': 'https://api.github.com/users/xuhdev', 'html_url': 'https://github.com/xuhdev', 'followers_url': 'https://api.github.com/users/xuhdev/followers', 'following_url': 'https://api.github.com/users/xuhdev/following{/other_user}', 'gists_url': 'https://api.github.com/users/xuhdev/gists{/gist_id}', 'starred_url': 'https://api.github.com/users/xuhdev/starred{/owner}{/repo}', 'subscriptions_url': 'https://api.github.com/users/xuhdev/subscriptions', 'organizations_url': 'https://api.github.com/users/xuhdev/orgs', 'repos_url': 'https://api.github.com/users/xuhdev/repos', 'events_url': 'https://api.github.com/users/xuhdev/events{/privacy}', 'received_events_url': 'https://api.github.com/users/xuhdev/received_events', 'type': 'User', 'site_admin': False}",referenced,9a9ef8c8d6d2c11a48c8349e8515b9f25f2e1ab1,https://api.github.com/repos/pytorch/pytorch/commits/9a9ef8c8d6d2c11a48c8349e8515b9f25f2e1ab1,2019-06-27T19:08:37Z,118,118,0
22262,2445758207,"{'login': 'xuhdev', 'id': 325476, 'node_id': 'MDQ6VXNlcjMyNTQ3Ng==', 'avatar_url': 'https://avatars1.githubusercontent.com/u/325476?v=4', 'gravatar_id': '', 'url': 'https://api.github.com/users/xuhdev', 'html_url': 'https://github.com/xuhdev', 'followers_url': 'https://api.github.com/users/xuhdev/followers', 'following_url': 'https://api.github.com/users/xuhdev/following{/other_user}', 'gists_url': 'https://api.github.com/users/xuhdev/gists{/gist_id}', 'starred_url': 'https://api.github.com/users/xuhdev/starred{/owner}{/repo}', 'subscriptions_url': 'https://api.github.com/users/xuhdev/subscriptions', 'organizations_url': 'https://api.github.com/users/xuhdev/orgs', 'repos_url': 'https://api.github.com/users/xuhdev/repos', 'events_url': 'https://api.github.com/users/xuhdev/events{/privacy}', 'received_events_url': 'https://api.github.com/users/xuhdev/received_events', 'type': 'User', 'site_admin': False}",referenced,1a8e29a7a4d2a91583c98bcf103af7d03ff9d9a2,https://api.github.com/repos/pytorch/pytorch/commits/1a8e29a7a4d2a91583c98bcf103af7d03ff9d9a2,2019-06-27T22:33:08Z,59,59,0
22262,2445758502,"{'login': 'xuhdev', 'id': 325476, 'node_id': 'MDQ6VXNlcjMyNTQ3Ng==', 'avatar_url': 'https://avatars1.githubusercontent.com/u/325476?v=4', 'gravatar_id': '', 'url': 'https://api.github.com/users/xuhdev', 'html_url': 'https://github.com/xuhdev', 'followers_url': 'https://api.github.com/users/xuhdev/followers', 'following_url': 'https://api.github.com/users/xuhdev/following{/other_user}', 'gists_url': 'https://api.github.com/users/xuhdev/gists{/gist_id}', 'starred_url': 'https://api.github.com/users/xuhdev/starred{/owner}{/repo}', 'subscriptions_url': 'https://api.github.com/users/xuhdev/subscriptions', 'organizations_url': 'https://api.github.com/users/xuhdev/orgs', 'repos_url': 'https://api.github.com/users/xuhdev/repos', 'events_url': 'https://api.github.com/users/xuhdev/events{/privacy}', 'received_events_url': 'https://api.github.com/users/xuhdev/received_events', 'type': 'User', 'site_admin': False}",referenced,0e9f837fa6862094b980a56db873daa83d2ce772,https://api.github.com/repos/pytorch/pytorch/commits/0e9f837fa6862094b980a56db873daa83d2ce772,2019-06-27T22:33:18Z,59,59,0
22262,2445759218,"{'login': 'xuhdev', 'id': 325476, 'node_id': 'MDQ6VXNlcjMyNTQ3Ng==', 'avatar_url': 'https://avatars1.githubusercontent.com/u/325476?v=4', 'gravatar_id': '', 'url': 'https://api.github.com/users/xuhdev', 'html_url': 'https://github.com/xuhdev', 'followers_url': 'https://api.github.com/users/xuhdev/followers', 'following_url': 'https://api.github.com/users/xuhdev/following{/other_user}', 'gists_url': 'https://api.github.com/users/xuhdev/gists{/gist_id}', 'starred_url': 'https://api.github.com/users/xuhdev/starred{/owner}{/repo}', 'subscriptions_url': 'https://api.github.com/users/xuhdev/subscriptions', 'organizations_url': 'https://api.github.com/users/xuhdev/orgs', 'repos_url': 'https://api.github.com/users/xuhdev/repos', 'events_url': 'https://api.github.com/users/xuhdev/events{/privacy}', 'received_events_url': 'https://api.github.com/users/xuhdev/received_events', 'type': 'User', 'site_admin': False}",referenced,fe77182bc4dd464a7797d109124dc97bcbabbec8,https://api.github.com/repos/pytorch/pytorch/commits/fe77182bc4dd464a7797d109124dc97bcbabbec8,2019-06-27T22:33:45Z,885,713,172
22262,2445759393,"{'login': 'xuhdev', 'id': 325476, 'node_id': 'MDQ6VXNlcjMyNTQ3Ng==', 'avatar_url': 'https://avatars1.githubusercontent.com/u/325476?v=4', 'gravatar_id': '', 'url': 'https://api.github.com/users/xuhdev', 'html_url': 'https://github.com/xuhdev', 'followers_url': 'https://api.github.com/users/xuhdev/followers', 'following_url': 'https://api.github.com/users/xuhdev/following{/other_user}', 'gists_url': 'https://api.github.com/users/xuhdev/gists{/gist_id}', 'starred_url': 'https://api.github.com/users/xuhdev/starred{/owner}{/repo}', 'subscriptions_url': 'https://api.github.com/users/xuhdev/subscriptions', 'organizations_url': 'https://api.github.com/users/xuhdev/orgs', 'repos_url': 'https://api.github.com/users/xuhdev/repos', 'events_url': 'https://api.github.com/users/xuhdev/events{/privacy}', 'received_events_url': 'https://api.github.com/users/xuhdev/received_events', 'type': 'User', 'site_admin': False}",referenced,e7188e4cd8c91dd5bf8d06271fbaecbd23a18aba,https://api.github.com/repos/pytorch/pytorch/commits/e7188e4cd8c91dd5bf8d06271fbaecbd23a18aba,2019-06-27T22:33:51Z,885,713,172
22262,2445759453,"{'login': 'xuhdev', 'id': 325476, 'node_id': 'MDQ6VXNlcjMyNTQ3Ng==', 'avatar_url': 'https://avatars1.githubusercontent.com/u/325476?v=4', 'gravatar_id': '', 'url': 'https://api.github.com/users/xuhdev', 'html_url': 'https://github.com/xuhdev', 'followers_url': 'https://api.github.com/users/xuhdev/followers', 'following_url': 'https://api.github.com/users/xuhdev/following{/other_user}', 'gists_url': 'https://api.github.com/users/xuhdev/gists{/gist_id}', 'starred_url': 'https://api.github.com/users/xuhdev/starred{/owner}{/repo}', 'subscriptions_url': 'https://api.github.com/users/xuhdev/subscriptions', 'organizations_url': 'https://api.github.com/users/xuhdev/orgs', 'repos_url': 'https://api.github.com/users/xuhdev/repos', 'events_url': 'https://api.github.com/users/xuhdev/events{/privacy}', 'received_events_url': 'https://api.github.com/users/xuhdev/received_events', 'type': 'User', 'site_admin': False}",referenced,281156ac6618b5d6d349f223effd6f709001e2b2,https://api.github.com/repos/pytorch/pytorch/commits/281156ac6618b5d6d349f223effd6f709001e2b2,2019-06-27T22:33:54Z,59,59,0
22262,2445761831,"{'login': 'xuhdev', 'id': 325476, 'node_id': 'MDQ6VXNlcjMyNTQ3Ng==', 'avatar_url': 'https://avatars1.githubusercontent.com/u/325476?v=4', 'gravatar_id': '', 'url': 'https://api.github.com/users/xuhdev', 'html_url': 'https://github.com/xuhdev', 'followers_url': 'https://api.github.com/users/xuhdev/followers', 'following_url': 'https://api.github.com/users/xuhdev/following{/other_user}', 'gists_url': 'https://api.github.com/users/xuhdev/gists{/gist_id}', 'starred_url': 'https://api.github.com/users/xuhdev/starred{/owner}{/repo}', 'subscriptions_url': 'https://api.github.com/users/xuhdev/subscriptions', 'organizations_url': 'https://api.github.com/users/xuhdev/orgs', 'repos_url': 'https://api.github.com/users/xuhdev/repos', 'events_url': 'https://api.github.com/users/xuhdev/events{/privacy}', 'received_events_url': 'https://api.github.com/users/xuhdev/received_events', 'type': 'User', 'site_admin': False}",referenced,10d38167149a4edc9c91432a2f0fbb8ad7b10da6,https://api.github.com/repos/pytorch/pytorch/commits/10d38167149a4edc9c91432a2f0fbb8ad7b10da6,2019-06-27T22:35:23Z,2,1,1
22262,2445761959,"{'login': 'xuhdev', 'id': 325476, 'node_id': 'MDQ6VXNlcjMyNTQ3Ng==', 'avatar_url': 'https://avatars1.githubusercontent.com/u/325476?v=4', 'gravatar_id': '', 'url': 'https://api.github.com/users/xuhdev', 'html_url': 'https://github.com/xuhdev', 'followers_url': 'https://api.github.com/users/xuhdev/followers', 'following_url': 'https://api.github.com/users/xuhdev/following{/other_user}', 'gists_url': 'https://api.github.com/users/xuhdev/gists{/gist_id}', 'starred_url': 'https://api.github.com/users/xuhdev/starred{/owner}{/repo}', 'subscriptions_url': 'https://api.github.com/users/xuhdev/subscriptions', 'organizations_url': 'https://api.github.com/users/xuhdev/orgs', 'repos_url': 'https://api.github.com/users/xuhdev/repos', 'events_url': 'https://api.github.com/users/xuhdev/events{/privacy}', 'received_events_url': 'https://api.github.com/users/xuhdev/received_events', 'type': 'User', 'site_admin': False}",referenced,cab8ea1dccf0a460592648e7610f25f1c15b3840,https://api.github.com/repos/pytorch/pytorch/commits/cab8ea1dccf0a460592648e7610f25f1c15b3840,2019-06-27T22:35:29Z,59,59,0
22262,2445774298,"{'login': 'xuhdev', 'id': 325476, 'node_id': 'MDQ6VXNlcjMyNTQ3Ng==', 'avatar_url': 'https://avatars1.githubusercontent.com/u/325476?v=4', 'gravatar_id': '', 'url': 'https://api.github.com/users/xuhdev', 'html_url': 'https://github.com/xuhdev', 'followers_url': 'https://api.github.com/users/xuhdev/followers', 'following_url': 'https://api.github.com/users/xuhdev/following{/other_user}', 'gists_url': 'https://api.github.com/users/xuhdev/gists{/gist_id}', 'starred_url': 'https://api.github.com/users/xuhdev/starred{/owner}{/repo}', 'subscriptions_url': 'https://api.github.com/users/xuhdev/subscriptions', 'organizations_url': 'https://api.github.com/users/xuhdev/orgs', 'repos_url': 'https://api.github.com/users/xuhdev/repos', 'events_url': 'https://api.github.com/users/xuhdev/events{/privacy}', 'received_events_url': 'https://api.github.com/users/xuhdev/received_events', 'type': 'User', 'site_admin': False}",referenced,20de04d20ffc81876f124f0b869adf2823861c75,https://api.github.com/repos/pytorch/pytorch/commits/20de04d20ffc81876f124f0b869adf2823861c75,2019-06-27T22:43:30Z,1,1,0
22262,2445774422,"{'login': 'xuhdev', 'id': 325476, 'node_id': 'MDQ6VXNlcjMyNTQ3Ng==', 'avatar_url': 'https://avatars1.githubusercontent.com/u/325476?v=4', 'gravatar_id': '', 'url': 'https://api.github.com/users/xuhdev', 'html_url': 'https://github.com/xuhdev', 'followers_url': 'https://api.github.com/users/xuhdev/followers', 'following_url': 'https://api.github.com/users/xuhdev/following{/other_user}', 'gists_url': 'https://api.github.com/users/xuhdev/gists{/gist_id}', 'starred_url': 'https://api.github.com/users/xuhdev/starred{/owner}{/repo}', 'subscriptions_url': 'https://api.github.com/users/xuhdev/subscriptions', 'organizations_url': 'https://api.github.com/users/xuhdev/orgs', 'repos_url': 'https://api.github.com/users/xuhdev/repos', 'events_url': 'https://api.github.com/users/xuhdev/events{/privacy}', 'received_events_url': 'https://api.github.com/users/xuhdev/received_events', 'type': 'User', 'site_admin': False}",referenced,7c926a98deeb26009411f43cbacfbf5dbd7414df,https://api.github.com/repos/pytorch/pytorch/commits/7c926a98deeb26009411f43cbacfbf5dbd7414df,2019-06-27T22:43:34Z,60,60,0
22262,2445807195,"{'login': 'xuhdev', 'id': 325476, 'node_id': 'MDQ6VXNlcjMyNTQ3Ng==', 'avatar_url': 'https://avatars1.githubusercontent.com/u/325476?v=4', 'gravatar_id': '', 'url': 'https://api.github.com/users/xuhdev', 'html_url': 'https://github.com/xuhdev', 'followers_url': 'https://api.github.com/users/xuhdev/followers', 'following_url': 'https://api.github.com/users/xuhdev/following{/other_user}', 'gists_url': 'https://api.github.com/users/xuhdev/gists{/gist_id}', 'starred_url': 'https://api.github.com/users/xuhdev/starred{/owner}{/repo}', 'subscriptions_url': 'https://api.github.com/users/xuhdev/subscriptions', 'organizations_url': 'https://api.github.com/users/xuhdev/orgs', 'repos_url': 'https://api.github.com/users/xuhdev/repos', 'events_url': 'https://api.github.com/users/xuhdev/events{/privacy}', 'received_events_url': 'https://api.github.com/users/xuhdev/received_events', 'type': 'User', 'site_admin': False}",referenced,a2437e8238930cf06d45824fd4932591b53cace6,https://api.github.com/repos/pytorch/pytorch/commits/a2437e8238930cf06d45824fd4932591b53cace6,2019-06-27T23:05:21Z,16,15,1
22260,2504670040,"{'login': 'facebook-github-bot', 'id': 6422482, 'node_id': 'MDQ6VXNlcjY0MjI0ODI=', 'avatar_url': 'https://avatars3.githubusercontent.com/u/6422482?v=4', 'gravatar_id': '', 'url': 'https://api.github.com/users/facebook-github-bot', 'html_url': 'https://github.com/facebook-github-bot', 'followers_url': 'https://api.github.com/users/facebook-github-bot/followers', 'following_url': 'https://api.github.com/users/facebook-github-bot/following{/other_user}', 'gists_url': 'https://api.github.com/users/facebook-github-bot/gists{/gist_id}', 'starred_url': 'https://api.github.com/users/facebook-github-bot/starred{/owner}{/repo}', 'subscriptions_url': 'https://api.github.com/users/facebook-github-bot/subscriptions', 'organizations_url': 'https://api.github.com/users/facebook-github-bot/orgs', 'repos_url': 'https://api.github.com/users/facebook-github-bot/repos', 'events_url': 'https://api.github.com/users/facebook-github-bot/events{/privacy}', 'received_events_url': 'https://api.github.com/users/facebook-github-bot/received_events', 'type': 'User', 'site_admin': False}",referenced,1c0309a9a924e34803bf7e8975f7ce88fb845131,https://api.github.com/repos/pytorch/pytorch/commits/1c0309a9a924e34803bf7e8975f7ce88fb845131,2019-07-23T23:17:00Z,13,12,1
22246,2442386600,"{'login': 'xuhdev', 'id': 325476, 'node_id': 'MDQ6VXNlcjMyNTQ3Ng==', 'avatar_url': 'https://avatars1.githubusercontent.com/u/325476?v=4', 'gravatar_id': '', 'url': 'https://api.github.com/users/xuhdev', 'html_url': 'https://github.com/xuhdev', 'followers_url': 'https://api.github.com/users/xuhdev/followers', 'following_url': 'https://api.github.com/users/xuhdev/following{/other_user}', 'gists_url': 'https://api.github.com/users/xuhdev/gists{/gist_id}', 'starred_url': 'https://api.github.com/users/xuhdev/starred{/owner}{/repo}', 'subscriptions_url': 'https://api.github.com/users/xuhdev/subscriptions', 'organizations_url': 'https://api.github.com/users/xuhdev/orgs', 'repos_url': 'https://api.github.com/users/xuhdev/repos', 'events_url': 'https://api.github.com/users/xuhdev/events{/privacy}', 'received_events_url': 'https://api.github.com/users/xuhdev/received_events', 'type': 'User', 'site_admin': False}",referenced,3589d05816bad7109fb65be17e85f347d9b79e98,https://api.github.com/repos/pytorch/pytorch/commits/3589d05816bad7109fb65be17e85f347d9b79e98,2019-06-26T22:29:36Z,91,91,0
22246,2442386765,"{'login': 'xuhdev', 'id': 325476, 'node_id': 'MDQ6VXNlcjMyNTQ3Ng==', 'avatar_url': 'https://avatars1.githubusercontent.com/u/325476?v=4', 'gravatar_id': '', 'url': 'https://api.github.com/users/xuhdev', 'html_url': 'https://github.com/xuhdev', 'followers_url': 'https://api.github.com/users/xuhdev/followers', 'following_url': 'https://api.github.com/users/xuhdev/following{/other_user}', 'gists_url': 'https://api.github.com/users/xuhdev/gists{/gist_id}', 'starred_url': 'https://api.github.com/users/xuhdev/starred{/owner}{/repo}', 'subscriptions_url': 'https://api.github.com/users/xuhdev/subscriptions', 'organizations_url': 'https://api.github.com/users/xuhdev/orgs', 'repos_url': 'https://api.github.com/users/xuhdev/repos', 'events_url': 'https://api.github.com/users/xuhdev/events{/privacy}', 'received_events_url': 'https://api.github.com/users/xuhdev/received_events', 'type': 'User', 'site_admin': False}",referenced,26045b10cb0ee112013bba82ded012fbcd035519,https://api.github.com/repos/pytorch/pytorch/commits/26045b10cb0ee112013bba82ded012fbcd035519,2019-06-26T22:29:43Z,91,91,0
22246,2442387540,"{'login': 'xuhdev', 'id': 325476, 'node_id': 'MDQ6VXNlcjMyNTQ3Ng==', 'avatar_url': 'https://avatars1.githubusercontent.com/u/325476?v=4', 'gravatar_id': '', 'url': 'https://api.github.com/users/xuhdev', 'html_url': 'https://github.com/xuhdev', 'followers_url': 'https://api.github.com/users/xuhdev/followers', 'following_url': 'https://api.github.com/users/xuhdev/following{/other_user}', 'gists_url': 'https://api.github.com/users/xuhdev/gists{/gist_id}', 'starred_url': 'https://api.github.com/users/xuhdev/starred{/owner}{/repo}', 'subscriptions_url': 'https://api.github.com/users/xuhdev/subscriptions', 'organizations_url': 'https://api.github.com/users/xuhdev/orgs', 'repos_url': 'https://api.github.com/users/xuhdev/repos', 'events_url': 'https://api.github.com/users/xuhdev/events{/privacy}', 'received_events_url': 'https://api.github.com/users/xuhdev/received_events', 'type': 'User', 'site_admin': False}",referenced,4fc2b225bc2a0f56df968cc80caea30d280faebd,https://api.github.com/repos/pytorch/pytorch/commits/4fc2b225bc2a0f56df968cc80caea30d280faebd,2019-06-26T22:30:10Z,1337,552,785
22246,2442387639,"{'login': 'xuhdev', 'id': 325476, 'node_id': 'MDQ6VXNlcjMyNTQ3Ng==', 'avatar_url': 'https://avatars1.githubusercontent.com/u/325476?v=4', 'gravatar_id': '', 'url': 'https://api.github.com/users/xuhdev', 'html_url': 'https://github.com/xuhdev', 'followers_url': 'https://api.github.com/users/xuhdev/followers', 'following_url': 'https://api.github.com/users/xuhdev/following{/other_user}', 'gists_url': 'https://api.github.com/users/xuhdev/gists{/gist_id}', 'starred_url': 'https://api.github.com/users/xuhdev/starred{/owner}{/repo}', 'subscriptions_url': 'https://api.github.com/users/xuhdev/subscriptions', 'organizations_url': 'https://api.github.com/users/xuhdev/orgs', 'repos_url': 'https://api.github.com/users/xuhdev/repos', 'events_url': 'https://api.github.com/users/xuhdev/events{/privacy}', 'received_events_url': 'https://api.github.com/users/xuhdev/received_events', 'type': 'User', 'site_admin': False}",referenced,ac46fe6ad13af169af7244bab924e15f8d87042d,https://api.github.com/repos/pytorch/pytorch/commits/ac46fe6ad13af169af7244bab924e15f8d87042d,2019-06-26T22:30:14Z,91,91,0
22246,2442486516,"{'login': 'xuhdev', 'id': 325476, 'node_id': 'MDQ6VXNlcjMyNTQ3Ng==', 'avatar_url': 'https://avatars1.githubusercontent.com/u/325476?v=4', 'gravatar_id': '', 'url': 'https://api.github.com/users/xuhdev', 'html_url': 'https://github.com/xuhdev', 'followers_url': 'https://api.github.com/users/xuhdev/followers', 'following_url': 'https://api.github.com/users/xuhdev/following{/other_user}', 'gists_url': 'https://api.github.com/users/xuhdev/gists{/gist_id}', 'starred_url': 'https://api.github.com/users/xuhdev/starred{/owner}{/repo}', 'subscriptions_url': 'https://api.github.com/users/xuhdev/subscriptions', 'organizations_url': 'https://api.github.com/users/xuhdev/orgs', 'repos_url': 'https://api.github.com/users/xuhdev/repos', 'events_url': 'https://api.github.com/users/xuhdev/events{/privacy}', 'received_events_url': 'https://api.github.com/users/xuhdev/received_events', 'type': 'User', 'site_admin': False}",referenced,259ee6876969ac610f0ad880656d313f0167371c,https://api.github.com/repos/pytorch/pytorch/commits/259ee6876969ac610f0ad880656d313f0167371c,2019-06-26T23:36:34Z,25,20,5
22246,2442486594,"{'login': 'xuhdev', 'id': 325476, 'node_id': 'MDQ6VXNlcjMyNTQ3Ng==', 'avatar_url': 'https://avatars1.githubusercontent.com/u/325476?v=4', 'gravatar_id': '', 'url': 'https://api.github.com/users/xuhdev', 'html_url': 'https://github.com/xuhdev', 'followers_url': 'https://api.github.com/users/xuhdev/followers', 'following_url': 'https://api.github.com/users/xuhdev/following{/other_user}', 'gists_url': 'https://api.github.com/users/xuhdev/gists{/gist_id}', 'starred_url': 'https://api.github.com/users/xuhdev/starred{/owner}{/repo}', 'subscriptions_url': 'https://api.github.com/users/xuhdev/subscriptions', 'organizations_url': 'https://api.github.com/users/xuhdev/orgs', 'repos_url': 'https://api.github.com/users/xuhdev/repos', 'events_url': 'https://api.github.com/users/xuhdev/events{/privacy}', 'received_events_url': 'https://api.github.com/users/xuhdev/received_events', 'type': 'User', 'site_admin': False}",referenced,7fee59926d3f6fcd4aebecab3818024f2e196a1b,https://api.github.com/repos/pytorch/pytorch/commits/7fee59926d3f6fcd4aebecab3818024f2e196a1b,2019-06-26T23:36:37Z,106,106,0
22246,2442510725,"{'login': 'xuhdev', 'id': 325476, 'node_id': 'MDQ6VXNlcjMyNTQ3Ng==', 'avatar_url': 'https://avatars1.githubusercontent.com/u/325476?v=4', 'gravatar_id': '', 'url': 'https://api.github.com/users/xuhdev', 'html_url': 'https://github.com/xuhdev', 'followers_url': 'https://api.github.com/users/xuhdev/followers', 'following_url': 'https://api.github.com/users/xuhdev/following{/other_user}', 'gists_url': 'https://api.github.com/users/xuhdev/gists{/gist_id}', 'starred_url': 'https://api.github.com/users/xuhdev/starred{/owner}{/repo}', 'subscriptions_url': 'https://api.github.com/users/xuhdev/subscriptions', 'organizations_url': 'https://api.github.com/users/xuhdev/orgs', 'repos_url': 'https://api.github.com/users/xuhdev/repos', 'events_url': 'https://api.github.com/users/xuhdev/events{/privacy}', 'received_events_url': 'https://api.github.com/users/xuhdev/received_events', 'type': 'User', 'site_admin': False}",referenced,c0d693de9c74f4122556ae14586d3eae286c0479,https://api.github.com/repos/pytorch/pytorch/commits/c0d693de9c74f4122556ae14586d3eae286c0479,2019-06-26T23:56:16Z,1012,908,104
22246,2442510803,"{'login': 'xuhdev', 'id': 325476, 'node_id': 'MDQ6VXNlcjMyNTQ3Ng==', 'avatar_url': 'https://avatars1.githubusercontent.com/u/325476?v=4', 'gravatar_id': '', 'url': 'https://api.github.com/users/xuhdev', 'html_url': 'https://github.com/xuhdev', 'followers_url': 'https://api.github.com/users/xuhdev/followers', 'following_url': 'https://api.github.com/users/xuhdev/following{/other_user}', 'gists_url': 'https://api.github.com/users/xuhdev/gists{/gist_id}', 'starred_url': 'https://api.github.com/users/xuhdev/starred{/owner}{/repo}', 'subscriptions_url': 'https://api.github.com/users/xuhdev/subscriptions', 'organizations_url': 'https://api.github.com/users/xuhdev/orgs', 'repos_url': 'https://api.github.com/users/xuhdev/repos', 'events_url': 'https://api.github.com/users/xuhdev/events{/privacy}', 'received_events_url': 'https://api.github.com/users/xuhdev/received_events', 'type': 'User', 'site_admin': False}",referenced,0d6d02c136697c2faa2d471ea56c7f3b15a14275,https://api.github.com/repos/pytorch/pytorch/commits/0d6d02c136697c2faa2d471ea56c7f3b15a14275,2019-06-26T23:56:19Z,106,106,0
22246,2442622008,"{'login': 'xuhdev', 'id': 325476, 'node_id': 'MDQ6VXNlcjMyNTQ3Ng==', 'avatar_url': 'https://avatars1.githubusercontent.com/u/325476?v=4', 'gravatar_id': '', 'url': 'https://api.github.com/users/xuhdev', 'html_url': 'https://github.com/xuhdev', 'followers_url': 'https://api.github.com/users/xuhdev/followers', 'following_url': 'https://api.github.com/users/xuhdev/following{/other_user}', 'gists_url': 'https://api.github.com/users/xuhdev/gists{/gist_id}', 'starred_url': 'https://api.github.com/users/xuhdev/starred{/owner}{/repo}', 'subscriptions_url': 'https://api.github.com/users/xuhdev/subscriptions', 'organizations_url': 'https://api.github.com/users/xuhdev/orgs', 'repos_url': 'https://api.github.com/users/xuhdev/repos', 'events_url': 'https://api.github.com/users/xuhdev/events{/privacy}', 'received_events_url': 'https://api.github.com/users/xuhdev/received_events', 'type': 'User', 'site_admin': False}",referenced,f95d61715d9a0f6ce4f0b79bcce51ac62611d15d,https://api.github.com/repos/pytorch/pytorch/commits/f95d61715d9a0f6ce4f0b79bcce51ac62611d15d,2019-06-27T01:02:22Z,14,5,9
22246,2442622097,"{'login': 'xuhdev', 'id': 325476, 'node_id': 'MDQ6VXNlcjMyNTQ3Ng==', 'avatar_url': 'https://avatars1.githubusercontent.com/u/325476?v=4', 'gravatar_id': '', 'url': 'https://api.github.com/users/xuhdev', 'html_url': 'https://github.com/xuhdev', 'followers_url': 'https://api.github.com/users/xuhdev/followers', 'following_url': 'https://api.github.com/users/xuhdev/following{/other_user}', 'gists_url': 'https://api.github.com/users/xuhdev/gists{/gist_id}', 'starred_url': 'https://api.github.com/users/xuhdev/starred{/owner}{/repo}', 'subscriptions_url': 'https://api.github.com/users/xuhdev/subscriptions', 'organizations_url': 'https://api.github.com/users/xuhdev/orgs', 'repos_url': 'https://api.github.com/users/xuhdev/repos', 'events_url': 'https://api.github.com/users/xuhdev/events{/privacy}', 'received_events_url': 'https://api.github.com/users/xuhdev/received_events', 'type': 'User', 'site_admin': False}",referenced,37ae1f1a88bb58ca161c404140f3fdd348581cdc,https://api.github.com/repos/pytorch/pytorch/commits/37ae1f1a88bb58ca161c404140f3fdd348581cdc,2019-06-27T01:02:27Z,102,102,0
22246,2442677963,"{'login': 'xuhdev', 'id': 325476, 'node_id': 'MDQ6VXNlcjMyNTQ3Ng==', 'avatar_url': 'https://avatars1.githubusercontent.com/u/325476?v=4', 'gravatar_id': '', 'url': 'https://api.github.com/users/xuhdev', 'html_url': 'https://github.com/xuhdev', 'followers_url': 'https://api.github.com/users/xuhdev/followers', 'following_url': 'https://api.github.com/users/xuhdev/following{/other_user}', 'gists_url': 'https://api.github.com/users/xuhdev/gists{/gist_id}', 'starred_url': 'https://api.github.com/users/xuhdev/starred{/owner}{/repo}', 'subscriptions_url': 'https://api.github.com/users/xuhdev/subscriptions', 'organizations_url': 'https://api.github.com/users/xuhdev/orgs', 'repos_url': 'https://api.github.com/users/xuhdev/repos', 'events_url': 'https://api.github.com/users/xuhdev/events{/privacy}', 'received_events_url': 'https://api.github.com/users/xuhdev/received_events', 'type': 'User', 'site_admin': False}",referenced,185e61892e0d6555eec944381de8b028ed514869,https://api.github.com/repos/pytorch/pytorch/commits/185e61892e0d6555eec944381de8b028ed514869,2019-06-27T01:49:16Z,103,103,0
22246,2442677967,"{'login': 'xuhdev', 'id': 325476, 'node_id': 'MDQ6VXNlcjMyNTQ3Ng==', 'avatar_url': 'https://avatars1.githubusercontent.com/u/325476?v=4', 'gravatar_id': '', 'url': 'https://api.github.com/users/xuhdev', 'html_url': 'https://github.com/xuhdev', 'followers_url': 'https://api.github.com/users/xuhdev/followers', 'following_url': 'https://api.github.com/users/xuhdev/following{/other_user}', 'gists_url': 'https://api.github.com/users/xuhdev/gists{/gist_id}', 'starred_url': 'https://api.github.com/users/xuhdev/starred{/owner}{/repo}', 'subscriptions_url': 'https://api.github.com/users/xuhdev/subscriptions', 'organizations_url': 'https://api.github.com/users/xuhdev/orgs', 'repos_url': 'https://api.github.com/users/xuhdev/repos', 'events_url': 'https://api.github.com/users/xuhdev/events{/privacy}', 'received_events_url': 'https://api.github.com/users/xuhdev/received_events', 'type': 'User', 'site_admin': False}",referenced,89b293ac33a4576c356d580ead36bc63cbf342af,https://api.github.com/repos/pytorch/pytorch/commits/89b293ac33a4576c356d580ead36bc63cbf342af,2019-06-27T01:49:17Z,1,1,0
22246,2443432618,"{'login': 'xuhdev', 'id': 325476, 'node_id': 'MDQ6VXNlcjMyNTQ3Ng==', 'avatar_url': 'https://avatars1.githubusercontent.com/u/325476?v=4', 'gravatar_id': '', 'url': 'https://api.github.com/users/xuhdev', 'html_url': 'https://github.com/xuhdev', 'followers_url': 'https://api.github.com/users/xuhdev/followers', 'following_url': 'https://api.github.com/users/xuhdev/following{/other_user}', 'gists_url': 'https://api.github.com/users/xuhdev/gists{/gist_id}', 'starred_url': 'https://api.github.com/users/xuhdev/starred{/owner}{/repo}', 'subscriptions_url': 'https://api.github.com/users/xuhdev/subscriptions', 'organizations_url': 'https://api.github.com/users/xuhdev/orgs', 'repos_url': 'https://api.github.com/users/xuhdev/repos', 'events_url': 'https://api.github.com/users/xuhdev/events{/privacy}', 'received_events_url': 'https://api.github.com/users/xuhdev/received_events', 'type': 'User', 'site_admin': False}",referenced,197a22ff932e0b7dea3e8eed8e692510978d355c,https://api.github.com/repos/pytorch/pytorch/commits/197a22ff932e0b7dea3e8eed8e692510978d355c,2019-06-27T08:27:01Z,605,477,128
22246,2443432851,"{'login': 'xuhdev', 'id': 325476, 'node_id': 'MDQ6VXNlcjMyNTQ3Ng==', 'avatar_url': 'https://avatars1.githubusercontent.com/u/325476?v=4', 'gravatar_id': '', 'url': 'https://api.github.com/users/xuhdev', 'html_url': 'https://github.com/xuhdev', 'followers_url': 'https://api.github.com/users/xuhdev/followers', 'following_url': 'https://api.github.com/users/xuhdev/following{/other_user}', 'gists_url': 'https://api.github.com/users/xuhdev/gists{/gist_id}', 'starred_url': 'https://api.github.com/users/xuhdev/starred{/owner}{/repo}', 'subscriptions_url': 'https://api.github.com/users/xuhdev/subscriptions', 'organizations_url': 'https://api.github.com/users/xuhdev/orgs', 'repos_url': 'https://api.github.com/users/xuhdev/repos', 'events_url': 'https://api.github.com/users/xuhdev/events{/privacy}', 'received_events_url': 'https://api.github.com/users/xuhdev/received_events', 'type': 'User', 'site_admin': False}",referenced,8eda0cfb89538d9a35b524db85dc17b370845419,https://api.github.com/repos/pytorch/pytorch/commits/8eda0cfb89538d9a35b524db85dc17b370845419,2019-06-27T08:27:06Z,103,103,0
22246,2444906896,"{'login': 'xuhdev', 'id': 325476, 'node_id': 'MDQ6VXNlcjMyNTQ3Ng==', 'avatar_url': 'https://avatars1.githubusercontent.com/u/325476?v=4', 'gravatar_id': '', 'url': 'https://api.github.com/users/xuhdev', 'html_url': 'https://github.com/xuhdev', 'followers_url': 'https://api.github.com/users/xuhdev/followers', 'following_url': 'https://api.github.com/users/xuhdev/following{/other_user}', 'gists_url': 'https://api.github.com/users/xuhdev/gists{/gist_id}', 'starred_url': 'https://api.github.com/users/xuhdev/starred{/owner}{/repo}', 'subscriptions_url': 'https://api.github.com/users/xuhdev/subscriptions', 'organizations_url': 'https://api.github.com/users/xuhdev/orgs', 'repos_url': 'https://api.github.com/users/xuhdev/repos', 'events_url': 'https://api.github.com/users/xuhdev/events{/privacy}', 'received_events_url': 'https://api.github.com/users/xuhdev/received_events', 'type': 'User', 'site_admin': False}",referenced,af834bdd70956d86397894321bca51abc3ed855b,https://api.github.com/repos/pytorch/pytorch/commits/af834bdd70956d86397894321bca51abc3ed855b,2019-06-27T16:41:15Z,31,23,8
22246,2444907038,"{'login': 'xuhdev', 'id': 325476, 'node_id': 'MDQ6VXNlcjMyNTQ3Ng==', 'avatar_url': 'https://avatars1.githubusercontent.com/u/325476?v=4', 'gravatar_id': '', 'url': 'https://api.github.com/users/xuhdev', 'html_url': 'https://github.com/xuhdev', 'followers_url': 'https://api.github.com/users/xuhdev/followers', 'following_url': 'https://api.github.com/users/xuhdev/following{/other_user}', 'gists_url': 'https://api.github.com/users/xuhdev/gists{/gist_id}', 'starred_url': 'https://api.github.com/users/xuhdev/starred{/owner}{/repo}', 'subscriptions_url': 'https://api.github.com/users/xuhdev/subscriptions', 'organizations_url': 'https://api.github.com/users/xuhdev/orgs', 'repos_url': 'https://api.github.com/users/xuhdev/repos', 'events_url': 'https://api.github.com/users/xuhdev/events{/privacy}', 'received_events_url': 'https://api.github.com/users/xuhdev/received_events', 'type': 'User', 'site_admin': False}",referenced,707c40739efeda0f2e715770315164061e346e10,https://api.github.com/repos/pytorch/pytorch/commits/707c40739efeda0f2e715770315164061e346e10,2019-06-27T16:41:19Z,118,118,0
22246,2445290043,"{'login': 'xuhdev', 'id': 325476, 'node_id': 'MDQ6VXNlcjMyNTQ3Ng==', 'avatar_url': 'https://avatars1.githubusercontent.com/u/325476?v=4', 'gravatar_id': '', 'url': 'https://api.github.com/users/xuhdev', 'html_url': 'https://github.com/xuhdev', 'followers_url': 'https://api.github.com/users/xuhdev/followers', 'following_url': 'https://api.github.com/users/xuhdev/following{/other_user}', 'gists_url': 'https://api.github.com/users/xuhdev/gists{/gist_id}', 'starred_url': 'https://api.github.com/users/xuhdev/starred{/owner}{/repo}', 'subscriptions_url': 'https://api.github.com/users/xuhdev/subscriptions', 'organizations_url': 'https://api.github.com/users/xuhdev/orgs', 'repos_url': 'https://api.github.com/users/xuhdev/repos', 'events_url': 'https://api.github.com/users/xuhdev/events{/privacy}', 'received_events_url': 'https://api.github.com/users/xuhdev/received_events', 'type': 'User', 'site_admin': False}",referenced,97b13f1a249adeb6f19e743ee9b5d1f962ab239d,https://api.github.com/repos/pytorch/pytorch/commits/97b13f1a249adeb6f19e743ee9b5d1f962ab239d,2019-06-27T19:08:35Z,1619,1073,546
22246,2445290091,"{'login': 'xuhdev', 'id': 325476, 'node_id': 'MDQ6VXNlcjMyNTQ3Ng==', 'avatar_url': 'https://avatars1.githubusercontent.com/u/325476?v=4', 'gravatar_id': '', 'url': 'https://api.github.com/users/xuhdev', 'html_url': 'https://github.com/xuhdev', 'followers_url': 'https://api.github.com/users/xuhdev/followers', 'following_url': 'https://api.github.com/users/xuhdev/following{/other_user}', 'gists_url': 'https://api.github.com/users/xuhdev/gists{/gist_id}', 'starred_url': 'https://api.github.com/users/xuhdev/starred{/owner}{/repo}', 'subscriptions_url': 'https://api.github.com/users/xuhdev/subscriptions', 'organizations_url': 'https://api.github.com/users/xuhdev/orgs', 'repos_url': 'https://api.github.com/users/xuhdev/repos', 'events_url': 'https://api.github.com/users/xuhdev/events{/privacy}', 'received_events_url': 'https://api.github.com/users/xuhdev/received_events', 'type': 'User', 'site_admin': False}",referenced,9a9ef8c8d6d2c11a48c8349e8515b9f25f2e1ab1,https://api.github.com/repos/pytorch/pytorch/commits/9a9ef8c8d6d2c11a48c8349e8515b9f25f2e1ab1,2019-06-27T19:08:37Z,118,118,0
22246,2445758206,"{'login': 'xuhdev', 'id': 325476, 'node_id': 'MDQ6VXNlcjMyNTQ3Ng==', 'avatar_url': 'https://avatars1.githubusercontent.com/u/325476?v=4', 'gravatar_id': '', 'url': 'https://api.github.com/users/xuhdev', 'html_url': 'https://github.com/xuhdev', 'followers_url': 'https://api.github.com/users/xuhdev/followers', 'following_url': 'https://api.github.com/users/xuhdev/following{/other_user}', 'gists_url': 'https://api.github.com/users/xuhdev/gists{/gist_id}', 'starred_url': 'https://api.github.com/users/xuhdev/starred{/owner}{/repo}', 'subscriptions_url': 'https://api.github.com/users/xuhdev/subscriptions', 'organizations_url': 'https://api.github.com/users/xuhdev/orgs', 'repos_url': 'https://api.github.com/users/xuhdev/repos', 'events_url': 'https://api.github.com/users/xuhdev/events{/privacy}', 'received_events_url': 'https://api.github.com/users/xuhdev/received_events', 'type': 'User', 'site_admin': False}",referenced,1a8e29a7a4d2a91583c98bcf103af7d03ff9d9a2,https://api.github.com/repos/pytorch/pytorch/commits/1a8e29a7a4d2a91583c98bcf103af7d03ff9d9a2,2019-06-27T22:33:08Z,59,59,0
22246,2445758500,"{'login': 'xuhdev', 'id': 325476, 'node_id': 'MDQ6VXNlcjMyNTQ3Ng==', 'avatar_url': 'https://avatars1.githubusercontent.com/u/325476?v=4', 'gravatar_id': '', 'url': 'https://api.github.com/users/xuhdev', 'html_url': 'https://github.com/xuhdev', 'followers_url': 'https://api.github.com/users/xuhdev/followers', 'following_url': 'https://api.github.com/users/xuhdev/following{/other_user}', 'gists_url': 'https://api.github.com/users/xuhdev/gists{/gist_id}', 'starred_url': 'https://api.github.com/users/xuhdev/starred{/owner}{/repo}', 'subscriptions_url': 'https://api.github.com/users/xuhdev/subscriptions', 'organizations_url': 'https://api.github.com/users/xuhdev/orgs', 'repos_url': 'https://api.github.com/users/xuhdev/repos', 'events_url': 'https://api.github.com/users/xuhdev/events{/privacy}', 'received_events_url': 'https://api.github.com/users/xuhdev/received_events', 'type': 'User', 'site_admin': False}",referenced,0e9f837fa6862094b980a56db873daa83d2ce772,https://api.github.com/repos/pytorch/pytorch/commits/0e9f837fa6862094b980a56db873daa83d2ce772,2019-06-27T22:33:18Z,59,59,0
22246,2445759214,"{'login': 'xuhdev', 'id': 325476, 'node_id': 'MDQ6VXNlcjMyNTQ3Ng==', 'avatar_url': 'https://avatars1.githubusercontent.com/u/325476?v=4', 'gravatar_id': '', 'url': 'https://api.github.com/users/xuhdev', 'html_url': 'https://github.com/xuhdev', 'followers_url': 'https://api.github.com/users/xuhdev/followers', 'following_url': 'https://api.github.com/users/xuhdev/following{/other_user}', 'gists_url': 'https://api.github.com/users/xuhdev/gists{/gist_id}', 'starred_url': 'https://api.github.com/users/xuhdev/starred{/owner}{/repo}', 'subscriptions_url': 'https://api.github.com/users/xuhdev/subscriptions', 'organizations_url': 'https://api.github.com/users/xuhdev/orgs', 'repos_url': 'https://api.github.com/users/xuhdev/repos', 'events_url': 'https://api.github.com/users/xuhdev/events{/privacy}', 'received_events_url': 'https://api.github.com/users/xuhdev/received_events', 'type': 'User', 'site_admin': False}",referenced,fe77182bc4dd464a7797d109124dc97bcbabbec8,https://api.github.com/repos/pytorch/pytorch/commits/fe77182bc4dd464a7797d109124dc97bcbabbec8,2019-06-27T22:33:44Z,885,713,172
22246,2445759391,"{'login': 'xuhdev', 'id': 325476, 'node_id': 'MDQ6VXNlcjMyNTQ3Ng==', 'avatar_url': 'https://avatars1.githubusercontent.com/u/325476?v=4', 'gravatar_id': '', 'url': 'https://api.github.com/users/xuhdev', 'html_url': 'https://github.com/xuhdev', 'followers_url': 'https://api.github.com/users/xuhdev/followers', 'following_url': 'https://api.github.com/users/xuhdev/following{/other_user}', 'gists_url': 'https://api.github.com/users/xuhdev/gists{/gist_id}', 'starred_url': 'https://api.github.com/users/xuhdev/starred{/owner}{/repo}', 'subscriptions_url': 'https://api.github.com/users/xuhdev/subscriptions', 'organizations_url': 'https://api.github.com/users/xuhdev/orgs', 'repos_url': 'https://api.github.com/users/xuhdev/repos', 'events_url': 'https://api.github.com/users/xuhdev/events{/privacy}', 'received_events_url': 'https://api.github.com/users/xuhdev/received_events', 'type': 'User', 'site_admin': False}",referenced,e7188e4cd8c91dd5bf8d06271fbaecbd23a18aba,https://api.github.com/repos/pytorch/pytorch/commits/e7188e4cd8c91dd5bf8d06271fbaecbd23a18aba,2019-06-27T22:33:51Z,885,713,172
22246,2445759449,"{'login': 'xuhdev', 'id': 325476, 'node_id': 'MDQ6VXNlcjMyNTQ3Ng==', 'avatar_url': 'https://avatars1.githubusercontent.com/u/325476?v=4', 'gravatar_id': '', 'url': 'https://api.github.com/users/xuhdev', 'html_url': 'https://github.com/xuhdev', 'followers_url': 'https://api.github.com/users/xuhdev/followers', 'following_url': 'https://api.github.com/users/xuhdev/following{/other_user}', 'gists_url': 'https://api.github.com/users/xuhdev/gists{/gist_id}', 'starred_url': 'https://api.github.com/users/xuhdev/starred{/owner}{/repo}', 'subscriptions_url': 'https://api.github.com/users/xuhdev/subscriptions', 'organizations_url': 'https://api.github.com/users/xuhdev/orgs', 'repos_url': 'https://api.github.com/users/xuhdev/repos', 'events_url': 'https://api.github.com/users/xuhdev/events{/privacy}', 'received_events_url': 'https://api.github.com/users/xuhdev/received_events', 'type': 'User', 'site_admin': False}",referenced,281156ac6618b5d6d349f223effd6f709001e2b2,https://api.github.com/repos/pytorch/pytorch/commits/281156ac6618b5d6d349f223effd6f709001e2b2,2019-06-27T22:33:54Z,59,59,0
22246,2445761828,"{'login': 'xuhdev', 'id': 325476, 'node_id': 'MDQ6VXNlcjMyNTQ3Ng==', 'avatar_url': 'https://avatars1.githubusercontent.com/u/325476?v=4', 'gravatar_id': '', 'url': 'https://api.github.com/users/xuhdev', 'html_url': 'https://github.com/xuhdev', 'followers_url': 'https://api.github.com/users/xuhdev/followers', 'following_url': 'https://api.github.com/users/xuhdev/following{/other_user}', 'gists_url': 'https://api.github.com/users/xuhdev/gists{/gist_id}', 'starred_url': 'https://api.github.com/users/xuhdev/starred{/owner}{/repo}', 'subscriptions_url': 'https://api.github.com/users/xuhdev/subscriptions', 'organizations_url': 'https://api.github.com/users/xuhdev/orgs', 'repos_url': 'https://api.github.com/users/xuhdev/repos', 'events_url': 'https://api.github.com/users/xuhdev/events{/privacy}', 'received_events_url': 'https://api.github.com/users/xuhdev/received_events', 'type': 'User', 'site_admin': False}",referenced,10d38167149a4edc9c91432a2f0fbb8ad7b10da6,https://api.github.com/repos/pytorch/pytorch/commits/10d38167149a4edc9c91432a2f0fbb8ad7b10da6,2019-06-27T22:35:23Z,2,1,1
22246,2445761956,"{'login': 'xuhdev', 'id': 325476, 'node_id': 'MDQ6VXNlcjMyNTQ3Ng==', 'avatar_url': 'https://avatars1.githubusercontent.com/u/325476?v=4', 'gravatar_id': '', 'url': 'https://api.github.com/users/xuhdev', 'html_url': 'https://github.com/xuhdev', 'followers_url': 'https://api.github.com/users/xuhdev/followers', 'following_url': 'https://api.github.com/users/xuhdev/following{/other_user}', 'gists_url': 'https://api.github.com/users/xuhdev/gists{/gist_id}', 'starred_url': 'https://api.github.com/users/xuhdev/starred{/owner}{/repo}', 'subscriptions_url': 'https://api.github.com/users/xuhdev/subscriptions', 'organizations_url': 'https://api.github.com/users/xuhdev/orgs', 'repos_url': 'https://api.github.com/users/xuhdev/repos', 'events_url': 'https://api.github.com/users/xuhdev/events{/privacy}', 'received_events_url': 'https://api.github.com/users/xuhdev/received_events', 'type': 'User', 'site_admin': False}",referenced,cab8ea1dccf0a460592648e7610f25f1c15b3840,https://api.github.com/repos/pytorch/pytorch/commits/cab8ea1dccf0a460592648e7610f25f1c15b3840,2019-06-27T22:35:29Z,59,59,0
22246,2445774295,"{'login': 'xuhdev', 'id': 325476, 'node_id': 'MDQ6VXNlcjMyNTQ3Ng==', 'avatar_url': 'https://avatars1.githubusercontent.com/u/325476?v=4', 'gravatar_id': '', 'url': 'https://api.github.com/users/xuhdev', 'html_url': 'https://github.com/xuhdev', 'followers_url': 'https://api.github.com/users/xuhdev/followers', 'following_url': 'https://api.github.com/users/xuhdev/following{/other_user}', 'gists_url': 'https://api.github.com/users/xuhdev/gists{/gist_id}', 'starred_url': 'https://api.github.com/users/xuhdev/starred{/owner}{/repo}', 'subscriptions_url': 'https://api.github.com/users/xuhdev/subscriptions', 'organizations_url': 'https://api.github.com/users/xuhdev/orgs', 'repos_url': 'https://api.github.com/users/xuhdev/repos', 'events_url': 'https://api.github.com/users/xuhdev/events{/privacy}', 'received_events_url': 'https://api.github.com/users/xuhdev/received_events', 'type': 'User', 'site_admin': False}",referenced,20de04d20ffc81876f124f0b869adf2823861c75,https://api.github.com/repos/pytorch/pytorch/commits/20de04d20ffc81876f124f0b869adf2823861c75,2019-06-27T22:43:30Z,1,1,0
22246,2445774420,"{'login': 'xuhdev', 'id': 325476, 'node_id': 'MDQ6VXNlcjMyNTQ3Ng==', 'avatar_url': 'https://avatars1.githubusercontent.com/u/325476?v=4', 'gravatar_id': '', 'url': 'https://api.github.com/users/xuhdev', 'html_url': 'https://github.com/xuhdev', 'followers_url': 'https://api.github.com/users/xuhdev/followers', 'following_url': 'https://api.github.com/users/xuhdev/following{/other_user}', 'gists_url': 'https://api.github.com/users/xuhdev/gists{/gist_id}', 'starred_url': 'https://api.github.com/users/xuhdev/starred{/owner}{/repo}', 'subscriptions_url': 'https://api.github.com/users/xuhdev/subscriptions', 'organizations_url': 'https://api.github.com/users/xuhdev/orgs', 'repos_url': 'https://api.github.com/users/xuhdev/repos', 'events_url': 'https://api.github.com/users/xuhdev/events{/privacy}', 'received_events_url': 'https://api.github.com/users/xuhdev/received_events', 'type': 'User', 'site_admin': False}",referenced,7c926a98deeb26009411f43cbacfbf5dbd7414df,https://api.github.com/repos/pytorch/pytorch/commits/7c926a98deeb26009411f43cbacfbf5dbd7414df,2019-06-27T22:43:34Z,60,60,0
22226,2644250459,"{'login': 'facebook-github-bot', 'id': 6422482, 'node_id': 'MDQ6VXNlcjY0MjI0ODI=', 'avatar_url': 'https://avatars3.githubusercontent.com/u/6422482?v=4', 'gravatar_id': '', 'url': 'https://api.github.com/users/facebook-github-bot', 'html_url': 'https://github.com/facebook-github-bot', 'followers_url': 'https://api.github.com/users/facebook-github-bot/followers', 'following_url': 'https://api.github.com/users/facebook-github-bot/following{/other_user}', 'gists_url': 'https://api.github.com/users/facebook-github-bot/gists{/gist_id}', 'starred_url': 'https://api.github.com/users/facebook-github-bot/starred{/owner}{/repo}', 'subscriptions_url': 'https://api.github.com/users/facebook-github-bot/subscriptions', 'organizations_url': 'https://api.github.com/users/facebook-github-bot/orgs', 'repos_url': 'https://api.github.com/users/facebook-github-bot/repos', 'events_url': 'https://api.github.com/users/facebook-github-bot/events{/privacy}', 'received_events_url': 'https://api.github.com/users/facebook-github-bot/received_events', 'type': 'User', 'site_admin': False}",closed,ed09704899253be4c3810f96202655d4ed3bfb04,https://api.github.com/repos/pytorch/pytorch/commits/ed09704899253be4c3810f96202655d4ed3bfb04,2019-09-18T16:58:02Z,96,62,34
22200,2438880546,"{'login': 'xuhdev', 'id': 325476, 'node_id': 'MDQ6VXNlcjMyNTQ3Ng==', 'avatar_url': 'https://avatars1.githubusercontent.com/u/325476?v=4', 'gravatar_id': '', 'url': 'https://api.github.com/users/xuhdev', 'html_url': 'https://github.com/xuhdev', 'followers_url': 'https://api.github.com/users/xuhdev/followers', 'following_url': 'https://api.github.com/users/xuhdev/following{/other_user}', 'gists_url': 'https://api.github.com/users/xuhdev/gists{/gist_id}', 'starred_url': 'https://api.github.com/users/xuhdev/starred{/owner}{/repo}', 'subscriptions_url': 'https://api.github.com/users/xuhdev/subscriptions', 'organizations_url': 'https://api.github.com/users/xuhdev/orgs', 'repos_url': 'https://api.github.com/users/xuhdev/repos', 'events_url': 'https://api.github.com/users/xuhdev/events{/privacy}', 'received_events_url': 'https://api.github.com/users/xuhdev/received_events', 'type': 'User', 'site_admin': False}",referenced,2c3c8610849e6d90aba96fd71ddcd0af2735123f,https://api.github.com/repos/pytorch/pytorch/commits/2c3c8610849e6d90aba96fd71ddcd0af2735123f,2019-06-25T20:43:47Z,26,7,19
22200,2439027159,"{'login': 'xuhdev', 'id': 325476, 'node_id': 'MDQ6VXNlcjMyNTQ3Ng==', 'avatar_url': 'https://avatars1.githubusercontent.com/u/325476?v=4', 'gravatar_id': '', 'url': 'https://api.github.com/users/xuhdev', 'html_url': 'https://github.com/xuhdev', 'followers_url': 'https://api.github.com/users/xuhdev/followers', 'following_url': 'https://api.github.com/users/xuhdev/following{/other_user}', 'gists_url': 'https://api.github.com/users/xuhdev/gists{/gist_id}', 'starred_url': 'https://api.github.com/users/xuhdev/starred{/owner}{/repo}', 'subscriptions_url': 'https://api.github.com/users/xuhdev/subscriptions', 'organizations_url': 'https://api.github.com/users/xuhdev/orgs', 'repos_url': 'https://api.github.com/users/xuhdev/repos', 'events_url': 'https://api.github.com/users/xuhdev/events{/privacy}', 'received_events_url': 'https://api.github.com/users/xuhdev/received_events', 'type': 'User', 'site_admin': False}",referenced,7b8ba114c848072ebd1676702e94914fa14c2137,https://api.github.com/repos/pytorch/pytorch/commits/7b8ba114c848072ebd1676702e94914fa14c2137,2019-06-25T21:42:49Z,2,1,1
22200,2439037628,"{'login': 'xuhdev', 'id': 325476, 'node_id': 'MDQ6VXNlcjMyNTQ3Ng==', 'avatar_url': 'https://avatars1.githubusercontent.com/u/325476?v=4', 'gravatar_id': '', 'url': 'https://api.github.com/users/xuhdev', 'html_url': 'https://github.com/xuhdev', 'followers_url': 'https://api.github.com/users/xuhdev/followers', 'following_url': 'https://api.github.com/users/xuhdev/following{/other_user}', 'gists_url': 'https://api.github.com/users/xuhdev/gists{/gist_id}', 'starred_url': 'https://api.github.com/users/xuhdev/starred{/owner}{/repo}', 'subscriptions_url': 'https://api.github.com/users/xuhdev/subscriptions', 'organizations_url': 'https://api.github.com/users/xuhdev/orgs', 'repos_url': 'https://api.github.com/users/xuhdev/repos', 'events_url': 'https://api.github.com/users/xuhdev/events{/privacy}', 'received_events_url': 'https://api.github.com/users/xuhdev/received_events', 'type': 'User', 'site_admin': False}",referenced,264e9b366d641184007111a4626a6bf36b0dbc31,https://api.github.com/repos/pytorch/pytorch/commits/264e9b366d641184007111a4626a6bf36b0dbc31,2019-06-25T21:47:40Z,62,3,59
22200,2439095009,"{'login': 'xuhdev', 'id': 325476, 'node_id': 'MDQ6VXNlcjMyNTQ3Ng==', 'avatar_url': 'https://avatars1.githubusercontent.com/u/325476?v=4', 'gravatar_id': '', 'url': 'https://api.github.com/users/xuhdev', 'html_url': 'https://github.com/xuhdev', 'followers_url': 'https://api.github.com/users/xuhdev/followers', 'following_url': 'https://api.github.com/users/xuhdev/following{/other_user}', 'gists_url': 'https://api.github.com/users/xuhdev/gists{/gist_id}', 'starred_url': 'https://api.github.com/users/xuhdev/starred{/owner}{/repo}', 'subscriptions_url': 'https://api.github.com/users/xuhdev/subscriptions', 'organizations_url': 'https://api.github.com/users/xuhdev/orgs', 'repos_url': 'https://api.github.com/users/xuhdev/repos', 'events_url': 'https://api.github.com/users/xuhdev/events{/privacy}', 'received_events_url': 'https://api.github.com/users/xuhdev/received_events', 'type': 'User', 'site_admin': False}",referenced,3681ec4a8c6745afab68086dc625125094601406,https://api.github.com/repos/pytorch/pytorch/commits/3681ec4a8c6745afab68086dc625125094601406,2019-06-25T22:15:54Z,4,2,2
22200,2439104713,"{'login': 'xuhdev', 'id': 325476, 'node_id': 'MDQ6VXNlcjMyNTQ3Ng==', 'avatar_url': 'https://avatars1.githubusercontent.com/u/325476?v=4', 'gravatar_id': '', 'url': 'https://api.github.com/users/xuhdev', 'html_url': 'https://github.com/xuhdev', 'followers_url': 'https://api.github.com/users/xuhdev/followers', 'following_url': 'https://api.github.com/users/xuhdev/following{/other_user}', 'gists_url': 'https://api.github.com/users/xuhdev/gists{/gist_id}', 'starred_url': 'https://api.github.com/users/xuhdev/starred{/owner}{/repo}', 'subscriptions_url': 'https://api.github.com/users/xuhdev/subscriptions', 'organizations_url': 'https://api.github.com/users/xuhdev/orgs', 'repos_url': 'https://api.github.com/users/xuhdev/repos', 'events_url': 'https://api.github.com/users/xuhdev/events{/privacy}', 'received_events_url': 'https://api.github.com/users/xuhdev/received_events', 'type': 'User', 'site_admin': False}",referenced,f89f4b07cba6f5740ed380a213b76e9e251bac7d,https://api.github.com/repos/pytorch/pytorch/commits/f89f4b07cba6f5740ed380a213b76e9e251bac7d,2019-06-25T22:21:12Z,2,1,1
22200,2439172871,"{'login': 'xuhdev', 'id': 325476, 'node_id': 'MDQ6VXNlcjMyNTQ3Ng==', 'avatar_url': 'https://avatars1.githubusercontent.com/u/325476?v=4', 'gravatar_id': '', 'url': 'https://api.github.com/users/xuhdev', 'html_url': 'https://github.com/xuhdev', 'followers_url': 'https://api.github.com/users/xuhdev/followers', 'following_url': 'https://api.github.com/users/xuhdev/following{/other_user}', 'gists_url': 'https://api.github.com/users/xuhdev/gists{/gist_id}', 'starred_url': 'https://api.github.com/users/xuhdev/starred{/owner}{/repo}', 'subscriptions_url': 'https://api.github.com/users/xuhdev/subscriptions', 'organizations_url': 'https://api.github.com/users/xuhdev/orgs', 'repos_url': 'https://api.github.com/users/xuhdev/repos', 'events_url': 'https://api.github.com/users/xuhdev/events{/privacy}', 'received_events_url': 'https://api.github.com/users/xuhdev/received_events', 'type': 'User', 'site_admin': False}",referenced,2f4adabd89db6c874ce97526664079d63686040c,https://api.github.com/repos/pytorch/pytorch/commits/2f4adabd89db6c874ce97526664079d63686040c,2019-06-25T23:01:22Z,63,0,63
22200,2439184798,"{'login': 'xuhdev', 'id': 325476, 'node_id': 'MDQ6VXNlcjMyNTQ3Ng==', 'avatar_url': 'https://avatars1.githubusercontent.com/u/325476?v=4', 'gravatar_id': '', 'url': 'https://api.github.com/users/xuhdev', 'html_url': 'https://github.com/xuhdev', 'followers_url': 'https://api.github.com/users/xuhdev/followers', 'following_url': 'https://api.github.com/users/xuhdev/following{/other_user}', 'gists_url': 'https://api.github.com/users/xuhdev/gists{/gist_id}', 'starred_url': 'https://api.github.com/users/xuhdev/starred{/owner}{/repo}', 'subscriptions_url': 'https://api.github.com/users/xuhdev/subscriptions', 'organizations_url': 'https://api.github.com/users/xuhdev/orgs', 'repos_url': 'https://api.github.com/users/xuhdev/repos', 'events_url': 'https://api.github.com/users/xuhdev/events{/privacy}', 'received_events_url': 'https://api.github.com/users/xuhdev/received_events', 'type': 'User', 'site_admin': False}",referenced,865b601144cfeef0ae7123cd149e022ee1fb25eb,https://api.github.com/repos/pytorch/pytorch/commits/865b601144cfeef0ae7123cd149e022ee1fb25eb,2019-06-25T23:09:10Z,82,77,5
22200,2445092087,"{'login': 'xuhdev', 'id': 325476, 'node_id': 'MDQ6VXNlcjMyNTQ3Ng==', 'avatar_url': 'https://avatars1.githubusercontent.com/u/325476?v=4', 'gravatar_id': '', 'url': 'https://api.github.com/users/xuhdev', 'html_url': 'https://github.com/xuhdev', 'followers_url': 'https://api.github.com/users/xuhdev/followers', 'following_url': 'https://api.github.com/users/xuhdev/following{/other_user}', 'gists_url': 'https://api.github.com/users/xuhdev/gists{/gist_id}', 'starred_url': 'https://api.github.com/users/xuhdev/starred{/owner}{/repo}', 'subscriptions_url': 'https://api.github.com/users/xuhdev/subscriptions', 'organizations_url': 'https://api.github.com/users/xuhdev/orgs', 'repos_url': 'https://api.github.com/users/xuhdev/repos', 'events_url': 'https://api.github.com/users/xuhdev/events{/privacy}', 'received_events_url': 'https://api.github.com/users/xuhdev/received_events', 'type': 'User', 'site_admin': False}",referenced,37de6711cf76e6c6ee7f707cf5dd00c702836875,https://api.github.com/repos/pytorch/pytorch/commits/37de6711cf76e6c6ee7f707cf5dd00c702836875,2019-06-27T17:51:47Z,5194,3499,1695
22200,2448217964,"{'login': 'xuhdev', 'id': 325476, 'node_id': 'MDQ6VXNlcjMyNTQ3Ng==', 'avatar_url': 'https://avatars1.githubusercontent.com/u/325476?v=4', 'gravatar_id': '', 'url': 'https://api.github.com/users/xuhdev', 'html_url': 'https://github.com/xuhdev', 'followers_url': 'https://api.github.com/users/xuhdev/followers', 'following_url': 'https://api.github.com/users/xuhdev/following{/other_user}', 'gists_url': 'https://api.github.com/users/xuhdev/gists{/gist_id}', 'starred_url': 'https://api.github.com/users/xuhdev/starred{/owner}{/repo}', 'subscriptions_url': 'https://api.github.com/users/xuhdev/subscriptions', 'organizations_url': 'https://api.github.com/users/xuhdev/orgs', 'repos_url': 'https://api.github.com/users/xuhdev/repos', 'events_url': 'https://api.github.com/users/xuhdev/events{/privacy}', 'received_events_url': 'https://api.github.com/users/xuhdev/received_events', 'type': 'User', 'site_admin': False}",referenced,2ea3449e3620feedaab4a5c738381f0f1c7ebb51,https://api.github.com/repos/pytorch/pytorch/commits/2ea3449e3620feedaab4a5c738381f0f1c7ebb51,2019-06-28T19:24:26Z,2045,1457,588
22200,2448221092,"{'login': 'xuhdev', 'id': 325476, 'node_id': 'MDQ6VXNlcjMyNTQ3Ng==', 'avatar_url': 'https://avatars1.githubusercontent.com/u/325476?v=4', 'gravatar_id': '', 'url': 'https://api.github.com/users/xuhdev', 'html_url': 'https://github.com/xuhdev', 'followers_url': 'https://api.github.com/users/xuhdev/followers', 'following_url': 'https://api.github.com/users/xuhdev/following{/other_user}', 'gists_url': 'https://api.github.com/users/xuhdev/gists{/gist_id}', 'starred_url': 'https://api.github.com/users/xuhdev/starred{/owner}{/repo}', 'subscriptions_url': 'https://api.github.com/users/xuhdev/subscriptions', 'organizations_url': 'https://api.github.com/users/xuhdev/orgs', 'repos_url': 'https://api.github.com/users/xuhdev/repos', 'events_url': 'https://api.github.com/users/xuhdev/events{/privacy}', 'received_events_url': 'https://api.github.com/users/xuhdev/received_events', 'type': 'User', 'site_admin': False}",referenced,9284fe103a1525ec7838e6a3b923e2d15d2b63a9,https://api.github.com/repos/pytorch/pytorch/commits/9284fe103a1525ec7838e6a3b923e2d15d2b63a9,2019-06-28T19:26:05Z,0,0,0
22200,2448274983,"{'login': 'xuhdev', 'id': 325476, 'node_id': 'MDQ6VXNlcjMyNTQ3Ng==', 'avatar_url': 'https://avatars1.githubusercontent.com/u/325476?v=4', 'gravatar_id': '', 'url': 'https://api.github.com/users/xuhdev', 'html_url': 'https://github.com/xuhdev', 'followers_url': 'https://api.github.com/users/xuhdev/followers', 'following_url': 'https://api.github.com/users/xuhdev/following{/other_user}', 'gists_url': 'https://api.github.com/users/xuhdev/gists{/gist_id}', 'starred_url': 'https://api.github.com/users/xuhdev/starred{/owner}{/repo}', 'subscriptions_url': 'https://api.github.com/users/xuhdev/subscriptions', 'organizations_url': 'https://api.github.com/users/xuhdev/orgs', 'repos_url': 'https://api.github.com/users/xuhdev/repos', 'events_url': 'https://api.github.com/users/xuhdev/events{/privacy}', 'received_events_url': 'https://api.github.com/users/xuhdev/received_events', 'type': 'User', 'site_admin': False}",referenced,259707efd9bfa613643f8b74c84c6d10128bac2c,https://api.github.com/repos/pytorch/pytorch/commits/259707efd9bfa613643f8b74c84c6d10128bac2c,2019-06-28T19:52:43Z,2,1,1
22200,2453326635,"{'login': 'facebook-github-bot', 'id': 6422482, 'node_id': 'MDQ6VXNlcjY0MjI0ODI=', 'avatar_url': 'https://avatars3.githubusercontent.com/u/6422482?v=4', 'gravatar_id': '', 'url': 'https://api.github.com/users/facebook-github-bot', 'html_url': 'https://github.com/facebook-github-bot', 'followers_url': 'https://api.github.com/users/facebook-github-bot/followers', 'following_url': 'https://api.github.com/users/facebook-github-bot/following{/other_user}', 'gists_url': 'https://api.github.com/users/facebook-github-bot/gists{/gist_id}', 'starred_url': 'https://api.github.com/users/facebook-github-bot/starred{/owner}{/repo}', 'subscriptions_url': 'https://api.github.com/users/facebook-github-bot/subscriptions', 'organizations_url': 'https://api.github.com/users/facebook-github-bot/orgs', 'repos_url': 'https://api.github.com/users/facebook-github-bot/repos', 'events_url': 'https://api.github.com/users/facebook-github-bot/events{/privacy}', 'received_events_url': 'https://api.github.com/users/facebook-github-bot/received_events', 'type': 'User', 'site_admin': False}",closed,b9ede6600e26b5a2b549737a4b343afb7f8b3c48,https://api.github.com/repos/pytorch/pytorch/commits/b9ede6600e26b5a2b549737a4b343afb7f8b3c48,2019-07-02T07:08:27Z,30,1,29
22192,2459115593,"{'login': 'facebook-github-bot', 'id': 6422482, 'node_id': 'MDQ6VXNlcjY0MjI0ODI=', 'avatar_url': 'https://avatars3.githubusercontent.com/u/6422482?v=4', 'gravatar_id': '', 'url': 'https://api.github.com/users/facebook-github-bot', 'html_url': 'https://github.com/facebook-github-bot', 'followers_url': 'https://api.github.com/users/facebook-github-bot/followers', 'following_url': 'https://api.github.com/users/facebook-github-bot/following{/other_user}', 'gists_url': 'https://api.github.com/users/facebook-github-bot/gists{/gist_id}', 'starred_url': 'https://api.github.com/users/facebook-github-bot/starred{/owner}{/repo}', 'subscriptions_url': 'https://api.github.com/users/facebook-github-bot/subscriptions', 'organizations_url': 'https://api.github.com/users/facebook-github-bot/orgs', 'repos_url': 'https://api.github.com/users/facebook-github-bot/repos', 'events_url': 'https://api.github.com/users/facebook-github-bot/events{/privacy}', 'received_events_url': 'https://api.github.com/users/facebook-github-bot/received_events', 'type': 'User', 'site_admin': False}",closed,29ec4769bbcf545e8727184b413f3b4b6a002b44,https://api.github.com/repos/pytorch/pytorch/commits/29ec4769bbcf545e8727184b413f3b4b6a002b44,2019-07-04T00:20:32Z,74,64,10
22158,2898222696,"{'login': 'gchanan', 'id': 3768583, 'node_id': 'MDQ6VXNlcjM3Njg1ODM=', 'avatar_url': 'https://avatars2.githubusercontent.com/u/3768583?v=4', 'gravatar_id': '', 'url': 'https://api.github.com/users/gchanan', 'html_url': 'https://github.com/gchanan', 'followers_url': 'https://api.github.com/users/gchanan/followers', 'following_url': 'https://api.github.com/users/gchanan/following{/other_user}', 'gists_url': 'https://api.github.com/users/gchanan/gists{/gist_id}', 'starred_url': 'https://api.github.com/users/gchanan/starred{/owner}{/repo}', 'subscriptions_url': 'https://api.github.com/users/gchanan/subscriptions', 'organizations_url': 'https://api.github.com/users/gchanan/orgs', 'repos_url': 'https://api.github.com/users/gchanan/repos', 'events_url': 'https://api.github.com/users/gchanan/events{/privacy}', 'received_events_url': 'https://api.github.com/users/gchanan/received_events', 'type': 'User', 'site_admin': False}",referenced,59a1195e93343f65e25daf56d214bd4483bacbd7,https://api.github.com/repos/pytorch/pytorch/commits/59a1195e93343f65e25daf56d214bd4483bacbd7,2019-12-19T18:29:14Z,51,51,0
22158,2898223106,"{'login': 'gchanan', 'id': 3768583, 'node_id': 'MDQ6VXNlcjM3Njg1ODM=', 'avatar_url': 'https://avatars2.githubusercontent.com/u/3768583?v=4', 'gravatar_id': '', 'url': 'https://api.github.com/users/gchanan', 'html_url': 'https://github.com/gchanan', 'followers_url': 'https://api.github.com/users/gchanan/followers', 'following_url': 'https://api.github.com/users/gchanan/following{/other_user}', 'gists_url': 'https://api.github.com/users/gchanan/gists{/gist_id}', 'starred_url': 'https://api.github.com/users/gchanan/starred{/owner}{/repo}', 'subscriptions_url': 'https://api.github.com/users/gchanan/subscriptions', 'organizations_url': 'https://api.github.com/users/gchanan/orgs', 'repos_url': 'https://api.github.com/users/gchanan/repos', 'events_url': 'https://api.github.com/users/gchanan/events{/privacy}', 'received_events_url': 'https://api.github.com/users/gchanan/received_events', 'type': 'User', 'site_admin': False}",referenced,819791311d4eb6382b579b552c2f74c99a52d940,https://api.github.com/repos/pytorch/pytorch/commits/819791311d4eb6382b579b552c2f74c99a52d940,2019-12-19T18:29:23Z,51,51,0
22158,2901150459,"{'login': 'gchanan', 'id': 3768583, 'node_id': 'MDQ6VXNlcjM3Njg1ODM=', 'avatar_url': 'https://avatars2.githubusercontent.com/u/3768583?v=4', 'gravatar_id': '', 'url': 'https://api.github.com/users/gchanan', 'html_url': 'https://github.com/gchanan', 'followers_url': 'https://api.github.com/users/gchanan/followers', 'following_url': 'https://api.github.com/users/gchanan/following{/other_user}', 'gists_url': 'https://api.github.com/users/gchanan/gists{/gist_id}', 'starred_url': 'https://api.github.com/users/gchanan/starred{/owner}{/repo}', 'subscriptions_url': 'https://api.github.com/users/gchanan/subscriptions', 'organizations_url': 'https://api.github.com/users/gchanan/orgs', 'repos_url': 'https://api.github.com/users/gchanan/repos', 'events_url': 'https://api.github.com/users/gchanan/events{/privacy}', 'received_events_url': 'https://api.github.com/users/gchanan/received_events', 'type': 'User', 'site_admin': False}",referenced,94c4c19c423f7f02308a0854b850b7c484a981af,https://api.github.com/repos/pytorch/pytorch/commits/94c4c19c423f7f02308a0854b850b7c484a981af,2019-12-20T15:48:28Z,827,490,337
22158,2905537247,"{'login': 'gchanan', 'id': 3768583, 'node_id': 'MDQ6VXNlcjM3Njg1ODM=', 'avatar_url': 'https://avatars2.githubusercontent.com/u/3768583?v=4', 'gravatar_id': '', 'url': 'https://api.github.com/users/gchanan', 'html_url': 'https://github.com/gchanan', 'followers_url': 'https://api.github.com/users/gchanan/followers', 'following_url': 'https://api.github.com/users/gchanan/following{/other_user}', 'gists_url': 'https://api.github.com/users/gchanan/gists{/gist_id}', 'starred_url': 'https://api.github.com/users/gchanan/starred{/owner}{/repo}', 'subscriptions_url': 'https://api.github.com/users/gchanan/subscriptions', 'organizations_url': 'https://api.github.com/users/gchanan/orgs', 'repos_url': 'https://api.github.com/users/gchanan/repos', 'events_url': 'https://api.github.com/users/gchanan/events{/privacy}', 'received_events_url': 'https://api.github.com/users/gchanan/received_events', 'type': 'User', 'site_admin': False}",referenced,ff9d072679d2e9e92261d4f881c0d44b62569148,https://api.github.com/repos/pytorch/pytorch/commits/ff9d072679d2e9e92261d4f881c0d44b62569148,2019-12-23T19:55:52Z,6,4,2
22158,2909251244,"{'login': 'facebook-github-bot', 'id': 6422482, 'node_id': 'MDQ6VXNlcjY0MjI0ODI=', 'avatar_url': 'https://avatars3.githubusercontent.com/u/6422482?v=4', 'gravatar_id': '', 'url': 'https://api.github.com/users/facebook-github-bot', 'html_url': 'https://github.com/facebook-github-bot', 'followers_url': 'https://api.github.com/users/facebook-github-bot/followers', 'following_url': 'https://api.github.com/users/facebook-github-bot/following{/other_user}', 'gists_url': 'https://api.github.com/users/facebook-github-bot/gists{/gist_id}', 'starred_url': 'https://api.github.com/users/facebook-github-bot/starred{/owner}{/repo}', 'subscriptions_url': 'https://api.github.com/users/facebook-github-bot/subscriptions', 'organizations_url': 'https://api.github.com/users/facebook-github-bot/orgs', 'repos_url': 'https://api.github.com/users/facebook-github-bot/repos', 'events_url': 'https://api.github.com/users/facebook-github-bot/events{/privacy}', 'received_events_url': 'https://api.github.com/users/facebook-github-bot/received_events', 'type': 'User', 'site_admin': False}",closed,29f345831e5a5eee388842d99e5065540baa878f,https://api.github.com/repos/pytorch/pytorch/commits/29f345831e5a5eee388842d99e5065540baa878f,2019-12-26T15:27:41Z,53,53,0
22158,2909255299,"{'login': 'gchanan', 'id': 3768583, 'node_id': 'MDQ6VXNlcjM3Njg1ODM=', 'avatar_url': 'https://avatars2.githubusercontent.com/u/3768583?v=4', 'gravatar_id': '', 'url': 'https://api.github.com/users/gchanan', 'html_url': 'https://github.com/gchanan', 'followers_url': 'https://api.github.com/users/gchanan/followers', 'following_url': 'https://api.github.com/users/gchanan/following{/other_user}', 'gists_url': 'https://api.github.com/users/gchanan/gists{/gist_id}', 'starred_url': 'https://api.github.com/users/gchanan/starred{/owner}{/repo}', 'subscriptions_url': 'https://api.github.com/users/gchanan/subscriptions', 'organizations_url': 'https://api.github.com/users/gchanan/orgs', 'repos_url': 'https://api.github.com/users/gchanan/repos', 'events_url': 'https://api.github.com/users/gchanan/events{/privacy}', 'received_events_url': 'https://api.github.com/users/gchanan/received_events', 'type': 'User', 'site_admin': False}",referenced,ba173ffb3f9350a0f1f52d60ee4ae2f69504e4a0,https://api.github.com/repos/pytorch/pytorch/commits/ba173ffb3f9350a0f1f52d60ee4ae2f69504e4a0,2019-12-26T15:31:01Z,4594,3071,1523
22131,2517652856,"{'login': 'facebook-github-bot', 'id': 6422482, 'node_id': 'MDQ6VXNlcjY0MjI0ODI=', 'avatar_url': 'https://avatars3.githubusercontent.com/u/6422482?v=4', 'gravatar_id': '', 'url': 'https://api.github.com/users/facebook-github-bot', 'html_url': 'https://github.com/facebook-github-bot', 'followers_url': 'https://api.github.com/users/facebook-github-bot/followers', 'following_url': 'https://api.github.com/users/facebook-github-bot/following{/other_user}', 'gists_url': 'https://api.github.com/users/facebook-github-bot/gists{/gist_id}', 'starred_url': 'https://api.github.com/users/facebook-github-bot/starred{/owner}{/repo}', 'subscriptions_url': 'https://api.github.com/users/facebook-github-bot/subscriptions', 'organizations_url': 'https://api.github.com/users/facebook-github-bot/orgs', 'repos_url': 'https://api.github.com/users/facebook-github-bot/repos', 'events_url': 'https://api.github.com/users/facebook-github-bot/events{/privacy}', 'received_events_url': 'https://api.github.com/users/facebook-github-bot/received_events', 'type': 'User', 'site_admin': False}",closed,e982e46de34eed411a11c0b7ca034a5b7b177fa4,https://api.github.com/repos/pytorch/pytorch/commits/e982e46de34eed411a11c0b7ca034a5b7b177fa4,2019-07-29T20:01:31Z,215,163,52
22124,2604535706,"{'login': 'facebook-github-bot', 'id': 6422482, 'node_id': 'MDQ6VXNlcjY0MjI0ODI=', 'avatar_url': 'https://avatars3.githubusercontent.com/u/6422482?v=4', 'gravatar_id': '', 'url': 'https://api.github.com/users/facebook-github-bot', 'html_url': 'https://github.com/facebook-github-bot', 'followers_url': 'https://api.github.com/users/facebook-github-bot/followers', 'following_url': 'https://api.github.com/users/facebook-github-bot/following{/other_user}', 'gists_url': 'https://api.github.com/users/facebook-github-bot/gists{/gist_id}', 'starred_url': 'https://api.github.com/users/facebook-github-bot/starred{/owner}{/repo}', 'subscriptions_url': 'https://api.github.com/users/facebook-github-bot/subscriptions', 'organizations_url': 'https://api.github.com/users/facebook-github-bot/orgs', 'repos_url': 'https://api.github.com/users/facebook-github-bot/repos', 'events_url': 'https://api.github.com/users/facebook-github-bot/events{/privacy}', 'received_events_url': 'https://api.github.com/users/facebook-github-bot/received_events', 'type': 'User', 'site_admin': False}",closed,f3f83ccb2370b12150797e85b70435306e7002a6,https://api.github.com/repos/pytorch/pytorch/commits/f3f83ccb2370b12150797e85b70435306e7002a6,2019-09-03T18:16:42Z,40,28,12
22109,2487525235,"{'login': 'facebook-github-bot', 'id': 6422482, 'node_id': 'MDQ6VXNlcjY0MjI0ODI=', 'avatar_url': 'https://avatars3.githubusercontent.com/u/6422482?v=4', 'gravatar_id': '', 'url': 'https://api.github.com/users/facebook-github-bot', 'html_url': 'https://github.com/facebook-github-bot', 'followers_url': 'https://api.github.com/users/facebook-github-bot/followers', 'following_url': 'https://api.github.com/users/facebook-github-bot/following{/other_user}', 'gists_url': 'https://api.github.com/users/facebook-github-bot/gists{/gist_id}', 'starred_url': 'https://api.github.com/users/facebook-github-bot/starred{/owner}{/repo}', 'subscriptions_url': 'https://api.github.com/users/facebook-github-bot/subscriptions', 'organizations_url': 'https://api.github.com/users/facebook-github-bot/orgs', 'repos_url': 'https://api.github.com/users/facebook-github-bot/repos', 'events_url': 'https://api.github.com/users/facebook-github-bot/events{/privacy}', 'received_events_url': 'https://api.github.com/users/facebook-github-bot/received_events', 'type': 'User', 'site_admin': False}",closed,cd11109c2eedbe58ada092b1b8fc274006385c43,https://api.github.com/repos/pytorch/pytorch/commits/cd11109c2eedbe58ada092b1b8fc274006385c43,2019-07-16T21:19:52Z,4,0,4
22107,2591968668,"{'login': 'vincentqb', 'id': 3047868, 'node_id': 'MDQ6VXNlcjMwNDc4Njg=', 'avatar_url': 'https://avatars0.githubusercontent.com/u/3047868?v=4', 'gravatar_id': '', 'url': 'https://api.github.com/users/vincentqb', 'html_url': 'https://github.com/vincentqb', 'followers_url': 'https://api.github.com/users/vincentqb/followers', 'following_url': 'https://api.github.com/users/vincentqb/following{/other_user}', 'gists_url': 'https://api.github.com/users/vincentqb/gists{/gist_id}', 'starred_url': 'https://api.github.com/users/vincentqb/starred{/owner}{/repo}', 'subscriptions_url': 'https://api.github.com/users/vincentqb/subscriptions', 'organizations_url': 'https://api.github.com/users/vincentqb/orgs', 'repos_url': 'https://api.github.com/users/vincentqb/repos', 'events_url': 'https://api.github.com/users/vincentqb/events{/privacy}', 'received_events_url': 'https://api.github.com/users/vincentqb/received_events', 'type': 'User', 'site_admin': False}",referenced,43757305a20856f0cddb65798b17fe82ae9478bc,https://api.github.com/repos/pytorch/pytorch/commits/43757305a20856f0cddb65798b17fe82ae9478bc,2019-08-28T21:16:19Z,45106,31942,13164
22107,2591989311,"{'login': 'vincentqb', 'id': 3047868, 'node_id': 'MDQ6VXNlcjMwNDc4Njg=', 'avatar_url': 'https://avatars0.githubusercontent.com/u/3047868?v=4', 'gravatar_id': '', 'url': 'https://api.github.com/users/vincentqb', 'html_url': 'https://github.com/vincentqb', 'followers_url': 'https://api.github.com/users/vincentqb/followers', 'following_url': 'https://api.github.com/users/vincentqb/following{/other_user}', 'gists_url': 'https://api.github.com/users/vincentqb/gists{/gist_id}', 'starred_url': 'https://api.github.com/users/vincentqb/starred{/owner}{/repo}', 'subscriptions_url': 'https://api.github.com/users/vincentqb/subscriptions', 'organizations_url': 'https://api.github.com/users/vincentqb/orgs', 'repos_url': 'https://api.github.com/users/vincentqb/repos', 'events_url': 'https://api.github.com/users/vincentqb/events{/privacy}', 'received_events_url': 'https://api.github.com/users/vincentqb/received_events', 'type': 'User', 'site_admin': False}",referenced,2bea2cdcd90dd8d68a8efd8a5dcc278f7d7569fa,https://api.github.com/repos/pytorch/pytorch/commits/2bea2cdcd90dd8d68a8efd8a5dcc278f7d7569fa,2019-08-28T21:24:57Z,13,7,6
22107,2611356212,"{'login': 'vincentqb', 'id': 3047868, 'node_id': 'MDQ6VXNlcjMwNDc4Njg=', 'avatar_url': 'https://avatars0.githubusercontent.com/u/3047868?v=4', 'gravatar_id': '', 'url': 'https://api.github.com/users/vincentqb', 'html_url': 'https://github.com/vincentqb', 'followers_url': 'https://api.github.com/users/vincentqb/followers', 'following_url': 'https://api.github.com/users/vincentqb/following{/other_user}', 'gists_url': 'https://api.github.com/users/vincentqb/gists{/gist_id}', 'starred_url': 'https://api.github.com/users/vincentqb/starred{/owner}{/repo}', 'subscriptions_url': 'https://api.github.com/users/vincentqb/subscriptions', 'organizations_url': 'https://api.github.com/users/vincentqb/orgs', 'repos_url': 'https://api.github.com/users/vincentqb/repos', 'events_url': 'https://api.github.com/users/vincentqb/events{/privacy}', 'received_events_url': 'https://api.github.com/users/vincentqb/received_events', 'type': 'User', 'site_admin': False}",referenced,e00c0a2704aaec1c3cd3c63a09e8db5403913f61,https://api.github.com/repos/pytorch/pytorch/commits/e00c0a2704aaec1c3cd3c63a09e8db5403913f61,2019-09-05T16:25:20Z,31451,17773,13678
22107,2620155695,"{'login': 'vincentqb', 'id': 3047868, 'node_id': 'MDQ6VXNlcjMwNDc4Njg=', 'avatar_url': 'https://avatars0.githubusercontent.com/u/3047868?v=4', 'gravatar_id': '', 'url': 'https://api.github.com/users/vincentqb', 'html_url': 'https://github.com/vincentqb', 'followers_url': 'https://api.github.com/users/vincentqb/followers', 'following_url': 'https://api.github.com/users/vincentqb/following{/other_user}', 'gists_url': 'https://api.github.com/users/vincentqb/gists{/gist_id}', 'starred_url': 'https://api.github.com/users/vincentqb/starred{/owner}{/repo}', 'subscriptions_url': 'https://api.github.com/users/vincentqb/subscriptions', 'organizations_url': 'https://api.github.com/users/vincentqb/orgs', 'repos_url': 'https://api.github.com/users/vincentqb/repos', 'events_url': 'https://api.github.com/users/vincentqb/events{/privacy}', 'received_events_url': 'https://api.github.com/users/vincentqb/received_events', 'type': 'User', 'site_admin': False}",referenced,67357c61a89891a8fb149538600f674c7134f186,https://api.github.com/repos/pytorch/pytorch/commits/67357c61a89891a8fb149538600f674c7134f186,2019-09-09T21:04:29Z,119,85,34
22107,2620222368,"{'login': 'vincentqb', 'id': 3047868, 'node_id': 'MDQ6VXNlcjMwNDc4Njg=', 'avatar_url': 'https://avatars0.githubusercontent.com/u/3047868?v=4', 'gravatar_id': '', 'url': 'https://api.github.com/users/vincentqb', 'html_url': 'https://github.com/vincentqb', 'followers_url': 'https://api.github.com/users/vincentqb/followers', 'following_url': 'https://api.github.com/users/vincentqb/following{/other_user}', 'gists_url': 'https://api.github.com/users/vincentqb/gists{/gist_id}', 'starred_url': 'https://api.github.com/users/vincentqb/starred{/owner}{/repo}', 'subscriptions_url': 'https://api.github.com/users/vincentqb/subscriptions', 'organizations_url': 'https://api.github.com/users/vincentqb/orgs', 'repos_url': 'https://api.github.com/users/vincentqb/repos', 'events_url': 'https://api.github.com/users/vincentqb/events{/privacy}', 'received_events_url': 'https://api.github.com/users/vincentqb/received_events', 'type': 'User', 'site_admin': False}",referenced,d5095a7d3da0853e7629553ebd1138d8e7a352d8,https://api.github.com/repos/pytorch/pytorch/commits/d5095a7d3da0853e7629553ebd1138d8e7a352d8,2019-09-09T21:30:42Z,4,3,1
22107,2630301627,"{'login': 'vincentqb', 'id': 3047868, 'node_id': 'MDQ6VXNlcjMwNDc4Njg=', 'avatar_url': 'https://avatars0.githubusercontent.com/u/3047868?v=4', 'gravatar_id': '', 'url': 'https://api.github.com/users/vincentqb', 'html_url': 'https://github.com/vincentqb', 'followers_url': 'https://api.github.com/users/vincentqb/followers', 'following_url': 'https://api.github.com/users/vincentqb/following{/other_user}', 'gists_url': 'https://api.github.com/users/vincentqb/gists{/gist_id}', 'starred_url': 'https://api.github.com/users/vincentqb/starred{/owner}{/repo}', 'subscriptions_url': 'https://api.github.com/users/vincentqb/subscriptions', 'organizations_url': 'https://api.github.com/users/vincentqb/orgs', 'repos_url': 'https://api.github.com/users/vincentqb/repos', 'events_url': 'https://api.github.com/users/vincentqb/events{/privacy}', 'received_events_url': 'https://api.github.com/users/vincentqb/received_events', 'type': 'User', 'site_admin': False}",referenced,f59ce0cbaa1e2a04f5c166273e93c4346b883f7f,https://api.github.com/repos/pytorch/pytorch/commits/f59ce0cbaa1e2a04f5c166273e93c4346b883f7f,2019-09-12T19:25:35Z,84367,79418,4949
22107,2632555922,"{'login': 'facebook-github-bot', 'id': 6422482, 'node_id': 'MDQ6VXNlcjY0MjI0ODI=', 'avatar_url': 'https://avatars3.githubusercontent.com/u/6422482?v=4', 'gravatar_id': '', 'url': 'https://api.github.com/users/facebook-github-bot', 'html_url': 'https://github.com/facebook-github-bot', 'followers_url': 'https://api.github.com/users/facebook-github-bot/followers', 'following_url': 'https://api.github.com/users/facebook-github-bot/following{/other_user}', 'gists_url': 'https://api.github.com/users/facebook-github-bot/gists{/gist_id}', 'starred_url': 'https://api.github.com/users/facebook-github-bot/starred{/owner}{/repo}', 'subscriptions_url': 'https://api.github.com/users/facebook-github-bot/subscriptions', 'organizations_url': 'https://api.github.com/users/facebook-github-bot/orgs', 'repos_url': 'https://api.github.com/users/facebook-github-bot/repos', 'events_url': 'https://api.github.com/users/facebook-github-bot/events{/privacy}', 'received_events_url': 'https://api.github.com/users/facebook-github-bot/received_events', 'type': 'User', 'site_admin': False}",referenced,939ae80de14deb87ae2fd5f90f32e5d504689bbb,https://api.github.com/repos/pytorch/pytorch/commits/939ae80de14deb87ae2fd5f90f32e5d504689bbb,2019-09-13T14:36:21Z,527,436,91
22106,2431903439,"{'login': 'apaszke', 'id': 4583066, 'node_id': 'MDQ6VXNlcjQ1ODMwNjY=', 'avatar_url': 'https://avatars3.githubusercontent.com/u/4583066?v=4', 'gravatar_id': '', 'url': 'https://api.github.com/users/apaszke', 'html_url': 'https://github.com/apaszke', 'followers_url': 'https://api.github.com/users/apaszke/followers', 'following_url': 'https://api.github.com/users/apaszke/following{/other_user}', 'gists_url': 'https://api.github.com/users/apaszke/gists{/gist_id}', 'starred_url': 'https://api.github.com/users/apaszke/starred{/owner}{/repo}', 'subscriptions_url': 'https://api.github.com/users/apaszke/subscriptions', 'organizations_url': 'https://api.github.com/users/apaszke/orgs', 'repos_url': 'https://api.github.com/users/apaszke/repos', 'events_url': 'https://api.github.com/users/apaszke/events{/privacy}', 'received_events_url': 'https://api.github.com/users/apaszke/received_events', 'type': 'User', 'site_admin': False}",referenced,eb530686898d6d5f3a9a596143505d0f1ba6d127,https://api.github.com/repos/pytorch/pytorch/commits/eb530686898d6d5f3a9a596143505d0f1ba6d127,2019-06-22T10:19:18Z,3,1,2
22106,2435745540,"{'login': 'facebook-github-bot', 'id': 6422482, 'node_id': 'MDQ6VXNlcjY0MjI0ODI=', 'avatar_url': 'https://avatars3.githubusercontent.com/u/6422482?v=4', 'gravatar_id': '', 'url': 'https://api.github.com/users/facebook-github-bot', 'html_url': 'https://github.com/facebook-github-bot', 'followers_url': 'https://api.github.com/users/facebook-github-bot/followers', 'following_url': 'https://api.github.com/users/facebook-github-bot/following{/other_user}', 'gists_url': 'https://api.github.com/users/facebook-github-bot/gists{/gist_id}', 'starred_url': 'https://api.github.com/users/facebook-github-bot/starred{/owner}{/repo}', 'subscriptions_url': 'https://api.github.com/users/facebook-github-bot/subscriptions', 'organizations_url': 'https://api.github.com/users/facebook-github-bot/orgs', 'repos_url': 'https://api.github.com/users/facebook-github-bot/repos', 'events_url': 'https://api.github.com/users/facebook-github-bot/events{/privacy}', 'received_events_url': 'https://api.github.com/users/facebook-github-bot/received_events', 'type': 'User', 'site_admin': False}",closed,b2a39314e75b02153d0a1f3bbc98e5f082500d87,https://api.github.com/repos/pytorch/pytorch/commits/b2a39314e75b02153d0a1f3bbc98e5f082500d87,2019-06-24T22:29:47Z,3,1,2
22087,2445559863,"{'login': 'facebook-github-bot', 'id': 6422482, 'node_id': 'MDQ6VXNlcjY0MjI0ODI=', 'avatar_url': 'https://avatars3.githubusercontent.com/u/6422482?v=4', 'gravatar_id': '', 'url': 'https://api.github.com/users/facebook-github-bot', 'html_url': 'https://github.com/facebook-github-bot', 'followers_url': 'https://api.github.com/users/facebook-github-bot/followers', 'following_url': 'https://api.github.com/users/facebook-github-bot/following{/other_user}', 'gists_url': 'https://api.github.com/users/facebook-github-bot/gists{/gist_id}', 'starred_url': 'https://api.github.com/users/facebook-github-bot/starred{/owner}{/repo}', 'subscriptions_url': 'https://api.github.com/users/facebook-github-bot/subscriptions', 'organizations_url': 'https://api.github.com/users/facebook-github-bot/orgs', 'repos_url': 'https://api.github.com/users/facebook-github-bot/repos', 'events_url': 'https://api.github.com/users/facebook-github-bot/events{/privacy}', 'received_events_url': 'https://api.github.com/users/facebook-github-bot/received_events', 'type': 'User', 'site_admin': False}",closed,ac39869370be187046246c7202d37eb958fbd23c,https://api.github.com/repos/pytorch/pytorch/commits/ac39869370be187046246c7202d37eb958fbd23c,2019-06-27T20:58:09Z,14,7,7
22072,2436164957,"{'login': 'facebook-github-bot', 'id': 6422482, 'node_id': 'MDQ6VXNlcjY0MjI0ODI=', 'avatar_url': 'https://avatars3.githubusercontent.com/u/6422482?v=4', 'gravatar_id': '', 'url': 'https://api.github.com/users/facebook-github-bot', 'html_url': 'https://github.com/facebook-github-bot', 'followers_url': 'https://api.github.com/users/facebook-github-bot/followers', 'following_url': 'https://api.github.com/users/facebook-github-bot/following{/other_user}', 'gists_url': 'https://api.github.com/users/facebook-github-bot/gists{/gist_id}', 'starred_url': 'https://api.github.com/users/facebook-github-bot/starred{/owner}{/repo}', 'subscriptions_url': 'https://api.github.com/users/facebook-github-bot/subscriptions', 'organizations_url': 'https://api.github.com/users/facebook-github-bot/orgs', 'repos_url': 'https://api.github.com/users/facebook-github-bot/repos', 'events_url': 'https://api.github.com/users/facebook-github-bot/events{/privacy}', 'received_events_url': 'https://api.github.com/users/facebook-github-bot/received_events', 'type': 'User', 'site_admin': False}",closed,f5df0c9104b0c663db53be50981dd8119707517d,https://api.github.com/repos/pytorch/pytorch/commits/f5df0c9104b0c663db53be50981dd8119707517d,2019-06-25T03:42:11Z,18,13,5
22066,2445707621,"{'login': 'facebook-github-bot', 'id': 6422482, 'node_id': 'MDQ6VXNlcjY0MjI0ODI=', 'avatar_url': 'https://avatars3.githubusercontent.com/u/6422482?v=4', 'gravatar_id': '', 'url': 'https://api.github.com/users/facebook-github-bot', 'html_url': 'https://github.com/facebook-github-bot', 'followers_url': 'https://api.github.com/users/facebook-github-bot/followers', 'following_url': 'https://api.github.com/users/facebook-github-bot/following{/other_user}', 'gists_url': 'https://api.github.com/users/facebook-github-bot/gists{/gist_id}', 'starred_url': 'https://api.github.com/users/facebook-github-bot/starred{/owner}{/repo}', 'subscriptions_url': 'https://api.github.com/users/facebook-github-bot/subscriptions', 'organizations_url': 'https://api.github.com/users/facebook-github-bot/orgs', 'repos_url': 'https://api.github.com/users/facebook-github-bot/repos', 'events_url': 'https://api.github.com/users/facebook-github-bot/events{/privacy}', 'received_events_url': 'https://api.github.com/users/facebook-github-bot/received_events', 'type': 'User', 'site_admin': False}",referenced,83768f0756ed4c142db642923f9c7866ccd7db52,https://api.github.com/repos/pytorch/pytorch/commits/83768f0756ed4c142db642923f9c7866ccd7db52,2019-06-27T22:04:45Z,39,25,14
22053,2435745514,"{'login': 'facebook-github-bot', 'id': 6422482, 'node_id': 'MDQ6VXNlcjY0MjI0ODI=', 'avatar_url': 'https://avatars3.githubusercontent.com/u/6422482?v=4', 'gravatar_id': '', 'url': 'https://api.github.com/users/facebook-github-bot', 'html_url': 'https://github.com/facebook-github-bot', 'followers_url': 'https://api.github.com/users/facebook-github-bot/followers', 'following_url': 'https://api.github.com/users/facebook-github-bot/following{/other_user}', 'gists_url': 'https://api.github.com/users/facebook-github-bot/gists{/gist_id}', 'starred_url': 'https://api.github.com/users/facebook-github-bot/starred{/owner}{/repo}', 'subscriptions_url': 'https://api.github.com/users/facebook-github-bot/subscriptions', 'organizations_url': 'https://api.github.com/users/facebook-github-bot/orgs', 'repos_url': 'https://api.github.com/users/facebook-github-bot/repos', 'events_url': 'https://api.github.com/users/facebook-github-bot/events{/privacy}', 'received_events_url': 'https://api.github.com/users/facebook-github-bot/received_events', 'type': 'User', 'site_admin': False}",closed,273b6c5bae35196d0da279bb2775ebf2aa13b951,https://api.github.com/repos/pytorch/pytorch/commits/273b6c5bae35196d0da279bb2775ebf2aa13b951,2019-06-24T22:29:47Z,2,1,1
22032,2435755155,"{'login': 'facebook-github-bot', 'id': 6422482, 'node_id': 'MDQ6VXNlcjY0MjI0ODI=', 'avatar_url': 'https://avatars3.githubusercontent.com/u/6422482?v=4', 'gravatar_id': '', 'url': 'https://api.github.com/users/facebook-github-bot', 'html_url': 'https://github.com/facebook-github-bot', 'followers_url': 'https://api.github.com/users/facebook-github-bot/followers', 'following_url': 'https://api.github.com/users/facebook-github-bot/following{/other_user}', 'gists_url': 'https://api.github.com/users/facebook-github-bot/gists{/gist_id}', 'starred_url': 'https://api.github.com/users/facebook-github-bot/starred{/owner}{/repo}', 'subscriptions_url': 'https://api.github.com/users/facebook-github-bot/subscriptions', 'organizations_url': 'https://api.github.com/users/facebook-github-bot/orgs', 'repos_url': 'https://api.github.com/users/facebook-github-bot/repos', 'events_url': 'https://api.github.com/users/facebook-github-bot/events{/privacy}', 'received_events_url': 'https://api.github.com/users/facebook-github-bot/received_events', 'type': 'User', 'site_admin': False}",closed,2372e7ed2e7e104b5ad98da74fa7ac3424883c4b,https://api.github.com/repos/pytorch/pytorch/commits/2372e7ed2e7e104b5ad98da74fa7ac3424883c4b,2019-06-24T22:35:31Z,64,28,36
21965,2630781521,"{'login': 'facebook-github-bot', 'id': 6422482, 'node_id': 'MDQ6VXNlcjY0MjI0ODI=', 'avatar_url': 'https://avatars3.githubusercontent.com/u/6422482?v=4', 'gravatar_id': '', 'url': 'https://api.github.com/users/facebook-github-bot', 'html_url': 'https://github.com/facebook-github-bot', 'followers_url': 'https://api.github.com/users/facebook-github-bot/followers', 'following_url': 'https://api.github.com/users/facebook-github-bot/following{/other_user}', 'gists_url': 'https://api.github.com/users/facebook-github-bot/gists{/gist_id}', 'starred_url': 'https://api.github.com/users/facebook-github-bot/starred{/owner}{/repo}', 'subscriptions_url': 'https://api.github.com/users/facebook-github-bot/subscriptions', 'organizations_url': 'https://api.github.com/users/facebook-github-bot/orgs', 'repos_url': 'https://api.github.com/users/facebook-github-bot/repos', 'events_url': 'https://api.github.com/users/facebook-github-bot/events{/privacy}', 'received_events_url': 'https://api.github.com/users/facebook-github-bot/received_events', 'type': 'User', 'site_admin': False}",referenced,135bbc261d55c4ffbbb341af47a9c69215d3f1f0,https://api.github.com/repos/pytorch/pytorch/commits/135bbc261d55c4ffbbb341af47a9c69215d3f1f0,2019-09-12T22:53:15Z,24,24,0
21935,2490768562,"{'login': 'facebook-github-bot', 'id': 6422482, 'node_id': 'MDQ6VXNlcjY0MjI0ODI=', 'avatar_url': 'https://avatars3.githubusercontent.com/u/6422482?v=4', 'gravatar_id': '', 'url': 'https://api.github.com/users/facebook-github-bot', 'html_url': 'https://github.com/facebook-github-bot', 'followers_url': 'https://api.github.com/users/facebook-github-bot/followers', 'following_url': 'https://api.github.com/users/facebook-github-bot/following{/other_user}', 'gists_url': 'https://api.github.com/users/facebook-github-bot/gists{/gist_id}', 'starred_url': 'https://api.github.com/users/facebook-github-bot/starred{/owner}{/repo}', 'subscriptions_url': 'https://api.github.com/users/facebook-github-bot/subscriptions', 'organizations_url': 'https://api.github.com/users/facebook-github-bot/orgs', 'repos_url': 'https://api.github.com/users/facebook-github-bot/repos', 'events_url': 'https://api.github.com/users/facebook-github-bot/events{/privacy}', 'received_events_url': 'https://api.github.com/users/facebook-github-bot/received_events', 'type': 'User', 'site_admin': False}",closed,5adba33c01f460f52ac7eeb1124efb0e48f36ca8,https://api.github.com/repos/pytorch/pytorch/commits/5adba33c01f460f52ac7eeb1124efb0e48f36ca8,2019-07-17T20:26:11Z,98,45,53
21922,2456857203,"{'login': 'facebook-github-bot', 'id': 6422482, 'node_id': 'MDQ6VXNlcjY0MjI0ODI=', 'avatar_url': 'https://avatars3.githubusercontent.com/u/6422482?v=4', 'gravatar_id': '', 'url': 'https://api.github.com/users/facebook-github-bot', 'html_url': 'https://github.com/facebook-github-bot', 'followers_url': 'https://api.github.com/users/facebook-github-bot/followers', 'following_url': 'https://api.github.com/users/facebook-github-bot/following{/other_user}', 'gists_url': 'https://api.github.com/users/facebook-github-bot/gists{/gist_id}', 'starred_url': 'https://api.github.com/users/facebook-github-bot/starred{/owner}{/repo}', 'subscriptions_url': 'https://api.github.com/users/facebook-github-bot/subscriptions', 'organizations_url': 'https://api.github.com/users/facebook-github-bot/orgs', 'repos_url': 'https://api.github.com/users/facebook-github-bot/repos', 'events_url': 'https://api.github.com/users/facebook-github-bot/events{/privacy}', 'received_events_url': 'https://api.github.com/users/facebook-github-bot/received_events', 'type': 'User', 'site_admin': False}",closed,c9f41e9bc0c8296daede62ee936b9b7e32a8b658,https://api.github.com/repos/pytorch/pytorch/commits/c9f41e9bc0c8296daede62ee936b9b7e32a8b658,2019-07-03T09:04:35Z,11,11,0
21857,2435294236,"{'login': 'facebook-github-bot', 'id': 6422482, 'node_id': 'MDQ6VXNlcjY0MjI0ODI=', 'avatar_url': 'https://avatars3.githubusercontent.com/u/6422482?v=4', 'gravatar_id': '', 'url': 'https://api.github.com/users/facebook-github-bot', 'html_url': 'https://github.com/facebook-github-bot', 'followers_url': 'https://api.github.com/users/facebook-github-bot/followers', 'following_url': 'https://api.github.com/users/facebook-github-bot/following{/other_user}', 'gists_url': 'https://api.github.com/users/facebook-github-bot/gists{/gist_id}', 'starred_url': 'https://api.github.com/users/facebook-github-bot/starred{/owner}{/repo}', 'subscriptions_url': 'https://api.github.com/users/facebook-github-bot/subscriptions', 'organizations_url': 'https://api.github.com/users/facebook-github-bot/orgs', 'repos_url': 'https://api.github.com/users/facebook-github-bot/repos', 'events_url': 'https://api.github.com/users/facebook-github-bot/events{/privacy}', 'received_events_url': 'https://api.github.com/users/facebook-github-bot/received_events', 'type': 'User', 'site_admin': False}",closed,2347a4032b160aaddfb8ba526a7e50af778d3cf8,https://api.github.com/repos/pytorch/pytorch/commits/2347a4032b160aaddfb8ba526a7e50af778d3cf8,2019-06-24T19:13:14Z,48,37,11
21850,2437077155,"{'login': 'xkszltl', 'id': 5203025, 'node_id': 'MDQ6VXNlcjUyMDMwMjU=', 'avatar_url': 'https://avatars0.githubusercontent.com/u/5203025?v=4', 'gravatar_id': '', 'url': 'https://api.github.com/users/xkszltl', 'html_url': 'https://github.com/xkszltl', 'followers_url': 'https://api.github.com/users/xkszltl/followers', 'following_url': 'https://api.github.com/users/xkszltl/following{/other_user}', 'gists_url': 'https://api.github.com/users/xkszltl/gists{/gist_id}', 'starred_url': 'https://api.github.com/users/xkszltl/starred{/owner}{/repo}', 'subscriptions_url': 'https://api.github.com/users/xkszltl/subscriptions', 'organizations_url': 'https://api.github.com/users/xkszltl/orgs', 'repos_url': 'https://api.github.com/users/xkszltl/repos', 'events_url': 'https://api.github.com/users/xkszltl/events{/privacy}', 'received_events_url': 'https://api.github.com/users/xkszltl/received_events', 'type': 'User', 'site_admin': False}",referenced,f164c01f9cb4d4d8a4a644f4f2c602a3a3b9891a,https://api.github.com/repos/pytorch/pytorch/commits/f164c01f9cb4d4d8a4a644f4f2c602a3a3b9891a,2019-06-25T10:33:10Z,101,94,7
21832,2416277445,"{'login': 'facebook-github-bot', 'id': 6422482, 'node_id': 'MDQ6VXNlcjY0MjI0ODI=', 'avatar_url': 'https://avatars3.githubusercontent.com/u/6422482?v=4', 'gravatar_id': '', 'url': 'https://api.github.com/users/facebook-github-bot', 'html_url': 'https://github.com/facebook-github-bot', 'followers_url': 'https://api.github.com/users/facebook-github-bot/followers', 'following_url': 'https://api.github.com/users/facebook-github-bot/following{/other_user}', 'gists_url': 'https://api.github.com/users/facebook-github-bot/gists{/gist_id}', 'starred_url': 'https://api.github.com/users/facebook-github-bot/starred{/owner}{/repo}', 'subscriptions_url': 'https://api.github.com/users/facebook-github-bot/subscriptions', 'organizations_url': 'https://api.github.com/users/facebook-github-bot/orgs', 'repos_url': 'https://api.github.com/users/facebook-github-bot/repos', 'events_url': 'https://api.github.com/users/facebook-github-bot/events{/privacy}', 'received_events_url': 'https://api.github.com/users/facebook-github-bot/received_events', 'type': 'User', 'site_admin': False}",closed,c9ba3f699daf086cfc6592fcdc7e813916de479a,https://api.github.com/repos/pytorch/pytorch/commits/c9ba3f699daf086cfc6592fcdc7e813916de479a,2019-06-17T02:38:12Z,25,13,12
21831,2416277436,"{'login': 'facebook-github-bot', 'id': 6422482, 'node_id': 'MDQ6VXNlcjY0MjI0ODI=', 'avatar_url': 'https://avatars3.githubusercontent.com/u/6422482?v=4', 'gravatar_id': '', 'url': 'https://api.github.com/users/facebook-github-bot', 'html_url': 'https://github.com/facebook-github-bot', 'followers_url': 'https://api.github.com/users/facebook-github-bot/followers', 'following_url': 'https://api.github.com/users/facebook-github-bot/following{/other_user}', 'gists_url': 'https://api.github.com/users/facebook-github-bot/gists{/gist_id}', 'starred_url': 'https://api.github.com/users/facebook-github-bot/starred{/owner}{/repo}', 'subscriptions_url': 'https://api.github.com/users/facebook-github-bot/subscriptions', 'organizations_url': 'https://api.github.com/users/facebook-github-bot/orgs', 'repos_url': 'https://api.github.com/users/facebook-github-bot/repos', 'events_url': 'https://api.github.com/users/facebook-github-bot/events{/privacy}', 'received_events_url': 'https://api.github.com/users/facebook-github-bot/received_events', 'type': 'User', 'site_admin': False}",closed,c9ba3f699daf086cfc6592fcdc7e813916de479a,https://api.github.com/repos/pytorch/pytorch/commits/c9ba3f699daf086cfc6592fcdc7e813916de479a,2019-06-17T02:38:11Z,25,13,12
21830,2416277433,"{'login': 'facebook-github-bot', 'id': 6422482, 'node_id': 'MDQ6VXNlcjY0MjI0ODI=', 'avatar_url': 'https://avatars3.githubusercontent.com/u/6422482?v=4', 'gravatar_id': '', 'url': 'https://api.github.com/users/facebook-github-bot', 'html_url': 'https://github.com/facebook-github-bot', 'followers_url': 'https://api.github.com/users/facebook-github-bot/followers', 'following_url': 'https://api.github.com/users/facebook-github-bot/following{/other_user}', 'gists_url': 'https://api.github.com/users/facebook-github-bot/gists{/gist_id}', 'starred_url': 'https://api.github.com/users/facebook-github-bot/starred{/owner}{/repo}', 'subscriptions_url': 'https://api.github.com/users/facebook-github-bot/subscriptions', 'organizations_url': 'https://api.github.com/users/facebook-github-bot/orgs', 'repos_url': 'https://api.github.com/users/facebook-github-bot/repos', 'events_url': 'https://api.github.com/users/facebook-github-bot/events{/privacy}', 'received_events_url': 'https://api.github.com/users/facebook-github-bot/received_events', 'type': 'User', 'site_admin': False}",closed,c9ba3f699daf086cfc6592fcdc7e813916de479a,https://api.github.com/repos/pytorch/pytorch/commits/c9ba3f699daf086cfc6592fcdc7e813916de479a,2019-06-17T02:38:11Z,25,13,12
21827,2416277447,"{'login': 'facebook-github-bot', 'id': 6422482, 'node_id': 'MDQ6VXNlcjY0MjI0ODI=', 'avatar_url': 'https://avatars3.githubusercontent.com/u/6422482?v=4', 'gravatar_id': '', 'url': 'https://api.github.com/users/facebook-github-bot', 'html_url': 'https://github.com/facebook-github-bot', 'followers_url': 'https://api.github.com/users/facebook-github-bot/followers', 'following_url': 'https://api.github.com/users/facebook-github-bot/following{/other_user}', 'gists_url': 'https://api.github.com/users/facebook-github-bot/gists{/gist_id}', 'starred_url': 'https://api.github.com/users/facebook-github-bot/starred{/owner}{/repo}', 'subscriptions_url': 'https://api.github.com/users/facebook-github-bot/subscriptions', 'organizations_url': 'https://api.github.com/users/facebook-github-bot/orgs', 'repos_url': 'https://api.github.com/users/facebook-github-bot/repos', 'events_url': 'https://api.github.com/users/facebook-github-bot/events{/privacy}', 'received_events_url': 'https://api.github.com/users/facebook-github-bot/received_events', 'type': 'User', 'site_admin': False}",closed,c9ba3f699daf086cfc6592fcdc7e813916de479a,https://api.github.com/repos/pytorch/pytorch/commits/c9ba3f699daf086cfc6592fcdc7e813916de479a,2019-06-17T02:38:12Z,25,13,12
21822,2416277449,"{'login': 'facebook-github-bot', 'id': 6422482, 'node_id': 'MDQ6VXNlcjY0MjI0ODI=', 'avatar_url': 'https://avatars3.githubusercontent.com/u/6422482?v=4', 'gravatar_id': '', 'url': 'https://api.github.com/users/facebook-github-bot', 'html_url': 'https://github.com/facebook-github-bot', 'followers_url': 'https://api.github.com/users/facebook-github-bot/followers', 'following_url': 'https://api.github.com/users/facebook-github-bot/following{/other_user}', 'gists_url': 'https://api.github.com/users/facebook-github-bot/gists{/gist_id}', 'starred_url': 'https://api.github.com/users/facebook-github-bot/starred{/owner}{/repo}', 'subscriptions_url': 'https://api.github.com/users/facebook-github-bot/subscriptions', 'organizations_url': 'https://api.github.com/users/facebook-github-bot/orgs', 'repos_url': 'https://api.github.com/users/facebook-github-bot/repos', 'events_url': 'https://api.github.com/users/facebook-github-bot/events{/privacy}', 'received_events_url': 'https://api.github.com/users/facebook-github-bot/received_events', 'type': 'User', 'site_admin': False}",closed,c9ba3f699daf086cfc6592fcdc7e813916de479a,https://api.github.com/repos/pytorch/pytorch/commits/c9ba3f699daf086cfc6592fcdc7e813916de479a,2019-06-17T02:38:12Z,25,13,12
21820,2416277451,"{'login': 'facebook-github-bot', 'id': 6422482, 'node_id': 'MDQ6VXNlcjY0MjI0ODI=', 'avatar_url': 'https://avatars3.githubusercontent.com/u/6422482?v=4', 'gravatar_id': '', 'url': 'https://api.github.com/users/facebook-github-bot', 'html_url': 'https://github.com/facebook-github-bot', 'followers_url': 'https://api.github.com/users/facebook-github-bot/followers', 'following_url': 'https://api.github.com/users/facebook-github-bot/following{/other_user}', 'gists_url': 'https://api.github.com/users/facebook-github-bot/gists{/gist_id}', 'starred_url': 'https://api.github.com/users/facebook-github-bot/starred{/owner}{/repo}', 'subscriptions_url': 'https://api.github.com/users/facebook-github-bot/subscriptions', 'organizations_url': 'https://api.github.com/users/facebook-github-bot/orgs', 'repos_url': 'https://api.github.com/users/facebook-github-bot/repos', 'events_url': 'https://api.github.com/users/facebook-github-bot/events{/privacy}', 'received_events_url': 'https://api.github.com/users/facebook-github-bot/received_events', 'type': 'User', 'site_admin': False}",closed,c9ba3f699daf086cfc6592fcdc7e813916de479a,https://api.github.com/repos/pytorch/pytorch/commits/c9ba3f699daf086cfc6592fcdc7e813916de479a,2019-06-17T02:38:12Z,25,13,12
21817,2594278568,"{'login': 'facebook-github-bot', 'id': 6422482, 'node_id': 'MDQ6VXNlcjY0MjI0ODI=', 'avatar_url': 'https://avatars3.githubusercontent.com/u/6422482?v=4', 'gravatar_id': '', 'url': 'https://api.github.com/users/facebook-github-bot', 'html_url': 'https://github.com/facebook-github-bot', 'followers_url': 'https://api.github.com/users/facebook-github-bot/followers', 'following_url': 'https://api.github.com/users/facebook-github-bot/following{/other_user}', 'gists_url': 'https://api.github.com/users/facebook-github-bot/gists{/gist_id}', 'starred_url': 'https://api.github.com/users/facebook-github-bot/starred{/owner}{/repo}', 'subscriptions_url': 'https://api.github.com/users/facebook-github-bot/subscriptions', 'organizations_url': 'https://api.github.com/users/facebook-github-bot/orgs', 'repos_url': 'https://api.github.com/users/facebook-github-bot/repos', 'events_url': 'https://api.github.com/users/facebook-github-bot/events{/privacy}', 'received_events_url': 'https://api.github.com/users/facebook-github-bot/received_events', 'type': 'User', 'site_admin': False}",closed,8145dd35ef316ebd82b782f439701a48952cbfb8,https://api.github.com/repos/pytorch/pytorch/commits/8145dd35ef316ebd82b782f439701a48952cbfb8,2019-08-29T14:48:36Z,52,52,0
21798,2456062374,"{'login': 'facebook-github-bot', 'id': 6422482, 'node_id': 'MDQ6VXNlcjY0MjI0ODI=', 'avatar_url': 'https://avatars3.githubusercontent.com/u/6422482?v=4', 'gravatar_id': '', 'url': 'https://api.github.com/users/facebook-github-bot', 'html_url': 'https://github.com/facebook-github-bot', 'followers_url': 'https://api.github.com/users/facebook-github-bot/followers', 'following_url': 'https://api.github.com/users/facebook-github-bot/following{/other_user}', 'gists_url': 'https://api.github.com/users/facebook-github-bot/gists{/gist_id}', 'starred_url': 'https://api.github.com/users/facebook-github-bot/starred{/owner}{/repo}', 'subscriptions_url': 'https://api.github.com/users/facebook-github-bot/subscriptions', 'organizations_url': 'https://api.github.com/users/facebook-github-bot/orgs', 'repos_url': 'https://api.github.com/users/facebook-github-bot/repos', 'events_url': 'https://api.github.com/users/facebook-github-bot/events{/privacy}', 'received_events_url': 'https://api.github.com/users/facebook-github-bot/received_events', 'type': 'User', 'site_admin': False}",referenced,e210c6509742c04b5a9e0dc9802e6a8b0a29fcd4,https://api.github.com/repos/pytorch/pytorch/commits/e210c6509742c04b5a9e0dc9802e6a8b0a29fcd4,2019-07-03T01:20:40Z,20,18,2
21796,2476530434,"{'login': 'facebook-github-bot', 'id': 6422482, 'node_id': 'MDQ6VXNlcjY0MjI0ODI=', 'avatar_url': 'https://avatars3.githubusercontent.com/u/6422482?v=4', 'gravatar_id': '', 'url': 'https://api.github.com/users/facebook-github-bot', 'html_url': 'https://github.com/facebook-github-bot', 'followers_url': 'https://api.github.com/users/facebook-github-bot/followers', 'following_url': 'https://api.github.com/users/facebook-github-bot/following{/other_user}', 'gists_url': 'https://api.github.com/users/facebook-github-bot/gists{/gist_id}', 'starred_url': 'https://api.github.com/users/facebook-github-bot/starred{/owner}{/repo}', 'subscriptions_url': 'https://api.github.com/users/facebook-github-bot/subscriptions', 'organizations_url': 'https://api.github.com/users/facebook-github-bot/orgs', 'repos_url': 'https://api.github.com/users/facebook-github-bot/repos', 'events_url': 'https://api.github.com/users/facebook-github-bot/events{/privacy}', 'received_events_url': 'https://api.github.com/users/facebook-github-bot/received_events', 'type': 'User', 'site_admin': False}",closed,45cf33a731598df01d83f71cf69913a3419bcd4f,https://api.github.com/repos/pytorch/pytorch/commits/45cf33a731598df01d83f71cf69913a3419bcd4f,2019-07-11T16:23:27Z,139,139,0
21796,2477340667,"{'login': 'izdeby', 'id': 47012416, 'node_id': 'MDQ6VXNlcjQ3MDEyNDE2', 'avatar_url': 'https://avatars0.githubusercontent.com/u/47012416?v=4', 'gravatar_id': '', 'url': 'https://api.github.com/users/izdeby', 'html_url': 'https://github.com/izdeby', 'followers_url': 'https://api.github.com/users/izdeby/followers', 'following_url': 'https://api.github.com/users/izdeby/following{/other_user}', 'gists_url': 'https://api.github.com/users/izdeby/gists{/gist_id}', 'starred_url': 'https://api.github.com/users/izdeby/starred{/owner}{/repo}', 'subscriptions_url': 'https://api.github.com/users/izdeby/subscriptions', 'organizations_url': 'https://api.github.com/users/izdeby/orgs', 'repos_url': 'https://api.github.com/users/izdeby/repos', 'events_url': 'https://api.github.com/users/izdeby/events{/privacy}', 'received_events_url': 'https://api.github.com/users/izdeby/received_events', 'type': 'User', 'site_admin': False}",referenced,0924d8d36b035f218b68c25bc0618e7ff2b5f540,https://api.github.com/repos/pytorch/pytorch/commits/0924d8d36b035f218b68c25bc0618e7ff2b5f540,2019-07-11T21:40:18Z,698,596,102
21761,2426155255,"{'login': 'facebook-github-bot', 'id': 6422482, 'node_id': 'MDQ6VXNlcjY0MjI0ODI=', 'avatar_url': 'https://avatars3.githubusercontent.com/u/6422482?v=4', 'gravatar_id': '', 'url': 'https://api.github.com/users/facebook-github-bot', 'html_url': 'https://github.com/facebook-github-bot', 'followers_url': 'https://api.github.com/users/facebook-github-bot/followers', 'following_url': 'https://api.github.com/users/facebook-github-bot/following{/other_user}', 'gists_url': 'https://api.github.com/users/facebook-github-bot/gists{/gist_id}', 'starred_url': 'https://api.github.com/users/facebook-github-bot/starred{/owner}{/repo}', 'subscriptions_url': 'https://api.github.com/users/facebook-github-bot/subscriptions', 'organizations_url': 'https://api.github.com/users/facebook-github-bot/orgs', 'repos_url': 'https://api.github.com/users/facebook-github-bot/repos', 'events_url': 'https://api.github.com/users/facebook-github-bot/events{/privacy}', 'received_events_url': 'https://api.github.com/users/facebook-github-bot/received_events', 'type': 'User', 'site_admin': False}",closed,5d67c606ea7d0d4da7005d00570c8eb18333e058,https://api.github.com/repos/pytorch/pytorch/commits/5d67c606ea7d0d4da7005d00570c8eb18333e058,2019-06-20T04:36:11Z,4,4,0
21743,2663280429,"{'login': 'facebook-github-bot', 'id': 6422482, 'node_id': 'MDQ6VXNlcjY0MjI0ODI=', 'avatar_url': 'https://avatars3.githubusercontent.com/u/6422482?v=4', 'gravatar_id': '', 'url': 'https://api.github.com/users/facebook-github-bot', 'html_url': 'https://github.com/facebook-github-bot', 'followers_url': 'https://api.github.com/users/facebook-github-bot/followers', 'following_url': 'https://api.github.com/users/facebook-github-bot/following{/other_user}', 'gists_url': 'https://api.github.com/users/facebook-github-bot/gists{/gist_id}', 'starred_url': 'https://api.github.com/users/facebook-github-bot/starred{/owner}{/repo}', 'subscriptions_url': 'https://api.github.com/users/facebook-github-bot/subscriptions', 'organizations_url': 'https://api.github.com/users/facebook-github-bot/orgs', 'repos_url': 'https://api.github.com/users/facebook-github-bot/repos', 'events_url': 'https://api.github.com/users/facebook-github-bot/events{/privacy}', 'received_events_url': 'https://api.github.com/users/facebook-github-bot/received_events', 'type': 'User', 'site_admin': False}",referenced,5fc52482cf7984f10185bc35d6bc06924dbc13bd,https://api.github.com/repos/pytorch/pytorch/commits/5fc52482cf7984f10185bc35d6bc06924dbc13bd,2019-09-25T21:59:13Z,34,25,9
21730,2605024240,"{'login': 'facebook-github-bot', 'id': 6422482, 'node_id': 'MDQ6VXNlcjY0MjI0ODI=', 'avatar_url': 'https://avatars3.githubusercontent.com/u/6422482?v=4', 'gravatar_id': '', 'url': 'https://api.github.com/users/facebook-github-bot', 'html_url': 'https://github.com/facebook-github-bot', 'followers_url': 'https://api.github.com/users/facebook-github-bot/followers', 'following_url': 'https://api.github.com/users/facebook-github-bot/following{/other_user}', 'gists_url': 'https://api.github.com/users/facebook-github-bot/gists{/gist_id}', 'starred_url': 'https://api.github.com/users/facebook-github-bot/starred{/owner}{/repo}', 'subscriptions_url': 'https://api.github.com/users/facebook-github-bot/subscriptions', 'organizations_url': 'https://api.github.com/users/facebook-github-bot/orgs', 'repos_url': 'https://api.github.com/users/facebook-github-bot/repos', 'events_url': 'https://api.github.com/users/facebook-github-bot/events{/privacy}', 'received_events_url': 'https://api.github.com/users/facebook-github-bot/received_events', 'type': 'User', 'site_admin': False}",referenced,896cd1c51071a13a465e3c54ef7c49abf4f1d0c0,https://api.github.com/repos/pytorch/pytorch/commits/896cd1c51071a13a465e3c54ef7c49abf4f1d0c0,2019-09-03T21:16:18Z,38,38,0
21710,2431474161,"{'login': 'facebook-github-bot', 'id': 6422482, 'node_id': 'MDQ6VXNlcjY0MjI0ODI=', 'avatar_url': 'https://avatars3.githubusercontent.com/u/6422482?v=4', 'gravatar_id': '', 'url': 'https://api.github.com/users/facebook-github-bot', 'html_url': 'https://github.com/facebook-github-bot', 'followers_url': 'https://api.github.com/users/facebook-github-bot/followers', 'following_url': 'https://api.github.com/users/facebook-github-bot/following{/other_user}', 'gists_url': 'https://api.github.com/users/facebook-github-bot/gists{/gist_id}', 'starred_url': 'https://api.github.com/users/facebook-github-bot/starred{/owner}{/repo}', 'subscriptions_url': 'https://api.github.com/users/facebook-github-bot/subscriptions', 'organizations_url': 'https://api.github.com/users/facebook-github-bot/orgs', 'repos_url': 'https://api.github.com/users/facebook-github-bot/repos', 'events_url': 'https://api.github.com/users/facebook-github-bot/events{/privacy}', 'received_events_url': 'https://api.github.com/users/facebook-github-bot/received_events', 'type': 'User', 'site_admin': False}",closed,1c5fe2e8c4105ffd1672c828d4b67b29802d6594,https://api.github.com/repos/pytorch/pytorch/commits/1c5fe2e8c4105ffd1672c828d4b67b29802d6594,2019-06-21T21:24:40Z,22,19,3
21706,2441106172,"{'login': 'facebook-github-bot', 'id': 6422482, 'node_id': 'MDQ6VXNlcjY0MjI0ODI=', 'avatar_url': 'https://avatars3.githubusercontent.com/u/6422482?v=4', 'gravatar_id': '', 'url': 'https://api.github.com/users/facebook-github-bot', 'html_url': 'https://github.com/facebook-github-bot', 'followers_url': 'https://api.github.com/users/facebook-github-bot/followers', 'following_url': 'https://api.github.com/users/facebook-github-bot/following{/other_user}', 'gists_url': 'https://api.github.com/users/facebook-github-bot/gists{/gist_id}', 'starred_url': 'https://api.github.com/users/facebook-github-bot/starred{/owner}{/repo}', 'subscriptions_url': 'https://api.github.com/users/facebook-github-bot/subscriptions', 'organizations_url': 'https://api.github.com/users/facebook-github-bot/orgs', 'repos_url': 'https://api.github.com/users/facebook-github-bot/repos', 'events_url': 'https://api.github.com/users/facebook-github-bot/events{/privacy}', 'received_events_url': 'https://api.github.com/users/facebook-github-bot/received_events', 'type': 'User', 'site_admin': False}",closed,95b57180078d9decf47180cdf963b1341fe74614,https://api.github.com/repos/pytorch/pytorch/commits/95b57180078d9decf47180cdf963b1341fe74614,2019-06-26T14:32:03Z,2,1,1
21703,2598278933,"{'login': 'facebook-github-bot', 'id': 6422482, 'node_id': 'MDQ6VXNlcjY0MjI0ODI=', 'avatar_url': 'https://avatars3.githubusercontent.com/u/6422482?v=4', 'gravatar_id': '', 'url': 'https://api.github.com/users/facebook-github-bot', 'html_url': 'https://github.com/facebook-github-bot', 'followers_url': 'https://api.github.com/users/facebook-github-bot/followers', 'following_url': 'https://api.github.com/users/facebook-github-bot/following{/other_user}', 'gists_url': 'https://api.github.com/users/facebook-github-bot/gists{/gist_id}', 'starred_url': 'https://api.github.com/users/facebook-github-bot/starred{/owner}{/repo}', 'subscriptions_url': 'https://api.github.com/users/facebook-github-bot/subscriptions', 'organizations_url': 'https://api.github.com/users/facebook-github-bot/orgs', 'repos_url': 'https://api.github.com/users/facebook-github-bot/repos', 'events_url': 'https://api.github.com/users/facebook-github-bot/events{/privacy}', 'received_events_url': 'https://api.github.com/users/facebook-github-bot/received_events', 'type': 'User', 'site_admin': False}",closed,03f67e4b162f1d92808397d772214c44c8597475,https://api.github.com/repos/pytorch/pytorch/commits/03f67e4b162f1d92808397d772214c44c8597475,2019-08-30T20:44:51Z,186,79,107
21680,2493131513,"{'login': 'facebook-github-bot', 'id': 6422482, 'node_id': 'MDQ6VXNlcjY0MjI0ODI=', 'avatar_url': 'https://avatars3.githubusercontent.com/u/6422482?v=4', 'gravatar_id': '', 'url': 'https://api.github.com/users/facebook-github-bot', 'html_url': 'https://github.com/facebook-github-bot', 'followers_url': 'https://api.github.com/users/facebook-github-bot/followers', 'following_url': 'https://api.github.com/users/facebook-github-bot/following{/other_user}', 'gists_url': 'https://api.github.com/users/facebook-github-bot/gists{/gist_id}', 'starred_url': 'https://api.github.com/users/facebook-github-bot/starred{/owner}{/repo}', 'subscriptions_url': 'https://api.github.com/users/facebook-github-bot/subscriptions', 'organizations_url': 'https://api.github.com/users/facebook-github-bot/orgs', 'repos_url': 'https://api.github.com/users/facebook-github-bot/repos', 'events_url': 'https://api.github.com/users/facebook-github-bot/events{/privacy}', 'received_events_url': 'https://api.github.com/users/facebook-github-bot/received_events', 'type': 'User', 'site_admin': False}",referenced,0c091380cc03b23e68dde7368f3b910c21deb010,https://api.github.com/repos/pytorch/pytorch/commits/0c091380cc03b23e68dde7368f3b910c21deb010,2019-07-18T15:31:24Z,4,3,1
21644,2413888515,"{'login': 'facebook-github-bot', 'id': 6422482, 'node_id': 'MDQ6VXNlcjY0MjI0ODI=', 'avatar_url': 'https://avatars3.githubusercontent.com/u/6422482?v=4', 'gravatar_id': '', 'url': 'https://api.github.com/users/facebook-github-bot', 'html_url': 'https://github.com/facebook-github-bot', 'followers_url': 'https://api.github.com/users/facebook-github-bot/followers', 'following_url': 'https://api.github.com/users/facebook-github-bot/following{/other_user}', 'gists_url': 'https://api.github.com/users/facebook-github-bot/gists{/gist_id}', 'starred_url': 'https://api.github.com/users/facebook-github-bot/starred{/owner}{/repo}', 'subscriptions_url': 'https://api.github.com/users/facebook-github-bot/subscriptions', 'organizations_url': 'https://api.github.com/users/facebook-github-bot/orgs', 'repos_url': 'https://api.github.com/users/facebook-github-bot/repos', 'events_url': 'https://api.github.com/users/facebook-github-bot/events{/privacy}', 'received_events_url': 'https://api.github.com/users/facebook-github-bot/received_events', 'type': 'User', 'site_admin': False}",referenced,2d5ce519f2175e7194be364f864750681c5866aa,https://api.github.com/repos/pytorch/pytorch/commits/2d5ce519f2175e7194be364f864750681c5866aa,2019-06-14T14:37:55Z,71,56,15
21640,2591431612,"{'login': 'facebook-github-bot', 'id': 6422482, 'node_id': 'MDQ6VXNlcjY0MjI0ODI=', 'avatar_url': 'https://avatars3.githubusercontent.com/u/6422482?v=4', 'gravatar_id': '', 'url': 'https://api.github.com/users/facebook-github-bot', 'html_url': 'https://github.com/facebook-github-bot', 'followers_url': 'https://api.github.com/users/facebook-github-bot/followers', 'following_url': 'https://api.github.com/users/facebook-github-bot/following{/other_user}', 'gists_url': 'https://api.github.com/users/facebook-github-bot/gists{/gist_id}', 'starred_url': 'https://api.github.com/users/facebook-github-bot/starred{/owner}{/repo}', 'subscriptions_url': 'https://api.github.com/users/facebook-github-bot/subscriptions', 'organizations_url': 'https://api.github.com/users/facebook-github-bot/orgs', 'repos_url': 'https://api.github.com/users/facebook-github-bot/repos', 'events_url': 'https://api.github.com/users/facebook-github-bot/events{/privacy}', 'received_events_url': 'https://api.github.com/users/facebook-github-bot/received_events', 'type': 'User', 'site_admin': False}",referenced,590619ab8c2d237d4e0b55c8cc3552932afe7da5,https://api.github.com/repos/pytorch/pytorch/commits/590619ab8c2d237d4e0b55c8cc3552932afe7da5,2019-08-28T17:57:48Z,497,497,0
21584,2402154390,"{'login': 'facebook-github-bot', 'id': 6422482, 'node_id': 'MDQ6VXNlcjY0MjI0ODI=', 'avatar_url': 'https://avatars3.githubusercontent.com/u/6422482?v=4', 'gravatar_id': '', 'url': 'https://api.github.com/users/facebook-github-bot', 'html_url': 'https://github.com/facebook-github-bot', 'followers_url': 'https://api.github.com/users/facebook-github-bot/followers', 'following_url': 'https://api.github.com/users/facebook-github-bot/following{/other_user}', 'gists_url': 'https://api.github.com/users/facebook-github-bot/gists{/gist_id}', 'starred_url': 'https://api.github.com/users/facebook-github-bot/starred{/owner}{/repo}', 'subscriptions_url': 'https://api.github.com/users/facebook-github-bot/subscriptions', 'organizations_url': 'https://api.github.com/users/facebook-github-bot/orgs', 'repos_url': 'https://api.github.com/users/facebook-github-bot/repos', 'events_url': 'https://api.github.com/users/facebook-github-bot/events{/privacy}', 'received_events_url': 'https://api.github.com/users/facebook-github-bot/received_events', 'type': 'User', 'site_admin': False}",closed,5f25a252d6847db951aecbeb0000c53821fb7b63,https://api.github.com/repos/pytorch/pytorch/commits/5f25a252d6847db951aecbeb0000c53821fb7b63,2019-06-10T20:39:42Z,3,0,3
21579,2428416020,"{'login': 'facebook-github-bot', 'id': 6422482, 'node_id': 'MDQ6VXNlcjY0MjI0ODI=', 'avatar_url': 'https://avatars3.githubusercontent.com/u/6422482?v=4', 'gravatar_id': '', 'url': 'https://api.github.com/users/facebook-github-bot', 'html_url': 'https://github.com/facebook-github-bot', 'followers_url': 'https://api.github.com/users/facebook-github-bot/followers', 'following_url': 'https://api.github.com/users/facebook-github-bot/following{/other_user}', 'gists_url': 'https://api.github.com/users/facebook-github-bot/gists{/gist_id}', 'starred_url': 'https://api.github.com/users/facebook-github-bot/starred{/owner}{/repo}', 'subscriptions_url': 'https://api.github.com/users/facebook-github-bot/subscriptions', 'organizations_url': 'https://api.github.com/users/facebook-github-bot/orgs', 'repos_url': 'https://api.github.com/users/facebook-github-bot/repos', 'events_url': 'https://api.github.com/users/facebook-github-bot/events{/privacy}', 'received_events_url': 'https://api.github.com/users/facebook-github-bot/received_events', 'type': 'User', 'site_admin': False}",referenced,4cd7d787188a5643a2380e0435fa9f6c0307686f,https://api.github.com/repos/pytorch/pytorch/commits/4cd7d787188a5643a2380e0435fa9f6c0307686f,2019-06-20T19:38:34Z,2,1,1
21545,2801240122,"{'login': 'facebook-github-bot', 'id': 6422482, 'node_id': 'MDQ6VXNlcjY0MjI0ODI=', 'avatar_url': 'https://avatars3.githubusercontent.com/u/6422482?v=4', 'gravatar_id': '', 'url': 'https://api.github.com/users/facebook-github-bot', 'html_url': 'https://github.com/facebook-github-bot', 'followers_url': 'https://api.github.com/users/facebook-github-bot/followers', 'following_url': 'https://api.github.com/users/facebook-github-bot/following{/other_user}', 'gists_url': 'https://api.github.com/users/facebook-github-bot/gists{/gist_id}', 'starred_url': 'https://api.github.com/users/facebook-github-bot/starred{/owner}{/repo}', 'subscriptions_url': 'https://api.github.com/users/facebook-github-bot/subscriptions', 'organizations_url': 'https://api.github.com/users/facebook-github-bot/orgs', 'repos_url': 'https://api.github.com/users/facebook-github-bot/repos', 'events_url': 'https://api.github.com/users/facebook-github-bot/events{/privacy}', 'received_events_url': 'https://api.github.com/users/facebook-github-bot/received_events', 'type': 'User', 'site_admin': False}",referenced,902c1f9ef1c3fd4e8a7d2880b4bb44d83a75d740,https://api.github.com/repos/pytorch/pytorch/commits/902c1f9ef1c3fd4e8a7d2880b4bb44d83a75d740,2019-11-15T02:29:11Z,44,44,0
21526,2399651639,"{'login': 'facebook-github-bot', 'id': 6422482, 'node_id': 'MDQ6VXNlcjY0MjI0ODI=', 'avatar_url': 'https://avatars3.githubusercontent.com/u/6422482?v=4', 'gravatar_id': '', 'url': 'https://api.github.com/users/facebook-github-bot', 'html_url': 'https://github.com/facebook-github-bot', 'followers_url': 'https://api.github.com/users/facebook-github-bot/followers', 'following_url': 'https://api.github.com/users/facebook-github-bot/following{/other_user}', 'gists_url': 'https://api.github.com/users/facebook-github-bot/gists{/gist_id}', 'starred_url': 'https://api.github.com/users/facebook-github-bot/starred{/owner}{/repo}', 'subscriptions_url': 'https://api.github.com/users/facebook-github-bot/subscriptions', 'organizations_url': 'https://api.github.com/users/facebook-github-bot/orgs', 'repos_url': 'https://api.github.com/users/facebook-github-bot/repos', 'events_url': 'https://api.github.com/users/facebook-github-bot/events{/privacy}', 'received_events_url': 'https://api.github.com/users/facebook-github-bot/received_events', 'type': 'User', 'site_admin': False}",referenced,74828be4a7d0d2dba3f0ec3f6e79265cdfae5329,https://api.github.com/repos/pytorch/pytorch/commits/74828be4a7d0d2dba3f0ec3f6e79265cdfae5329,2019-06-09T22:31:23Z,12,11,1
21508,2401922748,"{'login': 'facebook-github-bot', 'id': 6422482, 'node_id': 'MDQ6VXNlcjY0MjI0ODI=', 'avatar_url': 'https://avatars3.githubusercontent.com/u/6422482?v=4', 'gravatar_id': '', 'url': 'https://api.github.com/users/facebook-github-bot', 'html_url': 'https://github.com/facebook-github-bot', 'followers_url': 'https://api.github.com/users/facebook-github-bot/followers', 'following_url': 'https://api.github.com/users/facebook-github-bot/following{/other_user}', 'gists_url': 'https://api.github.com/users/facebook-github-bot/gists{/gist_id}', 'starred_url': 'https://api.github.com/users/facebook-github-bot/starred{/owner}{/repo}', 'subscriptions_url': 'https://api.github.com/users/facebook-github-bot/subscriptions', 'organizations_url': 'https://api.github.com/users/facebook-github-bot/orgs', 'repos_url': 'https://api.github.com/users/facebook-github-bot/repos', 'events_url': 'https://api.github.com/users/facebook-github-bot/events{/privacy}', 'received_events_url': 'https://api.github.com/users/facebook-github-bot/received_events', 'type': 'User', 'site_admin': False}",closed,bb1dbdb99bb56c49a585c496efe12c6d5115d04f,https://api.github.com/repos/pytorch/pytorch/commits/bb1dbdb99bb56c49a585c496efe12c6d5115d04f,2019-06-10T19:08:38Z,65,50,15
21508,2405657445,"{'login': 'facebook-github-bot', 'id': 6422482, 'node_id': 'MDQ6VXNlcjY0MjI0ODI=', 'avatar_url': 'https://avatars3.githubusercontent.com/u/6422482?v=4', 'gravatar_id': '', 'url': 'https://api.github.com/users/facebook-github-bot', 'html_url': 'https://github.com/facebook-github-bot', 'followers_url': 'https://api.github.com/users/facebook-github-bot/followers', 'following_url': 'https://api.github.com/users/facebook-github-bot/following{/other_user}', 'gists_url': 'https://api.github.com/users/facebook-github-bot/gists{/gist_id}', 'starred_url': 'https://api.github.com/users/facebook-github-bot/starred{/owner}{/repo}', 'subscriptions_url': 'https://api.github.com/users/facebook-github-bot/subscriptions', 'organizations_url': 'https://api.github.com/users/facebook-github-bot/orgs', 'repos_url': 'https://api.github.com/users/facebook-github-bot/repos', 'events_url': 'https://api.github.com/users/facebook-github-bot/events{/privacy}', 'received_events_url': 'https://api.github.com/users/facebook-github-bot/received_events', 'type': 'User', 'site_admin': False}",closed,9737b166a4788ff57c24c1e59651453dc701d161,https://api.github.com/repos/pytorch/pytorch/commits/9737b166a4788ff57c24c1e59651453dc701d161,2019-06-11T22:21:08Z,66,51,15
21469,2421489843,"{'login': 'vincentqb', 'id': 3047868, 'node_id': 'MDQ6VXNlcjMwNDc4Njg=', 'avatar_url': 'https://avatars0.githubusercontent.com/u/3047868?v=4', 'gravatar_id': '', 'url': 'https://api.github.com/users/vincentqb', 'html_url': 'https://github.com/vincentqb', 'followers_url': 'https://api.github.com/users/vincentqb/followers', 'following_url': 'https://api.github.com/users/vincentqb/following{/other_user}', 'gists_url': 'https://api.github.com/users/vincentqb/gists{/gist_id}', 'starred_url': 'https://api.github.com/users/vincentqb/starred{/owner}{/repo}', 'subscriptions_url': 'https://api.github.com/users/vincentqb/subscriptions', 'organizations_url': 'https://api.github.com/users/vincentqb/orgs', 'repos_url': 'https://api.github.com/users/vincentqb/repos', 'events_url': 'https://api.github.com/users/vincentqb/events{/privacy}', 'received_events_url': 'https://api.github.com/users/vincentqb/received_events', 'type': 'User', 'site_admin': False}",referenced,0998a32588a51f204d9b325ec265312420c73070,https://api.github.com/repos/pytorch/pytorch/commits/0998a32588a51f204d9b325ec265312420c73070,2019-06-18T16:22:18Z,36,36,0
21418,2392708926,"{'login': 'facebook-github-bot', 'id': 6422482, 'node_id': 'MDQ6VXNlcjY0MjI0ODI=', 'avatar_url': 'https://avatars3.githubusercontent.com/u/6422482?v=4', 'gravatar_id': '', 'url': 'https://api.github.com/users/facebook-github-bot', 'html_url': 'https://github.com/facebook-github-bot', 'followers_url': 'https://api.github.com/users/facebook-github-bot/followers', 'following_url': 'https://api.github.com/users/facebook-github-bot/following{/other_user}', 'gists_url': 'https://api.github.com/users/facebook-github-bot/gists{/gist_id}', 'starred_url': 'https://api.github.com/users/facebook-github-bot/starred{/owner}{/repo}', 'subscriptions_url': 'https://api.github.com/users/facebook-github-bot/subscriptions', 'organizations_url': 'https://api.github.com/users/facebook-github-bot/orgs', 'repos_url': 'https://api.github.com/users/facebook-github-bot/repos', 'events_url': 'https://api.github.com/users/facebook-github-bot/events{/privacy}', 'received_events_url': 'https://api.github.com/users/facebook-github-bot/received_events', 'type': 'User', 'site_admin': False}",closed,6b9f46b2d0eca208386886c9cc9c76ed351533fb,https://api.github.com/repos/pytorch/pytorch/commits/6b9f46b2d0eca208386886c9cc9c76ed351533fb,2019-06-05T22:33:27Z,32,26,6
21406,2518569092,"{'login': 'facebook-github-bot', 'id': 6422482, 'node_id': 'MDQ6VXNlcjY0MjI0ODI=', 'avatar_url': 'https://avatars3.githubusercontent.com/u/6422482?v=4', 'gravatar_id': '', 'url': 'https://api.github.com/users/facebook-github-bot', 'html_url': 'https://github.com/facebook-github-bot', 'followers_url': 'https://api.github.com/users/facebook-github-bot/followers', 'following_url': 'https://api.github.com/users/facebook-github-bot/following{/other_user}', 'gists_url': 'https://api.github.com/users/facebook-github-bot/gists{/gist_id}', 'starred_url': 'https://api.github.com/users/facebook-github-bot/starred{/owner}{/repo}', 'subscriptions_url': 'https://api.github.com/users/facebook-github-bot/subscriptions', 'organizations_url': 'https://api.github.com/users/facebook-github-bot/orgs', 'repos_url': 'https://api.github.com/users/facebook-github-bot/repos', 'events_url': 'https://api.github.com/users/facebook-github-bot/events{/privacy}', 'received_events_url': 'https://api.github.com/users/facebook-github-bot/received_events', 'type': 'User', 'site_admin': False}",closed,4e59055c4d8d07ba99279a50a4394ec4289c318a,https://api.github.com/repos/pytorch/pytorch/commits/4e59055c4d8d07ba99279a50a4394ec4289c318a,2019-07-30T05:38:12Z,23,20,3
21344,2407512516,"{'login': 'facebook-github-bot', 'id': 6422482, 'node_id': 'MDQ6VXNlcjY0MjI0ODI=', 'avatar_url': 'https://avatars3.githubusercontent.com/u/6422482?v=4', 'gravatar_id': '', 'url': 'https://api.github.com/users/facebook-github-bot', 'html_url': 'https://github.com/facebook-github-bot', 'followers_url': 'https://api.github.com/users/facebook-github-bot/followers', 'following_url': 'https://api.github.com/users/facebook-github-bot/following{/other_user}', 'gists_url': 'https://api.github.com/users/facebook-github-bot/gists{/gist_id}', 'starred_url': 'https://api.github.com/users/facebook-github-bot/starred{/owner}{/repo}', 'subscriptions_url': 'https://api.github.com/users/facebook-github-bot/subscriptions', 'organizations_url': 'https://api.github.com/users/facebook-github-bot/orgs', 'repos_url': 'https://api.github.com/users/facebook-github-bot/repos', 'events_url': 'https://api.github.com/users/facebook-github-bot/events{/privacy}', 'received_events_url': 'https://api.github.com/users/facebook-github-bot/received_events', 'type': 'User', 'site_admin': False}",closed,cbcb2b5ad767622cf5ec04263018609bde3c974a,https://api.github.com/repos/pytorch/pytorch/commits/cbcb2b5ad767622cf5ec04263018609bde3c974a,2019-06-12T14:11:23Z,111,105,6
21271,2408251667,"{'login': 'facebook-github-bot', 'id': 6422482, 'node_id': 'MDQ6VXNlcjY0MjI0ODI=', 'avatar_url': 'https://avatars3.githubusercontent.com/u/6422482?v=4', 'gravatar_id': '', 'url': 'https://api.github.com/users/facebook-github-bot', 'html_url': 'https://github.com/facebook-github-bot', 'followers_url': 'https://api.github.com/users/facebook-github-bot/followers', 'following_url': 'https://api.github.com/users/facebook-github-bot/following{/other_user}', 'gists_url': 'https://api.github.com/users/facebook-github-bot/gists{/gist_id}', 'starred_url': 'https://api.github.com/users/facebook-github-bot/starred{/owner}{/repo}', 'subscriptions_url': 'https://api.github.com/users/facebook-github-bot/subscriptions', 'organizations_url': 'https://api.github.com/users/facebook-github-bot/orgs', 'repos_url': 'https://api.github.com/users/facebook-github-bot/repos', 'events_url': 'https://api.github.com/users/facebook-github-bot/events{/privacy}', 'received_events_url': 'https://api.github.com/users/facebook-github-bot/received_events', 'type': 'User', 'site_admin': False}",referenced,76e01542ed1ff9892a766efad4bddcc061b9dbab,https://api.github.com/repos/pytorch/pytorch/commits/76e01542ed1ff9892a766efad4bddcc061b9dbab,2019-06-12T18:06:40Z,97,97,0
21269,2395044527,"{'login': 'facebook-github-bot', 'id': 6422482, 'node_id': 'MDQ6VXNlcjY0MjI0ODI=', 'avatar_url': 'https://avatars3.githubusercontent.com/u/6422482?v=4', 'gravatar_id': '', 'url': 'https://api.github.com/users/facebook-github-bot', 'html_url': 'https://github.com/facebook-github-bot', 'followers_url': 'https://api.github.com/users/facebook-github-bot/followers', 'following_url': 'https://api.github.com/users/facebook-github-bot/following{/other_user}', 'gists_url': 'https://api.github.com/users/facebook-github-bot/gists{/gist_id}', 'starred_url': 'https://api.github.com/users/facebook-github-bot/starred{/owner}{/repo}', 'subscriptions_url': 'https://api.github.com/users/facebook-github-bot/subscriptions', 'organizations_url': 'https://api.github.com/users/facebook-github-bot/orgs', 'repos_url': 'https://api.github.com/users/facebook-github-bot/repos', 'events_url': 'https://api.github.com/users/facebook-github-bot/events{/privacy}', 'received_events_url': 'https://api.github.com/users/facebook-github-bot/received_events', 'type': 'User', 'site_admin': False}",closed,ee15ad1bd614186ce48b776f9bda570a758e20da,https://api.github.com/repos/pytorch/pytorch/commits/ee15ad1bd614186ce48b776f9bda570a758e20da,2019-06-06T17:09:41Z,8,1,7
21261,2385636743,"{'login': 'facebook-github-bot', 'id': 6422482, 'node_id': 'MDQ6VXNlcjY0MjI0ODI=', 'avatar_url': 'https://avatars3.githubusercontent.com/u/6422482?v=4', 'gravatar_id': '', 'url': 'https://api.github.com/users/facebook-github-bot', 'html_url': 'https://github.com/facebook-github-bot', 'followers_url': 'https://api.github.com/users/facebook-github-bot/followers', 'following_url': 'https://api.github.com/users/facebook-github-bot/following{/other_user}', 'gists_url': 'https://api.github.com/users/facebook-github-bot/gists{/gist_id}', 'starred_url': 'https://api.github.com/users/facebook-github-bot/starred{/owner}{/repo}', 'subscriptions_url': 'https://api.github.com/users/facebook-github-bot/subscriptions', 'organizations_url': 'https://api.github.com/users/facebook-github-bot/orgs', 'repos_url': 'https://api.github.com/users/facebook-github-bot/repos', 'events_url': 'https://api.github.com/users/facebook-github-bot/events{/privacy}', 'received_events_url': 'https://api.github.com/users/facebook-github-bot/received_events', 'type': 'User', 'site_admin': False}",closed,2e59a0a646883f6b20f2e0d0af9c795e629bc115,https://api.github.com/repos/pytorch/pytorch/commits/2e59a0a646883f6b20f2e0d0af9c795e629bc115,2019-06-03T17:19:27Z,1,1,0
21257,2401922733,"{'login': 'facebook-github-bot', 'id': 6422482, 'node_id': 'MDQ6VXNlcjY0MjI0ODI=', 'avatar_url': 'https://avatars3.githubusercontent.com/u/6422482?v=4', 'gravatar_id': '', 'url': 'https://api.github.com/users/facebook-github-bot', 'html_url': 'https://github.com/facebook-github-bot', 'followers_url': 'https://api.github.com/users/facebook-github-bot/followers', 'following_url': 'https://api.github.com/users/facebook-github-bot/following{/other_user}', 'gists_url': 'https://api.github.com/users/facebook-github-bot/gists{/gist_id}', 'starred_url': 'https://api.github.com/users/facebook-github-bot/starred{/owner}{/repo}', 'subscriptions_url': 'https://api.github.com/users/facebook-github-bot/subscriptions', 'organizations_url': 'https://api.github.com/users/facebook-github-bot/orgs', 'repos_url': 'https://api.github.com/users/facebook-github-bot/repos', 'events_url': 'https://api.github.com/users/facebook-github-bot/events{/privacy}', 'received_events_url': 'https://api.github.com/users/facebook-github-bot/received_events', 'type': 'User', 'site_admin': False}",closed,bb1dbdb99bb56c49a585c496efe12c6d5115d04f,https://api.github.com/repos/pytorch/pytorch/commits/bb1dbdb99bb56c49a585c496efe12c6d5115d04f,2019-06-10T19:08:37Z,65,50,15
21257,2405657430,"{'login': 'facebook-github-bot', 'id': 6422482, 'node_id': 'MDQ6VXNlcjY0MjI0ODI=', 'avatar_url': 'https://avatars3.githubusercontent.com/u/6422482?v=4', 'gravatar_id': '', 'url': 'https://api.github.com/users/facebook-github-bot', 'html_url': 'https://github.com/facebook-github-bot', 'followers_url': 'https://api.github.com/users/facebook-github-bot/followers', 'following_url': 'https://api.github.com/users/facebook-github-bot/following{/other_user}', 'gists_url': 'https://api.github.com/users/facebook-github-bot/gists{/gist_id}', 'starred_url': 'https://api.github.com/users/facebook-github-bot/starred{/owner}{/repo}', 'subscriptions_url': 'https://api.github.com/users/facebook-github-bot/subscriptions', 'organizations_url': 'https://api.github.com/users/facebook-github-bot/orgs', 'repos_url': 'https://api.github.com/users/facebook-github-bot/repos', 'events_url': 'https://api.github.com/users/facebook-github-bot/events{/privacy}', 'received_events_url': 'https://api.github.com/users/facebook-github-bot/received_events', 'type': 'User', 'site_admin': False}",closed,9737b166a4788ff57c24c1e59651453dc701d161,https://api.github.com/repos/pytorch/pytorch/commits/9737b166a4788ff57c24c1e59651453dc701d161,2019-06-11T22:21:08Z,66,51,15
21251,2464732474,"{'login': 'facebook-github-bot', 'id': 6422482, 'node_id': 'MDQ6VXNlcjY0MjI0ODI=', 'avatar_url': 'https://avatars3.githubusercontent.com/u/6422482?v=4', 'gravatar_id': '', 'url': 'https://api.github.com/users/facebook-github-bot', 'html_url': 'https://github.com/facebook-github-bot', 'followers_url': 'https://api.github.com/users/facebook-github-bot/followers', 'following_url': 'https://api.github.com/users/facebook-github-bot/following{/other_user}', 'gists_url': 'https://api.github.com/users/facebook-github-bot/gists{/gist_id}', 'starred_url': 'https://api.github.com/users/facebook-github-bot/starred{/owner}{/repo}', 'subscriptions_url': 'https://api.github.com/users/facebook-github-bot/subscriptions', 'organizations_url': 'https://api.github.com/users/facebook-github-bot/orgs', 'repos_url': 'https://api.github.com/users/facebook-github-bot/repos', 'events_url': 'https://api.github.com/users/facebook-github-bot/events{/privacy}', 'received_events_url': 'https://api.github.com/users/facebook-github-bot/received_events', 'type': 'User', 'site_admin': False}",closed,d48cbd62cd822740d9b4f48a243de84f75fdfbc1,https://api.github.com/repos/pytorch/pytorch/commits/d48cbd62cd822740d9b4f48a243de84f75fdfbc1,2019-07-08T02:11:31Z,167,119,48
21173,2379541470,"{'login': 'driazati', 'id': 9407960, 'node_id': 'MDQ6VXNlcjk0MDc5NjA=', 'avatar_url': 'https://avatars3.githubusercontent.com/u/9407960?v=4', 'gravatar_id': '', 'url': 'https://api.github.com/users/driazati', 'html_url': 'https://github.com/driazati', 'followers_url': 'https://api.github.com/users/driazati/followers', 'following_url': 'https://api.github.com/users/driazati/following{/other_user}', 'gists_url': 'https://api.github.com/users/driazati/gists{/gist_id}', 'starred_url': 'https://api.github.com/users/driazati/starred{/owner}{/repo}', 'subscriptions_url': 'https://api.github.com/users/driazati/subscriptions', 'organizations_url': 'https://api.github.com/users/driazati/orgs', 'repos_url': 'https://api.github.com/users/driazati/repos', 'events_url': 'https://api.github.com/users/driazati/events{/privacy}', 'received_events_url': 'https://api.github.com/users/driazati/received_events', 'type': 'User', 'site_admin': False}",referenced,f7411ad4e9a44dab60d8d936c0401aa922789a3b,https://api.github.com/repos/pytorch/pytorch/commits/f7411ad4e9a44dab60d8d936c0401aa922789a3b,2019-05-30T23:09:58Z,54,37,17
21167,2382795227,"{'login': 'facebook-github-bot', 'id': 6422482, 'node_id': 'MDQ6VXNlcjY0MjI0ODI=', 'avatar_url': 'https://avatars3.githubusercontent.com/u/6422482?v=4', 'gravatar_id': '', 'url': 'https://api.github.com/users/facebook-github-bot', 'html_url': 'https://github.com/facebook-github-bot', 'followers_url': 'https://api.github.com/users/facebook-github-bot/followers', 'following_url': 'https://api.github.com/users/facebook-github-bot/following{/other_user}', 'gists_url': 'https://api.github.com/users/facebook-github-bot/gists{/gist_id}', 'starred_url': 'https://api.github.com/users/facebook-github-bot/starred{/owner}{/repo}', 'subscriptions_url': 'https://api.github.com/users/facebook-github-bot/subscriptions', 'organizations_url': 'https://api.github.com/users/facebook-github-bot/orgs', 'repos_url': 'https://api.github.com/users/facebook-github-bot/repos', 'events_url': 'https://api.github.com/users/facebook-github-bot/events{/privacy}', 'received_events_url': 'https://api.github.com/users/facebook-github-bot/received_events', 'type': 'User', 'site_admin': False}",closed,be7fc40621719fd881378756ee1945351bd14a99,https://api.github.com/repos/pytorch/pytorch/commits/be7fc40621719fd881378756ee1945351bd14a99,2019-06-01T16:50:08Z,17,10,7
21108,2382814520,"{'login': 'facebook-github-bot', 'id': 6422482, 'node_id': 'MDQ6VXNlcjY0MjI0ODI=', 'avatar_url': 'https://avatars3.githubusercontent.com/u/6422482?v=4', 'gravatar_id': '', 'url': 'https://api.github.com/users/facebook-github-bot', 'html_url': 'https://github.com/facebook-github-bot', 'followers_url': 'https://api.github.com/users/facebook-github-bot/followers', 'following_url': 'https://api.github.com/users/facebook-github-bot/following{/other_user}', 'gists_url': 'https://api.github.com/users/facebook-github-bot/gists{/gist_id}', 'starred_url': 'https://api.github.com/users/facebook-github-bot/starred{/owner}{/repo}', 'subscriptions_url': 'https://api.github.com/users/facebook-github-bot/subscriptions', 'organizations_url': 'https://api.github.com/users/facebook-github-bot/orgs', 'repos_url': 'https://api.github.com/users/facebook-github-bot/repos', 'events_url': 'https://api.github.com/users/facebook-github-bot/events{/privacy}', 'received_events_url': 'https://api.github.com/users/facebook-github-bot/received_events', 'type': 'User', 'site_admin': False}",closed,51ebbe970ada230586aae0677814b4b66f5b00f6,https://api.github.com/repos/pytorch/pytorch/commits/51ebbe970ada230586aae0677814b4b66f5b00f6,2019-06-01T17:40:22Z,44,40,4
21081,2486906982,"{'login': 'facebook-github-bot', 'id': 6422482, 'node_id': 'MDQ6VXNlcjY0MjI0ODI=', 'avatar_url': 'https://avatars3.githubusercontent.com/u/6422482?v=4', 'gravatar_id': '', 'url': 'https://api.github.com/users/facebook-github-bot', 'html_url': 'https://github.com/facebook-github-bot', 'followers_url': 'https://api.github.com/users/facebook-github-bot/followers', 'following_url': 'https://api.github.com/users/facebook-github-bot/following{/other_user}', 'gists_url': 'https://api.github.com/users/facebook-github-bot/gists{/gist_id}', 'starred_url': 'https://api.github.com/users/facebook-github-bot/starred{/owner}{/repo}', 'subscriptions_url': 'https://api.github.com/users/facebook-github-bot/subscriptions', 'organizations_url': 'https://api.github.com/users/facebook-github-bot/orgs', 'repos_url': 'https://api.github.com/users/facebook-github-bot/repos', 'events_url': 'https://api.github.com/users/facebook-github-bot/events{/privacy}', 'received_events_url': 'https://api.github.com/users/facebook-github-bot/received_events', 'type': 'User', 'site_admin': False}",closed,8482efb2036475072f26c07e4d7d91e14e5e2c20,https://api.github.com/repos/pytorch/pytorch/commits/8482efb2036475072f26c07e4d7d91e14e5e2c20,2019-07-16T17:21:09Z,291,208,83
21076,2521910770,"{'login': 'facebook-github-bot', 'id': 6422482, 'node_id': 'MDQ6VXNlcjY0MjI0ODI=', 'avatar_url': 'https://avatars3.githubusercontent.com/u/6422482?v=4', 'gravatar_id': '', 'url': 'https://api.github.com/users/facebook-github-bot', 'html_url': 'https://github.com/facebook-github-bot', 'followers_url': 'https://api.github.com/users/facebook-github-bot/followers', 'following_url': 'https://api.github.com/users/facebook-github-bot/following{/other_user}', 'gists_url': 'https://api.github.com/users/facebook-github-bot/gists{/gist_id}', 'starred_url': 'https://api.github.com/users/facebook-github-bot/starred{/owner}{/repo}', 'subscriptions_url': 'https://api.github.com/users/facebook-github-bot/subscriptions', 'organizations_url': 'https://api.github.com/users/facebook-github-bot/orgs', 'repos_url': 'https://api.github.com/users/facebook-github-bot/repos', 'events_url': 'https://api.github.com/users/facebook-github-bot/events{/privacy}', 'received_events_url': 'https://api.github.com/users/facebook-github-bot/received_events', 'type': 'User', 'site_admin': False}",closed,af638ad5d7c8fc9ff97f0ad1cd2bbcfa3ced514e,https://api.github.com/repos/pytorch/pytorch/commits/af638ad5d7c8fc9ff97f0ad1cd2bbcfa3ced514e,2019-07-31T04:19:05Z,166,119,47
21044,2507744714,"{'login': 'facebook-github-bot', 'id': 6422482, 'node_id': 'MDQ6VXNlcjY0MjI0ODI=', 'avatar_url': 'https://avatars3.githubusercontent.com/u/6422482?v=4', 'gravatar_id': '', 'url': 'https://api.github.com/users/facebook-github-bot', 'html_url': 'https://github.com/facebook-github-bot', 'followers_url': 'https://api.github.com/users/facebook-github-bot/followers', 'following_url': 'https://api.github.com/users/facebook-github-bot/following{/other_user}', 'gists_url': 'https://api.github.com/users/facebook-github-bot/gists{/gist_id}', 'starred_url': 'https://api.github.com/users/facebook-github-bot/starred{/owner}{/repo}', 'subscriptions_url': 'https://api.github.com/users/facebook-github-bot/subscriptions', 'organizations_url': 'https://api.github.com/users/facebook-github-bot/orgs', 'repos_url': 'https://api.github.com/users/facebook-github-bot/repos', 'events_url': 'https://api.github.com/users/facebook-github-bot/events{/privacy}', 'received_events_url': 'https://api.github.com/users/facebook-github-bot/received_events', 'type': 'User', 'site_admin': False}",closed,b7d90332eabd2a2ddbe328e8ac60e09ad68e3b66,https://api.github.com/repos/pytorch/pytorch/commits/b7d90332eabd2a2ddbe328e8ac60e09ad68e3b66,2019-07-24T21:49:28Z,12,12,0
21026,2395605024,"{'login': 'facebook-github-bot', 'id': 6422482, 'node_id': 'MDQ6VXNlcjY0MjI0ODI=', 'avatar_url': 'https://avatars3.githubusercontent.com/u/6422482?v=4', 'gravatar_id': '', 'url': 'https://api.github.com/users/facebook-github-bot', 'html_url': 'https://github.com/facebook-github-bot', 'followers_url': 'https://api.github.com/users/facebook-github-bot/followers', 'following_url': 'https://api.github.com/users/facebook-github-bot/following{/other_user}', 'gists_url': 'https://api.github.com/users/facebook-github-bot/gists{/gist_id}', 'starred_url': 'https://api.github.com/users/facebook-github-bot/starred{/owner}{/repo}', 'subscriptions_url': 'https://api.github.com/users/facebook-github-bot/subscriptions', 'organizations_url': 'https://api.github.com/users/facebook-github-bot/orgs', 'repos_url': 'https://api.github.com/users/facebook-github-bot/repos', 'events_url': 'https://api.github.com/users/facebook-github-bot/events{/privacy}', 'received_events_url': 'https://api.github.com/users/facebook-github-bot/received_events', 'type': 'User', 'site_admin': False}",closed,51d0da2802c92d2e66826099729a43303218abc8,https://api.github.com/repos/pytorch/pytorch/commits/51d0da2802c92d2e66826099729a43303218abc8,2019-06-06T20:49:38Z,77,54,23
20984,2493430009,"{'login': 'ezyang', 'id': 13564, 'node_id': 'MDQ6VXNlcjEzNTY0', 'avatar_url': 'https://avatars0.githubusercontent.com/u/13564?v=4', 'gravatar_id': '', 'url': 'https://api.github.com/users/ezyang', 'html_url': 'https://github.com/ezyang', 'followers_url': 'https://api.github.com/users/ezyang/followers', 'following_url': 'https://api.github.com/users/ezyang/following{/other_user}', 'gists_url': 'https://api.github.com/users/ezyang/gists{/gist_id}', 'starred_url': 'https://api.github.com/users/ezyang/starred{/owner}{/repo}', 'subscriptions_url': 'https://api.github.com/users/ezyang/subscriptions', 'organizations_url': 'https://api.github.com/users/ezyang/orgs', 'repos_url': 'https://api.github.com/users/ezyang/repos', 'events_url': 'https://api.github.com/users/ezyang/events{/privacy}', 'received_events_url': 'https://api.github.com/users/ezyang/received_events', 'type': 'User', 'site_admin': False}",referenced,30a8d2176519ade23f974510e4773d5007f0fa35,https://api.github.com/repos/pytorch/pytorch/commits/30a8d2176519ade23f974510e4773d5007f0fa35,2019-07-18T17:12:57Z,21,1,20
20984,2493430539,"{'login': 'ezyang', 'id': 13564, 'node_id': 'MDQ6VXNlcjEzNTY0', 'avatar_url': 'https://avatars0.githubusercontent.com/u/13564?v=4', 'gravatar_id': '', 'url': 'https://api.github.com/users/ezyang', 'html_url': 'https://github.com/ezyang', 'followers_url': 'https://api.github.com/users/ezyang/followers', 'following_url': 'https://api.github.com/users/ezyang/following{/other_user}', 'gists_url': 'https://api.github.com/users/ezyang/gists{/gist_id}', 'starred_url': 'https://api.github.com/users/ezyang/starred{/owner}{/repo}', 'subscriptions_url': 'https://api.github.com/users/ezyang/subscriptions', 'organizations_url': 'https://api.github.com/users/ezyang/orgs', 'repos_url': 'https://api.github.com/users/ezyang/repos', 'events_url': 'https://api.github.com/users/ezyang/events{/privacy}', 'received_events_url': 'https://api.github.com/users/ezyang/received_events', 'type': 'User', 'site_admin': False}",referenced,d338b10f2037ba06293bb4545bb106fad884f5f2,https://api.github.com/repos/pytorch/pytorch/commits/d338b10f2037ba06293bb4545bb106fad884f5f2,2019-07-18T17:13:09Z,21,1,20
20978,2376427226,"{'login': 'facebook-github-bot', 'id': 6422482, 'node_id': 'MDQ6VXNlcjY0MjI0ODI=', 'avatar_url': 'https://avatars3.githubusercontent.com/u/6422482?v=4', 'gravatar_id': '', 'url': 'https://api.github.com/users/facebook-github-bot', 'html_url': 'https://github.com/facebook-github-bot', 'followers_url': 'https://api.github.com/users/facebook-github-bot/followers', 'following_url': 'https://api.github.com/users/facebook-github-bot/following{/other_user}', 'gists_url': 'https://api.github.com/users/facebook-github-bot/gists{/gist_id}', 'starred_url': 'https://api.github.com/users/facebook-github-bot/starred{/owner}{/repo}', 'subscriptions_url': 'https://api.github.com/users/facebook-github-bot/subscriptions', 'organizations_url': 'https://api.github.com/users/facebook-github-bot/orgs', 'repos_url': 'https://api.github.com/users/facebook-github-bot/repos', 'events_url': 'https://api.github.com/users/facebook-github-bot/events{/privacy}', 'received_events_url': 'https://api.github.com/users/facebook-github-bot/received_events', 'type': 'User', 'site_admin': False}",closed,736bf7b46c0458875af2eee36072794f054c5bc4,https://api.github.com/repos/pytorch/pytorch/commits/736bf7b46c0458875af2eee36072794f054c5bc4,2019-05-29T20:58:19Z,33,18,15
20939,2376876498,"{'login': 'facebook-github-bot', 'id': 6422482, 'node_id': 'MDQ6VXNlcjY0MjI0ODI=', 'avatar_url': 'https://avatars3.githubusercontent.com/u/6422482?v=4', 'gravatar_id': '', 'url': 'https://api.github.com/users/facebook-github-bot', 'html_url': 'https://github.com/facebook-github-bot', 'followers_url': 'https://api.github.com/users/facebook-github-bot/followers', 'following_url': 'https://api.github.com/users/facebook-github-bot/following{/other_user}', 'gists_url': 'https://api.github.com/users/facebook-github-bot/gists{/gist_id}', 'starred_url': 'https://api.github.com/users/facebook-github-bot/starred{/owner}{/repo}', 'subscriptions_url': 'https://api.github.com/users/facebook-github-bot/subscriptions', 'organizations_url': 'https://api.github.com/users/facebook-github-bot/orgs', 'repos_url': 'https://api.github.com/users/facebook-github-bot/repos', 'events_url': 'https://api.github.com/users/facebook-github-bot/events{/privacy}', 'received_events_url': 'https://api.github.com/users/facebook-github-bot/received_events', 'type': 'User', 'site_admin': False}",referenced,8d3388aef2b6b109e45d0c58da720601aa1e94cd,https://api.github.com/repos/pytorch/pytorch/commits/8d3388aef2b6b109e45d0c58da720601aa1e94cd,2019-05-30T01:54:51Z,328,282,46
20939,2382192189,"{'login': 'facebook-github-bot', 'id': 6422482, 'node_id': 'MDQ6VXNlcjY0MjI0ODI=', 'avatar_url': 'https://avatars3.githubusercontent.com/u/6422482?v=4', 'gravatar_id': '', 'url': 'https://api.github.com/users/facebook-github-bot', 'html_url': 'https://github.com/facebook-github-bot', 'followers_url': 'https://api.github.com/users/facebook-github-bot/followers', 'following_url': 'https://api.github.com/users/facebook-github-bot/following{/other_user}', 'gists_url': 'https://api.github.com/users/facebook-github-bot/gists{/gist_id}', 'starred_url': 'https://api.github.com/users/facebook-github-bot/starred{/owner}{/repo}', 'subscriptions_url': 'https://api.github.com/users/facebook-github-bot/subscriptions', 'organizations_url': 'https://api.github.com/users/facebook-github-bot/orgs', 'repos_url': 'https://api.github.com/users/facebook-github-bot/repos', 'events_url': 'https://api.github.com/users/facebook-github-bot/events{/privacy}', 'received_events_url': 'https://api.github.com/users/facebook-github-bot/received_events', 'type': 'User', 'site_admin': False}",referenced,2f4824b2fb199e77424aabfddf42b73ffb1450ff,https://api.github.com/repos/pytorch/pytorch/commits/2f4824b2fb199e77424aabfddf42b73ffb1450ff,2019-05-31T21:29:39Z,320,275,45
20939,2484395219,"{'login': 'driazati', 'id': 9407960, 'node_id': 'MDQ6VXNlcjk0MDc5NjA=', 'avatar_url': 'https://avatars3.githubusercontent.com/u/9407960?v=4', 'gravatar_id': '', 'url': 'https://api.github.com/users/driazati', 'html_url': 'https://github.com/driazati', 'followers_url': 'https://api.github.com/users/driazati/followers', 'following_url': 'https://api.github.com/users/driazati/following{/other_user}', 'gists_url': 'https://api.github.com/users/driazati/gists{/gist_id}', 'starred_url': 'https://api.github.com/users/driazati/starred{/owner}{/repo}', 'subscriptions_url': 'https://api.github.com/users/driazati/subscriptions', 'organizations_url': 'https://api.github.com/users/driazati/orgs', 'repos_url': 'https://api.github.com/users/driazati/repos', 'events_url': 'https://api.github.com/users/driazati/events{/privacy}', 'received_events_url': 'https://api.github.com/users/driazati/received_events', 'type': 'User', 'site_admin': False}",referenced,931c2defd04fc9ac7ffa43c47f0a07e8b3b9b2e5,https://api.github.com/repos/pytorch/pytorch/commits/931c2defd04fc9ac7ffa43c47f0a07e8b3b9b2e5,2019-07-15T22:23:01Z,156,64,92
20926,2366845260,"{'login': 'facebook-github-bot', 'id': 6422482, 'node_id': 'MDQ6VXNlcjY0MjI0ODI=', 'avatar_url': 'https://avatars3.githubusercontent.com/u/6422482?v=4', 'gravatar_id': '', 'url': 'https://api.github.com/users/facebook-github-bot', 'html_url': 'https://github.com/facebook-github-bot', 'followers_url': 'https://api.github.com/users/facebook-github-bot/followers', 'following_url': 'https://api.github.com/users/facebook-github-bot/following{/other_user}', 'gists_url': 'https://api.github.com/users/facebook-github-bot/gists{/gist_id}', 'starred_url': 'https://api.github.com/users/facebook-github-bot/starred{/owner}{/repo}', 'subscriptions_url': 'https://api.github.com/users/facebook-github-bot/subscriptions', 'organizations_url': 'https://api.github.com/users/facebook-github-bot/orgs', 'repos_url': 'https://api.github.com/users/facebook-github-bot/repos', 'events_url': 'https://api.github.com/users/facebook-github-bot/events{/privacy}', 'received_events_url': 'https://api.github.com/users/facebook-github-bot/received_events', 'type': 'User', 'site_admin': False}",referenced,430d1a2761ab85ce8e8a3b6f81f7106481a4973a,https://api.github.com/repos/pytorch/pytorch/commits/430d1a2761ab85ce8e8a3b6f81f7106481a4973a,2019-05-24T22:58:04Z,18,7,11
20921,2413888475,"{'login': 'facebook-github-bot', 'id': 6422482, 'node_id': 'MDQ6VXNlcjY0MjI0ODI=', 'avatar_url': 'https://avatars3.githubusercontent.com/u/6422482?v=4', 'gravatar_id': '', 'url': 'https://api.github.com/users/facebook-github-bot', 'html_url': 'https://github.com/facebook-github-bot', 'followers_url': 'https://api.github.com/users/facebook-github-bot/followers', 'following_url': 'https://api.github.com/users/facebook-github-bot/following{/other_user}', 'gists_url': 'https://api.github.com/users/facebook-github-bot/gists{/gist_id}', 'starred_url': 'https://api.github.com/users/facebook-github-bot/starred{/owner}{/repo}', 'subscriptions_url': 'https://api.github.com/users/facebook-github-bot/subscriptions', 'organizations_url': 'https://api.github.com/users/facebook-github-bot/orgs', 'repos_url': 'https://api.github.com/users/facebook-github-bot/repos', 'events_url': 'https://api.github.com/users/facebook-github-bot/events{/privacy}', 'received_events_url': 'https://api.github.com/users/facebook-github-bot/received_events', 'type': 'User', 'site_admin': False}",referenced,b9675efb5a40a0d54caab6cdc578aa992d3221a4,https://api.github.com/repos/pytorch/pytorch/commits/b9675efb5a40a0d54caab6cdc578aa992d3221a4,2019-06-14T14:37:54Z,22,11,11
20888,2366874731,"{'login': 'facebook-github-bot', 'id': 6422482, 'node_id': 'MDQ6VXNlcjY0MjI0ODI=', 'avatar_url': 'https://avatars3.githubusercontent.com/u/6422482?v=4', 'gravatar_id': '', 'url': 'https://api.github.com/users/facebook-github-bot', 'html_url': 'https://github.com/facebook-github-bot', 'followers_url': 'https://api.github.com/users/facebook-github-bot/followers', 'following_url': 'https://api.github.com/users/facebook-github-bot/following{/other_user}', 'gists_url': 'https://api.github.com/users/facebook-github-bot/gists{/gist_id}', 'starred_url': 'https://api.github.com/users/facebook-github-bot/starred{/owner}{/repo}', 'subscriptions_url': 'https://api.github.com/users/facebook-github-bot/subscriptions', 'organizations_url': 'https://api.github.com/users/facebook-github-bot/orgs', 'repos_url': 'https://api.github.com/users/facebook-github-bot/repos', 'events_url': 'https://api.github.com/users/facebook-github-bot/events{/privacy}', 'received_events_url': 'https://api.github.com/users/facebook-github-bot/received_events', 'type': 'User', 'site_admin': False}",closed,b93bdf6989ee96502512eb298dcfc267974dcc12,https://api.github.com/repos/pytorch/pytorch/commits/b93bdf6989ee96502512eb298dcfc267974dcc12,2019-05-24T23:27:22Z,35,25,10
20862,2527232611,"{'login': 'facebook-github-bot', 'id': 6422482, 'node_id': 'MDQ6VXNlcjY0MjI0ODI=', 'avatar_url': 'https://avatars3.githubusercontent.com/u/6422482?v=4', 'gravatar_id': '', 'url': 'https://api.github.com/users/facebook-github-bot', 'html_url': 'https://github.com/facebook-github-bot', 'followers_url': 'https://api.github.com/users/facebook-github-bot/followers', 'following_url': 'https://api.github.com/users/facebook-github-bot/following{/other_user}', 'gists_url': 'https://api.github.com/users/facebook-github-bot/gists{/gist_id}', 'starred_url': 'https://api.github.com/users/facebook-github-bot/starred{/owner}{/repo}', 'subscriptions_url': 'https://api.github.com/users/facebook-github-bot/subscriptions', 'organizations_url': 'https://api.github.com/users/facebook-github-bot/orgs', 'repos_url': 'https://api.github.com/users/facebook-github-bot/repos', 'events_url': 'https://api.github.com/users/facebook-github-bot/events{/privacy}', 'received_events_url': 'https://api.github.com/users/facebook-github-bot/received_events', 'type': 'User', 'site_admin': False}",closed,029c8e7754625c4652a169888ea2c5806e043520,https://api.github.com/repos/pytorch/pytorch/commits/029c8e7754625c4652a169888ea2c5806e043520,2019-08-01T16:54:25Z,82,80,2
20823,2438407495,"{'login': 'facebook-github-bot', 'id': 6422482, 'node_id': 'MDQ6VXNlcjY0MjI0ODI=', 'avatar_url': 'https://avatars3.githubusercontent.com/u/6422482?v=4', 'gravatar_id': '', 'url': 'https://api.github.com/users/facebook-github-bot', 'html_url': 'https://github.com/facebook-github-bot', 'followers_url': 'https://api.github.com/users/facebook-github-bot/followers', 'following_url': 'https://api.github.com/users/facebook-github-bot/following{/other_user}', 'gists_url': 'https://api.github.com/users/facebook-github-bot/gists{/gist_id}', 'starred_url': 'https://api.github.com/users/facebook-github-bot/starred{/owner}{/repo}', 'subscriptions_url': 'https://api.github.com/users/facebook-github-bot/subscriptions', 'organizations_url': 'https://api.github.com/users/facebook-github-bot/orgs', 'repos_url': 'https://api.github.com/users/facebook-github-bot/repos', 'events_url': 'https://api.github.com/users/facebook-github-bot/events{/privacy}', 'received_events_url': 'https://api.github.com/users/facebook-github-bot/received_events', 'type': 'User', 'site_admin': False}",closed,c68119387d7b1b24c796a041bdcfa1f6b627e5fa,https://api.github.com/repos/pytorch/pytorch/commits/c68119387d7b1b24c796a041bdcfa1f6b627e5fa,2019-06-25T17:47:11Z,34,34,0
20781,2363107789,"{'login': 'facebook-github-bot', 'id': 6422482, 'node_id': 'MDQ6VXNlcjY0MjI0ODI=', 'avatar_url': 'https://avatars3.githubusercontent.com/u/6422482?v=4', 'gravatar_id': '', 'url': 'https://api.github.com/users/facebook-github-bot', 'html_url': 'https://github.com/facebook-github-bot', 'followers_url': 'https://api.github.com/users/facebook-github-bot/followers', 'following_url': 'https://api.github.com/users/facebook-github-bot/following{/other_user}', 'gists_url': 'https://api.github.com/users/facebook-github-bot/gists{/gist_id}', 'starred_url': 'https://api.github.com/users/facebook-github-bot/starred{/owner}{/repo}', 'subscriptions_url': 'https://api.github.com/users/facebook-github-bot/subscriptions', 'organizations_url': 'https://api.github.com/users/facebook-github-bot/orgs', 'repos_url': 'https://api.github.com/users/facebook-github-bot/repos', 'events_url': 'https://api.github.com/users/facebook-github-bot/events{/privacy}', 'received_events_url': 'https://api.github.com/users/facebook-github-bot/received_events', 'type': 'User', 'site_admin': False}",closed,a16708a1ae85542794437b0ba5028359fdf3b156,https://api.github.com/repos/pytorch/pytorch/commits/a16708a1ae85542794437b0ba5028359fdf3b156,2019-05-23T16:47:02Z,45,33,12
20756,2407867297,"{'login': 'ezyang', 'id': 13564, 'node_id': 'MDQ6VXNlcjEzNTY0', 'avatar_url': 'https://avatars0.githubusercontent.com/u/13564?v=4', 'gravatar_id': '', 'url': 'https://api.github.com/users/ezyang', 'html_url': 'https://github.com/ezyang', 'followers_url': 'https://api.github.com/users/ezyang/followers', 'following_url': 'https://api.github.com/users/ezyang/following{/other_user}', 'gists_url': 'https://api.github.com/users/ezyang/gists{/gist_id}', 'starred_url': 'https://api.github.com/users/ezyang/starred{/owner}{/repo}', 'subscriptions_url': 'https://api.github.com/users/ezyang/subscriptions', 'organizations_url': 'https://api.github.com/users/ezyang/orgs', 'repos_url': 'https://api.github.com/users/ezyang/repos', 'events_url': 'https://api.github.com/users/ezyang/events{/privacy}', 'received_events_url': 'https://api.github.com/users/ezyang/received_events', 'type': 'User', 'site_admin': False}",referenced,12bdc4c32ddbcf6e6ca5f8bed6b135cdf2e1fda4,https://api.github.com/repos/pytorch/pytorch/commits/12bdc4c32ddbcf6e6ca5f8bed6b135cdf2e1fda4,2019-06-12T15:51:16Z,5,5,0
20756,2407867598,"{'login': 'ezyang', 'id': 13564, 'node_id': 'MDQ6VXNlcjEzNTY0', 'avatar_url': 'https://avatars0.githubusercontent.com/u/13564?v=4', 'gravatar_id': '', 'url': 'https://api.github.com/users/ezyang', 'html_url': 'https://github.com/ezyang', 'followers_url': 'https://api.github.com/users/ezyang/followers', 'following_url': 'https://api.github.com/users/ezyang/following{/other_user}', 'gists_url': 'https://api.github.com/users/ezyang/gists{/gist_id}', 'starred_url': 'https://api.github.com/users/ezyang/starred{/owner}{/repo}', 'subscriptions_url': 'https://api.github.com/users/ezyang/subscriptions', 'organizations_url': 'https://api.github.com/users/ezyang/orgs', 'repos_url': 'https://api.github.com/users/ezyang/repos', 'events_url': 'https://api.github.com/users/ezyang/events{/privacy}', 'received_events_url': 'https://api.github.com/users/ezyang/received_events', 'type': 'User', 'site_admin': False}",referenced,bc3b531c8a8736149301dc235d7241849000d810,https://api.github.com/repos/pytorch/pytorch/commits/bc3b531c8a8736149301dc235d7241849000d810,2019-06-12T15:51:21Z,5,5,0
20756,2411360344,"{'login': 'ezyang', 'id': 13564, 'node_id': 'MDQ6VXNlcjEzNTY0', 'avatar_url': 'https://avatars0.githubusercontent.com/u/13564?v=4', 'gravatar_id': '', 'url': 'https://api.github.com/users/ezyang', 'html_url': 'https://github.com/ezyang', 'followers_url': 'https://api.github.com/users/ezyang/followers', 'following_url': 'https://api.github.com/users/ezyang/following{/other_user}', 'gists_url': 'https://api.github.com/users/ezyang/gists{/gist_id}', 'starred_url': 'https://api.github.com/users/ezyang/starred{/owner}{/repo}', 'subscriptions_url': 'https://api.github.com/users/ezyang/subscriptions', 'organizations_url': 'https://api.github.com/users/ezyang/orgs', 'repos_url': 'https://api.github.com/users/ezyang/repos', 'events_url': 'https://api.github.com/users/ezyang/events{/privacy}', 'received_events_url': 'https://api.github.com/users/ezyang/received_events', 'type': 'User', 'site_admin': False}",referenced,88844faa54fe857fd6d1e301e18211e1ead9e347,https://api.github.com/repos/pytorch/pytorch/commits/88844faa54fe857fd6d1e301e18211e1ead9e347,2019-06-13T17:24:17Z,9737,6573,3164
20756,2411360421,"{'login': 'ezyang', 'id': 13564, 'node_id': 'MDQ6VXNlcjEzNTY0', 'avatar_url': 'https://avatars0.githubusercontent.com/u/13564?v=4', 'gravatar_id': '', 'url': 'https://api.github.com/users/ezyang', 'html_url': 'https://github.com/ezyang', 'followers_url': 'https://api.github.com/users/ezyang/followers', 'following_url': 'https://api.github.com/users/ezyang/following{/other_user}', 'gists_url': 'https://api.github.com/users/ezyang/gists{/gist_id}', 'starred_url': 'https://api.github.com/users/ezyang/starred{/owner}{/repo}', 'subscriptions_url': 'https://api.github.com/users/ezyang/subscriptions', 'organizations_url': 'https://api.github.com/users/ezyang/orgs', 'repos_url': 'https://api.github.com/users/ezyang/repos', 'events_url': 'https://api.github.com/users/ezyang/events{/privacy}', 'received_events_url': 'https://api.github.com/users/ezyang/received_events', 'type': 'User', 'site_admin': False}",referenced,7fef75c6429e3b2d6366fee145d933f2cb5c1a8a,https://api.github.com/repos/pytorch/pytorch/commits/7fef75c6429e3b2d6366fee145d933f2cb5c1a8a,2019-06-13T17:24:19Z,22,22,0
20756,2411426524,"{'login': 'ezyang', 'id': 13564, 'node_id': 'MDQ6VXNlcjEzNTY0', 'avatar_url': 'https://avatars0.githubusercontent.com/u/13564?v=4', 'gravatar_id': '', 'url': 'https://api.github.com/users/ezyang', 'html_url': 'https://github.com/ezyang', 'followers_url': 'https://api.github.com/users/ezyang/followers', 'following_url': 'https://api.github.com/users/ezyang/following{/other_user}', 'gists_url': 'https://api.github.com/users/ezyang/gists{/gist_id}', 'starred_url': 'https://api.github.com/users/ezyang/starred{/owner}{/repo}', 'subscriptions_url': 'https://api.github.com/users/ezyang/subscriptions', 'organizations_url': 'https://api.github.com/users/ezyang/orgs', 'repos_url': 'https://api.github.com/users/ezyang/repos', 'events_url': 'https://api.github.com/users/ezyang/events{/privacy}', 'received_events_url': 'https://api.github.com/users/ezyang/received_events', 'type': 'User', 'site_admin': False}",referenced,ab2d460c7fe4c0ff383a62abe4154549e0122b5d,https://api.github.com/repos/pytorch/pytorch/commits/ab2d460c7fe4c0ff383a62abe4154549e0122b5d,2019-06-13T17:49:16Z,1960,1301,659
20756,2411426692,"{'login': 'ezyang', 'id': 13564, 'node_id': 'MDQ6VXNlcjEzNTY0', 'avatar_url': 'https://avatars0.githubusercontent.com/u/13564?v=4', 'gravatar_id': '', 'url': 'https://api.github.com/users/ezyang', 'html_url': 'https://github.com/ezyang', 'followers_url': 'https://api.github.com/users/ezyang/followers', 'following_url': 'https://api.github.com/users/ezyang/following{/other_user}', 'gists_url': 'https://api.github.com/users/ezyang/gists{/gist_id}', 'starred_url': 'https://api.github.com/users/ezyang/starred{/owner}{/repo}', 'subscriptions_url': 'https://api.github.com/users/ezyang/subscriptions', 'organizations_url': 'https://api.github.com/users/ezyang/orgs', 'repos_url': 'https://api.github.com/users/ezyang/repos', 'events_url': 'https://api.github.com/users/ezyang/events{/privacy}', 'received_events_url': 'https://api.github.com/users/ezyang/received_events', 'type': 'User', 'site_admin': False}",referenced,0e3a187f5668637eabc01df676bb26b8abcaddea,https://api.github.com/repos/pytorch/pytorch/commits/0e3a187f5668637eabc01df676bb26b8abcaddea,2019-06-13T17:49:19Z,23,23,0
20756,2411808437,"{'login': 'ezyang', 'id': 13564, 'node_id': 'MDQ6VXNlcjEzNTY0', 'avatar_url': 'https://avatars0.githubusercontent.com/u/13564?v=4', 'gravatar_id': '', 'url': 'https://api.github.com/users/ezyang', 'html_url': 'https://github.com/ezyang', 'followers_url': 'https://api.github.com/users/ezyang/followers', 'following_url': 'https://api.github.com/users/ezyang/following{/other_user}', 'gists_url': 'https://api.github.com/users/ezyang/gists{/gist_id}', 'starred_url': 'https://api.github.com/users/ezyang/starred{/owner}{/repo}', 'subscriptions_url': 'https://api.github.com/users/ezyang/subscriptions', 'organizations_url': 'https://api.github.com/users/ezyang/orgs', 'repos_url': 'https://api.github.com/users/ezyang/repos', 'events_url': 'https://api.github.com/users/ezyang/events{/privacy}', 'received_events_url': 'https://api.github.com/users/ezyang/received_events', 'type': 'User', 'site_admin': False}",referenced,1eb6b48cc1015f92d531cc0926be4cdeec38d71c,https://api.github.com/repos/pytorch/pytorch/commits/1eb6b48cc1015f92d531cc0926be4cdeec38d71c,2019-06-13T20:21:15Z,4,1,3
20756,2411808684,"{'login': 'ezyang', 'id': 13564, 'node_id': 'MDQ6VXNlcjEzNTY0', 'avatar_url': 'https://avatars0.githubusercontent.com/u/13564?v=4', 'gravatar_id': '', 'url': 'https://api.github.com/users/ezyang', 'html_url': 'https://github.com/ezyang', 'followers_url': 'https://api.github.com/users/ezyang/followers', 'following_url': 'https://api.github.com/users/ezyang/following{/other_user}', 'gists_url': 'https://api.github.com/users/ezyang/gists{/gist_id}', 'starred_url': 'https://api.github.com/users/ezyang/starred{/owner}{/repo}', 'subscriptions_url': 'https://api.github.com/users/ezyang/subscriptions', 'organizations_url': 'https://api.github.com/users/ezyang/orgs', 'repos_url': 'https://api.github.com/users/ezyang/repos', 'events_url': 'https://api.github.com/users/ezyang/events{/privacy}', 'received_events_url': 'https://api.github.com/users/ezyang/received_events', 'type': 'User', 'site_admin': False}",referenced,f6739be9cb4cccec3b22ae3c11c84927b0738385,https://api.github.com/repos/pytorch/pytorch/commits/f6739be9cb4cccec3b22ae3c11c84927b0738385,2019-06-13T20:21:21Z,27,24,3
20756,2413585405,"{'login': 'ezyang', 'id': 13564, 'node_id': 'MDQ6VXNlcjEzNTY0', 'avatar_url': 'https://avatars0.githubusercontent.com/u/13564?v=4', 'gravatar_id': '', 'url': 'https://api.github.com/users/ezyang', 'html_url': 'https://github.com/ezyang', 'followers_url': 'https://api.github.com/users/ezyang/followers', 'following_url': 'https://api.github.com/users/ezyang/following{/other_user}', 'gists_url': 'https://api.github.com/users/ezyang/gists{/gist_id}', 'starred_url': 'https://api.github.com/users/ezyang/starred{/owner}{/repo}', 'subscriptions_url': 'https://api.github.com/users/ezyang/subscriptions', 'organizations_url': 'https://api.github.com/users/ezyang/orgs', 'repos_url': 'https://api.github.com/users/ezyang/repos', 'events_url': 'https://api.github.com/users/ezyang/events{/privacy}', 'received_events_url': 'https://api.github.com/users/ezyang/received_events', 'type': 'User', 'site_admin': False}",referenced,1fb103ff49d2e0e677763b6eaad458629a29920f,https://api.github.com/repos/pytorch/pytorch/commits/1fb103ff49d2e0e677763b6eaad458629a29920f,2019-06-14T12:54:45Z,5,4,1
20756,2413585577,"{'login': 'ezyang', 'id': 13564, 'node_id': 'MDQ6VXNlcjEzNTY0', 'avatar_url': 'https://avatars0.githubusercontent.com/u/13564?v=4', 'gravatar_id': '', 'url': 'https://api.github.com/users/ezyang', 'html_url': 'https://github.com/ezyang', 'followers_url': 'https://api.github.com/users/ezyang/followers', 'following_url': 'https://api.github.com/users/ezyang/following{/other_user}', 'gists_url': 'https://api.github.com/users/ezyang/gists{/gist_id}', 'starred_url': 'https://api.github.com/users/ezyang/starred{/owner}{/repo}', 'subscriptions_url': 'https://api.github.com/users/ezyang/subscriptions', 'organizations_url': 'https://api.github.com/users/ezyang/orgs', 'repos_url': 'https://api.github.com/users/ezyang/repos', 'events_url': 'https://api.github.com/users/ezyang/events{/privacy}', 'received_events_url': 'https://api.github.com/users/ezyang/received_events', 'type': 'User', 'site_admin': False}",referenced,6ab182c3f4ffbcb71d1685bf5df1093ac06ef69d,https://api.github.com/repos/pytorch/pytorch/commits/6ab182c3f4ffbcb71d1685bf5df1093ac06ef69d,2019-06-14T12:54:50Z,30,27,3
20756,2413789972,"{'login': 'ezyang', 'id': 13564, 'node_id': 'MDQ6VXNlcjEzNTY0', 'avatar_url': 'https://avatars0.githubusercontent.com/u/13564?v=4', 'gravatar_id': '', 'url': 'https://api.github.com/users/ezyang', 'html_url': 'https://github.com/ezyang', 'followers_url': 'https://api.github.com/users/ezyang/followers', 'following_url': 'https://api.github.com/users/ezyang/following{/other_user}', 'gists_url': 'https://api.github.com/users/ezyang/gists{/gist_id}', 'starred_url': 'https://api.github.com/users/ezyang/starred{/owner}{/repo}', 'subscriptions_url': 'https://api.github.com/users/ezyang/subscriptions', 'organizations_url': 'https://api.github.com/users/ezyang/orgs', 'repos_url': 'https://api.github.com/users/ezyang/repos', 'events_url': 'https://api.github.com/users/ezyang/events{/privacy}', 'received_events_url': 'https://api.github.com/users/ezyang/received_events', 'type': 'User', 'site_admin': False}",referenced,c14dede4ea9eccc6ed415e5fbafb360a480c771a,https://api.github.com/repos/pytorch/pytorch/commits/c14dede4ea9eccc6ed415e5fbafb360a480c771a,2019-06-14T14:05:59Z,2,1,1
20756,2413790268,"{'login': 'ezyang', 'id': 13564, 'node_id': 'MDQ6VXNlcjEzNTY0', 'avatar_url': 'https://avatars0.githubusercontent.com/u/13564?v=4', 'gravatar_id': '', 'url': 'https://api.github.com/users/ezyang', 'html_url': 'https://github.com/ezyang', 'followers_url': 'https://api.github.com/users/ezyang/followers', 'following_url': 'https://api.github.com/users/ezyang/following{/other_user}', 'gists_url': 'https://api.github.com/users/ezyang/gists{/gist_id}', 'starred_url': 'https://api.github.com/users/ezyang/starred{/owner}{/repo}', 'subscriptions_url': 'https://api.github.com/users/ezyang/subscriptions', 'organizations_url': 'https://api.github.com/users/ezyang/orgs', 'repos_url': 'https://api.github.com/users/ezyang/repos', 'events_url': 'https://api.github.com/users/ezyang/events{/privacy}', 'received_events_url': 'https://api.github.com/users/ezyang/received_events', 'type': 'User', 'site_admin': False}",referenced,df49530d25239ac4d62eae83c5d7b0d8f00f836a,https://api.github.com/repos/pytorch/pytorch/commits/df49530d25239ac4d62eae83c5d7b0d8f00f836a,2019-06-14T14:06:05Z,30,27,3
20755,2357644362,"{'login': 'facebook-github-bot', 'id': 6422482, 'node_id': 'MDQ6VXNlcjY0MjI0ODI=', 'avatar_url': 'https://avatars3.githubusercontent.com/u/6422482?v=4', 'gravatar_id': '', 'url': 'https://api.github.com/users/facebook-github-bot', 'html_url': 'https://github.com/facebook-github-bot', 'followers_url': 'https://api.github.com/users/facebook-github-bot/followers', 'following_url': 'https://api.github.com/users/facebook-github-bot/following{/other_user}', 'gists_url': 'https://api.github.com/users/facebook-github-bot/gists{/gist_id}', 'starred_url': 'https://api.github.com/users/facebook-github-bot/starred{/owner}{/repo}', 'subscriptions_url': 'https://api.github.com/users/facebook-github-bot/subscriptions', 'organizations_url': 'https://api.github.com/users/facebook-github-bot/orgs', 'repos_url': 'https://api.github.com/users/facebook-github-bot/repos', 'events_url': 'https://api.github.com/users/facebook-github-bot/events{/privacy}', 'received_events_url': 'https://api.github.com/users/facebook-github-bot/received_events', 'type': 'User', 'site_admin': False}",closed,7a0c6d528a12037495847e83bdcd09f7acc1e736,https://api.github.com/repos/pytorch/pytorch/commits/7a0c6d528a12037495847e83bdcd09f7acc1e736,2019-05-21T22:40:30Z,13,13,0
20743,2423129709,"{'login': 'facebook-github-bot', 'id': 6422482, 'node_id': 'MDQ6VXNlcjY0MjI0ODI=', 'avatar_url': 'https://avatars3.githubusercontent.com/u/6422482?v=4', 'gravatar_id': '', 'url': 'https://api.github.com/users/facebook-github-bot', 'html_url': 'https://github.com/facebook-github-bot', 'followers_url': 'https://api.github.com/users/facebook-github-bot/followers', 'following_url': 'https://api.github.com/users/facebook-github-bot/following{/other_user}', 'gists_url': 'https://api.github.com/users/facebook-github-bot/gists{/gist_id}', 'starred_url': 'https://api.github.com/users/facebook-github-bot/starred{/owner}{/repo}', 'subscriptions_url': 'https://api.github.com/users/facebook-github-bot/subscriptions', 'organizations_url': 'https://api.github.com/users/facebook-github-bot/orgs', 'repos_url': 'https://api.github.com/users/facebook-github-bot/repos', 'events_url': 'https://api.github.com/users/facebook-github-bot/events{/privacy}', 'received_events_url': 'https://api.github.com/users/facebook-github-bot/received_events', 'type': 'User', 'site_admin': False}",referenced,34536e207ae48564fb559b7801d69b3ada4af6be,https://api.github.com/repos/pytorch/pytorch/commits/34536e207ae48564fb559b7801d69b3ada4af6be,2019-06-19T07:11:54Z,50,45,5
20694,2368018907,"{'login': 'facebook-github-bot', 'id': 6422482, 'node_id': 'MDQ6VXNlcjY0MjI0ODI=', 'avatar_url': 'https://avatars3.githubusercontent.com/u/6422482?v=4', 'gravatar_id': '', 'url': 'https://api.github.com/users/facebook-github-bot', 'html_url': 'https://github.com/facebook-github-bot', 'followers_url': 'https://api.github.com/users/facebook-github-bot/followers', 'following_url': 'https://api.github.com/users/facebook-github-bot/following{/other_user}', 'gists_url': 'https://api.github.com/users/facebook-github-bot/gists{/gist_id}', 'starred_url': 'https://api.github.com/users/facebook-github-bot/starred{/owner}{/repo}', 'subscriptions_url': 'https://api.github.com/users/facebook-github-bot/subscriptions', 'organizations_url': 'https://api.github.com/users/facebook-github-bot/orgs', 'repos_url': 'https://api.github.com/users/facebook-github-bot/repos', 'events_url': 'https://api.github.com/users/facebook-github-bot/events{/privacy}', 'received_events_url': 'https://api.github.com/users/facebook-github-bot/received_events', 'type': 'User', 'site_admin': False}",closed,5e69e76aba4d75664920832a1e584f14350f160d,https://api.github.com/repos/pytorch/pytorch/commits/5e69e76aba4d75664920832a1e584f14350f160d,2019-05-26T21:55:26Z,11,4,7
20651,2353270877,"{'login': 'facebook-github-bot', 'id': 6422482, 'node_id': 'MDQ6VXNlcjY0MjI0ODI=', 'avatar_url': 'https://avatars3.githubusercontent.com/u/6422482?v=4', 'gravatar_id': '', 'url': 'https://api.github.com/users/facebook-github-bot', 'html_url': 'https://github.com/facebook-github-bot', 'followers_url': 'https://api.github.com/users/facebook-github-bot/followers', 'following_url': 'https://api.github.com/users/facebook-github-bot/following{/other_user}', 'gists_url': 'https://api.github.com/users/facebook-github-bot/gists{/gist_id}', 'starred_url': 'https://api.github.com/users/facebook-github-bot/starred{/owner}{/repo}', 'subscriptions_url': 'https://api.github.com/users/facebook-github-bot/subscriptions', 'organizations_url': 'https://api.github.com/users/facebook-github-bot/orgs', 'repos_url': 'https://api.github.com/users/facebook-github-bot/repos', 'events_url': 'https://api.github.com/users/facebook-github-bot/events{/privacy}', 'received_events_url': 'https://api.github.com/users/facebook-github-bot/received_events', 'type': 'User', 'site_admin': False}",closed,8acaa286b76adda792dc59948efc5e8621d8447e,https://api.github.com/repos/pytorch/pytorch/commits/8acaa286b76adda792dc59948efc5e8621d8447e,2019-05-20T14:16:34Z,56,46,10
20642,2363488047,"{'login': 'facebook-github-bot', 'id': 6422482, 'node_id': 'MDQ6VXNlcjY0MjI0ODI=', 'avatar_url': 'https://avatars3.githubusercontent.com/u/6422482?v=4', 'gravatar_id': '', 'url': 'https://api.github.com/users/facebook-github-bot', 'html_url': 'https://github.com/facebook-github-bot', 'followers_url': 'https://api.github.com/users/facebook-github-bot/followers', 'following_url': 'https://api.github.com/users/facebook-github-bot/following{/other_user}', 'gists_url': 'https://api.github.com/users/facebook-github-bot/gists{/gist_id}', 'starred_url': 'https://api.github.com/users/facebook-github-bot/starred{/owner}{/repo}', 'subscriptions_url': 'https://api.github.com/users/facebook-github-bot/subscriptions', 'organizations_url': 'https://api.github.com/users/facebook-github-bot/orgs', 'repos_url': 'https://api.github.com/users/facebook-github-bot/repos', 'events_url': 'https://api.github.com/users/facebook-github-bot/events{/privacy}', 'received_events_url': 'https://api.github.com/users/facebook-github-bot/received_events', 'type': 'User', 'site_admin': False}",closed,5f83c5d8349fb0c3645146efe7ad4b4f20fca457,https://api.github.com/repos/pytorch/pytorch/commits/5f83c5d8349fb0c3645146efe7ad4b4f20fca457,2019-05-23T19:14:21Z,2,1,1
20630,2367974282,"{'login': 'facebook-github-bot', 'id': 6422482, 'node_id': 'MDQ6VXNlcjY0MjI0ODI=', 'avatar_url': 'https://avatars3.githubusercontent.com/u/6422482?v=4', 'gravatar_id': '', 'url': 'https://api.github.com/users/facebook-github-bot', 'html_url': 'https://github.com/facebook-github-bot', 'followers_url': 'https://api.github.com/users/facebook-github-bot/followers', 'following_url': 'https://api.github.com/users/facebook-github-bot/following{/other_user}', 'gists_url': 'https://api.github.com/users/facebook-github-bot/gists{/gist_id}', 'starred_url': 'https://api.github.com/users/facebook-github-bot/starred{/owner}{/repo}', 'subscriptions_url': 'https://api.github.com/users/facebook-github-bot/subscriptions', 'organizations_url': 'https://api.github.com/users/facebook-github-bot/orgs', 'repos_url': 'https://api.github.com/users/facebook-github-bot/repos', 'events_url': 'https://api.github.com/users/facebook-github-bot/events{/privacy}', 'received_events_url': 'https://api.github.com/users/facebook-github-bot/received_events', 'type': 'User', 'site_admin': False}",closed,4c5b1e3460294a57141ebeafa77212a17a25eda5,https://api.github.com/repos/pytorch/pytorch/commits/4c5b1e3460294a57141ebeafa77212a17a25eda5,2019-05-26T20:02:50Z,2,1,1
20615,2895673361,"{'login': 'facebook-github-bot', 'id': 6422482, 'node_id': 'MDQ6VXNlcjY0MjI0ODI=', 'avatar_url': 'https://avatars3.githubusercontent.com/u/6422482?v=4', 'gravatar_id': '', 'url': 'https://api.github.com/users/facebook-github-bot', 'html_url': 'https://github.com/facebook-github-bot', 'followers_url': 'https://api.github.com/users/facebook-github-bot/followers', 'following_url': 'https://api.github.com/users/facebook-github-bot/following{/other_user}', 'gists_url': 'https://api.github.com/users/facebook-github-bot/gists{/gist_id}', 'starred_url': 'https://api.github.com/users/facebook-github-bot/starred{/owner}{/repo}', 'subscriptions_url': 'https://api.github.com/users/facebook-github-bot/subscriptions', 'organizations_url': 'https://api.github.com/users/facebook-github-bot/orgs', 'repos_url': 'https://api.github.com/users/facebook-github-bot/repos', 'events_url': 'https://api.github.com/users/facebook-github-bot/events{/privacy}', 'received_events_url': 'https://api.github.com/users/facebook-github-bot/received_events', 'type': 'User', 'site_admin': False}",closed,e1509cb468b2b00ab3fab674f9b40f501b216742,https://api.github.com/repos/pytorch/pytorch/commits/e1509cb468b2b00ab3fab674f9b40f501b216742,2019-12-19T02:19:36Z,150,147,3
20615,2899650884,"{'login': 'facebook-github-bot', 'id': 6422482, 'node_id': 'MDQ6VXNlcjY0MjI0ODI=', 'avatar_url': 'https://avatars3.githubusercontent.com/u/6422482?v=4', 'gravatar_id': '', 'url': 'https://api.github.com/users/facebook-github-bot', 'html_url': 'https://github.com/facebook-github-bot', 'followers_url': 'https://api.github.com/users/facebook-github-bot/followers', 'following_url': 'https://api.github.com/users/facebook-github-bot/following{/other_user}', 'gists_url': 'https://api.github.com/users/facebook-github-bot/gists{/gist_id}', 'starred_url': 'https://api.github.com/users/facebook-github-bot/starred{/owner}{/repo}', 'subscriptions_url': 'https://api.github.com/users/facebook-github-bot/subscriptions', 'organizations_url': 'https://api.github.com/users/facebook-github-bot/orgs', 'repos_url': 'https://api.github.com/users/facebook-github-bot/repos', 'events_url': 'https://api.github.com/users/facebook-github-bot/events{/privacy}', 'received_events_url': 'https://api.github.com/users/facebook-github-bot/received_events', 'type': 'User', 'site_admin': False}",referenced,06dbef663d72be2c6ef7661ac5972d788f66a801,https://api.github.com/repos/pytorch/pytorch/commits/06dbef663d72be2c6ef7661ac5972d788f66a801,2019-12-20T05:48:24Z,155,151,4
20579,2363193210,"{'login': 'facebook-github-bot', 'id': 6422482, 'node_id': 'MDQ6VXNlcjY0MjI0ODI=', 'avatar_url': 'https://avatars3.githubusercontent.com/u/6422482?v=4', 'gravatar_id': '', 'url': 'https://api.github.com/users/facebook-github-bot', 'html_url': 'https://github.com/facebook-github-bot', 'followers_url': 'https://api.github.com/users/facebook-github-bot/followers', 'following_url': 'https://api.github.com/users/facebook-github-bot/following{/other_user}', 'gists_url': 'https://api.github.com/users/facebook-github-bot/gists{/gist_id}', 'starred_url': 'https://api.github.com/users/facebook-github-bot/starred{/owner}{/repo}', 'subscriptions_url': 'https://api.github.com/users/facebook-github-bot/subscriptions', 'organizations_url': 'https://api.github.com/users/facebook-github-bot/orgs', 'repos_url': 'https://api.github.com/users/facebook-github-bot/repos', 'events_url': 'https://api.github.com/users/facebook-github-bot/events{/privacy}', 'received_events_url': 'https://api.github.com/users/facebook-github-bot/received_events', 'type': 'User', 'site_admin': False}",closed,99b3f5cd705018c96b5559daa89aa71e66fc7e8a,https://api.github.com/repos/pytorch/pytorch/commits/99b3f5cd705018c96b5559daa89aa71e66fc7e8a,2019-05-23T17:20:22Z,2,1,1
20568,2349523706,"{'login': 'facebook-github-bot', 'id': 6422482, 'node_id': 'MDQ6VXNlcjY0MjI0ODI=', 'avatar_url': 'https://avatars3.githubusercontent.com/u/6422482?v=4', 'gravatar_id': '', 'url': 'https://api.github.com/users/facebook-github-bot', 'html_url': 'https://github.com/facebook-github-bot', 'followers_url': 'https://api.github.com/users/facebook-github-bot/followers', 'following_url': 'https://api.github.com/users/facebook-github-bot/following{/other_user}', 'gists_url': 'https://api.github.com/users/facebook-github-bot/gists{/gist_id}', 'starred_url': 'https://api.github.com/users/facebook-github-bot/starred{/owner}{/repo}', 'subscriptions_url': 'https://api.github.com/users/facebook-github-bot/subscriptions', 'organizations_url': 'https://api.github.com/users/facebook-github-bot/orgs', 'repos_url': 'https://api.github.com/users/facebook-github-bot/repos', 'events_url': 'https://api.github.com/users/facebook-github-bot/events{/privacy}', 'received_events_url': 'https://api.github.com/users/facebook-github-bot/received_events', 'type': 'User', 'site_admin': False}",closed,3bc0bd953482e079827a96a9f6c5509c43b7c7c9,https://api.github.com/repos/pytorch/pytorch/commits/3bc0bd953482e079827a96a9f6c5509c43b7c7c9,2019-05-17T14:24:21Z,4,3,1
20548,2360214602,"{'login': 'facebook-github-bot', 'id': 6422482, 'node_id': 'MDQ6VXNlcjY0MjI0ODI=', 'avatar_url': 'https://avatars3.githubusercontent.com/u/6422482?v=4', 'gravatar_id': '', 'url': 'https://api.github.com/users/facebook-github-bot', 'html_url': 'https://github.com/facebook-github-bot', 'followers_url': 'https://api.github.com/users/facebook-github-bot/followers', 'following_url': 'https://api.github.com/users/facebook-github-bot/following{/other_user}', 'gists_url': 'https://api.github.com/users/facebook-github-bot/gists{/gist_id}', 'starred_url': 'https://api.github.com/users/facebook-github-bot/starred{/owner}{/repo}', 'subscriptions_url': 'https://api.github.com/users/facebook-github-bot/subscriptions', 'organizations_url': 'https://api.github.com/users/facebook-github-bot/orgs', 'repos_url': 'https://api.github.com/users/facebook-github-bot/repos', 'events_url': 'https://api.github.com/users/facebook-github-bot/events{/privacy}', 'received_events_url': 'https://api.github.com/users/facebook-github-bot/received_events', 'type': 'User', 'site_admin': False}",closed,4e0d098ace3492847d3d2a426441eac1de4c1977,https://api.github.com/repos/pytorch/pytorch/commits/4e0d098ace3492847d3d2a426441eac1de4c1977,2019-05-22T18:30:12Z,2,1,1
20535,2506714238,"{'login': 'facebook-github-bot', 'id': 6422482, 'node_id': 'MDQ6VXNlcjY0MjI0ODI=', 'avatar_url': 'https://avatars3.githubusercontent.com/u/6422482?v=4', 'gravatar_id': '', 'url': 'https://api.github.com/users/facebook-github-bot', 'html_url': 'https://github.com/facebook-github-bot', 'followers_url': 'https://api.github.com/users/facebook-github-bot/followers', 'following_url': 'https://api.github.com/users/facebook-github-bot/following{/other_user}', 'gists_url': 'https://api.github.com/users/facebook-github-bot/gists{/gist_id}', 'starred_url': 'https://api.github.com/users/facebook-github-bot/starred{/owner}{/repo}', 'subscriptions_url': 'https://api.github.com/users/facebook-github-bot/subscriptions', 'organizations_url': 'https://api.github.com/users/facebook-github-bot/orgs', 'repos_url': 'https://api.github.com/users/facebook-github-bot/repos', 'events_url': 'https://api.github.com/users/facebook-github-bot/events{/privacy}', 'received_events_url': 'https://api.github.com/users/facebook-github-bot/received_events', 'type': 'User', 'site_admin': False}",closed,7203612f852e57b3f1667a614444bbb24beec7fb,https://api.github.com/repos/pytorch/pytorch/commits/7203612f852e57b3f1667a614444bbb24beec7fb,2019-07-24T15:21:06Z,4,2,2
20535,2507199852,"{'login': 'facebook-github-bot', 'id': 6422482, 'node_id': 'MDQ6VXNlcjY0MjI0ODI=', 'avatar_url': 'https://avatars3.githubusercontent.com/u/6422482?v=4', 'gravatar_id': '', 'url': 'https://api.github.com/users/facebook-github-bot', 'html_url': 'https://github.com/facebook-github-bot', 'followers_url': 'https://api.github.com/users/facebook-github-bot/followers', 'following_url': 'https://api.github.com/users/facebook-github-bot/following{/other_user}', 'gists_url': 'https://api.github.com/users/facebook-github-bot/gists{/gist_id}', 'starred_url': 'https://api.github.com/users/facebook-github-bot/starred{/owner}{/repo}', 'subscriptions_url': 'https://api.github.com/users/facebook-github-bot/subscriptions', 'organizations_url': 'https://api.github.com/users/facebook-github-bot/orgs', 'repos_url': 'https://api.github.com/users/facebook-github-bot/repos', 'events_url': 'https://api.github.com/users/facebook-github-bot/events{/privacy}', 'received_events_url': 'https://api.github.com/users/facebook-github-bot/received_events', 'type': 'User', 'site_admin': False}",referenced,eb51131fb4be155005506a76a4d506e5dc1e7741,https://api.github.com/repos/pytorch/pytorch/commits/eb51131fb4be155005506a76a4d506e5dc1e7741,2019-07-24T18:13:01Z,4,2,2
20529,2395592691,"{'login': 'facebook-github-bot', 'id': 6422482, 'node_id': 'MDQ6VXNlcjY0MjI0ODI=', 'avatar_url': 'https://avatars3.githubusercontent.com/u/6422482?v=4', 'gravatar_id': '', 'url': 'https://api.github.com/users/facebook-github-bot', 'html_url': 'https://github.com/facebook-github-bot', 'followers_url': 'https://api.github.com/users/facebook-github-bot/followers', 'following_url': 'https://api.github.com/users/facebook-github-bot/following{/other_user}', 'gists_url': 'https://api.github.com/users/facebook-github-bot/gists{/gist_id}', 'starred_url': 'https://api.github.com/users/facebook-github-bot/starred{/owner}{/repo}', 'subscriptions_url': 'https://api.github.com/users/facebook-github-bot/subscriptions', 'organizations_url': 'https://api.github.com/users/facebook-github-bot/orgs', 'repos_url': 'https://api.github.com/users/facebook-github-bot/repos', 'events_url': 'https://api.github.com/users/facebook-github-bot/events{/privacy}', 'received_events_url': 'https://api.github.com/users/facebook-github-bot/received_events', 'type': 'User', 'site_admin': False}",closed,3feb40d602490a99d2794b2b5d5fc35a2657b919,https://api.github.com/repos/pytorch/pytorch/commits/3feb40d602490a99d2794b2b5d5fc35a2657b919,2019-06-06T20:44:32Z,5,4,1
20528,2411631316,"{'login': 'ezyang', 'id': 13564, 'node_id': 'MDQ6VXNlcjEzNTY0', 'avatar_url': 'https://avatars0.githubusercontent.com/u/13564?v=4', 'gravatar_id': '', 'url': 'https://api.github.com/users/ezyang', 'html_url': 'https://github.com/ezyang', 'followers_url': 'https://api.github.com/users/ezyang/followers', 'following_url': 'https://api.github.com/users/ezyang/following{/other_user}', 'gists_url': 'https://api.github.com/users/ezyang/gists{/gist_id}', 'starred_url': 'https://api.github.com/users/ezyang/starred{/owner}{/repo}', 'subscriptions_url': 'https://api.github.com/users/ezyang/subscriptions', 'organizations_url': 'https://api.github.com/users/ezyang/orgs', 'repos_url': 'https://api.github.com/users/ezyang/repos', 'events_url': 'https://api.github.com/users/ezyang/events{/privacy}', 'received_events_url': 'https://api.github.com/users/ezyang/received_events', 'type': 'User', 'site_admin': False}",referenced,8142026447e783fd816143a37708b6ae1fb9ad06,https://api.github.com/repos/pytorch/pytorch/commits/8142026447e783fd816143a37708b6ae1fb9ad06,2019-06-13T19:06:41Z,10,9,1
20528,2411631604,"{'login': 'ezyang', 'id': 13564, 'node_id': 'MDQ6VXNlcjEzNTY0', 'avatar_url': 'https://avatars0.githubusercontent.com/u/13564?v=4', 'gravatar_id': '', 'url': 'https://api.github.com/users/ezyang', 'html_url': 'https://github.com/ezyang', 'followers_url': 'https://api.github.com/users/ezyang/followers', 'following_url': 'https://api.github.com/users/ezyang/following{/other_user}', 'gists_url': 'https://api.github.com/users/ezyang/gists{/gist_id}', 'starred_url': 'https://api.github.com/users/ezyang/starred{/owner}{/repo}', 'subscriptions_url': 'https://api.github.com/users/ezyang/subscriptions', 'organizations_url': 'https://api.github.com/users/ezyang/orgs', 'repos_url': 'https://api.github.com/users/ezyang/repos', 'events_url': 'https://api.github.com/users/ezyang/events{/privacy}', 'received_events_url': 'https://api.github.com/users/ezyang/received_events', 'type': 'User', 'site_admin': False}",referenced,dfb53759024d9ba9d104fdb2a8151ab996e55234,https://api.github.com/repos/pytorch/pytorch/commits/dfb53759024d9ba9d104fdb2a8151ab996e55234,2019-06-13T19:06:48Z,10,9,1
20525,2370738939,"{'login': 'facebook-github-bot', 'id': 6422482, 'node_id': 'MDQ6VXNlcjY0MjI0ODI=', 'avatar_url': 'https://avatars3.githubusercontent.com/u/6422482?v=4', 'gravatar_id': '', 'url': 'https://api.github.com/users/facebook-github-bot', 'html_url': 'https://github.com/facebook-github-bot', 'followers_url': 'https://api.github.com/users/facebook-github-bot/followers', 'following_url': 'https://api.github.com/users/facebook-github-bot/following{/other_user}', 'gists_url': 'https://api.github.com/users/facebook-github-bot/gists{/gist_id}', 'starred_url': 'https://api.github.com/users/facebook-github-bot/starred{/owner}{/repo}', 'subscriptions_url': 'https://api.github.com/users/facebook-github-bot/subscriptions', 'organizations_url': 'https://api.github.com/users/facebook-github-bot/orgs', 'repos_url': 'https://api.github.com/users/facebook-github-bot/repos', 'events_url': 'https://api.github.com/users/facebook-github-bot/events{/privacy}', 'received_events_url': 'https://api.github.com/users/facebook-github-bot/received_events', 'type': 'User', 'site_admin': False}",closed,f4b434a6a53d9fe45283aee8572174f94a79f558,https://api.github.com/repos/pytorch/pytorch/commits/f4b434a6a53d9fe45283aee8572174f94a79f558,2019-05-28T06:49:15Z,6,5,1
20523,2349501391,"{'login': 'facebook-github-bot', 'id': 6422482, 'node_id': 'MDQ6VXNlcjY0MjI0ODI=', 'avatar_url': 'https://avatars3.githubusercontent.com/u/6422482?v=4', 'gravatar_id': '', 'url': 'https://api.github.com/users/facebook-github-bot', 'html_url': 'https://github.com/facebook-github-bot', 'followers_url': 'https://api.github.com/users/facebook-github-bot/followers', 'following_url': 'https://api.github.com/users/facebook-github-bot/following{/other_user}', 'gists_url': 'https://api.github.com/users/facebook-github-bot/gists{/gist_id}', 'starred_url': 'https://api.github.com/users/facebook-github-bot/starred{/owner}{/repo}', 'subscriptions_url': 'https://api.github.com/users/facebook-github-bot/subscriptions', 'organizations_url': 'https://api.github.com/users/facebook-github-bot/orgs', 'repos_url': 'https://api.github.com/users/facebook-github-bot/repos', 'events_url': 'https://api.github.com/users/facebook-github-bot/events{/privacy}', 'received_events_url': 'https://api.github.com/users/facebook-github-bot/received_events', 'type': 'User', 'site_admin': False}",closed,4c806a9e8a0fd3a40a392bed3b3f0859188609d1,https://api.github.com/repos/pytorch/pytorch/commits/4c806a9e8a0fd3a40a392bed3b3f0859188609d1,2019-05-17T14:16:58Z,5,4,1
20522,2374894138,"{'login': 'facebook-github-bot', 'id': 6422482, 'node_id': 'MDQ6VXNlcjY0MjI0ODI=', 'avatar_url': 'https://avatars3.githubusercontent.com/u/6422482?v=4', 'gravatar_id': '', 'url': 'https://api.github.com/users/facebook-github-bot', 'html_url': 'https://github.com/facebook-github-bot', 'followers_url': 'https://api.github.com/users/facebook-github-bot/followers', 'following_url': 'https://api.github.com/users/facebook-github-bot/following{/other_user}', 'gists_url': 'https://api.github.com/users/facebook-github-bot/gists{/gist_id}', 'starred_url': 'https://api.github.com/users/facebook-github-bot/starred{/owner}{/repo}', 'subscriptions_url': 'https://api.github.com/users/facebook-github-bot/subscriptions', 'organizations_url': 'https://api.github.com/users/facebook-github-bot/orgs', 'repos_url': 'https://api.github.com/users/facebook-github-bot/repos', 'events_url': 'https://api.github.com/users/facebook-github-bot/events{/privacy}', 'received_events_url': 'https://api.github.com/users/facebook-github-bot/received_events', 'type': 'User', 'site_admin': False}",closed,aa42742df0ea7bee8281f15265efae0351ebfbdc,https://api.github.com/repos/pytorch/pytorch/commits/aa42742df0ea7bee8281f15265efae0351ebfbdc,2019-05-29T12:15:40Z,14,7,7
20500,2641285445,"{'login': 'facebook-github-bot', 'id': 6422482, 'node_id': 'MDQ6VXNlcjY0MjI0ODI=', 'avatar_url': 'https://avatars3.githubusercontent.com/u/6422482?v=4', 'gravatar_id': '', 'url': 'https://api.github.com/users/facebook-github-bot', 'html_url': 'https://github.com/facebook-github-bot', 'followers_url': 'https://api.github.com/users/facebook-github-bot/followers', 'following_url': 'https://api.github.com/users/facebook-github-bot/following{/other_user}', 'gists_url': 'https://api.github.com/users/facebook-github-bot/gists{/gist_id}', 'starred_url': 'https://api.github.com/users/facebook-github-bot/starred{/owner}{/repo}', 'subscriptions_url': 'https://api.github.com/users/facebook-github-bot/subscriptions', 'organizations_url': 'https://api.github.com/users/facebook-github-bot/orgs', 'repos_url': 'https://api.github.com/users/facebook-github-bot/repos', 'events_url': 'https://api.github.com/users/facebook-github-bot/events{/privacy}', 'received_events_url': 'https://api.github.com/users/facebook-github-bot/received_events', 'type': 'User', 'site_admin': False}",referenced,a8073f34afc4e2a708af833e6d5ca773ddd9d72b,https://api.github.com/repos/pytorch/pytorch/commits/a8073f34afc4e2a708af833e6d5ca773ddd9d72b,2019-09-17T20:47:57Z,197,150,47
20500,2648618795,"{'login': 'facebook-github-bot', 'id': 6422482, 'node_id': 'MDQ6VXNlcjY0MjI0ODI=', 'avatar_url': 'https://avatars3.githubusercontent.com/u/6422482?v=4', 'gravatar_id': '', 'url': 'https://api.github.com/users/facebook-github-bot', 'html_url': 'https://github.com/facebook-github-bot', 'followers_url': 'https://api.github.com/users/facebook-github-bot/followers', 'following_url': 'https://api.github.com/users/facebook-github-bot/following{/other_user}', 'gists_url': 'https://api.github.com/users/facebook-github-bot/gists{/gist_id}', 'starred_url': 'https://api.github.com/users/facebook-github-bot/starred{/owner}{/repo}', 'subscriptions_url': 'https://api.github.com/users/facebook-github-bot/subscriptions', 'organizations_url': 'https://api.github.com/users/facebook-github-bot/orgs', 'repos_url': 'https://api.github.com/users/facebook-github-bot/repos', 'events_url': 'https://api.github.com/users/facebook-github-bot/events{/privacy}', 'received_events_url': 'https://api.github.com/users/facebook-github-bot/received_events', 'type': 'User', 'site_admin': False}",referenced,0f42881269d10056108e51320533ea2e55ade221,https://api.github.com/repos/pytorch/pytorch/commits/0f42881269d10056108e51320533ea2e55ade221,2019-09-19T22:46:39Z,200,158,42
20499,2347045862,"{'login': 'facebook-github-bot', 'id': 6422482, 'node_id': 'MDQ6VXNlcjY0MjI0ODI=', 'avatar_url': 'https://avatars3.githubusercontent.com/u/6422482?v=4', 'gravatar_id': '', 'url': 'https://api.github.com/users/facebook-github-bot', 'html_url': 'https://github.com/facebook-github-bot', 'followers_url': 'https://api.github.com/users/facebook-github-bot/followers', 'following_url': 'https://api.github.com/users/facebook-github-bot/following{/other_user}', 'gists_url': 'https://api.github.com/users/facebook-github-bot/gists{/gist_id}', 'starred_url': 'https://api.github.com/users/facebook-github-bot/starred{/owner}{/repo}', 'subscriptions_url': 'https://api.github.com/users/facebook-github-bot/subscriptions', 'organizations_url': 'https://api.github.com/users/facebook-github-bot/orgs', 'repos_url': 'https://api.github.com/users/facebook-github-bot/repos', 'events_url': 'https://api.github.com/users/facebook-github-bot/events{/privacy}', 'received_events_url': 'https://api.github.com/users/facebook-github-bot/received_events', 'type': 'User', 'site_admin': False}",referenced,66c61332647daf311ac7bf475e02966a0bd3d034,https://api.github.com/repos/pytorch/pytorch/commits/66c61332647daf311ac7bf475e02966a0bd3d034,2019-05-16T16:36:29Z,17,15,2
20495,2372894093,"{'login': 'facebook-github-bot', 'id': 6422482, 'node_id': 'MDQ6VXNlcjY0MjI0ODI=', 'avatar_url': 'https://avatars3.githubusercontent.com/u/6422482?v=4', 'gravatar_id': '', 'url': 'https://api.github.com/users/facebook-github-bot', 'html_url': 'https://github.com/facebook-github-bot', 'followers_url': 'https://api.github.com/users/facebook-github-bot/followers', 'following_url': 'https://api.github.com/users/facebook-github-bot/following{/other_user}', 'gists_url': 'https://api.github.com/users/facebook-github-bot/gists{/gist_id}', 'starred_url': 'https://api.github.com/users/facebook-github-bot/starred{/owner}{/repo}', 'subscriptions_url': 'https://api.github.com/users/facebook-github-bot/subscriptions', 'organizations_url': 'https://api.github.com/users/facebook-github-bot/orgs', 'repos_url': 'https://api.github.com/users/facebook-github-bot/repos', 'events_url': 'https://api.github.com/users/facebook-github-bot/events{/privacy}', 'received_events_url': 'https://api.github.com/users/facebook-github-bot/received_events', 'type': 'User', 'site_admin': False}",closed,52d27890dc4bea72f58d7b861201ea5ab5986c29,https://api.github.com/repos/pytorch/pytorch/commits/52d27890dc4bea72f58d7b861201ea5ab5986c29,2019-05-28T19:30:20Z,88,57,31
20465,2507754367,"{'login': 'facebook-github-bot', 'id': 6422482, 'node_id': 'MDQ6VXNlcjY0MjI0ODI=', 'avatar_url': 'https://avatars3.githubusercontent.com/u/6422482?v=4', 'gravatar_id': '', 'url': 'https://api.github.com/users/facebook-github-bot', 'html_url': 'https://github.com/facebook-github-bot', 'followers_url': 'https://api.github.com/users/facebook-github-bot/followers', 'following_url': 'https://api.github.com/users/facebook-github-bot/following{/other_user}', 'gists_url': 'https://api.github.com/users/facebook-github-bot/gists{/gist_id}', 'starred_url': 'https://api.github.com/users/facebook-github-bot/starred{/owner}{/repo}', 'subscriptions_url': 'https://api.github.com/users/facebook-github-bot/subscriptions', 'organizations_url': 'https://api.github.com/users/facebook-github-bot/orgs', 'repos_url': 'https://api.github.com/users/facebook-github-bot/repos', 'events_url': 'https://api.github.com/users/facebook-github-bot/events{/privacy}', 'received_events_url': 'https://api.github.com/users/facebook-github-bot/received_events', 'type': 'User', 'site_admin': False}",closed,87d3f6650648dbd44fd1d6e91bd65227e0d68214,https://api.github.com/repos/pytorch/pytorch/commits/87d3f6650648dbd44fd1d6e91bd65227e0d68214,2019-07-24T21:54:22Z,56,35,21
20457,2385847341,"{'login': 'facebook-github-bot', 'id': 6422482, 'node_id': 'MDQ6VXNlcjY0MjI0ODI=', 'avatar_url': 'https://avatars3.githubusercontent.com/u/6422482?v=4', 'gravatar_id': '', 'url': 'https://api.github.com/users/facebook-github-bot', 'html_url': 'https://github.com/facebook-github-bot', 'followers_url': 'https://api.github.com/users/facebook-github-bot/followers', 'following_url': 'https://api.github.com/users/facebook-github-bot/following{/other_user}', 'gists_url': 'https://api.github.com/users/facebook-github-bot/gists{/gist_id}', 'starred_url': 'https://api.github.com/users/facebook-github-bot/starred{/owner}{/repo}', 'subscriptions_url': 'https://api.github.com/users/facebook-github-bot/subscriptions', 'organizations_url': 'https://api.github.com/users/facebook-github-bot/orgs', 'repos_url': 'https://api.github.com/users/facebook-github-bot/repos', 'events_url': 'https://api.github.com/users/facebook-github-bot/events{/privacy}', 'received_events_url': 'https://api.github.com/users/facebook-github-bot/received_events', 'type': 'User', 'site_admin': False}",closed,ad971a37d0c5732296dcfb186211cc6e285efc89,https://api.github.com/repos/pytorch/pytorch/commits/ad971a37d0c5732296dcfb186211cc6e285efc89,2019-06-03T18:41:28Z,666,442,224
20449,2663539782,"{'login': 'facebook-github-bot', 'id': 6422482, 'node_id': 'MDQ6VXNlcjY0MjI0ODI=', 'avatar_url': 'https://avatars3.githubusercontent.com/u/6422482?v=4', 'gravatar_id': '', 'url': 'https://api.github.com/users/facebook-github-bot', 'html_url': 'https://github.com/facebook-github-bot', 'followers_url': 'https://api.github.com/users/facebook-github-bot/followers', 'following_url': 'https://api.github.com/users/facebook-github-bot/following{/other_user}', 'gists_url': 'https://api.github.com/users/facebook-github-bot/gists{/gist_id}', 'starred_url': 'https://api.github.com/users/facebook-github-bot/starred{/owner}{/repo}', 'subscriptions_url': 'https://api.github.com/users/facebook-github-bot/subscriptions', 'organizations_url': 'https://api.github.com/users/facebook-github-bot/orgs', 'repos_url': 'https://api.github.com/users/facebook-github-bot/repos', 'events_url': 'https://api.github.com/users/facebook-github-bot/events{/privacy}', 'received_events_url': 'https://api.github.com/users/facebook-github-bot/received_events', 'type': 'User', 'site_admin': False}",referenced,90ffab6e3713a40f47f4c9d3d3b16d56e83f97c4,https://api.github.com/repos/pytorch/pytorch/commits/90ffab6e3713a40f47f4c9d3d3b16d56e83f97c4,2019-09-26T00:38:28Z,121,119,2
20421,2408406996,"{'login': 'facebook-github-bot', 'id': 6422482, 'node_id': 'MDQ6VXNlcjY0MjI0ODI=', 'avatar_url': 'https://avatars3.githubusercontent.com/u/6422482?v=4', 'gravatar_id': '', 'url': 'https://api.github.com/users/facebook-github-bot', 'html_url': 'https://github.com/facebook-github-bot', 'followers_url': 'https://api.github.com/users/facebook-github-bot/followers', 'following_url': 'https://api.github.com/users/facebook-github-bot/following{/other_user}', 'gists_url': 'https://api.github.com/users/facebook-github-bot/gists{/gist_id}', 'starred_url': 'https://api.github.com/users/facebook-github-bot/starred{/owner}{/repo}', 'subscriptions_url': 'https://api.github.com/users/facebook-github-bot/subscriptions', 'organizations_url': 'https://api.github.com/users/facebook-github-bot/orgs', 'repos_url': 'https://api.github.com/users/facebook-github-bot/repos', 'events_url': 'https://api.github.com/users/facebook-github-bot/events{/privacy}', 'received_events_url': 'https://api.github.com/users/facebook-github-bot/received_events', 'type': 'User', 'site_admin': False}",closed,39d412194f1e51338bb0a897742480e11b8e5a2b,https://api.github.com/repos/pytorch/pytorch/commits/39d412194f1e51338bb0a897742480e11b8e5a2b,2019-06-12T19:02:19Z,31,28,3
20356,2825204593,"{'login': 'facebook-github-bot', 'id': 6422482, 'node_id': 'MDQ6VXNlcjY0MjI0ODI=', 'avatar_url': 'https://avatars3.githubusercontent.com/u/6422482?v=4', 'gravatar_id': '', 'url': 'https://api.github.com/users/facebook-github-bot', 'html_url': 'https://github.com/facebook-github-bot', 'followers_url': 'https://api.github.com/users/facebook-github-bot/followers', 'following_url': 'https://api.github.com/users/facebook-github-bot/following{/other_user}', 'gists_url': 'https://api.github.com/users/facebook-github-bot/gists{/gist_id}', 'starred_url': 'https://api.github.com/users/facebook-github-bot/starred{/owner}{/repo}', 'subscriptions_url': 'https://api.github.com/users/facebook-github-bot/subscriptions', 'organizations_url': 'https://api.github.com/users/facebook-github-bot/orgs', 'repos_url': 'https://api.github.com/users/facebook-github-bot/repos', 'events_url': 'https://api.github.com/users/facebook-github-bot/events{/privacy}', 'received_events_url': 'https://api.github.com/users/facebook-github-bot/received_events', 'type': 'User', 'site_admin': False}",closed,2a7a39c1af96fc7816c886644eaf127c5ab53b89,https://api.github.com/repos/pytorch/pytorch/commits/2a7a39c1af96fc7816c886644eaf127c5ab53b89,2019-11-23T08:06:19Z,350,247,103
20322,2411800541,"{'login': 'facebook-github-bot', 'id': 6422482, 'node_id': 'MDQ6VXNlcjY0MjI0ODI=', 'avatar_url': 'https://avatars3.githubusercontent.com/u/6422482?v=4', 'gravatar_id': '', 'url': 'https://api.github.com/users/facebook-github-bot', 'html_url': 'https://github.com/facebook-github-bot', 'followers_url': 'https://api.github.com/users/facebook-github-bot/followers', 'following_url': 'https://api.github.com/users/facebook-github-bot/following{/other_user}', 'gists_url': 'https://api.github.com/users/facebook-github-bot/gists{/gist_id}', 'starred_url': 'https://api.github.com/users/facebook-github-bot/starred{/owner}{/repo}', 'subscriptions_url': 'https://api.github.com/users/facebook-github-bot/subscriptions', 'organizations_url': 'https://api.github.com/users/facebook-github-bot/orgs', 'repos_url': 'https://api.github.com/users/facebook-github-bot/repos', 'events_url': 'https://api.github.com/users/facebook-github-bot/events{/privacy}', 'received_events_url': 'https://api.github.com/users/facebook-github-bot/received_events', 'type': 'User', 'site_admin': False}",referenced,4b45f08f8765549915417997c30ae8981f2ad125,https://api.github.com/repos/pytorch/pytorch/commits/4b45f08f8765549915417997c30ae8981f2ad125,2019-06-13T20:18:06Z,6,5,1
20322,2422199657,"{'login': 'facebook-github-bot', 'id': 6422482, 'node_id': 'MDQ6VXNlcjY0MjI0ODI=', 'avatar_url': 'https://avatars3.githubusercontent.com/u/6422482?v=4', 'gravatar_id': '', 'url': 'https://api.github.com/users/facebook-github-bot', 'html_url': 'https://github.com/facebook-github-bot', 'followers_url': 'https://api.github.com/users/facebook-github-bot/followers', 'following_url': 'https://api.github.com/users/facebook-github-bot/following{/other_user}', 'gists_url': 'https://api.github.com/users/facebook-github-bot/gists{/gist_id}', 'starred_url': 'https://api.github.com/users/facebook-github-bot/starred{/owner}{/repo}', 'subscriptions_url': 'https://api.github.com/users/facebook-github-bot/subscriptions', 'organizations_url': 'https://api.github.com/users/facebook-github-bot/orgs', 'repos_url': 'https://api.github.com/users/facebook-github-bot/repos', 'events_url': 'https://api.github.com/users/facebook-github-bot/events{/privacy}', 'received_events_url': 'https://api.github.com/users/facebook-github-bot/received_events', 'type': 'User', 'site_admin': False}",referenced,c0f51142cd038792869fe98b6a6c0b98ea399644,https://api.github.com/repos/pytorch/pytorch/commits/c0f51142cd038792869fe98b6a6c0b98ea399644,2019-06-18T20:46:57Z,5,5,0
20301,2330221971,"{'login': 'facebook-github-bot', 'id': 6422482, 'node_id': 'MDQ6VXNlcjY0MjI0ODI=', 'avatar_url': 'https://avatars3.githubusercontent.com/u/6422482?v=4', 'gravatar_id': '', 'url': 'https://api.github.com/users/facebook-github-bot', 'html_url': 'https://github.com/facebook-github-bot', 'followers_url': 'https://api.github.com/users/facebook-github-bot/followers', 'following_url': 'https://api.github.com/users/facebook-github-bot/following{/other_user}', 'gists_url': 'https://api.github.com/users/facebook-github-bot/gists{/gist_id}', 'starred_url': 'https://api.github.com/users/facebook-github-bot/starred{/owner}{/repo}', 'subscriptions_url': 'https://api.github.com/users/facebook-github-bot/subscriptions', 'organizations_url': 'https://api.github.com/users/facebook-github-bot/orgs', 'repos_url': 'https://api.github.com/users/facebook-github-bot/repos', 'events_url': 'https://api.github.com/users/facebook-github-bot/events{/privacy}', 'received_events_url': 'https://api.github.com/users/facebook-github-bot/received_events', 'type': 'User', 'site_admin': False}",referenced,2aea5b63350edac33f6455ef13636685f4d6e201,https://api.github.com/repos/pytorch/pytorch/commits/2aea5b63350edac33f6455ef13636685f4d6e201,2019-05-09T13:24:02Z,2,1,1
20297,2395055557,"{'login': 'facebook-github-bot', 'id': 6422482, 'node_id': 'MDQ6VXNlcjY0MjI0ODI=', 'avatar_url': 'https://avatars3.githubusercontent.com/u/6422482?v=4', 'gravatar_id': '', 'url': 'https://api.github.com/users/facebook-github-bot', 'html_url': 'https://github.com/facebook-github-bot', 'followers_url': 'https://api.github.com/users/facebook-github-bot/followers', 'following_url': 'https://api.github.com/users/facebook-github-bot/following{/other_user}', 'gists_url': 'https://api.github.com/users/facebook-github-bot/gists{/gist_id}', 'starred_url': 'https://api.github.com/users/facebook-github-bot/starred{/owner}{/repo}', 'subscriptions_url': 'https://api.github.com/users/facebook-github-bot/subscriptions', 'organizations_url': 'https://api.github.com/users/facebook-github-bot/orgs', 'repos_url': 'https://api.github.com/users/facebook-github-bot/repos', 'events_url': 'https://api.github.com/users/facebook-github-bot/events{/privacy}', 'received_events_url': 'https://api.github.com/users/facebook-github-bot/received_events', 'type': 'User', 'site_admin': False}",referenced,26bcadcc61631051abdd2d573a91c2467e9a288b,https://api.github.com/repos/pytorch/pytorch/commits/26bcadcc61631051abdd2d573a91c2467e9a288b,2019-06-06T17:14:01Z,5,3,2
20287,2338483416,"{'login': 'facebook-github-bot', 'id': 6422482, 'node_id': 'MDQ6VXNlcjY0MjI0ODI=', 'avatar_url': 'https://avatars3.githubusercontent.com/u/6422482?v=4', 'gravatar_id': '', 'url': 'https://api.github.com/users/facebook-github-bot', 'html_url': 'https://github.com/facebook-github-bot', 'followers_url': 'https://api.github.com/users/facebook-github-bot/followers', 'following_url': 'https://api.github.com/users/facebook-github-bot/following{/other_user}', 'gists_url': 'https://api.github.com/users/facebook-github-bot/gists{/gist_id}', 'starred_url': 'https://api.github.com/users/facebook-github-bot/starred{/owner}{/repo}', 'subscriptions_url': 'https://api.github.com/users/facebook-github-bot/subscriptions', 'organizations_url': 'https://api.github.com/users/facebook-github-bot/orgs', 'repos_url': 'https://api.github.com/users/facebook-github-bot/repos', 'events_url': 'https://api.github.com/users/facebook-github-bot/events{/privacy}', 'received_events_url': 'https://api.github.com/users/facebook-github-bot/received_events', 'type': 'User', 'site_admin': False}",referenced,f0829f37c8cfe7c1da4d2b1d9b4c8329b190ed26,https://api.github.com/repos/pytorch/pytorch/commits/f0829f37c8cfe7c1da4d2b1d9b4c8329b190ed26,2019-05-13T23:19:24Z,249,213,36
20271,2379135082,"{'login': 'facebook-github-bot', 'id': 6422482, 'node_id': 'MDQ6VXNlcjY0MjI0ODI=', 'avatar_url': 'https://avatars3.githubusercontent.com/u/6422482?v=4', 'gravatar_id': '', 'url': 'https://api.github.com/users/facebook-github-bot', 'html_url': 'https://github.com/facebook-github-bot', 'followers_url': 'https://api.github.com/users/facebook-github-bot/followers', 'following_url': 'https://api.github.com/users/facebook-github-bot/following{/other_user}', 'gists_url': 'https://api.github.com/users/facebook-github-bot/gists{/gist_id}', 'starred_url': 'https://api.github.com/users/facebook-github-bot/starred{/owner}{/repo}', 'subscriptions_url': 'https://api.github.com/users/facebook-github-bot/subscriptions', 'organizations_url': 'https://api.github.com/users/facebook-github-bot/orgs', 'repos_url': 'https://api.github.com/users/facebook-github-bot/repos', 'events_url': 'https://api.github.com/users/facebook-github-bot/events{/privacy}', 'received_events_url': 'https://api.github.com/users/facebook-github-bot/received_events', 'type': 'User', 'site_admin': False}",closed,4aee92833c7d5dc81d0398893c2af8fbdaaea9ae,https://api.github.com/repos/pytorch/pytorch/commits/4aee92833c7d5dc81d0398893c2af8fbdaaea9ae,2019-05-30T19:52:28Z,15,11,4
20250,2330243168,"{'login': 'facebook-github-bot', 'id': 6422482, 'node_id': 'MDQ6VXNlcjY0MjI0ODI=', 'avatar_url': 'https://avatars3.githubusercontent.com/u/6422482?v=4', 'gravatar_id': '', 'url': 'https://api.github.com/users/facebook-github-bot', 'html_url': 'https://github.com/facebook-github-bot', 'followers_url': 'https://api.github.com/users/facebook-github-bot/followers', 'following_url': 'https://api.github.com/users/facebook-github-bot/following{/other_user}', 'gists_url': 'https://api.github.com/users/facebook-github-bot/gists{/gist_id}', 'starred_url': 'https://api.github.com/users/facebook-github-bot/starred{/owner}{/repo}', 'subscriptions_url': 'https://api.github.com/users/facebook-github-bot/subscriptions', 'organizations_url': 'https://api.github.com/users/facebook-github-bot/orgs', 'repos_url': 'https://api.github.com/users/facebook-github-bot/repos', 'events_url': 'https://api.github.com/users/facebook-github-bot/events{/privacy}', 'received_events_url': 'https://api.github.com/users/facebook-github-bot/received_events', 'type': 'User', 'site_admin': False}",closed,1e35ef07e9fa6781e85c3e915295adeca53bceb1,https://api.github.com/repos/pytorch/pytorch/commits/1e35ef07e9fa6781e85c3e915295adeca53bceb1,2019-05-09T13:31:26Z,2,2,0
20250,2333187996,"{'login': 'facebook-github-bot', 'id': 6422482, 'node_id': 'MDQ6VXNlcjY0MjI0ODI=', 'avatar_url': 'https://avatars3.githubusercontent.com/u/6422482?v=4', 'gravatar_id': '', 'url': 'https://api.github.com/users/facebook-github-bot', 'html_url': 'https://github.com/facebook-github-bot', 'followers_url': 'https://api.github.com/users/facebook-github-bot/followers', 'following_url': 'https://api.github.com/users/facebook-github-bot/following{/other_user}', 'gists_url': 'https://api.github.com/users/facebook-github-bot/gists{/gist_id}', 'starred_url': 'https://api.github.com/users/facebook-github-bot/starred{/owner}{/repo}', 'subscriptions_url': 'https://api.github.com/users/facebook-github-bot/subscriptions', 'organizations_url': 'https://api.github.com/users/facebook-github-bot/orgs', 'repos_url': 'https://api.github.com/users/facebook-github-bot/repos', 'events_url': 'https://api.github.com/users/facebook-github-bot/events{/privacy}', 'received_events_url': 'https://api.github.com/users/facebook-github-bot/received_events', 'type': 'User', 'site_admin': False}",closed,2a875fc126c73833e59756eea34c9bbcf54a6362,https://api.github.com/repos/pytorch/pytorch/commits/2a875fc126c73833e59756eea34c9bbcf54a6362,2019-05-10T13:53:12Z,2,1,1
20241,2467173607,"{'login': 'facebook-github-bot', 'id': 6422482, 'node_id': 'MDQ6VXNlcjY0MjI0ODI=', 'avatar_url': 'https://avatars3.githubusercontent.com/u/6422482?v=4', 'gravatar_id': '', 'url': 'https://api.github.com/users/facebook-github-bot', 'html_url': 'https://github.com/facebook-github-bot', 'followers_url': 'https://api.github.com/users/facebook-github-bot/followers', 'following_url': 'https://api.github.com/users/facebook-github-bot/following{/other_user}', 'gists_url': 'https://api.github.com/users/facebook-github-bot/gists{/gist_id}', 'starred_url': 'https://api.github.com/users/facebook-github-bot/starred{/owner}{/repo}', 'subscriptions_url': 'https://api.github.com/users/facebook-github-bot/subscriptions', 'organizations_url': 'https://api.github.com/users/facebook-github-bot/orgs', 'repos_url': 'https://api.github.com/users/facebook-github-bot/repos', 'events_url': 'https://api.github.com/users/facebook-github-bot/events{/privacy}', 'received_events_url': 'https://api.github.com/users/facebook-github-bot/received_events', 'type': 'User', 'site_admin': False}",referenced,478d480d376fa00dd7bfc5becb7dc689f91b3dfc,https://api.github.com/repos/pytorch/pytorch/commits/478d480d376fa00dd7bfc5becb7dc689f91b3dfc,2019-07-08T19:15:37Z,43,43,0
20215,2327459308,"{'login': 'facebook-github-bot', 'id': 6422482, 'node_id': 'MDQ6VXNlcjY0MjI0ODI=', 'avatar_url': 'https://avatars3.githubusercontent.com/u/6422482?v=4', 'gravatar_id': '', 'url': 'https://api.github.com/users/facebook-github-bot', 'html_url': 'https://github.com/facebook-github-bot', 'followers_url': 'https://api.github.com/users/facebook-github-bot/followers', 'following_url': 'https://api.github.com/users/facebook-github-bot/following{/other_user}', 'gists_url': 'https://api.github.com/users/facebook-github-bot/gists{/gist_id}', 'starred_url': 'https://api.github.com/users/facebook-github-bot/starred{/owner}{/repo}', 'subscriptions_url': 'https://api.github.com/users/facebook-github-bot/subscriptions', 'organizations_url': 'https://api.github.com/users/facebook-github-bot/orgs', 'repos_url': 'https://api.github.com/users/facebook-github-bot/repos', 'events_url': 'https://api.github.com/users/facebook-github-bot/events{/privacy}', 'received_events_url': 'https://api.github.com/users/facebook-github-bot/received_events', 'type': 'User', 'site_admin': False}",referenced,10715ffc308a40449772cdac554712b7950f15c1,https://api.github.com/repos/pytorch/pytorch/commits/10715ffc308a40449772cdac554712b7950f15c1,2019-05-08T14:36:27Z,8,4,4
20215,2330787298,"{'login': 'facebook-github-bot', 'id': 6422482, 'node_id': 'MDQ6VXNlcjY0MjI0ODI=', 'avatar_url': 'https://avatars3.githubusercontent.com/u/6422482?v=4', 'gravatar_id': '', 'url': 'https://api.github.com/users/facebook-github-bot', 'html_url': 'https://github.com/facebook-github-bot', 'followers_url': 'https://api.github.com/users/facebook-github-bot/followers', 'following_url': 'https://api.github.com/users/facebook-github-bot/following{/other_user}', 'gists_url': 'https://api.github.com/users/facebook-github-bot/gists{/gist_id}', 'starred_url': 'https://api.github.com/users/facebook-github-bot/starred{/owner}{/repo}', 'subscriptions_url': 'https://api.github.com/users/facebook-github-bot/subscriptions', 'organizations_url': 'https://api.github.com/users/facebook-github-bot/orgs', 'repos_url': 'https://api.github.com/users/facebook-github-bot/repos', 'events_url': 'https://api.github.com/users/facebook-github-bot/events{/privacy}', 'received_events_url': 'https://api.github.com/users/facebook-github-bot/received_events', 'type': 'User', 'site_admin': False}",closed,899bddeeb6054e89c30cda704f9fe816b5e18f9c,https://api.github.com/repos/pytorch/pytorch/commits/899bddeeb6054e89c30cda704f9fe816b5e18f9c,2019-05-09T16:31:38Z,43,20,23
20208,2353446274,"{'login': 'facebook-github-bot', 'id': 6422482, 'node_id': 'MDQ6VXNlcjY0MjI0ODI=', 'avatar_url': 'https://avatars3.githubusercontent.com/u/6422482?v=4', 'gravatar_id': '', 'url': 'https://api.github.com/users/facebook-github-bot', 'html_url': 'https://github.com/facebook-github-bot', 'followers_url': 'https://api.github.com/users/facebook-github-bot/followers', 'following_url': 'https://api.github.com/users/facebook-github-bot/following{/other_user}', 'gists_url': 'https://api.github.com/users/facebook-github-bot/gists{/gist_id}', 'starred_url': 'https://api.github.com/users/facebook-github-bot/starred{/owner}{/repo}', 'subscriptions_url': 'https://api.github.com/users/facebook-github-bot/subscriptions', 'organizations_url': 'https://api.github.com/users/facebook-github-bot/orgs', 'repos_url': 'https://api.github.com/users/facebook-github-bot/repos', 'events_url': 'https://api.github.com/users/facebook-github-bot/events{/privacy}', 'received_events_url': 'https://api.github.com/users/facebook-github-bot/received_events', 'type': 'User', 'site_admin': False}",referenced,71260b98e2b215b166d5515b496ceee4a36dd86d,https://api.github.com/repos/pytorch/pytorch/commits/71260b98e2b215b166d5515b496ceee4a36dd86d,2019-05-20T15:11:05Z,116,56,60
20202,2327198144,"{'login': 'facebook-github-bot', 'id': 6422482, 'node_id': 'MDQ6VXNlcjY0MjI0ODI=', 'avatar_url': 'https://avatars3.githubusercontent.com/u/6422482?v=4', 'gravatar_id': '', 'url': 'https://api.github.com/users/facebook-github-bot', 'html_url': 'https://github.com/facebook-github-bot', 'followers_url': 'https://api.github.com/users/facebook-github-bot/followers', 'following_url': 'https://api.github.com/users/facebook-github-bot/following{/other_user}', 'gists_url': 'https://api.github.com/users/facebook-github-bot/gists{/gist_id}', 'starred_url': 'https://api.github.com/users/facebook-github-bot/starred{/owner}{/repo}', 'subscriptions_url': 'https://api.github.com/users/facebook-github-bot/subscriptions', 'organizations_url': 'https://api.github.com/users/facebook-github-bot/orgs', 'repos_url': 'https://api.github.com/users/facebook-github-bot/repos', 'events_url': 'https://api.github.com/users/facebook-github-bot/events{/privacy}', 'received_events_url': 'https://api.github.com/users/facebook-github-bot/received_events', 'type': 'User', 'site_admin': False}",closed,d6f62b70f3f889b3c95495a99377a9bb13d8b273,https://api.github.com/repos/pytorch/pytorch/commits/d6f62b70f3f889b3c95495a99377a9bb13d8b273,2019-05-08T13:10:50Z,36,33,3
20199,2354002064,"{'login': 'facebook-github-bot', 'id': 6422482, 'node_id': 'MDQ6VXNlcjY0MjI0ODI=', 'avatar_url': 'https://avatars3.githubusercontent.com/u/6422482?v=4', 'gravatar_id': '', 'url': 'https://api.github.com/users/facebook-github-bot', 'html_url': 'https://github.com/facebook-github-bot', 'followers_url': 'https://api.github.com/users/facebook-github-bot/followers', 'following_url': 'https://api.github.com/users/facebook-github-bot/following{/other_user}', 'gists_url': 'https://api.github.com/users/facebook-github-bot/gists{/gist_id}', 'starred_url': 'https://api.github.com/users/facebook-github-bot/starred{/owner}{/repo}', 'subscriptions_url': 'https://api.github.com/users/facebook-github-bot/subscriptions', 'organizations_url': 'https://api.github.com/users/facebook-github-bot/orgs', 'repos_url': 'https://api.github.com/users/facebook-github-bot/repos', 'events_url': 'https://api.github.com/users/facebook-github-bot/events{/privacy}', 'received_events_url': 'https://api.github.com/users/facebook-github-bot/received_events', 'type': 'User', 'site_admin': False}",referenced,c1fa449763ee8de5dda3540342f15bf6121d7ec1,https://api.github.com/repos/pytorch/pytorch/commits/c1fa449763ee8de5dda3540342f15bf6121d7ec1,2019-05-20T18:48:43Z,14,14,0
20198,2325730258,"{'login': 'facebook-github-bot', 'id': 6422482, 'node_id': 'MDQ6VXNlcjY0MjI0ODI=', 'avatar_url': 'https://avatars3.githubusercontent.com/u/6422482?v=4', 'gravatar_id': '', 'url': 'https://api.github.com/users/facebook-github-bot', 'html_url': 'https://github.com/facebook-github-bot', 'followers_url': 'https://api.github.com/users/facebook-github-bot/followers', 'following_url': 'https://api.github.com/users/facebook-github-bot/following{/other_user}', 'gists_url': 'https://api.github.com/users/facebook-github-bot/gists{/gist_id}', 'starred_url': 'https://api.github.com/users/facebook-github-bot/starred{/owner}{/repo}', 'subscriptions_url': 'https://api.github.com/users/facebook-github-bot/subscriptions', 'organizations_url': 'https://api.github.com/users/facebook-github-bot/orgs', 'repos_url': 'https://api.github.com/users/facebook-github-bot/repos', 'events_url': 'https://api.github.com/users/facebook-github-bot/events{/privacy}', 'received_events_url': 'https://api.github.com/users/facebook-github-bot/received_events', 'type': 'User', 'site_admin': False}",closed,ba3e6de4c230c140ca98ac7f12012db5faf4a680,https://api.github.com/repos/pytorch/pytorch/commits/ba3e6de4c230c140ca98ac7f12012db5faf4a680,2019-05-07T23:00:36Z,5,1,4
20178,2517518159,"{'login': 'facebook-github-bot', 'id': 6422482, 'node_id': 'MDQ6VXNlcjY0MjI0ODI=', 'avatar_url': 'https://avatars3.githubusercontent.com/u/6422482?v=4', 'gravatar_id': '', 'url': 'https://api.github.com/users/facebook-github-bot', 'html_url': 'https://github.com/facebook-github-bot', 'followers_url': 'https://api.github.com/users/facebook-github-bot/followers', 'following_url': 'https://api.github.com/users/facebook-github-bot/following{/other_user}', 'gists_url': 'https://api.github.com/users/facebook-github-bot/gists{/gist_id}', 'starred_url': 'https://api.github.com/users/facebook-github-bot/starred{/owner}{/repo}', 'subscriptions_url': 'https://api.github.com/users/facebook-github-bot/subscriptions', 'organizations_url': 'https://api.github.com/users/facebook-github-bot/orgs', 'repos_url': 'https://api.github.com/users/facebook-github-bot/repos', 'events_url': 'https://api.github.com/users/facebook-github-bot/events{/privacy}', 'received_events_url': 'https://api.github.com/users/facebook-github-bot/received_events', 'type': 'User', 'site_admin': False}",closed,be644d822b9912677c2cc7fa8b5f568f93728fe0,https://api.github.com/repos/pytorch/pytorch/commits/be644d822b9912677c2cc7fa8b5f568f93728fe0,2019-07-29T19:07:31Z,6,3,3
20155,2333170706,"{'login': 'facebook-github-bot', 'id': 6422482, 'node_id': 'MDQ6VXNlcjY0MjI0ODI=', 'avatar_url': 'https://avatars3.githubusercontent.com/u/6422482?v=4', 'gravatar_id': '', 'url': 'https://api.github.com/users/facebook-github-bot', 'html_url': 'https://github.com/facebook-github-bot', 'followers_url': 'https://api.github.com/users/facebook-github-bot/followers', 'following_url': 'https://api.github.com/users/facebook-github-bot/following{/other_user}', 'gists_url': 'https://api.github.com/users/facebook-github-bot/gists{/gist_id}', 'starred_url': 'https://api.github.com/users/facebook-github-bot/starred{/owner}{/repo}', 'subscriptions_url': 'https://api.github.com/users/facebook-github-bot/subscriptions', 'organizations_url': 'https://api.github.com/users/facebook-github-bot/orgs', 'repos_url': 'https://api.github.com/users/facebook-github-bot/repos', 'events_url': 'https://api.github.com/users/facebook-github-bot/events{/privacy}', 'received_events_url': 'https://api.github.com/users/facebook-github-bot/received_events', 'type': 'User', 'site_admin': False}",closed,8726b273334a1ae772d3a36784db89515ecd77d4,https://api.github.com/repos/pytorch/pytorch/commits/8726b273334a1ae772d3a36784db89515ecd77d4,2019-05-10T13:47:11Z,19,11,8
20153,2501521979,"{'login': 'facebook-github-bot', 'id': 6422482, 'node_id': 'MDQ6VXNlcjY0MjI0ODI=', 'avatar_url': 'https://avatars3.githubusercontent.com/u/6422482?v=4', 'gravatar_id': '', 'url': 'https://api.github.com/users/facebook-github-bot', 'html_url': 'https://github.com/facebook-github-bot', 'followers_url': 'https://api.github.com/users/facebook-github-bot/followers', 'following_url': 'https://api.github.com/users/facebook-github-bot/following{/other_user}', 'gists_url': 'https://api.github.com/users/facebook-github-bot/gists{/gist_id}', 'starred_url': 'https://api.github.com/users/facebook-github-bot/starred{/owner}{/repo}', 'subscriptions_url': 'https://api.github.com/users/facebook-github-bot/subscriptions', 'organizations_url': 'https://api.github.com/users/facebook-github-bot/orgs', 'repos_url': 'https://api.github.com/users/facebook-github-bot/repos', 'events_url': 'https://api.github.com/users/facebook-github-bot/events{/privacy}', 'received_events_url': 'https://api.github.com/users/facebook-github-bot/received_events', 'type': 'User', 'site_admin': False}",referenced,a24f6c13a368c407b408045e0f82c8b18f991036,https://api.github.com/repos/pytorch/pytorch/commits/a24f6c13a368c407b408045e0f82c8b18f991036,2019-07-23T01:14:18Z,173,120,53
20146,2493742455,"{'login': 'facebook-github-bot', 'id': 6422482, 'node_id': 'MDQ6VXNlcjY0MjI0ODI=', 'avatar_url': 'https://avatars3.githubusercontent.com/u/6422482?v=4', 'gravatar_id': '', 'url': 'https://api.github.com/users/facebook-github-bot', 'html_url': 'https://github.com/facebook-github-bot', 'followers_url': 'https://api.github.com/users/facebook-github-bot/followers', 'following_url': 'https://api.github.com/users/facebook-github-bot/following{/other_user}', 'gists_url': 'https://api.github.com/users/facebook-github-bot/gists{/gist_id}', 'starred_url': 'https://api.github.com/users/facebook-github-bot/starred{/owner}{/repo}', 'subscriptions_url': 'https://api.github.com/users/facebook-github-bot/subscriptions', 'organizations_url': 'https://api.github.com/users/facebook-github-bot/orgs', 'repos_url': 'https://api.github.com/users/facebook-github-bot/repos', 'events_url': 'https://api.github.com/users/facebook-github-bot/events{/privacy}', 'received_events_url': 'https://api.github.com/users/facebook-github-bot/received_events', 'type': 'User', 'site_admin': False}",closed,11d257e5df15cad15f17fdd3b1577653d112d315,https://api.github.com/repos/pytorch/pytorch/commits/11d257e5df15cad15f17fdd3b1577653d112d315,2019-07-18T19:12:50Z,1,1,0
20132,2337341502,"{'login': 'facebook-github-bot', 'id': 6422482, 'node_id': 'MDQ6VXNlcjY0MjI0ODI=', 'avatar_url': 'https://avatars3.githubusercontent.com/u/6422482?v=4', 'gravatar_id': '', 'url': 'https://api.github.com/users/facebook-github-bot', 'html_url': 'https://github.com/facebook-github-bot', 'followers_url': 'https://api.github.com/users/facebook-github-bot/followers', 'following_url': 'https://api.github.com/users/facebook-github-bot/following{/other_user}', 'gists_url': 'https://api.github.com/users/facebook-github-bot/gists{/gist_id}', 'starred_url': 'https://api.github.com/users/facebook-github-bot/starred{/owner}{/repo}', 'subscriptions_url': 'https://api.github.com/users/facebook-github-bot/subscriptions', 'organizations_url': 'https://api.github.com/users/facebook-github-bot/orgs', 'repos_url': 'https://api.github.com/users/facebook-github-bot/repos', 'events_url': 'https://api.github.com/users/facebook-github-bot/events{/privacy}', 'received_events_url': 'https://api.github.com/users/facebook-github-bot/received_events', 'type': 'User', 'site_admin': False}",closed,41673d477c276ca7efb67bffb260cf2015011d48,https://api.github.com/repos/pytorch/pytorch/commits/41673d477c276ca7efb67bffb260cf2015011d48,2019-05-13T15:24:01Z,134,74,60
20130,2330184113,"{'login': 'facebook-github-bot', 'id': 6422482, 'node_id': 'MDQ6VXNlcjY0MjI0ODI=', 'avatar_url': 'https://avatars3.githubusercontent.com/u/6422482?v=4', 'gravatar_id': '', 'url': 'https://api.github.com/users/facebook-github-bot', 'html_url': 'https://github.com/facebook-github-bot', 'followers_url': 'https://api.github.com/users/facebook-github-bot/followers', 'following_url': 'https://api.github.com/users/facebook-github-bot/following{/other_user}', 'gists_url': 'https://api.github.com/users/facebook-github-bot/gists{/gist_id}', 'starred_url': 'https://api.github.com/users/facebook-github-bot/starred{/owner}{/repo}', 'subscriptions_url': 'https://api.github.com/users/facebook-github-bot/subscriptions', 'organizations_url': 'https://api.github.com/users/facebook-github-bot/orgs', 'repos_url': 'https://api.github.com/users/facebook-github-bot/repos', 'events_url': 'https://api.github.com/users/facebook-github-bot/events{/privacy}', 'received_events_url': 'https://api.github.com/users/facebook-github-bot/received_events', 'type': 'User', 'site_admin': False}",closed,0087069dce5ced2e6a09811e8727b612d4a654fc,https://api.github.com/repos/pytorch/pytorch/commits/0087069dce5ced2e6a09811e8727b612d4a654fc,2019-05-09T13:10:38Z,26,26,0
20128,2435745482,"{'login': 'facebook-github-bot', 'id': 6422482, 'node_id': 'MDQ6VXNlcjY0MjI0ODI=', 'avatar_url': 'https://avatars3.githubusercontent.com/u/6422482?v=4', 'gravatar_id': '', 'url': 'https://api.github.com/users/facebook-github-bot', 'html_url': 'https://github.com/facebook-github-bot', 'followers_url': 'https://api.github.com/users/facebook-github-bot/followers', 'following_url': 'https://api.github.com/users/facebook-github-bot/following{/other_user}', 'gists_url': 'https://api.github.com/users/facebook-github-bot/gists{/gist_id}', 'starred_url': 'https://api.github.com/users/facebook-github-bot/starred{/owner}{/repo}', 'subscriptions_url': 'https://api.github.com/users/facebook-github-bot/subscriptions', 'organizations_url': 'https://api.github.com/users/facebook-github-bot/orgs', 'repos_url': 'https://api.github.com/users/facebook-github-bot/repos', 'events_url': 'https://api.github.com/users/facebook-github-bot/events{/privacy}', 'received_events_url': 'https://api.github.com/users/facebook-github-bot/received_events', 'type': 'User', 'site_admin': False}",closed,41d0525de322be56a998065beaeddc6cb13ce552,https://api.github.com/repos/pytorch/pytorch/commits/41d0525de322be56a998065beaeddc6cb13ce552,2019-06-24T22:29:46Z,12,11,1
20124,2376470309,"{'login': 'facebook-github-bot', 'id': 6422482, 'node_id': 'MDQ6VXNlcjY0MjI0ODI=', 'avatar_url': 'https://avatars3.githubusercontent.com/u/6422482?v=4', 'gravatar_id': '', 'url': 'https://api.github.com/users/facebook-github-bot', 'html_url': 'https://github.com/facebook-github-bot', 'followers_url': 'https://api.github.com/users/facebook-github-bot/followers', 'following_url': 'https://api.github.com/users/facebook-github-bot/following{/other_user}', 'gists_url': 'https://api.github.com/users/facebook-github-bot/gists{/gist_id}', 'starred_url': 'https://api.github.com/users/facebook-github-bot/starred{/owner}{/repo}', 'subscriptions_url': 'https://api.github.com/users/facebook-github-bot/subscriptions', 'organizations_url': 'https://api.github.com/users/facebook-github-bot/orgs', 'repos_url': 'https://api.github.com/users/facebook-github-bot/repos', 'events_url': 'https://api.github.com/users/facebook-github-bot/events{/privacy}', 'received_events_url': 'https://api.github.com/users/facebook-github-bot/received_events', 'type': 'User', 'site_admin': False}",closed,449a2c35558c70f1bedcfcec36a6a4ef2181a2f2,https://api.github.com/repos/pytorch/pytorch/commits/449a2c35558c70f1bedcfcec36a6a4ef2181a2f2,2019-05-29T21:17:17Z,123,120,3
20124,2395623244,"{'login': 'facebook-github-bot', 'id': 6422482, 'node_id': 'MDQ6VXNlcjY0MjI0ODI=', 'avatar_url': 'https://avatars3.githubusercontent.com/u/6422482?v=4', 'gravatar_id': '', 'url': 'https://api.github.com/users/facebook-github-bot', 'html_url': 'https://github.com/facebook-github-bot', 'followers_url': 'https://api.github.com/users/facebook-github-bot/followers', 'following_url': 'https://api.github.com/users/facebook-github-bot/following{/other_user}', 'gists_url': 'https://api.github.com/users/facebook-github-bot/gists{/gist_id}', 'starred_url': 'https://api.github.com/users/facebook-github-bot/starred{/owner}{/repo}', 'subscriptions_url': 'https://api.github.com/users/facebook-github-bot/subscriptions', 'organizations_url': 'https://api.github.com/users/facebook-github-bot/orgs', 'repos_url': 'https://api.github.com/users/facebook-github-bot/repos', 'events_url': 'https://api.github.com/users/facebook-github-bot/events{/privacy}', 'received_events_url': 'https://api.github.com/users/facebook-github-bot/received_events', 'type': 'User', 'site_admin': False}",referenced,8ece538a79c6d3821454d24e66074a2221bb08e4,https://api.github.com/repos/pytorch/pytorch/commits/8ece538a79c6d3821454d24e66074a2221bb08e4,2019-06-06T20:57:28Z,122,101,21
20074,2316247827,"{'login': 'facebook-github-bot', 'id': 6422482, 'node_id': 'MDQ6VXNlcjY0MjI0ODI=', 'avatar_url': 'https://avatars3.githubusercontent.com/u/6422482?v=4', 'gravatar_id': '', 'url': 'https://api.github.com/users/facebook-github-bot', 'html_url': 'https://github.com/facebook-github-bot', 'followers_url': 'https://api.github.com/users/facebook-github-bot/followers', 'following_url': 'https://api.github.com/users/facebook-github-bot/following{/other_user}', 'gists_url': 'https://api.github.com/users/facebook-github-bot/gists{/gist_id}', 'starred_url': 'https://api.github.com/users/facebook-github-bot/starred{/owner}{/repo}', 'subscriptions_url': 'https://api.github.com/users/facebook-github-bot/subscriptions', 'organizations_url': 'https://api.github.com/users/facebook-github-bot/orgs', 'repos_url': 'https://api.github.com/users/facebook-github-bot/repos', 'events_url': 'https://api.github.com/users/facebook-github-bot/events{/privacy}', 'received_events_url': 'https://api.github.com/users/facebook-github-bot/received_events', 'type': 'User', 'site_admin': False}",referenced,792bc56ec2edd2371c1bd8f5f8ef49e010341613,https://api.github.com/repos/pytorch/pytorch/commits/792bc56ec2edd2371c1bd8f5f8ef49e010341613,2019-05-03T03:41:54Z,3,3,0
20067,2315258513,"{'login': 'facebook-github-bot', 'id': 6422482, 'node_id': 'MDQ6VXNlcjY0MjI0ODI=', 'avatar_url': 'https://avatars3.githubusercontent.com/u/6422482?v=4', 'gravatar_id': '', 'url': 'https://api.github.com/users/facebook-github-bot', 'html_url': 'https://github.com/facebook-github-bot', 'followers_url': 'https://api.github.com/users/facebook-github-bot/followers', 'following_url': 'https://api.github.com/users/facebook-github-bot/following{/other_user}', 'gists_url': 'https://api.github.com/users/facebook-github-bot/gists{/gist_id}', 'starred_url': 'https://api.github.com/users/facebook-github-bot/starred{/owner}{/repo}', 'subscriptions_url': 'https://api.github.com/users/facebook-github-bot/subscriptions', 'organizations_url': 'https://api.github.com/users/facebook-github-bot/orgs', 'repos_url': 'https://api.github.com/users/facebook-github-bot/repos', 'events_url': 'https://api.github.com/users/facebook-github-bot/events{/privacy}', 'received_events_url': 'https://api.github.com/users/facebook-github-bot/received_events', 'type': 'User', 'site_admin': False}",closed,75868683dc84b2e5c7eaf9055ddbfd04be0fccdd,https://api.github.com/repos/pytorch/pytorch/commits/75868683dc84b2e5c7eaf9055ddbfd04be0fccdd,2019-05-02T17:56:33Z,658,5,653
20052,2330370216,"{'login': 'facebook-github-bot', 'id': 6422482, 'node_id': 'MDQ6VXNlcjY0MjI0ODI=', 'avatar_url': 'https://avatars3.githubusercontent.com/u/6422482?v=4', 'gravatar_id': '', 'url': 'https://api.github.com/users/facebook-github-bot', 'html_url': 'https://github.com/facebook-github-bot', 'followers_url': 'https://api.github.com/users/facebook-github-bot/followers', 'following_url': 'https://api.github.com/users/facebook-github-bot/following{/other_user}', 'gists_url': 'https://api.github.com/users/facebook-github-bot/gists{/gist_id}', 'starred_url': 'https://api.github.com/users/facebook-github-bot/starred{/owner}{/repo}', 'subscriptions_url': 'https://api.github.com/users/facebook-github-bot/subscriptions', 'organizations_url': 'https://api.github.com/users/facebook-github-bot/orgs', 'repos_url': 'https://api.github.com/users/facebook-github-bot/repos', 'events_url': 'https://api.github.com/users/facebook-github-bot/events{/privacy}', 'received_events_url': 'https://api.github.com/users/facebook-github-bot/received_events', 'type': 'User', 'site_admin': False}",referenced,c406bf20a00ba69e4336a8ff9df18ca33ce57af9,https://api.github.com/repos/pytorch/pytorch/commits/c406bf20a00ba69e4336a8ff9df18ca33ce57af9,2019-05-09T14:12:37Z,17,16,1
20046,2700830274,"{'login': 'facebook-github-bot', 'id': 6422482, 'node_id': 'MDQ6VXNlcjY0MjI0ODI=', 'avatar_url': 'https://avatars3.githubusercontent.com/u/6422482?v=4', 'gravatar_id': '', 'url': 'https://api.github.com/users/facebook-github-bot', 'html_url': 'https://github.com/facebook-github-bot', 'followers_url': 'https://api.github.com/users/facebook-github-bot/followers', 'following_url': 'https://api.github.com/users/facebook-github-bot/following{/other_user}', 'gists_url': 'https://api.github.com/users/facebook-github-bot/gists{/gist_id}', 'starred_url': 'https://api.github.com/users/facebook-github-bot/starred{/owner}{/repo}', 'subscriptions_url': 'https://api.github.com/users/facebook-github-bot/subscriptions', 'organizations_url': 'https://api.github.com/users/facebook-github-bot/orgs', 'repos_url': 'https://api.github.com/users/facebook-github-bot/repos', 'events_url': 'https://api.github.com/users/facebook-github-bot/events{/privacy}', 'received_events_url': 'https://api.github.com/users/facebook-github-bot/received_events', 'type': 'User', 'site_admin': False}",closed,85f33a4738b6c654d87dac71b9ad15cf2a6aa571,https://api.github.com/repos/pytorch/pytorch/commits/85f33a4738b6c654d87dac71b9ad15cf2a6aa571,2019-10-09T23:37:54Z,33,17,16
20030,2325820874,"{'login': 'facebook-github-bot', 'id': 6422482, 'node_id': 'MDQ6VXNlcjY0MjI0ODI=', 'avatar_url': 'https://avatars3.githubusercontent.com/u/6422482?v=4', 'gravatar_id': '', 'url': 'https://api.github.com/users/facebook-github-bot', 'html_url': 'https://github.com/facebook-github-bot', 'followers_url': 'https://api.github.com/users/facebook-github-bot/followers', 'following_url': 'https://api.github.com/users/facebook-github-bot/following{/other_user}', 'gists_url': 'https://api.github.com/users/facebook-github-bot/gists{/gist_id}', 'starred_url': 'https://api.github.com/users/facebook-github-bot/starred{/owner}{/repo}', 'subscriptions_url': 'https://api.github.com/users/facebook-github-bot/subscriptions', 'organizations_url': 'https://api.github.com/users/facebook-github-bot/orgs', 'repos_url': 'https://api.github.com/users/facebook-github-bot/repos', 'events_url': 'https://api.github.com/users/facebook-github-bot/events{/privacy}', 'received_events_url': 'https://api.github.com/users/facebook-github-bot/received_events', 'type': 'User', 'site_admin': False}",closed,9c62280ea832ad2ea8fc7746cfd515af5360976f,https://api.github.com/repos/pytorch/pytorch/commits/9c62280ea832ad2ea8fc7746cfd515af5360976f,2019-05-08T00:11:34Z,48,38,10
20028,2349803383,"{'login': 'facebook-github-bot', 'id': 6422482, 'node_id': 'MDQ6VXNlcjY0MjI0ODI=', 'avatar_url': 'https://avatars3.githubusercontent.com/u/6422482?v=4', 'gravatar_id': '', 'url': 'https://api.github.com/users/facebook-github-bot', 'html_url': 'https://github.com/facebook-github-bot', 'followers_url': 'https://api.github.com/users/facebook-github-bot/followers', 'following_url': 'https://api.github.com/users/facebook-github-bot/following{/other_user}', 'gists_url': 'https://api.github.com/users/facebook-github-bot/gists{/gist_id}', 'starred_url': 'https://api.github.com/users/facebook-github-bot/starred{/owner}{/repo}', 'subscriptions_url': 'https://api.github.com/users/facebook-github-bot/subscriptions', 'organizations_url': 'https://api.github.com/users/facebook-github-bot/orgs', 'repos_url': 'https://api.github.com/users/facebook-github-bot/repos', 'events_url': 'https://api.github.com/users/facebook-github-bot/events{/privacy}', 'received_events_url': 'https://api.github.com/users/facebook-github-bot/received_events', 'type': 'User', 'site_admin': False}",closed,3c69c9a7fec69340f81344fa2817ae3d50c59fe5,https://api.github.com/repos/pytorch/pytorch/commits/3c69c9a7fec69340f81344fa2817ae3d50c59fe5,2019-05-17T16:05:07Z,20,17,3
20028,2349925030,"{'login': 'facebook-github-bot', 'id': 6422482, 'node_id': 'MDQ6VXNlcjY0MjI0ODI=', 'avatar_url': 'https://avatars3.githubusercontent.com/u/6422482?v=4', 'gravatar_id': '', 'url': 'https://api.github.com/users/facebook-github-bot', 'html_url': 'https://github.com/facebook-github-bot', 'followers_url': 'https://api.github.com/users/facebook-github-bot/followers', 'following_url': 'https://api.github.com/users/facebook-github-bot/following{/other_user}', 'gists_url': 'https://api.github.com/users/facebook-github-bot/gists{/gist_id}', 'starred_url': 'https://api.github.com/users/facebook-github-bot/starred{/owner}{/repo}', 'subscriptions_url': 'https://api.github.com/users/facebook-github-bot/subscriptions', 'organizations_url': 'https://api.github.com/users/facebook-github-bot/orgs', 'repos_url': 'https://api.github.com/users/facebook-github-bot/repos', 'events_url': 'https://api.github.com/users/facebook-github-bot/events{/privacy}', 'received_events_url': 'https://api.github.com/users/facebook-github-bot/received_events', 'type': 'User', 'site_admin': False}",referenced,839a69f587ede071755332bd4ebe102ace5d06b4,https://api.github.com/repos/pytorch/pytorch/commits/839a69f587ede071755332bd4ebe102ace5d06b4,2019-05-17T16:58:37Z,20,3,17
20028,2612937046,"{'login': 'facebook-github-bot', 'id': 6422482, 'node_id': 'MDQ6VXNlcjY0MjI0ODI=', 'avatar_url': 'https://avatars3.githubusercontent.com/u/6422482?v=4', 'gravatar_id': '', 'url': 'https://api.github.com/users/facebook-github-bot', 'html_url': 'https://github.com/facebook-github-bot', 'followers_url': 'https://api.github.com/users/facebook-github-bot/followers', 'following_url': 'https://api.github.com/users/facebook-github-bot/following{/other_user}', 'gists_url': 'https://api.github.com/users/facebook-github-bot/gists{/gist_id}', 'starred_url': 'https://api.github.com/users/facebook-github-bot/starred{/owner}{/repo}', 'subscriptions_url': 'https://api.github.com/users/facebook-github-bot/subscriptions', 'organizations_url': 'https://api.github.com/users/facebook-github-bot/orgs', 'repos_url': 'https://api.github.com/users/facebook-github-bot/repos', 'events_url': 'https://api.github.com/users/facebook-github-bot/events{/privacy}', 'received_events_url': 'https://api.github.com/users/facebook-github-bot/received_events', 'type': 'User', 'site_admin': False}",closed,38e4766349338174c126a65bc8c241c8f37a7785,https://api.github.com/repos/pytorch/pytorch/commits/38e4766349338174c126a65bc8c241c8f37a7785,2019-09-06T02:06:30Z,2,2,0
20028,2918271964,"{'login': 'facebook-github-bot', 'id': 6422482, 'node_id': 'MDQ6VXNlcjY0MjI0ODI=', 'avatar_url': 'https://avatars3.githubusercontent.com/u/6422482?v=4', 'gravatar_id': '', 'url': 'https://api.github.com/users/facebook-github-bot', 'html_url': 'https://github.com/facebook-github-bot', 'followers_url': 'https://api.github.com/users/facebook-github-bot/followers', 'following_url': 'https://api.github.com/users/facebook-github-bot/following{/other_user}', 'gists_url': 'https://api.github.com/users/facebook-github-bot/gists{/gist_id}', 'starred_url': 'https://api.github.com/users/facebook-github-bot/starred{/owner}{/repo}', 'subscriptions_url': 'https://api.github.com/users/facebook-github-bot/subscriptions', 'organizations_url': 'https://api.github.com/users/facebook-github-bot/orgs', 'repos_url': 'https://api.github.com/users/facebook-github-bot/repos', 'events_url': 'https://api.github.com/users/facebook-github-bot/events{/privacy}', 'received_events_url': 'https://api.github.com/users/facebook-github-bot/received_events', 'type': 'User', 'site_admin': False}",referenced,9e9bfbfd8d893cdf8205db67f220551214787d7f,https://api.github.com/repos/pytorch/pytorch/commits/9e9bfbfd8d893cdf8205db67f220551214787d7f,2020-01-02T17:15:16Z,2,1,1
20024,2442386596,"{'login': 'xuhdev', 'id': 325476, 'node_id': 'MDQ6VXNlcjMyNTQ3Ng==', 'avatar_url': 'https://avatars1.githubusercontent.com/u/325476?v=4', 'gravatar_id': '', 'url': 'https://api.github.com/users/xuhdev', 'html_url': 'https://github.com/xuhdev', 'followers_url': 'https://api.github.com/users/xuhdev/followers', 'following_url': 'https://api.github.com/users/xuhdev/following{/other_user}', 'gists_url': 'https://api.github.com/users/xuhdev/gists{/gist_id}', 'starred_url': 'https://api.github.com/users/xuhdev/starred{/owner}{/repo}', 'subscriptions_url': 'https://api.github.com/users/xuhdev/subscriptions', 'organizations_url': 'https://api.github.com/users/xuhdev/orgs', 'repos_url': 'https://api.github.com/users/xuhdev/repos', 'events_url': 'https://api.github.com/users/xuhdev/events{/privacy}', 'received_events_url': 'https://api.github.com/users/xuhdev/received_events', 'type': 'User', 'site_admin': False}",referenced,3589d05816bad7109fb65be17e85f347d9b79e98,https://api.github.com/repos/pytorch/pytorch/commits/3589d05816bad7109fb65be17e85f347d9b79e98,2019-06-26T22:29:36Z,91,91,0
20024,2442386764,"{'login': 'xuhdev', 'id': 325476, 'node_id': 'MDQ6VXNlcjMyNTQ3Ng==', 'avatar_url': 'https://avatars1.githubusercontent.com/u/325476?v=4', 'gravatar_id': '', 'url': 'https://api.github.com/users/xuhdev', 'html_url': 'https://github.com/xuhdev', 'followers_url': 'https://api.github.com/users/xuhdev/followers', 'following_url': 'https://api.github.com/users/xuhdev/following{/other_user}', 'gists_url': 'https://api.github.com/users/xuhdev/gists{/gist_id}', 'starred_url': 'https://api.github.com/users/xuhdev/starred{/owner}{/repo}', 'subscriptions_url': 'https://api.github.com/users/xuhdev/subscriptions', 'organizations_url': 'https://api.github.com/users/xuhdev/orgs', 'repos_url': 'https://api.github.com/users/xuhdev/repos', 'events_url': 'https://api.github.com/users/xuhdev/events{/privacy}', 'received_events_url': 'https://api.github.com/users/xuhdev/received_events', 'type': 'User', 'site_admin': False}",referenced,26045b10cb0ee112013bba82ded012fbcd035519,https://api.github.com/repos/pytorch/pytorch/commits/26045b10cb0ee112013bba82ded012fbcd035519,2019-06-26T22:29:43Z,91,91,0
20024,2442387536,"{'login': 'xuhdev', 'id': 325476, 'node_id': 'MDQ6VXNlcjMyNTQ3Ng==', 'avatar_url': 'https://avatars1.githubusercontent.com/u/325476?v=4', 'gravatar_id': '', 'url': 'https://api.github.com/users/xuhdev', 'html_url': 'https://github.com/xuhdev', 'followers_url': 'https://api.github.com/users/xuhdev/followers', 'following_url': 'https://api.github.com/users/xuhdev/following{/other_user}', 'gists_url': 'https://api.github.com/users/xuhdev/gists{/gist_id}', 'starred_url': 'https://api.github.com/users/xuhdev/starred{/owner}{/repo}', 'subscriptions_url': 'https://api.github.com/users/xuhdev/subscriptions', 'organizations_url': 'https://api.github.com/users/xuhdev/orgs', 'repos_url': 'https://api.github.com/users/xuhdev/repos', 'events_url': 'https://api.github.com/users/xuhdev/events{/privacy}', 'received_events_url': 'https://api.github.com/users/xuhdev/received_events', 'type': 'User', 'site_admin': False}",referenced,4fc2b225bc2a0f56df968cc80caea30d280faebd,https://api.github.com/repos/pytorch/pytorch/commits/4fc2b225bc2a0f56df968cc80caea30d280faebd,2019-06-26T22:30:10Z,1337,552,785
20024,2442387638,"{'login': 'xuhdev', 'id': 325476, 'node_id': 'MDQ6VXNlcjMyNTQ3Ng==', 'avatar_url': 'https://avatars1.githubusercontent.com/u/325476?v=4', 'gravatar_id': '', 'url': 'https://api.github.com/users/xuhdev', 'html_url': 'https://github.com/xuhdev', 'followers_url': 'https://api.github.com/users/xuhdev/followers', 'following_url': 'https://api.github.com/users/xuhdev/following{/other_user}', 'gists_url': 'https://api.github.com/users/xuhdev/gists{/gist_id}', 'starred_url': 'https://api.github.com/users/xuhdev/starred{/owner}{/repo}', 'subscriptions_url': 'https://api.github.com/users/xuhdev/subscriptions', 'organizations_url': 'https://api.github.com/users/xuhdev/orgs', 'repos_url': 'https://api.github.com/users/xuhdev/repos', 'events_url': 'https://api.github.com/users/xuhdev/events{/privacy}', 'received_events_url': 'https://api.github.com/users/xuhdev/received_events', 'type': 'User', 'site_admin': False}",referenced,ac46fe6ad13af169af7244bab924e15f8d87042d,https://api.github.com/repos/pytorch/pytorch/commits/ac46fe6ad13af169af7244bab924e15f8d87042d,2019-06-26T22:30:14Z,91,91,0
20024,2442486515,"{'login': 'xuhdev', 'id': 325476, 'node_id': 'MDQ6VXNlcjMyNTQ3Ng==', 'avatar_url': 'https://avatars1.githubusercontent.com/u/325476?v=4', 'gravatar_id': '', 'url': 'https://api.github.com/users/xuhdev', 'html_url': 'https://github.com/xuhdev', 'followers_url': 'https://api.github.com/users/xuhdev/followers', 'following_url': 'https://api.github.com/users/xuhdev/following{/other_user}', 'gists_url': 'https://api.github.com/users/xuhdev/gists{/gist_id}', 'starred_url': 'https://api.github.com/users/xuhdev/starred{/owner}{/repo}', 'subscriptions_url': 'https://api.github.com/users/xuhdev/subscriptions', 'organizations_url': 'https://api.github.com/users/xuhdev/orgs', 'repos_url': 'https://api.github.com/users/xuhdev/repos', 'events_url': 'https://api.github.com/users/xuhdev/events{/privacy}', 'received_events_url': 'https://api.github.com/users/xuhdev/received_events', 'type': 'User', 'site_admin': False}",referenced,259ee6876969ac610f0ad880656d313f0167371c,https://api.github.com/repos/pytorch/pytorch/commits/259ee6876969ac610f0ad880656d313f0167371c,2019-06-26T23:36:34Z,25,20,5
20024,2442486590,"{'login': 'xuhdev', 'id': 325476, 'node_id': 'MDQ6VXNlcjMyNTQ3Ng==', 'avatar_url': 'https://avatars1.githubusercontent.com/u/325476?v=4', 'gravatar_id': '', 'url': 'https://api.github.com/users/xuhdev', 'html_url': 'https://github.com/xuhdev', 'followers_url': 'https://api.github.com/users/xuhdev/followers', 'following_url': 'https://api.github.com/users/xuhdev/following{/other_user}', 'gists_url': 'https://api.github.com/users/xuhdev/gists{/gist_id}', 'starred_url': 'https://api.github.com/users/xuhdev/starred{/owner}{/repo}', 'subscriptions_url': 'https://api.github.com/users/xuhdev/subscriptions', 'organizations_url': 'https://api.github.com/users/xuhdev/orgs', 'repos_url': 'https://api.github.com/users/xuhdev/repos', 'events_url': 'https://api.github.com/users/xuhdev/events{/privacy}', 'received_events_url': 'https://api.github.com/users/xuhdev/received_events', 'type': 'User', 'site_admin': False}",referenced,7fee59926d3f6fcd4aebecab3818024f2e196a1b,https://api.github.com/repos/pytorch/pytorch/commits/7fee59926d3f6fcd4aebecab3818024f2e196a1b,2019-06-26T23:36:37Z,106,106,0
20024,2442510724,"{'login': 'xuhdev', 'id': 325476, 'node_id': 'MDQ6VXNlcjMyNTQ3Ng==', 'avatar_url': 'https://avatars1.githubusercontent.com/u/325476?v=4', 'gravatar_id': '', 'url': 'https://api.github.com/users/xuhdev', 'html_url': 'https://github.com/xuhdev', 'followers_url': 'https://api.github.com/users/xuhdev/followers', 'following_url': 'https://api.github.com/users/xuhdev/following{/other_user}', 'gists_url': 'https://api.github.com/users/xuhdev/gists{/gist_id}', 'starred_url': 'https://api.github.com/users/xuhdev/starred{/owner}{/repo}', 'subscriptions_url': 'https://api.github.com/users/xuhdev/subscriptions', 'organizations_url': 'https://api.github.com/users/xuhdev/orgs', 'repos_url': 'https://api.github.com/users/xuhdev/repos', 'events_url': 'https://api.github.com/users/xuhdev/events{/privacy}', 'received_events_url': 'https://api.github.com/users/xuhdev/received_events', 'type': 'User', 'site_admin': False}",referenced,c0d693de9c74f4122556ae14586d3eae286c0479,https://api.github.com/repos/pytorch/pytorch/commits/c0d693de9c74f4122556ae14586d3eae286c0479,2019-06-26T23:56:16Z,1012,908,104
20024,2442510802,"{'login': 'xuhdev', 'id': 325476, 'node_id': 'MDQ6VXNlcjMyNTQ3Ng==', 'avatar_url': 'https://avatars1.githubusercontent.com/u/325476?v=4', 'gravatar_id': '', 'url': 'https://api.github.com/users/xuhdev', 'html_url': 'https://github.com/xuhdev', 'followers_url': 'https://api.github.com/users/xuhdev/followers', 'following_url': 'https://api.github.com/users/xuhdev/following{/other_user}', 'gists_url': 'https://api.github.com/users/xuhdev/gists{/gist_id}', 'starred_url': 'https://api.github.com/users/xuhdev/starred{/owner}{/repo}', 'subscriptions_url': 'https://api.github.com/users/xuhdev/subscriptions', 'organizations_url': 'https://api.github.com/users/xuhdev/orgs', 'repos_url': 'https://api.github.com/users/xuhdev/repos', 'events_url': 'https://api.github.com/users/xuhdev/events{/privacy}', 'received_events_url': 'https://api.github.com/users/xuhdev/received_events', 'type': 'User', 'site_admin': False}",referenced,0d6d02c136697c2faa2d471ea56c7f3b15a14275,https://api.github.com/repos/pytorch/pytorch/commits/0d6d02c136697c2faa2d471ea56c7f3b15a14275,2019-06-26T23:56:19Z,106,106,0
20024,2442622005,"{'login': 'xuhdev', 'id': 325476, 'node_id': 'MDQ6VXNlcjMyNTQ3Ng==', 'avatar_url': 'https://avatars1.githubusercontent.com/u/325476?v=4', 'gravatar_id': '', 'url': 'https://api.github.com/users/xuhdev', 'html_url': 'https://github.com/xuhdev', 'followers_url': 'https://api.github.com/users/xuhdev/followers', 'following_url': 'https://api.github.com/users/xuhdev/following{/other_user}', 'gists_url': 'https://api.github.com/users/xuhdev/gists{/gist_id}', 'starred_url': 'https://api.github.com/users/xuhdev/starred{/owner}{/repo}', 'subscriptions_url': 'https://api.github.com/users/xuhdev/subscriptions', 'organizations_url': 'https://api.github.com/users/xuhdev/orgs', 'repos_url': 'https://api.github.com/users/xuhdev/repos', 'events_url': 'https://api.github.com/users/xuhdev/events{/privacy}', 'received_events_url': 'https://api.github.com/users/xuhdev/received_events', 'type': 'User', 'site_admin': False}",referenced,f95d61715d9a0f6ce4f0b79bcce51ac62611d15d,https://api.github.com/repos/pytorch/pytorch/commits/f95d61715d9a0f6ce4f0b79bcce51ac62611d15d,2019-06-27T01:02:22Z,14,5,9
20024,2442622096,"{'login': 'xuhdev', 'id': 325476, 'node_id': 'MDQ6VXNlcjMyNTQ3Ng==', 'avatar_url': 'https://avatars1.githubusercontent.com/u/325476?v=4', 'gravatar_id': '', 'url': 'https://api.github.com/users/xuhdev', 'html_url': 'https://github.com/xuhdev', 'followers_url': 'https://api.github.com/users/xuhdev/followers', 'following_url': 'https://api.github.com/users/xuhdev/following{/other_user}', 'gists_url': 'https://api.github.com/users/xuhdev/gists{/gist_id}', 'starred_url': 'https://api.github.com/users/xuhdev/starred{/owner}{/repo}', 'subscriptions_url': 'https://api.github.com/users/xuhdev/subscriptions', 'organizations_url': 'https://api.github.com/users/xuhdev/orgs', 'repos_url': 'https://api.github.com/users/xuhdev/repos', 'events_url': 'https://api.github.com/users/xuhdev/events{/privacy}', 'received_events_url': 'https://api.github.com/users/xuhdev/received_events', 'type': 'User', 'site_admin': False}",referenced,37ae1f1a88bb58ca161c404140f3fdd348581cdc,https://api.github.com/repos/pytorch/pytorch/commits/37ae1f1a88bb58ca161c404140f3fdd348581cdc,2019-06-27T01:02:26Z,102,102,0
20024,2442677962,"{'login': 'xuhdev', 'id': 325476, 'node_id': 'MDQ6VXNlcjMyNTQ3Ng==', 'avatar_url': 'https://avatars1.githubusercontent.com/u/325476?v=4', 'gravatar_id': '', 'url': 'https://api.github.com/users/xuhdev', 'html_url': 'https://github.com/xuhdev', 'followers_url': 'https://api.github.com/users/xuhdev/followers', 'following_url': 'https://api.github.com/users/xuhdev/following{/other_user}', 'gists_url': 'https://api.github.com/users/xuhdev/gists{/gist_id}', 'starred_url': 'https://api.github.com/users/xuhdev/starred{/owner}{/repo}', 'subscriptions_url': 'https://api.github.com/users/xuhdev/subscriptions', 'organizations_url': 'https://api.github.com/users/xuhdev/orgs', 'repos_url': 'https://api.github.com/users/xuhdev/repos', 'events_url': 'https://api.github.com/users/xuhdev/events{/privacy}', 'received_events_url': 'https://api.github.com/users/xuhdev/received_events', 'type': 'User', 'site_admin': False}",referenced,185e61892e0d6555eec944381de8b028ed514869,https://api.github.com/repos/pytorch/pytorch/commits/185e61892e0d6555eec944381de8b028ed514869,2019-06-27T01:49:16Z,103,103,0
20024,2442677966,"{'login': 'xuhdev', 'id': 325476, 'node_id': 'MDQ6VXNlcjMyNTQ3Ng==', 'avatar_url': 'https://avatars1.githubusercontent.com/u/325476?v=4', 'gravatar_id': '', 'url': 'https://api.github.com/users/xuhdev', 'html_url': 'https://github.com/xuhdev', 'followers_url': 'https://api.github.com/users/xuhdev/followers', 'following_url': 'https://api.github.com/users/xuhdev/following{/other_user}', 'gists_url': 'https://api.github.com/users/xuhdev/gists{/gist_id}', 'starred_url': 'https://api.github.com/users/xuhdev/starred{/owner}{/repo}', 'subscriptions_url': 'https://api.github.com/users/xuhdev/subscriptions', 'organizations_url': 'https://api.github.com/users/xuhdev/orgs', 'repos_url': 'https://api.github.com/users/xuhdev/repos', 'events_url': 'https://api.github.com/users/xuhdev/events{/privacy}', 'received_events_url': 'https://api.github.com/users/xuhdev/received_events', 'type': 'User', 'site_admin': False}",referenced,89b293ac33a4576c356d580ead36bc63cbf342af,https://api.github.com/repos/pytorch/pytorch/commits/89b293ac33a4576c356d580ead36bc63cbf342af,2019-06-27T01:49:17Z,1,1,0
20024,2443432613,"{'login': 'xuhdev', 'id': 325476, 'node_id': 'MDQ6VXNlcjMyNTQ3Ng==', 'avatar_url': 'https://avatars1.githubusercontent.com/u/325476?v=4', 'gravatar_id': '', 'url': 'https://api.github.com/users/xuhdev', 'html_url': 'https://github.com/xuhdev', 'followers_url': 'https://api.github.com/users/xuhdev/followers', 'following_url': 'https://api.github.com/users/xuhdev/following{/other_user}', 'gists_url': 'https://api.github.com/users/xuhdev/gists{/gist_id}', 'starred_url': 'https://api.github.com/users/xuhdev/starred{/owner}{/repo}', 'subscriptions_url': 'https://api.github.com/users/xuhdev/subscriptions', 'organizations_url': 'https://api.github.com/users/xuhdev/orgs', 'repos_url': 'https://api.github.com/users/xuhdev/repos', 'events_url': 'https://api.github.com/users/xuhdev/events{/privacy}', 'received_events_url': 'https://api.github.com/users/xuhdev/received_events', 'type': 'User', 'site_admin': False}",referenced,197a22ff932e0b7dea3e8eed8e692510978d355c,https://api.github.com/repos/pytorch/pytorch/commits/197a22ff932e0b7dea3e8eed8e692510978d355c,2019-06-27T08:27:01Z,605,477,128
20024,2443432849,"{'login': 'xuhdev', 'id': 325476, 'node_id': 'MDQ6VXNlcjMyNTQ3Ng==', 'avatar_url': 'https://avatars1.githubusercontent.com/u/325476?v=4', 'gravatar_id': '', 'url': 'https://api.github.com/users/xuhdev', 'html_url': 'https://github.com/xuhdev', 'followers_url': 'https://api.github.com/users/xuhdev/followers', 'following_url': 'https://api.github.com/users/xuhdev/following{/other_user}', 'gists_url': 'https://api.github.com/users/xuhdev/gists{/gist_id}', 'starred_url': 'https://api.github.com/users/xuhdev/starred{/owner}{/repo}', 'subscriptions_url': 'https://api.github.com/users/xuhdev/subscriptions', 'organizations_url': 'https://api.github.com/users/xuhdev/orgs', 'repos_url': 'https://api.github.com/users/xuhdev/repos', 'events_url': 'https://api.github.com/users/xuhdev/events{/privacy}', 'received_events_url': 'https://api.github.com/users/xuhdev/received_events', 'type': 'User', 'site_admin': False}",referenced,8eda0cfb89538d9a35b524db85dc17b370845419,https://api.github.com/repos/pytorch/pytorch/commits/8eda0cfb89538d9a35b524db85dc17b370845419,2019-06-27T08:27:06Z,103,103,0
20024,2444906894,"{'login': 'xuhdev', 'id': 325476, 'node_id': 'MDQ6VXNlcjMyNTQ3Ng==', 'avatar_url': 'https://avatars1.githubusercontent.com/u/325476?v=4', 'gravatar_id': '', 'url': 'https://api.github.com/users/xuhdev', 'html_url': 'https://github.com/xuhdev', 'followers_url': 'https://api.github.com/users/xuhdev/followers', 'following_url': 'https://api.github.com/users/xuhdev/following{/other_user}', 'gists_url': 'https://api.github.com/users/xuhdev/gists{/gist_id}', 'starred_url': 'https://api.github.com/users/xuhdev/starred{/owner}{/repo}', 'subscriptions_url': 'https://api.github.com/users/xuhdev/subscriptions', 'organizations_url': 'https://api.github.com/users/xuhdev/orgs', 'repos_url': 'https://api.github.com/users/xuhdev/repos', 'events_url': 'https://api.github.com/users/xuhdev/events{/privacy}', 'received_events_url': 'https://api.github.com/users/xuhdev/received_events', 'type': 'User', 'site_admin': False}",referenced,af834bdd70956d86397894321bca51abc3ed855b,https://api.github.com/repos/pytorch/pytorch/commits/af834bdd70956d86397894321bca51abc3ed855b,2019-06-27T16:41:15Z,31,23,8
20024,2444907033,"{'login': 'xuhdev', 'id': 325476, 'node_id': 'MDQ6VXNlcjMyNTQ3Ng==', 'avatar_url': 'https://avatars1.githubusercontent.com/u/325476?v=4', 'gravatar_id': '', 'url': 'https://api.github.com/users/xuhdev', 'html_url': 'https://github.com/xuhdev', 'followers_url': 'https://api.github.com/users/xuhdev/followers', 'following_url': 'https://api.github.com/users/xuhdev/following{/other_user}', 'gists_url': 'https://api.github.com/users/xuhdev/gists{/gist_id}', 'starred_url': 'https://api.github.com/users/xuhdev/starred{/owner}{/repo}', 'subscriptions_url': 'https://api.github.com/users/xuhdev/subscriptions', 'organizations_url': 'https://api.github.com/users/xuhdev/orgs', 'repos_url': 'https://api.github.com/users/xuhdev/repos', 'events_url': 'https://api.github.com/users/xuhdev/events{/privacy}', 'received_events_url': 'https://api.github.com/users/xuhdev/received_events', 'type': 'User', 'site_admin': False}",referenced,707c40739efeda0f2e715770315164061e346e10,https://api.github.com/repos/pytorch/pytorch/commits/707c40739efeda0f2e715770315164061e346e10,2019-06-27T16:41:19Z,118,118,0
20024,2445290037,"{'login': 'xuhdev', 'id': 325476, 'node_id': 'MDQ6VXNlcjMyNTQ3Ng==', 'avatar_url': 'https://avatars1.githubusercontent.com/u/325476?v=4', 'gravatar_id': '', 'url': 'https://api.github.com/users/xuhdev', 'html_url': 'https://github.com/xuhdev', 'followers_url': 'https://api.github.com/users/xuhdev/followers', 'following_url': 'https://api.github.com/users/xuhdev/following{/other_user}', 'gists_url': 'https://api.github.com/users/xuhdev/gists{/gist_id}', 'starred_url': 'https://api.github.com/users/xuhdev/starred{/owner}{/repo}', 'subscriptions_url': 'https://api.github.com/users/xuhdev/subscriptions', 'organizations_url': 'https://api.github.com/users/xuhdev/orgs', 'repos_url': 'https://api.github.com/users/xuhdev/repos', 'events_url': 'https://api.github.com/users/xuhdev/events{/privacy}', 'received_events_url': 'https://api.github.com/users/xuhdev/received_events', 'type': 'User', 'site_admin': False}",referenced,97b13f1a249adeb6f19e743ee9b5d1f962ab239d,https://api.github.com/repos/pytorch/pytorch/commits/97b13f1a249adeb6f19e743ee9b5d1f962ab239d,2019-06-27T19:08:35Z,1619,1073,546
20024,2445290090,"{'login': 'xuhdev', 'id': 325476, 'node_id': 'MDQ6VXNlcjMyNTQ3Ng==', 'avatar_url': 'https://avatars1.githubusercontent.com/u/325476?v=4', 'gravatar_id': '', 'url': 'https://api.github.com/users/xuhdev', 'html_url': 'https://github.com/xuhdev', 'followers_url': 'https://api.github.com/users/xuhdev/followers', 'following_url': 'https://api.github.com/users/xuhdev/following{/other_user}', 'gists_url': 'https://api.github.com/users/xuhdev/gists{/gist_id}', 'starred_url': 'https://api.github.com/users/xuhdev/starred{/owner}{/repo}', 'subscriptions_url': 'https://api.github.com/users/xuhdev/subscriptions', 'organizations_url': 'https://api.github.com/users/xuhdev/orgs', 'repos_url': 'https://api.github.com/users/xuhdev/repos', 'events_url': 'https://api.github.com/users/xuhdev/events{/privacy}', 'received_events_url': 'https://api.github.com/users/xuhdev/received_events', 'type': 'User', 'site_admin': False}",referenced,9a9ef8c8d6d2c11a48c8349e8515b9f25f2e1ab1,https://api.github.com/repos/pytorch/pytorch/commits/9a9ef8c8d6d2c11a48c8349e8515b9f25f2e1ab1,2019-06-27T19:08:37Z,118,118,0
20024,2445758203,"{'login': 'xuhdev', 'id': 325476, 'node_id': 'MDQ6VXNlcjMyNTQ3Ng==', 'avatar_url': 'https://avatars1.githubusercontent.com/u/325476?v=4', 'gravatar_id': '', 'url': 'https://api.github.com/users/xuhdev', 'html_url': 'https://github.com/xuhdev', 'followers_url': 'https://api.github.com/users/xuhdev/followers', 'following_url': 'https://api.github.com/users/xuhdev/following{/other_user}', 'gists_url': 'https://api.github.com/users/xuhdev/gists{/gist_id}', 'starred_url': 'https://api.github.com/users/xuhdev/starred{/owner}{/repo}', 'subscriptions_url': 'https://api.github.com/users/xuhdev/subscriptions', 'organizations_url': 'https://api.github.com/users/xuhdev/orgs', 'repos_url': 'https://api.github.com/users/xuhdev/repos', 'events_url': 'https://api.github.com/users/xuhdev/events{/privacy}', 'received_events_url': 'https://api.github.com/users/xuhdev/received_events', 'type': 'User', 'site_admin': False}",referenced,1a8e29a7a4d2a91583c98bcf103af7d03ff9d9a2,https://api.github.com/repos/pytorch/pytorch/commits/1a8e29a7a4d2a91583c98bcf103af7d03ff9d9a2,2019-06-27T22:33:08Z,59,59,0
20024,2445758497,"{'login': 'xuhdev', 'id': 325476, 'node_id': 'MDQ6VXNlcjMyNTQ3Ng==', 'avatar_url': 'https://avatars1.githubusercontent.com/u/325476?v=4', 'gravatar_id': '', 'url': 'https://api.github.com/users/xuhdev', 'html_url': 'https://github.com/xuhdev', 'followers_url': 'https://api.github.com/users/xuhdev/followers', 'following_url': 'https://api.github.com/users/xuhdev/following{/other_user}', 'gists_url': 'https://api.github.com/users/xuhdev/gists{/gist_id}', 'starred_url': 'https://api.github.com/users/xuhdev/starred{/owner}{/repo}', 'subscriptions_url': 'https://api.github.com/users/xuhdev/subscriptions', 'organizations_url': 'https://api.github.com/users/xuhdev/orgs', 'repos_url': 'https://api.github.com/users/xuhdev/repos', 'events_url': 'https://api.github.com/users/xuhdev/events{/privacy}', 'received_events_url': 'https://api.github.com/users/xuhdev/received_events', 'type': 'User', 'site_admin': False}",referenced,0e9f837fa6862094b980a56db873daa83d2ce772,https://api.github.com/repos/pytorch/pytorch/commits/0e9f837fa6862094b980a56db873daa83d2ce772,2019-06-27T22:33:18Z,59,59,0
20024,2445759212,"{'login': 'xuhdev', 'id': 325476, 'node_id': 'MDQ6VXNlcjMyNTQ3Ng==', 'avatar_url': 'https://avatars1.githubusercontent.com/u/325476?v=4', 'gravatar_id': '', 'url': 'https://api.github.com/users/xuhdev', 'html_url': 'https://github.com/xuhdev', 'followers_url': 'https://api.github.com/users/xuhdev/followers', 'following_url': 'https://api.github.com/users/xuhdev/following{/other_user}', 'gists_url': 'https://api.github.com/users/xuhdev/gists{/gist_id}', 'starred_url': 'https://api.github.com/users/xuhdev/starred{/owner}{/repo}', 'subscriptions_url': 'https://api.github.com/users/xuhdev/subscriptions', 'organizations_url': 'https://api.github.com/users/xuhdev/orgs', 'repos_url': 'https://api.github.com/users/xuhdev/repos', 'events_url': 'https://api.github.com/users/xuhdev/events{/privacy}', 'received_events_url': 'https://api.github.com/users/xuhdev/received_events', 'type': 'User', 'site_admin': False}",referenced,fe77182bc4dd464a7797d109124dc97bcbabbec8,https://api.github.com/repos/pytorch/pytorch/commits/fe77182bc4dd464a7797d109124dc97bcbabbec8,2019-06-27T22:33:44Z,885,713,172
20024,2445759390,"{'login': 'xuhdev', 'id': 325476, 'node_id': 'MDQ6VXNlcjMyNTQ3Ng==', 'avatar_url': 'https://avatars1.githubusercontent.com/u/325476?v=4', 'gravatar_id': '', 'url': 'https://api.github.com/users/xuhdev', 'html_url': 'https://github.com/xuhdev', 'followers_url': 'https://api.github.com/users/xuhdev/followers', 'following_url': 'https://api.github.com/users/xuhdev/following{/other_user}', 'gists_url': 'https://api.github.com/users/xuhdev/gists{/gist_id}', 'starred_url': 'https://api.github.com/users/xuhdev/starred{/owner}{/repo}', 'subscriptions_url': 'https://api.github.com/users/xuhdev/subscriptions', 'organizations_url': 'https://api.github.com/users/xuhdev/orgs', 'repos_url': 'https://api.github.com/users/xuhdev/repos', 'events_url': 'https://api.github.com/users/xuhdev/events{/privacy}', 'received_events_url': 'https://api.github.com/users/xuhdev/received_events', 'type': 'User', 'site_admin': False}",referenced,e7188e4cd8c91dd5bf8d06271fbaecbd23a18aba,https://api.github.com/repos/pytorch/pytorch/commits/e7188e4cd8c91dd5bf8d06271fbaecbd23a18aba,2019-06-27T22:33:51Z,885,713,172
20024,2445759445,"{'login': 'xuhdev', 'id': 325476, 'node_id': 'MDQ6VXNlcjMyNTQ3Ng==', 'avatar_url': 'https://avatars1.githubusercontent.com/u/325476?v=4', 'gravatar_id': '', 'url': 'https://api.github.com/users/xuhdev', 'html_url': 'https://github.com/xuhdev', 'followers_url': 'https://api.github.com/users/xuhdev/followers', 'following_url': 'https://api.github.com/users/xuhdev/following{/other_user}', 'gists_url': 'https://api.github.com/users/xuhdev/gists{/gist_id}', 'starred_url': 'https://api.github.com/users/xuhdev/starred{/owner}{/repo}', 'subscriptions_url': 'https://api.github.com/users/xuhdev/subscriptions', 'organizations_url': 'https://api.github.com/users/xuhdev/orgs', 'repos_url': 'https://api.github.com/users/xuhdev/repos', 'events_url': 'https://api.github.com/users/xuhdev/events{/privacy}', 'received_events_url': 'https://api.github.com/users/xuhdev/received_events', 'type': 'User', 'site_admin': False}",referenced,281156ac6618b5d6d349f223effd6f709001e2b2,https://api.github.com/repos/pytorch/pytorch/commits/281156ac6618b5d6d349f223effd6f709001e2b2,2019-06-27T22:33:54Z,59,59,0
20024,2445761827,"{'login': 'xuhdev', 'id': 325476, 'node_id': 'MDQ6VXNlcjMyNTQ3Ng==', 'avatar_url': 'https://avatars1.githubusercontent.com/u/325476?v=4', 'gravatar_id': '', 'url': 'https://api.github.com/users/xuhdev', 'html_url': 'https://github.com/xuhdev', 'followers_url': 'https://api.github.com/users/xuhdev/followers', 'following_url': 'https://api.github.com/users/xuhdev/following{/other_user}', 'gists_url': 'https://api.github.com/users/xuhdev/gists{/gist_id}', 'starred_url': 'https://api.github.com/users/xuhdev/starred{/owner}{/repo}', 'subscriptions_url': 'https://api.github.com/users/xuhdev/subscriptions', 'organizations_url': 'https://api.github.com/users/xuhdev/orgs', 'repos_url': 'https://api.github.com/users/xuhdev/repos', 'events_url': 'https://api.github.com/users/xuhdev/events{/privacy}', 'received_events_url': 'https://api.github.com/users/xuhdev/received_events', 'type': 'User', 'site_admin': False}",referenced,10d38167149a4edc9c91432a2f0fbb8ad7b10da6,https://api.github.com/repos/pytorch/pytorch/commits/10d38167149a4edc9c91432a2f0fbb8ad7b10da6,2019-06-27T22:35:23Z,2,1,1
20017,2334332237,"{'login': 'driazati', 'id': 9407960, 'node_id': 'MDQ6VXNlcjk0MDc5NjA=', 'avatar_url': 'https://avatars3.githubusercontent.com/u/9407960?v=4', 'gravatar_id': '', 'url': 'https://api.github.com/users/driazati', 'html_url': 'https://github.com/driazati', 'followers_url': 'https://api.github.com/users/driazati/followers', 'following_url': 'https://api.github.com/users/driazati/following{/other_user}', 'gists_url': 'https://api.github.com/users/driazati/gists{/gist_id}', 'starred_url': 'https://api.github.com/users/driazati/starred{/owner}{/repo}', 'subscriptions_url': 'https://api.github.com/users/driazati/subscriptions', 'organizations_url': 'https://api.github.com/users/driazati/orgs', 'repos_url': 'https://api.github.com/users/driazati/repos', 'events_url': 'https://api.github.com/users/driazati/events{/privacy}', 'received_events_url': 'https://api.github.com/users/driazati/received_events', 'type': 'User', 'site_admin': False}",referenced,bb4f3f2db85b1c158b816ca740ca59edbc808d83,https://api.github.com/repos/pytorch/pytorch/commits/bb4f3f2db85b1c158b816ca740ca59edbc808d83,2019-05-10T22:05:24Z,32,25,7
20017,2354548904,"{'login': 'facebook-github-bot', 'id': 6422482, 'node_id': 'MDQ6VXNlcjY0MjI0ODI=', 'avatar_url': 'https://avatars3.githubusercontent.com/u/6422482?v=4', 'gravatar_id': '', 'url': 'https://api.github.com/users/facebook-github-bot', 'html_url': 'https://github.com/facebook-github-bot', 'followers_url': 'https://api.github.com/users/facebook-github-bot/followers', 'following_url': 'https://api.github.com/users/facebook-github-bot/following{/other_user}', 'gists_url': 'https://api.github.com/users/facebook-github-bot/gists{/gist_id}', 'starred_url': 'https://api.github.com/users/facebook-github-bot/starred{/owner}{/repo}', 'subscriptions_url': 'https://api.github.com/users/facebook-github-bot/subscriptions', 'organizations_url': 'https://api.github.com/users/facebook-github-bot/orgs', 'repos_url': 'https://api.github.com/users/facebook-github-bot/repos', 'events_url': 'https://api.github.com/users/facebook-github-bot/events{/privacy}', 'received_events_url': 'https://api.github.com/users/facebook-github-bot/received_events', 'type': 'User', 'site_admin': False}",closed,410c7210db40622faf739d17a339b28058adafc6,https://api.github.com/repos/pytorch/pytorch/commits/410c7210db40622faf739d17a339b28058adafc6,2019-05-20T23:22:22Z,51,50,1
20004,2316493313,"{'login': 'suo', 'id': 1617424, 'node_id': 'MDQ6VXNlcjE2MTc0MjQ=', 'avatar_url': 'https://avatars2.githubusercontent.com/u/1617424?v=4', 'gravatar_id': '', 'url': 'https://api.github.com/users/suo', 'html_url': 'https://github.com/suo', 'followers_url': 'https://api.github.com/users/suo/followers', 'following_url': 'https://api.github.com/users/suo/following{/other_user}', 'gists_url': 'https://api.github.com/users/suo/gists{/gist_id}', 'starred_url': 'https://api.github.com/users/suo/starred{/owner}{/repo}', 'subscriptions_url': 'https://api.github.com/users/suo/subscriptions', 'organizations_url': 'https://api.github.com/users/suo/orgs', 'repos_url': 'https://api.github.com/users/suo/repos', 'events_url': 'https://api.github.com/users/suo/events{/privacy}', 'received_events_url': 'https://api.github.com/users/suo/received_events', 'type': 'User', 'site_admin': False}",referenced,d945e7a1e323f660e8581f293eda226ff5ed145f,https://api.github.com/repos/pytorch/pytorch/commits/d945e7a1e323f660e8581f293eda226ff5ed145f,2019-05-03T06:42:12Z,34,23,11
20004,2316493556,"{'login': 'suo', 'id': 1617424, 'node_id': 'MDQ6VXNlcjE2MTc0MjQ=', 'avatar_url': 'https://avatars2.githubusercontent.com/u/1617424?v=4', 'gravatar_id': '', 'url': 'https://api.github.com/users/suo', 'html_url': 'https://github.com/suo', 'followers_url': 'https://api.github.com/users/suo/followers', 'following_url': 'https://api.github.com/users/suo/following{/other_user}', 'gists_url': 'https://api.github.com/users/suo/gists{/gist_id}', 'starred_url': 'https://api.github.com/users/suo/starred{/owner}{/repo}', 'subscriptions_url': 'https://api.github.com/users/suo/subscriptions', 'organizations_url': 'https://api.github.com/users/suo/orgs', 'repos_url': 'https://api.github.com/users/suo/repos', 'events_url': 'https://api.github.com/users/suo/events{/privacy}', 'received_events_url': 'https://api.github.com/users/suo/received_events', 'type': 'User', 'site_admin': False}",referenced,84efb9817de1bb0bc06a4ed866c082a6f3488fce,https://api.github.com/repos/pytorch/pytorch/commits/84efb9817de1bb0bc06a4ed866c082a6f3488fce,2019-05-03T06:42:18Z,34,23,11
20004,2318116363,"{'login': 'suo', 'id': 1617424, 'node_id': 'MDQ6VXNlcjE2MTc0MjQ=', 'avatar_url': 'https://avatars2.githubusercontent.com/u/1617424?v=4', 'gravatar_id': '', 'url': 'https://api.github.com/users/suo', 'html_url': 'https://github.com/suo', 'followers_url': 'https://api.github.com/users/suo/followers', 'following_url': 'https://api.github.com/users/suo/following{/other_user}', 'gists_url': 'https://api.github.com/users/suo/gists{/gist_id}', 'starred_url': 'https://api.github.com/users/suo/starred{/owner}{/repo}', 'subscriptions_url': 'https://api.github.com/users/suo/subscriptions', 'organizations_url': 'https://api.github.com/users/suo/orgs', 'repos_url': 'https://api.github.com/users/suo/repos', 'events_url': 'https://api.github.com/users/suo/events{/privacy}', 'received_events_url': 'https://api.github.com/users/suo/received_events', 'type': 'User', 'site_admin': False}",referenced,67ded1a109fd26a0281b072299498896379b72c1,https://api.github.com/repos/pytorch/pytorch/commits/67ded1a109fd26a0281b072299498896379b72c1,2019-05-03T18:14:45Z,69,38,31
20004,2321496837,"{'login': 'suo', 'id': 1617424, 'node_id': 'MDQ6VXNlcjE2MTc0MjQ=', 'avatar_url': 'https://avatars2.githubusercontent.com/u/1617424?v=4', 'gravatar_id': '', 'url': 'https://api.github.com/users/suo', 'html_url': 'https://github.com/suo', 'followers_url': 'https://api.github.com/users/suo/followers', 'following_url': 'https://api.github.com/users/suo/following{/other_user}', 'gists_url': 'https://api.github.com/users/suo/gists{/gist_id}', 'starred_url': 'https://api.github.com/users/suo/starred{/owner}{/repo}', 'subscriptions_url': 'https://api.github.com/users/suo/subscriptions', 'organizations_url': 'https://api.github.com/users/suo/orgs', 'repos_url': 'https://api.github.com/users/suo/repos', 'events_url': 'https://api.github.com/users/suo/events{/privacy}', 'received_events_url': 'https://api.github.com/users/suo/received_events', 'type': 'User', 'site_admin': False}",referenced,c9642de4d904a12a43b020a5a284211e041182c8,https://api.github.com/repos/pytorch/pytorch/commits/c9642de4d904a12a43b020a5a284211e041182c8,2019-05-06T16:28:45Z,2003,1479,524
19995,2313204405,"{'login': 'facebook-github-bot', 'id': 6422482, 'node_id': 'MDQ6VXNlcjY0MjI0ODI=', 'avatar_url': 'https://avatars3.githubusercontent.com/u/6422482?v=4', 'gravatar_id': '', 'url': 'https://api.github.com/users/facebook-github-bot', 'html_url': 'https://github.com/facebook-github-bot', 'followers_url': 'https://api.github.com/users/facebook-github-bot/followers', 'following_url': 'https://api.github.com/users/facebook-github-bot/following{/other_user}', 'gists_url': 'https://api.github.com/users/facebook-github-bot/gists{/gist_id}', 'starred_url': 'https://api.github.com/users/facebook-github-bot/starred{/owner}{/repo}', 'subscriptions_url': 'https://api.github.com/users/facebook-github-bot/subscriptions', 'organizations_url': 'https://api.github.com/users/facebook-github-bot/orgs', 'repos_url': 'https://api.github.com/users/facebook-github-bot/repos', 'events_url': 'https://api.github.com/users/facebook-github-bot/events{/privacy}', 'received_events_url': 'https://api.github.com/users/facebook-github-bot/received_events', 'type': 'User', 'site_admin': False}",closed,18cb0985883d338f6c0d9c199884e921e83e1083,https://api.github.com/repos/pytorch/pytorch/commits/18cb0985883d338f6c0d9c199884e921e83e1083,2019-05-01T23:37:51Z,18,0,18
19990,2508008512,"{'login': 'ezyang', 'id': 13564, 'node_id': 'MDQ6VXNlcjEzNTY0', 'avatar_url': 'https://avatars0.githubusercontent.com/u/13564?v=4', 'gravatar_id': '', 'url': 'https://api.github.com/users/ezyang', 'html_url': 'https://github.com/ezyang', 'followers_url': 'https://api.github.com/users/ezyang/followers', 'following_url': 'https://api.github.com/users/ezyang/following{/other_user}', 'gists_url': 'https://api.github.com/users/ezyang/gists{/gist_id}', 'starred_url': 'https://api.github.com/users/ezyang/starred{/owner}{/repo}', 'subscriptions_url': 'https://api.github.com/users/ezyang/subscriptions', 'organizations_url': 'https://api.github.com/users/ezyang/orgs', 'repos_url': 'https://api.github.com/users/ezyang/repos', 'events_url': 'https://api.github.com/users/ezyang/events{/privacy}', 'received_events_url': 'https://api.github.com/users/ezyang/received_events', 'type': 'User', 'site_admin': False}",referenced,10425a1d1ee908a869ccab50e91aab66e5583f37,https://api.github.com/repos/pytorch/pytorch/commits/10425a1d1ee908a869ccab50e91aab66e5583f37,2019-07-25T00:48:55Z,561,558,3
19990,2508008585,"{'login': 'ezyang', 'id': 13564, 'node_id': 'MDQ6VXNlcjEzNTY0', 'avatar_url': 'https://avatars0.githubusercontent.com/u/13564?v=4', 'gravatar_id': '', 'url': 'https://api.github.com/users/ezyang', 'html_url': 'https://github.com/ezyang', 'followers_url': 'https://api.github.com/users/ezyang/followers', 'following_url': 'https://api.github.com/users/ezyang/following{/other_user}', 'gists_url': 'https://api.github.com/users/ezyang/gists{/gist_id}', 'starred_url': 'https://api.github.com/users/ezyang/starred{/owner}{/repo}', 'subscriptions_url': 'https://api.github.com/users/ezyang/subscriptions', 'organizations_url': 'https://api.github.com/users/ezyang/orgs', 'repos_url': 'https://api.github.com/users/ezyang/repos', 'events_url': 'https://api.github.com/users/ezyang/events{/privacy}', 'received_events_url': 'https://api.github.com/users/ezyang/received_events', 'type': 'User', 'site_admin': False}",referenced,e4c4ea838e860d07fd2f5abe1e60245846ebee2c,https://api.github.com/repos/pytorch/pytorch/commits/e4c4ea838e860d07fd2f5abe1e60245846ebee2c,2019-07-25T00:49:00Z,561,558,3
19990,2508065525,"{'login': 'facebook-github-bot', 'id': 6422482, 'node_id': 'MDQ6VXNlcjY0MjI0ODI=', 'avatar_url': 'https://avatars3.githubusercontent.com/u/6422482?v=4', 'gravatar_id': '', 'url': 'https://api.github.com/users/facebook-github-bot', 'html_url': 'https://github.com/facebook-github-bot', 'followers_url': 'https://api.github.com/users/facebook-github-bot/followers', 'following_url': 'https://api.github.com/users/facebook-github-bot/following{/other_user}', 'gists_url': 'https://api.github.com/users/facebook-github-bot/gists{/gist_id}', 'starred_url': 'https://api.github.com/users/facebook-github-bot/starred{/owner}{/repo}', 'subscriptions_url': 'https://api.github.com/users/facebook-github-bot/subscriptions', 'organizations_url': 'https://api.github.com/users/facebook-github-bot/orgs', 'repos_url': 'https://api.github.com/users/facebook-github-bot/repos', 'events_url': 'https://api.github.com/users/facebook-github-bot/events{/privacy}', 'received_events_url': 'https://api.github.com/users/facebook-github-bot/received_events', 'type': 'User', 'site_admin': False}",closed,ff3cc795c8c1ba19814909dfaf63e1e0dd9dc4d8,https://api.github.com/repos/pytorch/pytorch/commits/ff3cc795c8c1ba19814909dfaf63e1e0dd9dc4d8,2019-07-25T01:35:16Z,2,1,1
19961,2324641529,"{'login': 'facebook-github-bot', 'id': 6422482, 'node_id': 'MDQ6VXNlcjY0MjI0ODI=', 'avatar_url': 'https://avatars3.githubusercontent.com/u/6422482?v=4', 'gravatar_id': '', 'url': 'https://api.github.com/users/facebook-github-bot', 'html_url': 'https://github.com/facebook-github-bot', 'followers_url': 'https://api.github.com/users/facebook-github-bot/followers', 'following_url': 'https://api.github.com/users/facebook-github-bot/following{/other_user}', 'gists_url': 'https://api.github.com/users/facebook-github-bot/gists{/gist_id}', 'starred_url': 'https://api.github.com/users/facebook-github-bot/starred{/owner}{/repo}', 'subscriptions_url': 'https://api.github.com/users/facebook-github-bot/subscriptions', 'organizations_url': 'https://api.github.com/users/facebook-github-bot/orgs', 'repos_url': 'https://api.github.com/users/facebook-github-bot/repos', 'events_url': 'https://api.github.com/users/facebook-github-bot/events{/privacy}', 'received_events_url': 'https://api.github.com/users/facebook-github-bot/received_events', 'type': 'User', 'site_admin': False}",referenced,cf55670bddf6bb5f6199df2c543c8fb4ca21b08e,https://api.github.com/repos/pytorch/pytorch/commits/cf55670bddf6bb5f6199df2c543c8fb4ca21b08e,2019-05-07T15:40:21Z,3,3,0
19947,2651550058,"{'login': 'facebook-github-bot', 'id': 6422482, 'node_id': 'MDQ6VXNlcjY0MjI0ODI=', 'avatar_url': 'https://avatars3.githubusercontent.com/u/6422482?v=4', 'gravatar_id': '', 'url': 'https://api.github.com/users/facebook-github-bot', 'html_url': 'https://github.com/facebook-github-bot', 'followers_url': 'https://api.github.com/users/facebook-github-bot/followers', 'following_url': 'https://api.github.com/users/facebook-github-bot/following{/other_user}', 'gists_url': 'https://api.github.com/users/facebook-github-bot/gists{/gist_id}', 'starred_url': 'https://api.github.com/users/facebook-github-bot/starred{/owner}{/repo}', 'subscriptions_url': 'https://api.github.com/users/facebook-github-bot/subscriptions', 'organizations_url': 'https://api.github.com/users/facebook-github-bot/orgs', 'repos_url': 'https://api.github.com/users/facebook-github-bot/repos', 'events_url': 'https://api.github.com/users/facebook-github-bot/events{/privacy}', 'received_events_url': 'https://api.github.com/users/facebook-github-bot/received_events', 'type': 'User', 'site_admin': False}",referenced,916eee182c9dc8d335501f6672842c6d29f0af58,https://api.github.com/repos/pytorch/pytorch/commits/916eee182c9dc8d335501f6672842c6d29f0af58,2019-09-20T21:12:01Z,10,10,0
19940,2318634718,"{'login': 'facebook-github-bot', 'id': 6422482, 'node_id': 'MDQ6VXNlcjY0MjI0ODI=', 'avatar_url': 'https://avatars3.githubusercontent.com/u/6422482?v=4', 'gravatar_id': '', 'url': 'https://api.github.com/users/facebook-github-bot', 'html_url': 'https://github.com/facebook-github-bot', 'followers_url': 'https://api.github.com/users/facebook-github-bot/followers', 'following_url': 'https://api.github.com/users/facebook-github-bot/following{/other_user}', 'gists_url': 'https://api.github.com/users/facebook-github-bot/gists{/gist_id}', 'starred_url': 'https://api.github.com/users/facebook-github-bot/starred{/owner}{/repo}', 'subscriptions_url': 'https://api.github.com/users/facebook-github-bot/subscriptions', 'organizations_url': 'https://api.github.com/users/facebook-github-bot/orgs', 'repos_url': 'https://api.github.com/users/facebook-github-bot/repos', 'events_url': 'https://api.github.com/users/facebook-github-bot/events{/privacy}', 'received_events_url': 'https://api.github.com/users/facebook-github-bot/received_events', 'type': 'User', 'site_admin': False}",closed,7ad04ad28dff57c9655c09344b924eabe028d16a,https://api.github.com/repos/pytorch/pytorch/commits/7ad04ad28dff57c9655c09344b924eabe028d16a,2019-05-03T22:40:58Z,2,1,1
19797,2310860496,"{'login': 'facebook-github-bot', 'id': 6422482, 'node_id': 'MDQ6VXNlcjY0MjI0ODI=', 'avatar_url': 'https://avatars3.githubusercontent.com/u/6422482?v=4', 'gravatar_id': '', 'url': 'https://api.github.com/users/facebook-github-bot', 'html_url': 'https://github.com/facebook-github-bot', 'followers_url': 'https://api.github.com/users/facebook-github-bot/followers', 'following_url': 'https://api.github.com/users/facebook-github-bot/following{/other_user}', 'gists_url': 'https://api.github.com/users/facebook-github-bot/gists{/gist_id}', 'starred_url': 'https://api.github.com/users/facebook-github-bot/starred{/owner}{/repo}', 'subscriptions_url': 'https://api.github.com/users/facebook-github-bot/subscriptions', 'organizations_url': 'https://api.github.com/users/facebook-github-bot/orgs', 'repos_url': 'https://api.github.com/users/facebook-github-bot/repos', 'events_url': 'https://api.github.com/users/facebook-github-bot/events{/privacy}', 'received_events_url': 'https://api.github.com/users/facebook-github-bot/received_events', 'type': 'User', 'site_admin': False}",closed,cb8ff2a2b4640fea1981ed2e00ebbc038485c216,https://api.github.com/repos/pytorch/pytorch/commits/cb8ff2a2b4640fea1981ed2e00ebbc038485c216,2019-04-30T22:02:46Z,76,72,4
19778,2875213207,"{'login': 'facebook-github-bot', 'id': 6422482, 'node_id': 'MDQ6VXNlcjY0MjI0ODI=', 'avatar_url': 'https://avatars3.githubusercontent.com/u/6422482?v=4', 'gravatar_id': '', 'url': 'https://api.github.com/users/facebook-github-bot', 'html_url': 'https://github.com/facebook-github-bot', 'followers_url': 'https://api.github.com/users/facebook-github-bot/followers', 'following_url': 'https://api.github.com/users/facebook-github-bot/following{/other_user}', 'gists_url': 'https://api.github.com/users/facebook-github-bot/gists{/gist_id}', 'starred_url': 'https://api.github.com/users/facebook-github-bot/starred{/owner}{/repo}', 'subscriptions_url': 'https://api.github.com/users/facebook-github-bot/subscriptions', 'organizations_url': 'https://api.github.com/users/facebook-github-bot/orgs', 'repos_url': 'https://api.github.com/users/facebook-github-bot/repos', 'events_url': 'https://api.github.com/users/facebook-github-bot/events{/privacy}', 'received_events_url': 'https://api.github.com/users/facebook-github-bot/received_events', 'type': 'User', 'site_admin': False}",referenced,717274c001509ffbc14189edef0f7d2ee2e5b777,https://api.github.com/repos/pytorch/pytorch/commits/717274c001509ffbc14189edef0f7d2ee2e5b777,2019-12-11T17:47:33Z,62,48,14
19717,2301080887,"{'login': 'SsnL', 'id': 5674597, 'node_id': 'MDQ6VXNlcjU2NzQ1OTc=', 'avatar_url': 'https://avatars2.githubusercontent.com/u/5674597?v=4', 'gravatar_id': '', 'url': 'https://api.github.com/users/SsnL', 'html_url': 'https://github.com/SsnL', 'followers_url': 'https://api.github.com/users/SsnL/followers', 'following_url': 'https://api.github.com/users/SsnL/following{/other_user}', 'gists_url': 'https://api.github.com/users/SsnL/gists{/gist_id}', 'starred_url': 'https://api.github.com/users/SsnL/starred{/owner}{/repo}', 'subscriptions_url': 'https://api.github.com/users/SsnL/subscriptions', 'organizations_url': 'https://api.github.com/users/SsnL/orgs', 'repos_url': 'https://api.github.com/users/SsnL/repos', 'events_url': 'https://api.github.com/users/SsnL/events{/privacy}', 'received_events_url': 'https://api.github.com/users/SsnL/received_events', 'type': 'User', 'site_admin': False}",referenced,7db085d4321853a27921ca095f4114af8be64988,https://api.github.com/repos/pytorch/pytorch/commits/7db085d4321853a27921ca095f4114af8be64988,2019-04-25T18:18:55Z,30,16,14
19717,2304383514,"{'login': 'facebook-github-bot', 'id': 6422482, 'node_id': 'MDQ6VXNlcjY0MjI0ODI=', 'avatar_url': 'https://avatars3.githubusercontent.com/u/6422482?v=4', 'gravatar_id': '', 'url': 'https://api.github.com/users/facebook-github-bot', 'html_url': 'https://github.com/facebook-github-bot', 'followers_url': 'https://api.github.com/users/facebook-github-bot/followers', 'following_url': 'https://api.github.com/users/facebook-github-bot/following{/other_user}', 'gists_url': 'https://api.github.com/users/facebook-github-bot/gists{/gist_id}', 'starred_url': 'https://api.github.com/users/facebook-github-bot/starred{/owner}{/repo}', 'subscriptions_url': 'https://api.github.com/users/facebook-github-bot/subscriptions', 'organizations_url': 'https://api.github.com/users/facebook-github-bot/orgs', 'repos_url': 'https://api.github.com/users/facebook-github-bot/repos', 'events_url': 'https://api.github.com/users/facebook-github-bot/events{/privacy}', 'received_events_url': 'https://api.github.com/users/facebook-github-bot/received_events', 'type': 'User', 'site_admin': False}",referenced,42fbeef5d7bac6e53c821a7d9d4d26268cdd63f1,https://api.github.com/repos/pytorch/pytorch/commits/42fbeef5d7bac6e53c821a7d9d4d26268cdd63f1,2019-04-26T23:03:43Z,30,16,14
19650,2300941547,"{'login': 'facebook-github-bot', 'id': 6422482, 'node_id': 'MDQ6VXNlcjY0MjI0ODI=', 'avatar_url': 'https://avatars3.githubusercontent.com/u/6422482?v=4', 'gravatar_id': '', 'url': 'https://api.github.com/users/facebook-github-bot', 'html_url': 'https://github.com/facebook-github-bot', 'followers_url': 'https://api.github.com/users/facebook-github-bot/followers', 'following_url': 'https://api.github.com/users/facebook-github-bot/following{/other_user}', 'gists_url': 'https://api.github.com/users/facebook-github-bot/gists{/gist_id}', 'starred_url': 'https://api.github.com/users/facebook-github-bot/starred{/owner}{/repo}', 'subscriptions_url': 'https://api.github.com/users/facebook-github-bot/subscriptions', 'organizations_url': 'https://api.github.com/users/facebook-github-bot/orgs', 'repos_url': 'https://api.github.com/users/facebook-github-bot/repos', 'events_url': 'https://api.github.com/users/facebook-github-bot/events{/privacy}', 'received_events_url': 'https://api.github.com/users/facebook-github-bot/received_events', 'type': 'User', 'site_admin': False}",closed,0effe1d4a4d2cc8e16168f69746c5bb738a30bc7,https://api.github.com/repos/pytorch/pytorch/commits/0effe1d4a4d2cc8e16168f69746c5bb738a30bc7,2019-04-25T17:23:37Z,242,133,109
19540,2395337360,"{'login': 'facebook-github-bot', 'id': 6422482, 'node_id': 'MDQ6VXNlcjY0MjI0ODI=', 'avatar_url': 'https://avatars3.githubusercontent.com/u/6422482?v=4', 'gravatar_id': '', 'url': 'https://api.github.com/users/facebook-github-bot', 'html_url': 'https://github.com/facebook-github-bot', 'followers_url': 'https://api.github.com/users/facebook-github-bot/followers', 'following_url': 'https://api.github.com/users/facebook-github-bot/following{/other_user}', 'gists_url': 'https://api.github.com/users/facebook-github-bot/gists{/gist_id}', 'starred_url': 'https://api.github.com/users/facebook-github-bot/starred{/owner}{/repo}', 'subscriptions_url': 'https://api.github.com/users/facebook-github-bot/subscriptions', 'organizations_url': 'https://api.github.com/users/facebook-github-bot/orgs', 'repos_url': 'https://api.github.com/users/facebook-github-bot/repos', 'events_url': 'https://api.github.com/users/facebook-github-bot/events{/privacy}', 'received_events_url': 'https://api.github.com/users/facebook-github-bot/received_events', 'type': 'User', 'site_admin': False}",closed,b7b6b612a7ed28d7f6a794961690b92d60fe15e4,https://api.github.com/repos/pytorch/pytorch/commits/b7b6b612a7ed28d7f6a794961690b92d60fe15e4,2019-06-06T19:00:12Z,190,190,0
19509,2294537940,"{'login': 'facebook-github-bot', 'id': 6422482, 'node_id': 'MDQ6VXNlcjY0MjI0ODI=', 'avatar_url': 'https://avatars3.githubusercontent.com/u/6422482?v=4', 'gravatar_id': '', 'url': 'https://api.github.com/users/facebook-github-bot', 'html_url': 'https://github.com/facebook-github-bot', 'followers_url': 'https://api.github.com/users/facebook-github-bot/followers', 'following_url': 'https://api.github.com/users/facebook-github-bot/following{/other_user}', 'gists_url': 'https://api.github.com/users/facebook-github-bot/gists{/gist_id}', 'starred_url': 'https://api.github.com/users/facebook-github-bot/starred{/owner}{/repo}', 'subscriptions_url': 'https://api.github.com/users/facebook-github-bot/subscriptions', 'organizations_url': 'https://api.github.com/users/facebook-github-bot/orgs', 'repos_url': 'https://api.github.com/users/facebook-github-bot/repos', 'events_url': 'https://api.github.com/users/facebook-github-bot/events{/privacy}', 'received_events_url': 'https://api.github.com/users/facebook-github-bot/received_events', 'type': 'User', 'site_admin': False}",closed,dce3d74dfba7640227b96b72683bb7ab86a9c27f,https://api.github.com/repos/pytorch/pytorch/commits/dce3d74dfba7640227b96b72683bb7ab86a9c27f,2019-04-23T15:42:51Z,55,39,16
19508,2337573342,"{'login': 'facebook-github-bot', 'id': 6422482, 'node_id': 'MDQ6VXNlcjY0MjI0ODI=', 'avatar_url': 'https://avatars3.githubusercontent.com/u/6422482?v=4', 'gravatar_id': '', 'url': 'https://api.github.com/users/facebook-github-bot', 'html_url': 'https://github.com/facebook-github-bot', 'followers_url': 'https://api.github.com/users/facebook-github-bot/followers', 'following_url': 'https://api.github.com/users/facebook-github-bot/following{/other_user}', 'gists_url': 'https://api.github.com/users/facebook-github-bot/gists{/gist_id}', 'starred_url': 'https://api.github.com/users/facebook-github-bot/starred{/owner}{/repo}', 'subscriptions_url': 'https://api.github.com/users/facebook-github-bot/subscriptions', 'organizations_url': 'https://api.github.com/users/facebook-github-bot/orgs', 'repos_url': 'https://api.github.com/users/facebook-github-bot/repos', 'events_url': 'https://api.github.com/users/facebook-github-bot/events{/privacy}', 'received_events_url': 'https://api.github.com/users/facebook-github-bot/received_events', 'type': 'User', 'site_admin': False}",referenced,67414714e51b96f4820a842aa6727f954a29b66e,https://api.github.com/repos/pytorch/pytorch/commits/67414714e51b96f4820a842aa6727f954a29b66e,2019-05-13T16:41:03Z,406,359,47
19502,2299191485,"{'login': 'facebook-github-bot', 'id': 6422482, 'node_id': 'MDQ6VXNlcjY0MjI0ODI=', 'avatar_url': 'https://avatars3.githubusercontent.com/u/6422482?v=4', 'gravatar_id': '', 'url': 'https://api.github.com/users/facebook-github-bot', 'html_url': 'https://github.com/facebook-github-bot', 'followers_url': 'https://api.github.com/users/facebook-github-bot/followers', 'following_url': 'https://api.github.com/users/facebook-github-bot/following{/other_user}', 'gists_url': 'https://api.github.com/users/facebook-github-bot/gists{/gist_id}', 'starred_url': 'https://api.github.com/users/facebook-github-bot/starred{/owner}{/repo}', 'subscriptions_url': 'https://api.github.com/users/facebook-github-bot/subscriptions', 'organizations_url': 'https://api.github.com/users/facebook-github-bot/orgs', 'repos_url': 'https://api.github.com/users/facebook-github-bot/repos', 'events_url': 'https://api.github.com/users/facebook-github-bot/events{/privacy}', 'received_events_url': 'https://api.github.com/users/facebook-github-bot/received_events', 'type': 'User', 'site_admin': False}",closed,c571969148d3464060298640fd446808bff02345,https://api.github.com/repos/pytorch/pytorch/commits/c571969148d3464060298640fd446808bff02345,2019-04-25T06:14:55Z,4,2,2
19462,2395020979,"{'login': 'facebook-github-bot', 'id': 6422482, 'node_id': 'MDQ6VXNlcjY0MjI0ODI=', 'avatar_url': 'https://avatars3.githubusercontent.com/u/6422482?v=4', 'gravatar_id': '', 'url': 'https://api.github.com/users/facebook-github-bot', 'html_url': 'https://github.com/facebook-github-bot', 'followers_url': 'https://api.github.com/users/facebook-github-bot/followers', 'following_url': 'https://api.github.com/users/facebook-github-bot/following{/other_user}', 'gists_url': 'https://api.github.com/users/facebook-github-bot/gists{/gist_id}', 'starred_url': 'https://api.github.com/users/facebook-github-bot/starred{/owner}{/repo}', 'subscriptions_url': 'https://api.github.com/users/facebook-github-bot/subscriptions', 'organizations_url': 'https://api.github.com/users/facebook-github-bot/orgs', 'repos_url': 'https://api.github.com/users/facebook-github-bot/repos', 'events_url': 'https://api.github.com/users/facebook-github-bot/events{/privacy}', 'received_events_url': 'https://api.github.com/users/facebook-github-bot/received_events', 'type': 'User', 'site_admin': False}",closed,c8083e029270b73a3166af5aaf53176003ff28af,https://api.github.com/repos/pytorch/pytorch/commits/c8083e029270b73a3166af5aaf53176003ff28af,2019-06-06T17:00:32Z,2,1,1
19422,2520718685,"{'login': 'facebook-github-bot', 'id': 6422482, 'node_id': 'MDQ6VXNlcjY0MjI0ODI=', 'avatar_url': 'https://avatars3.githubusercontent.com/u/6422482?v=4', 'gravatar_id': '', 'url': 'https://api.github.com/users/facebook-github-bot', 'html_url': 'https://github.com/facebook-github-bot', 'followers_url': 'https://api.github.com/users/facebook-github-bot/followers', 'following_url': 'https://api.github.com/users/facebook-github-bot/following{/other_user}', 'gists_url': 'https://api.github.com/users/facebook-github-bot/gists{/gist_id}', 'starred_url': 'https://api.github.com/users/facebook-github-bot/starred{/owner}{/repo}', 'subscriptions_url': 'https://api.github.com/users/facebook-github-bot/subscriptions', 'organizations_url': 'https://api.github.com/users/facebook-github-bot/orgs', 'repos_url': 'https://api.github.com/users/facebook-github-bot/repos', 'events_url': 'https://api.github.com/users/facebook-github-bot/events{/privacy}', 'received_events_url': 'https://api.github.com/users/facebook-github-bot/received_events', 'type': 'User', 'site_admin': False}",closed,be3d27589fec1a31b4f821e69fb85cbcf3584257,https://api.github.com/repos/pytorch/pytorch/commits/be3d27589fec1a31b4f821e69fb85cbcf3584257,2019-07-30T18:12:56Z,63,62,1
19420,2936429214,"{'login': 'facebook-github-bot', 'id': 6422482, 'node_id': 'MDQ6VXNlcjY0MjI0ODI=', 'avatar_url': 'https://avatars3.githubusercontent.com/u/6422482?v=4', 'gravatar_id': '', 'url': 'https://api.github.com/users/facebook-github-bot', 'html_url': 'https://github.com/facebook-github-bot', 'followers_url': 'https://api.github.com/users/facebook-github-bot/followers', 'following_url': 'https://api.github.com/users/facebook-github-bot/following{/other_user}', 'gists_url': 'https://api.github.com/users/facebook-github-bot/gists{/gist_id}', 'starred_url': 'https://api.github.com/users/facebook-github-bot/starred{/owner}{/repo}', 'subscriptions_url': 'https://api.github.com/users/facebook-github-bot/subscriptions', 'organizations_url': 'https://api.github.com/users/facebook-github-bot/orgs', 'repos_url': 'https://api.github.com/users/facebook-github-bot/repos', 'events_url': 'https://api.github.com/users/facebook-github-bot/events{/privacy}', 'received_events_url': 'https://api.github.com/users/facebook-github-bot/received_events', 'type': 'User', 'site_admin': False}",referenced,cfdfdf70d7d5f363af43d3cc68fe12042b4518e4,https://api.github.com/repos/pytorch/pytorch/commits/cfdfdf70d7d5f363af43d3cc68fe12042b4518e4,2020-01-09T20:56:32Z,81,41,40
19394,2455027190,"{'login': 'facebook-github-bot', 'id': 6422482, 'node_id': 'MDQ6VXNlcjY0MjI0ODI=', 'avatar_url': 'https://avatars3.githubusercontent.com/u/6422482?v=4', 'gravatar_id': '', 'url': 'https://api.github.com/users/facebook-github-bot', 'html_url': 'https://github.com/facebook-github-bot', 'followers_url': 'https://api.github.com/users/facebook-github-bot/followers', 'following_url': 'https://api.github.com/users/facebook-github-bot/following{/other_user}', 'gists_url': 'https://api.github.com/users/facebook-github-bot/gists{/gist_id}', 'starred_url': 'https://api.github.com/users/facebook-github-bot/starred{/owner}{/repo}', 'subscriptions_url': 'https://api.github.com/users/facebook-github-bot/subscriptions', 'organizations_url': 'https://api.github.com/users/facebook-github-bot/orgs', 'repos_url': 'https://api.github.com/users/facebook-github-bot/repos', 'events_url': 'https://api.github.com/users/facebook-github-bot/events{/privacy}', 'received_events_url': 'https://api.github.com/users/facebook-github-bot/received_events', 'type': 'User', 'site_admin': False}",closed,2dd71b18c4bfc07bc07cafbd14e83e23add9e88f,https://api.github.com/repos/pytorch/pytorch/commits/2dd71b18c4bfc07bc07cafbd14e83e23add9e88f,2019-07-02T16:50:42Z,8,6,2
19372,2295640648,"{'login': 'facebook-github-bot', 'id': 6422482, 'node_id': 'MDQ6VXNlcjY0MjI0ODI=', 'avatar_url': 'https://avatars3.githubusercontent.com/u/6422482?v=4', 'gravatar_id': '', 'url': 'https://api.github.com/users/facebook-github-bot', 'html_url': 'https://github.com/facebook-github-bot', 'followers_url': 'https://api.github.com/users/facebook-github-bot/followers', 'following_url': 'https://api.github.com/users/facebook-github-bot/following{/other_user}', 'gists_url': 'https://api.github.com/users/facebook-github-bot/gists{/gist_id}', 'starred_url': 'https://api.github.com/users/facebook-github-bot/starred{/owner}{/repo}', 'subscriptions_url': 'https://api.github.com/users/facebook-github-bot/subscriptions', 'organizations_url': 'https://api.github.com/users/facebook-github-bot/orgs', 'repos_url': 'https://api.github.com/users/facebook-github-bot/repos', 'events_url': 'https://api.github.com/users/facebook-github-bot/events{/privacy}', 'received_events_url': 'https://api.github.com/users/facebook-github-bot/received_events', 'type': 'User', 'site_admin': False}",referenced,5119cc7cdf01093747713410dc27c3ab22b28ba3,https://api.github.com/repos/pytorch/pytorch/commits/5119cc7cdf01093747713410dc27c3ab22b28ba3,2019-04-23T23:40:21Z,68,68,0
19366,2301727032,"{'login': 'facebook-github-bot', 'id': 6422482, 'node_id': 'MDQ6VXNlcjY0MjI0ODI=', 'avatar_url': 'https://avatars3.githubusercontent.com/u/6422482?v=4', 'gravatar_id': '', 'url': 'https://api.github.com/users/facebook-github-bot', 'html_url': 'https://github.com/facebook-github-bot', 'followers_url': 'https://api.github.com/users/facebook-github-bot/followers', 'following_url': 'https://api.github.com/users/facebook-github-bot/following{/other_user}', 'gists_url': 'https://api.github.com/users/facebook-github-bot/gists{/gist_id}', 'starred_url': 'https://api.github.com/users/facebook-github-bot/starred{/owner}{/repo}', 'subscriptions_url': 'https://api.github.com/users/facebook-github-bot/subscriptions', 'organizations_url': 'https://api.github.com/users/facebook-github-bot/orgs', 'repos_url': 'https://api.github.com/users/facebook-github-bot/repos', 'events_url': 'https://api.github.com/users/facebook-github-bot/events{/privacy}', 'received_events_url': 'https://api.github.com/users/facebook-github-bot/received_events', 'type': 'User', 'site_admin': False}",referenced,9ef8eb4cbcb3909e66cdc125cf00f7d1a471707b,https://api.github.com/repos/pytorch/pytorch/commits/9ef8eb4cbcb3909e66cdc125cf00f7d1a471707b,2019-04-25T23:33:34Z,7,5,2
19363,2334469300,"{'login': 'facebook-github-bot', 'id': 6422482, 'node_id': 'MDQ6VXNlcjY0MjI0ODI=', 'avatar_url': 'https://avatars3.githubusercontent.com/u/6422482?v=4', 'gravatar_id': '', 'url': 'https://api.github.com/users/facebook-github-bot', 'html_url': 'https://github.com/facebook-github-bot', 'followers_url': 'https://api.github.com/users/facebook-github-bot/followers', 'following_url': 'https://api.github.com/users/facebook-github-bot/following{/other_user}', 'gists_url': 'https://api.github.com/users/facebook-github-bot/gists{/gist_id}', 'starred_url': 'https://api.github.com/users/facebook-github-bot/starred{/owner}{/repo}', 'subscriptions_url': 'https://api.github.com/users/facebook-github-bot/subscriptions', 'organizations_url': 'https://api.github.com/users/facebook-github-bot/orgs', 'repos_url': 'https://api.github.com/users/facebook-github-bot/repos', 'events_url': 'https://api.github.com/users/facebook-github-bot/events{/privacy}', 'received_events_url': 'https://api.github.com/users/facebook-github-bot/received_events', 'type': 'User', 'site_admin': False}",closed,3a39ce0f419ef8dd88c10ed72aef83c9d5f22c7f,https://api.github.com/repos/pytorch/pytorch/commits/3a39ce0f419ef8dd88c10ed72aef83c9d5f22c7f,2019-05-11T00:17:06Z,57,48,9
19354,2287023646,"{'login': 'facebook-github-bot', 'id': 6422482, 'node_id': 'MDQ6VXNlcjY0MjI0ODI=', 'avatar_url': 'https://avatars3.githubusercontent.com/u/6422482?v=4', 'gravatar_id': '', 'url': 'https://api.github.com/users/facebook-github-bot', 'html_url': 'https://github.com/facebook-github-bot', 'followers_url': 'https://api.github.com/users/facebook-github-bot/followers', 'following_url': 'https://api.github.com/users/facebook-github-bot/following{/other_user}', 'gists_url': 'https://api.github.com/users/facebook-github-bot/gists{/gist_id}', 'starred_url': 'https://api.github.com/users/facebook-github-bot/starred{/owner}{/repo}', 'subscriptions_url': 'https://api.github.com/users/facebook-github-bot/subscriptions', 'organizations_url': 'https://api.github.com/users/facebook-github-bot/orgs', 'repos_url': 'https://api.github.com/users/facebook-github-bot/repos', 'events_url': 'https://api.github.com/users/facebook-github-bot/events{/privacy}', 'received_events_url': 'https://api.github.com/users/facebook-github-bot/received_events', 'type': 'User', 'site_admin': False}",closed,a5c4348d54cc7736e5574ac56d890695197339ed,https://api.github.com/repos/pytorch/pytorch/commits/a5c4348d54cc7736e5574ac56d890695197339ed,2019-04-18T21:59:08Z,122,114,8
19351,2421386765,"{'login': 'facebook-github-bot', 'id': 6422482, 'node_id': 'MDQ6VXNlcjY0MjI0ODI=', 'avatar_url': 'https://avatars3.githubusercontent.com/u/6422482?v=4', 'gravatar_id': '', 'url': 'https://api.github.com/users/facebook-github-bot', 'html_url': 'https://github.com/facebook-github-bot', 'followers_url': 'https://api.github.com/users/facebook-github-bot/followers', 'following_url': 'https://api.github.com/users/facebook-github-bot/following{/other_user}', 'gists_url': 'https://api.github.com/users/facebook-github-bot/gists{/gist_id}', 'starred_url': 'https://api.github.com/users/facebook-github-bot/starred{/owner}{/repo}', 'subscriptions_url': 'https://api.github.com/users/facebook-github-bot/subscriptions', 'organizations_url': 'https://api.github.com/users/facebook-github-bot/orgs', 'repos_url': 'https://api.github.com/users/facebook-github-bot/repos', 'events_url': 'https://api.github.com/users/facebook-github-bot/events{/privacy}', 'received_events_url': 'https://api.github.com/users/facebook-github-bot/received_events', 'type': 'User', 'site_admin': False}",closed,f363a33e10336bb9cac797211e3c9bd74bf28e86,https://api.github.com/repos/pytorch/pytorch/commits/f363a33e10336bb9cac797211e3c9bd74bf28e86,2019-06-18T15:49:23Z,10,10,0
19326,2283830784,"{'login': 'facebook-github-bot', 'id': 6422482, 'node_id': 'MDQ6VXNlcjY0MjI0ODI=', 'avatar_url': 'https://avatars3.githubusercontent.com/u/6422482?v=4', 'gravatar_id': '', 'url': 'https://api.github.com/users/facebook-github-bot', 'html_url': 'https://github.com/facebook-github-bot', 'followers_url': 'https://api.github.com/users/facebook-github-bot/followers', 'following_url': 'https://api.github.com/users/facebook-github-bot/following{/other_user}', 'gists_url': 'https://api.github.com/users/facebook-github-bot/gists{/gist_id}', 'starred_url': 'https://api.github.com/users/facebook-github-bot/starred{/owner}{/repo}', 'subscriptions_url': 'https://api.github.com/users/facebook-github-bot/subscriptions', 'organizations_url': 'https://api.github.com/users/facebook-github-bot/orgs', 'repos_url': 'https://api.github.com/users/facebook-github-bot/repos', 'events_url': 'https://api.github.com/users/facebook-github-bot/events{/privacy}', 'received_events_url': 'https://api.github.com/users/facebook-github-bot/received_events', 'type': 'User', 'site_admin': False}",referenced,ff4a4d615582e9d5d4941405323fea96da04d9d7,https://api.github.com/repos/pytorch/pytorch/commits/ff4a4d615582e9d5d4941405323fea96da04d9d7,2019-04-17T19:58:09Z,5,3,2
19314,2313336873,"{'login': 'facebook-github-bot', 'id': 6422482, 'node_id': 'MDQ6VXNlcjY0MjI0ODI=', 'avatar_url': 'https://avatars3.githubusercontent.com/u/6422482?v=4', 'gravatar_id': '', 'url': 'https://api.github.com/users/facebook-github-bot', 'html_url': 'https://github.com/facebook-github-bot', 'followers_url': 'https://api.github.com/users/facebook-github-bot/followers', 'following_url': 'https://api.github.com/users/facebook-github-bot/following{/other_user}', 'gists_url': 'https://api.github.com/users/facebook-github-bot/gists{/gist_id}', 'starred_url': 'https://api.github.com/users/facebook-github-bot/starred{/owner}{/repo}', 'subscriptions_url': 'https://api.github.com/users/facebook-github-bot/subscriptions', 'organizations_url': 'https://api.github.com/users/facebook-github-bot/orgs', 'repos_url': 'https://api.github.com/users/facebook-github-bot/repos', 'events_url': 'https://api.github.com/users/facebook-github-bot/events{/privacy}', 'received_events_url': 'https://api.github.com/users/facebook-github-bot/received_events', 'type': 'User', 'site_admin': False}",closed,725ef26f344588884f9f803d687711af5a7f300a,https://api.github.com/repos/pytorch/pytorch/commits/725ef26f344588884f9f803d687711af5a7f300a,2019-05-02T01:00:11Z,133,125,8
19268,2622884950,"{'login': 'facebook-github-bot', 'id': 6422482, 'node_id': 'MDQ6VXNlcjY0MjI0ODI=', 'avatar_url': 'https://avatars3.githubusercontent.com/u/6422482?v=4', 'gravatar_id': '', 'url': 'https://api.github.com/users/facebook-github-bot', 'html_url': 'https://github.com/facebook-github-bot', 'followers_url': 'https://api.github.com/users/facebook-github-bot/followers', 'following_url': 'https://api.github.com/users/facebook-github-bot/following{/other_user}', 'gists_url': 'https://api.github.com/users/facebook-github-bot/gists{/gist_id}', 'starred_url': 'https://api.github.com/users/facebook-github-bot/starred{/owner}{/repo}', 'subscriptions_url': 'https://api.github.com/users/facebook-github-bot/subscriptions', 'organizations_url': 'https://api.github.com/users/facebook-github-bot/orgs', 'repos_url': 'https://api.github.com/users/facebook-github-bot/repos', 'events_url': 'https://api.github.com/users/facebook-github-bot/events{/privacy}', 'received_events_url': 'https://api.github.com/users/facebook-github-bot/received_events', 'type': 'User', 'site_admin': False}",closed,76ee02f10d2c936606bebf7f364a56f34a612823,https://api.github.com/repos/pytorch/pytorch/commits/76ee02f10d2c936606bebf7f364a56f34a612823,2019-09-10T16:19:06Z,515,292,223
19265,2370201350,"{'login': 'facebook-github-bot', 'id': 6422482, 'node_id': 'MDQ6VXNlcjY0MjI0ODI=', 'avatar_url': 'https://avatars3.githubusercontent.com/u/6422482?v=4', 'gravatar_id': '', 'url': 'https://api.github.com/users/facebook-github-bot', 'html_url': 'https://github.com/facebook-github-bot', 'followers_url': 'https://api.github.com/users/facebook-github-bot/followers', 'following_url': 'https://api.github.com/users/facebook-github-bot/following{/other_user}', 'gists_url': 'https://api.github.com/users/facebook-github-bot/gists{/gist_id}', 'starred_url': 'https://api.github.com/users/facebook-github-bot/starred{/owner}{/repo}', 'subscriptions_url': 'https://api.github.com/users/facebook-github-bot/subscriptions', 'organizations_url': 'https://api.github.com/users/facebook-github-bot/orgs', 'repos_url': 'https://api.github.com/users/facebook-github-bot/repos', 'events_url': 'https://api.github.com/users/facebook-github-bot/events{/privacy}', 'received_events_url': 'https://api.github.com/users/facebook-github-bot/received_events', 'type': 'User', 'site_admin': False}",closed,6e76813a3961e584ce6eb81dc4b817f79d22ff61,https://api.github.com/repos/pytorch/pytorch/commits/6e76813a3961e584ce6eb81dc4b817f79d22ff61,2019-05-27T21:49:19Z,2,1,1
19259,2282456617,"{'login': 'facebook-github-bot', 'id': 6422482, 'node_id': 'MDQ6VXNlcjY0MjI0ODI=', 'avatar_url': 'https://avatars3.githubusercontent.com/u/6422482?v=4', 'gravatar_id': '', 'url': 'https://api.github.com/users/facebook-github-bot', 'html_url': 'https://github.com/facebook-github-bot', 'followers_url': 'https://api.github.com/users/facebook-github-bot/followers', 'following_url': 'https://api.github.com/users/facebook-github-bot/following{/other_user}', 'gists_url': 'https://api.github.com/users/facebook-github-bot/gists{/gist_id}', 'starred_url': 'https://api.github.com/users/facebook-github-bot/starred{/owner}{/repo}', 'subscriptions_url': 'https://api.github.com/users/facebook-github-bot/subscriptions', 'organizations_url': 'https://api.github.com/users/facebook-github-bot/orgs', 'repos_url': 'https://api.github.com/users/facebook-github-bot/repos', 'events_url': 'https://api.github.com/users/facebook-github-bot/events{/privacy}', 'received_events_url': 'https://api.github.com/users/facebook-github-bot/received_events', 'type': 'User', 'site_admin': False}",closed,3fcee4875c4383bff78917284875f180ad41903c,https://api.github.com/repos/pytorch/pytorch/commits/3fcee4875c4383bff78917284875f180ad41903c,2019-04-17T11:42:25Z,5,5,0
19255,2288396488,"{'login': 'facebook-github-bot', 'id': 6422482, 'node_id': 'MDQ6VXNlcjY0MjI0ODI=', 'avatar_url': 'https://avatars3.githubusercontent.com/u/6422482?v=4', 'gravatar_id': '', 'url': 'https://api.github.com/users/facebook-github-bot', 'html_url': 'https://github.com/facebook-github-bot', 'followers_url': 'https://api.github.com/users/facebook-github-bot/followers', 'following_url': 'https://api.github.com/users/facebook-github-bot/following{/other_user}', 'gists_url': 'https://api.github.com/users/facebook-github-bot/gists{/gist_id}', 'starred_url': 'https://api.github.com/users/facebook-github-bot/starred{/owner}{/repo}', 'subscriptions_url': 'https://api.github.com/users/facebook-github-bot/subscriptions', 'organizations_url': 'https://api.github.com/users/facebook-github-bot/orgs', 'repos_url': 'https://api.github.com/users/facebook-github-bot/repos', 'events_url': 'https://api.github.com/users/facebook-github-bot/events{/privacy}', 'received_events_url': 'https://api.github.com/users/facebook-github-bot/received_events', 'type': 'User', 'site_admin': False}",closed,a97330b7c50b9e9e1f31de1aa6194945a2bc3ca4,https://api.github.com/repos/pytorch/pytorch/commits/a97330b7c50b9e9e1f31de1aa6194945a2bc3ca4,2019-04-19T15:02:12Z,4,3,1
19253,2287237274,"{'login': 'facebook-github-bot', 'id': 6422482, 'node_id': 'MDQ6VXNlcjY0MjI0ODI=', 'avatar_url': 'https://avatars3.githubusercontent.com/u/6422482?v=4', 'gravatar_id': '', 'url': 'https://api.github.com/users/facebook-github-bot', 'html_url': 'https://github.com/facebook-github-bot', 'followers_url': 'https://api.github.com/users/facebook-github-bot/followers', 'following_url': 'https://api.github.com/users/facebook-github-bot/following{/other_user}', 'gists_url': 'https://api.github.com/users/facebook-github-bot/gists{/gist_id}', 'starred_url': 'https://api.github.com/users/facebook-github-bot/starred{/owner}{/repo}', 'subscriptions_url': 'https://api.github.com/users/facebook-github-bot/subscriptions', 'organizations_url': 'https://api.github.com/users/facebook-github-bot/orgs', 'repos_url': 'https://api.github.com/users/facebook-github-bot/repos', 'events_url': 'https://api.github.com/users/facebook-github-bot/events{/privacy}', 'received_events_url': 'https://api.github.com/users/facebook-github-bot/received_events', 'type': 'User', 'site_admin': False}",closed,b9291f55bb5e16e5acb9c8e9e2cb69bac56e8ab1,https://api.github.com/repos/pytorch/pytorch/commits/b9291f55bb5e16e5acb9c8e9e2cb69bac56e8ab1,2019-04-19T01:00:18Z,55,36,19
19250,2982641198,"{'login': 'facebook-github-bot', 'id': 6422482, 'node_id': 'MDQ6VXNlcjY0MjI0ODI=', 'avatar_url': 'https://avatars3.githubusercontent.com/u/6422482?v=4', 'gravatar_id': '', 'url': 'https://api.github.com/users/facebook-github-bot', 'html_url': 'https://github.com/facebook-github-bot', 'followers_url': 'https://api.github.com/users/facebook-github-bot/followers', 'following_url': 'https://api.github.com/users/facebook-github-bot/following{/other_user}', 'gists_url': 'https://api.github.com/users/facebook-github-bot/gists{/gist_id}', 'starred_url': 'https://api.github.com/users/facebook-github-bot/starred{/owner}{/repo}', 'subscriptions_url': 'https://api.github.com/users/facebook-github-bot/subscriptions', 'organizations_url': 'https://api.github.com/users/facebook-github-bot/orgs', 'repos_url': 'https://api.github.com/users/facebook-github-bot/repos', 'events_url': 'https://api.github.com/users/facebook-github-bot/events{/privacy}', 'received_events_url': 'https://api.github.com/users/facebook-github-bot/received_events', 'type': 'User', 'site_admin': False}",referenced,602394e996e9ac16ae2fb8c1c47b07c2db17d224,https://api.github.com/repos/pytorch/pytorch/commits/602394e996e9ac16ae2fb8c1c47b07c2db17d224,2020-01-27T17:08:04Z,60,40,20
19245,2287456401,"{'login': 'facebook-github-bot', 'id': 6422482, 'node_id': 'MDQ6VXNlcjY0MjI0ODI=', 'avatar_url': 'https://avatars3.githubusercontent.com/u/6422482?v=4', 'gravatar_id': '', 'url': 'https://api.github.com/users/facebook-github-bot', 'html_url': 'https://github.com/facebook-github-bot', 'followers_url': 'https://api.github.com/users/facebook-github-bot/followers', 'following_url': 'https://api.github.com/users/facebook-github-bot/following{/other_user}', 'gists_url': 'https://api.github.com/users/facebook-github-bot/gists{/gist_id}', 'starred_url': 'https://api.github.com/users/facebook-github-bot/starred{/owner}{/repo}', 'subscriptions_url': 'https://api.github.com/users/facebook-github-bot/subscriptions', 'organizations_url': 'https://api.github.com/users/facebook-github-bot/orgs', 'repos_url': 'https://api.github.com/users/facebook-github-bot/repos', 'events_url': 'https://api.github.com/users/facebook-github-bot/events{/privacy}', 'received_events_url': 'https://api.github.com/users/facebook-github-bot/received_events', 'type': 'User', 'site_admin': False}",closed,8638634a6ed2f77b4ad64ca3d9ec59027a458368,https://api.github.com/repos/pytorch/pytorch/commits/8638634a6ed2f77b4ad64ca3d9ec59027a458368,2019-04-19T05:16:10Z,2,1,1
19241,2287456408,"{'login': 'facebook-github-bot', 'id': 6422482, 'node_id': 'MDQ6VXNlcjY0MjI0ODI=', 'avatar_url': 'https://avatars3.githubusercontent.com/u/6422482?v=4', 'gravatar_id': '', 'url': 'https://api.github.com/users/facebook-github-bot', 'html_url': 'https://github.com/facebook-github-bot', 'followers_url': 'https://api.github.com/users/facebook-github-bot/followers', 'following_url': 'https://api.github.com/users/facebook-github-bot/following{/other_user}', 'gists_url': 'https://api.github.com/users/facebook-github-bot/gists{/gist_id}', 'starred_url': 'https://api.github.com/users/facebook-github-bot/starred{/owner}{/repo}', 'subscriptions_url': 'https://api.github.com/users/facebook-github-bot/subscriptions', 'organizations_url': 'https://api.github.com/users/facebook-github-bot/orgs', 'repos_url': 'https://api.github.com/users/facebook-github-bot/repos', 'events_url': 'https://api.github.com/users/facebook-github-bot/events{/privacy}', 'received_events_url': 'https://api.github.com/users/facebook-github-bot/received_events', 'type': 'User', 'site_admin': False}",referenced,940caed0d47aa7001308e7f64fd5000d06abd618,https://api.github.com/repos/pytorch/pytorch/commits/940caed0d47aa7001308e7f64fd5000d06abd618,2019-04-19T05:16:11Z,14,2,12
19224,2285748824,"{'login': 'facebook-github-bot', 'id': 6422482, 'node_id': 'MDQ6VXNlcjY0MjI0ODI=', 'avatar_url': 'https://avatars3.githubusercontent.com/u/6422482?v=4', 'gravatar_id': '', 'url': 'https://api.github.com/users/facebook-github-bot', 'html_url': 'https://github.com/facebook-github-bot', 'followers_url': 'https://api.github.com/users/facebook-github-bot/followers', 'following_url': 'https://api.github.com/users/facebook-github-bot/following{/other_user}', 'gists_url': 'https://api.github.com/users/facebook-github-bot/gists{/gist_id}', 'starred_url': 'https://api.github.com/users/facebook-github-bot/starred{/owner}{/repo}', 'subscriptions_url': 'https://api.github.com/users/facebook-github-bot/subscriptions', 'organizations_url': 'https://api.github.com/users/facebook-github-bot/orgs', 'repos_url': 'https://api.github.com/users/facebook-github-bot/repos', 'events_url': 'https://api.github.com/users/facebook-github-bot/events{/privacy}', 'received_events_url': 'https://api.github.com/users/facebook-github-bot/received_events', 'type': 'User', 'site_admin': False}",closed,973d51079b3c406d6bd6e627c4179e1011ebae78,https://api.github.com/repos/pytorch/pytorch/commits/973d51079b3c406d6bd6e627c4179e1011ebae78,2019-04-18T13:41:26Z,330,238,92
19220,2295504605,"{'login': 'facebook-github-bot', 'id': 6422482, 'node_id': 'MDQ6VXNlcjY0MjI0ODI=', 'avatar_url': 'https://avatars3.githubusercontent.com/u/6422482?v=4', 'gravatar_id': '', 'url': 'https://api.github.com/users/facebook-github-bot', 'html_url': 'https://github.com/facebook-github-bot', 'followers_url': 'https://api.github.com/users/facebook-github-bot/followers', 'following_url': 'https://api.github.com/users/facebook-github-bot/following{/other_user}', 'gists_url': 'https://api.github.com/users/facebook-github-bot/gists{/gist_id}', 'starred_url': 'https://api.github.com/users/facebook-github-bot/starred{/owner}{/repo}', 'subscriptions_url': 'https://api.github.com/users/facebook-github-bot/subscriptions', 'organizations_url': 'https://api.github.com/users/facebook-github-bot/orgs', 'repos_url': 'https://api.github.com/users/facebook-github-bot/repos', 'events_url': 'https://api.github.com/users/facebook-github-bot/events{/privacy}', 'received_events_url': 'https://api.github.com/users/facebook-github-bot/received_events', 'type': 'User', 'site_admin': False}",referenced,9b272affdebf2392d8ede7f83223bf30392a6e43,https://api.github.com/repos/pytorch/pytorch/commits/9b272affdebf2392d8ede7f83223bf30392a6e43,2019-04-23T22:08:44Z,48,31,17
19219,2277495200,"{'login': 'facebook-github-bot', 'id': 6422482, 'node_id': 'MDQ6VXNlcjY0MjI0ODI=', 'avatar_url': 'https://avatars3.githubusercontent.com/u/6422482?v=4', 'gravatar_id': '', 'url': 'https://api.github.com/users/facebook-github-bot', 'html_url': 'https://github.com/facebook-github-bot', 'followers_url': 'https://api.github.com/users/facebook-github-bot/followers', 'following_url': 'https://api.github.com/users/facebook-github-bot/following{/other_user}', 'gists_url': 'https://api.github.com/users/facebook-github-bot/gists{/gist_id}', 'starred_url': 'https://api.github.com/users/facebook-github-bot/starred{/owner}{/repo}', 'subscriptions_url': 'https://api.github.com/users/facebook-github-bot/subscriptions', 'organizations_url': 'https://api.github.com/users/facebook-github-bot/orgs', 'repos_url': 'https://api.github.com/users/facebook-github-bot/repos', 'events_url': 'https://api.github.com/users/facebook-github-bot/events{/privacy}', 'received_events_url': 'https://api.github.com/users/facebook-github-bot/received_events', 'type': 'User', 'site_admin': False}",referenced,7caad0ed33f20c7ec4fab47a9ee7006973afce08,https://api.github.com/repos/pytorch/pytorch/commits/7caad0ed33f20c7ec4fab47a9ee7006973afce08,2019-04-15T18:31:14Z,51,51,0
19189,2509399236,"{'login': 'facebook-github-bot', 'id': 6422482, 'node_id': 'MDQ6VXNlcjY0MjI0ODI=', 'avatar_url': 'https://avatars3.githubusercontent.com/u/6422482?v=4', 'gravatar_id': '', 'url': 'https://api.github.com/users/facebook-github-bot', 'html_url': 'https://github.com/facebook-github-bot', 'followers_url': 'https://api.github.com/users/facebook-github-bot/followers', 'following_url': 'https://api.github.com/users/facebook-github-bot/following{/other_user}', 'gists_url': 'https://api.github.com/users/facebook-github-bot/gists{/gist_id}', 'starred_url': 'https://api.github.com/users/facebook-github-bot/starred{/owner}{/repo}', 'subscriptions_url': 'https://api.github.com/users/facebook-github-bot/subscriptions', 'organizations_url': 'https://api.github.com/users/facebook-github-bot/orgs', 'repos_url': 'https://api.github.com/users/facebook-github-bot/repos', 'events_url': 'https://api.github.com/users/facebook-github-bot/events{/privacy}', 'received_events_url': 'https://api.github.com/users/facebook-github-bot/received_events', 'type': 'User', 'site_admin': False}",closed,0c79753c0d384534225715ee3074d3469e433060,https://api.github.com/repos/pytorch/pytorch/commits/0c79753c0d384534225715ee3074d3469e433060,2019-07-25T12:51:42Z,13,11,2
19186,2333964956,"{'login': 'facebook-github-bot', 'id': 6422482, 'node_id': 'MDQ6VXNlcjY0MjI0ODI=', 'avatar_url': 'https://avatars3.githubusercontent.com/u/6422482?v=4', 'gravatar_id': '', 'url': 'https://api.github.com/users/facebook-github-bot', 'html_url': 'https://github.com/facebook-github-bot', 'followers_url': 'https://api.github.com/users/facebook-github-bot/followers', 'following_url': 'https://api.github.com/users/facebook-github-bot/following{/other_user}', 'gists_url': 'https://api.github.com/users/facebook-github-bot/gists{/gist_id}', 'starred_url': 'https://api.github.com/users/facebook-github-bot/starred{/owner}{/repo}', 'subscriptions_url': 'https://api.github.com/users/facebook-github-bot/subscriptions', 'organizations_url': 'https://api.github.com/users/facebook-github-bot/orgs', 'repos_url': 'https://api.github.com/users/facebook-github-bot/repos', 'events_url': 'https://api.github.com/users/facebook-github-bot/events{/privacy}', 'received_events_url': 'https://api.github.com/users/facebook-github-bot/received_events', 'type': 'User', 'site_admin': False}",closed,35fed93b1ef05175143f883c6f89f06c6dd9429b,https://api.github.com/repos/pytorch/pytorch/commits/35fed93b1ef05175143f883c6f89f06c6dd9429b,2019-05-10T19:00:07Z,43,29,14
19184,2395634107,"{'login': 'facebook-github-bot', 'id': 6422482, 'node_id': 'MDQ6VXNlcjY0MjI0ODI=', 'avatar_url': 'https://avatars3.githubusercontent.com/u/6422482?v=4', 'gravatar_id': '', 'url': 'https://api.github.com/users/facebook-github-bot', 'html_url': 'https://github.com/facebook-github-bot', 'followers_url': 'https://api.github.com/users/facebook-github-bot/followers', 'following_url': 'https://api.github.com/users/facebook-github-bot/following{/other_user}', 'gists_url': 'https://api.github.com/users/facebook-github-bot/gists{/gist_id}', 'starred_url': 'https://api.github.com/users/facebook-github-bot/starred{/owner}{/repo}', 'subscriptions_url': 'https://api.github.com/users/facebook-github-bot/subscriptions', 'organizations_url': 'https://api.github.com/users/facebook-github-bot/orgs', 'repos_url': 'https://api.github.com/users/facebook-github-bot/repos', 'events_url': 'https://api.github.com/users/facebook-github-bot/events{/privacy}', 'received_events_url': 'https://api.github.com/users/facebook-github-bot/received_events', 'type': 'User', 'site_admin': False}",referenced,87d10d49f476cdf6db0eda0f2dea57adf9ece057,https://api.github.com/repos/pytorch/pytorch/commits/87d10d49f476cdf6db0eda0f2dea57adf9ece057,2019-06-06T21:01:59Z,79,26,53
19161,3128459160,"{'login': 'facebook-github-bot', 'id': 6422482, 'node_id': 'MDQ6VXNlcjY0MjI0ODI=', 'avatar_url': 'https://avatars3.githubusercontent.com/u/6422482?v=4', 'gravatar_id': '', 'url': 'https://api.github.com/users/facebook-github-bot', 'html_url': 'https://github.com/facebook-github-bot', 'followers_url': 'https://api.github.com/users/facebook-github-bot/followers', 'following_url': 'https://api.github.com/users/facebook-github-bot/following{/other_user}', 'gists_url': 'https://api.github.com/users/facebook-github-bot/gists{/gist_id}', 'starred_url': 'https://api.github.com/users/facebook-github-bot/starred{/owner}{/repo}', 'subscriptions_url': 'https://api.github.com/users/facebook-github-bot/subscriptions', 'organizations_url': 'https://api.github.com/users/facebook-github-bot/orgs', 'repos_url': 'https://api.github.com/users/facebook-github-bot/repos', 'events_url': 'https://api.github.com/users/facebook-github-bot/events{/privacy}', 'received_events_url': 'https://api.github.com/users/facebook-github-bot/received_events', 'type': 'User', 'site_admin': False}",referenced,6d790c3611ef26be9a9407e1d286ff528b3c056c,https://api.github.com/repos/pytorch/pytorch/commits/6d790c3611ef26be9a9407e1d286ff528b3c056c,2020-03-13T22:29:39Z,2,1,1
19151,2781799323,"{'login': 'facebook-github-bot', 'id': 6422482, 'node_id': 'MDQ6VXNlcjY0MjI0ODI=', 'avatar_url': 'https://avatars3.githubusercontent.com/u/6422482?v=4', 'gravatar_id': '', 'url': 'https://api.github.com/users/facebook-github-bot', 'html_url': 'https://github.com/facebook-github-bot', 'followers_url': 'https://api.github.com/users/facebook-github-bot/followers', 'following_url': 'https://api.github.com/users/facebook-github-bot/following{/other_user}', 'gists_url': 'https://api.github.com/users/facebook-github-bot/gists{/gist_id}', 'starred_url': 'https://api.github.com/users/facebook-github-bot/starred{/owner}{/repo}', 'subscriptions_url': 'https://api.github.com/users/facebook-github-bot/subscriptions', 'organizations_url': 'https://api.github.com/users/facebook-github-bot/orgs', 'repos_url': 'https://api.github.com/users/facebook-github-bot/repos', 'events_url': 'https://api.github.com/users/facebook-github-bot/events{/privacy}', 'received_events_url': 'https://api.github.com/users/facebook-github-bot/received_events', 'type': 'User', 'site_admin': False}",closed,5f03ad96982fca914ec34525c43154b8282e3b4a,https://api.github.com/repos/pytorch/pytorch/commits/5f03ad96982fca914ec34525c43154b8282e3b4a,2019-11-08T06:03:28Z,8,8,0
19088,2658275285,"{'login': 'facebook-github-bot', 'id': 6422482, 'node_id': 'MDQ6VXNlcjY0MjI0ODI=', 'avatar_url': 'https://avatars3.githubusercontent.com/u/6422482?v=4', 'gravatar_id': '', 'url': 'https://api.github.com/users/facebook-github-bot', 'html_url': 'https://github.com/facebook-github-bot', 'followers_url': 'https://api.github.com/users/facebook-github-bot/followers', 'following_url': 'https://api.github.com/users/facebook-github-bot/following{/other_user}', 'gists_url': 'https://api.github.com/users/facebook-github-bot/gists{/gist_id}', 'starred_url': 'https://api.github.com/users/facebook-github-bot/starred{/owner}{/repo}', 'subscriptions_url': 'https://api.github.com/users/facebook-github-bot/subscriptions', 'organizations_url': 'https://api.github.com/users/facebook-github-bot/orgs', 'repos_url': 'https://api.github.com/users/facebook-github-bot/repos', 'events_url': 'https://api.github.com/users/facebook-github-bot/events{/privacy}', 'received_events_url': 'https://api.github.com/users/facebook-github-bot/received_events', 'type': 'User', 'site_admin': False}",closed,cf1dbc79dbeb0e6b3aac319b07b7f76af63df47f,https://api.github.com/repos/pytorch/pytorch/commits/cf1dbc79dbeb0e6b3aac319b07b7f76af63df47f,2019-09-24T14:25:11Z,59,42,17
19077,2266946315,"{'login': 'facebook-github-bot', 'id': 6422482, 'node_id': 'MDQ6VXNlcjY0MjI0ODI=', 'avatar_url': 'https://avatars3.githubusercontent.com/u/6422482?v=4', 'gravatar_id': '', 'url': 'https://api.github.com/users/facebook-github-bot', 'html_url': 'https://github.com/facebook-github-bot', 'followers_url': 'https://api.github.com/users/facebook-github-bot/followers', 'following_url': 'https://api.github.com/users/facebook-github-bot/following{/other_user}', 'gists_url': 'https://api.github.com/users/facebook-github-bot/gists{/gist_id}', 'starred_url': 'https://api.github.com/users/facebook-github-bot/starred{/owner}{/repo}', 'subscriptions_url': 'https://api.github.com/users/facebook-github-bot/subscriptions', 'organizations_url': 'https://api.github.com/users/facebook-github-bot/orgs', 'repos_url': 'https://api.github.com/users/facebook-github-bot/repos', 'events_url': 'https://api.github.com/users/facebook-github-bot/events{/privacy}', 'received_events_url': 'https://api.github.com/users/facebook-github-bot/received_events', 'type': 'User', 'site_admin': False}",closed,1858773c0c1395bc7fdccc16c7d5ad08b6d37682,https://api.github.com/repos/pytorch/pytorch/commits/1858773c0c1395bc7fdccc16c7d5ad08b6d37682,2019-04-10T18:11:17Z,9,8,1
19076,2928618317,"{'login': 'facebook-github-bot', 'id': 6422482, 'node_id': 'MDQ6VXNlcjY0MjI0ODI=', 'avatar_url': 'https://avatars3.githubusercontent.com/u/6422482?v=4', 'gravatar_id': '', 'url': 'https://api.github.com/users/facebook-github-bot', 'html_url': 'https://github.com/facebook-github-bot', 'followers_url': 'https://api.github.com/users/facebook-github-bot/followers', 'following_url': 'https://api.github.com/users/facebook-github-bot/following{/other_user}', 'gists_url': 'https://api.github.com/users/facebook-github-bot/gists{/gist_id}', 'starred_url': 'https://api.github.com/users/facebook-github-bot/starred{/owner}{/repo}', 'subscriptions_url': 'https://api.github.com/users/facebook-github-bot/subscriptions', 'organizations_url': 'https://api.github.com/users/facebook-github-bot/orgs', 'repos_url': 'https://api.github.com/users/facebook-github-bot/repos', 'events_url': 'https://api.github.com/users/facebook-github-bot/events{/privacy}', 'received_events_url': 'https://api.github.com/users/facebook-github-bot/received_events', 'type': 'User', 'site_admin': False}",referenced,2f5eefe525d2602222117de8ab990ec495763cc1,https://api.github.com/repos/pytorch/pytorch/commits/2f5eefe525d2602222117de8ab990ec495763cc1,2020-01-07T18:30:00Z,30,22,8
19045,2266319700,"{'login': 'facebook-github-bot', 'id': 6422482, 'node_id': 'MDQ6VXNlcjY0MjI0ODI=', 'avatar_url': 'https://avatars3.githubusercontent.com/u/6422482?v=4', 'gravatar_id': '', 'url': 'https://api.github.com/users/facebook-github-bot', 'html_url': 'https://github.com/facebook-github-bot', 'followers_url': 'https://api.github.com/users/facebook-github-bot/followers', 'following_url': 'https://api.github.com/users/facebook-github-bot/following{/other_user}', 'gists_url': 'https://api.github.com/users/facebook-github-bot/gists{/gist_id}', 'starred_url': 'https://api.github.com/users/facebook-github-bot/starred{/owner}{/repo}', 'subscriptions_url': 'https://api.github.com/users/facebook-github-bot/subscriptions', 'organizations_url': 'https://api.github.com/users/facebook-github-bot/orgs', 'repos_url': 'https://api.github.com/users/facebook-github-bot/repos', 'events_url': 'https://api.github.com/users/facebook-github-bot/events{/privacy}', 'received_events_url': 'https://api.github.com/users/facebook-github-bot/received_events', 'type': 'User', 'site_admin': False}",closed,ea2405c7dc4d69477d41d4347b6b90af9a42e7ee,https://api.github.com/repos/pytorch/pytorch/commits/ea2405c7dc4d69477d41d4347b6b90af9a42e7ee,2019-04-10T14:38:08Z,341,294,47
19039,2304087192,"{'login': 'facebook-github-bot', 'id': 6422482, 'node_id': 'MDQ6VXNlcjY0MjI0ODI=', 'avatar_url': 'https://avatars3.githubusercontent.com/u/6422482?v=4', 'gravatar_id': '', 'url': 'https://api.github.com/users/facebook-github-bot', 'html_url': 'https://github.com/facebook-github-bot', 'followers_url': 'https://api.github.com/users/facebook-github-bot/followers', 'following_url': 'https://api.github.com/users/facebook-github-bot/following{/other_user}', 'gists_url': 'https://api.github.com/users/facebook-github-bot/gists{/gist_id}', 'starred_url': 'https://api.github.com/users/facebook-github-bot/starred{/owner}{/repo}', 'subscriptions_url': 'https://api.github.com/users/facebook-github-bot/subscriptions', 'organizations_url': 'https://api.github.com/users/facebook-github-bot/orgs', 'repos_url': 'https://api.github.com/users/facebook-github-bot/repos', 'events_url': 'https://api.github.com/users/facebook-github-bot/events{/privacy}', 'received_events_url': 'https://api.github.com/users/facebook-github-bot/received_events', 'type': 'User', 'site_admin': False}",closed,236c2b238724364129e9670b42a555e976fd635b,https://api.github.com/repos/pytorch/pytorch/commits/236c2b238724364129e9670b42a555e976fd635b,2019-04-26T20:09:00Z,55,47,8
19017,2261754115,"{'login': 'facebook-github-bot', 'id': 6422482, 'node_id': 'MDQ6VXNlcjY0MjI0ODI=', 'avatar_url': 'https://avatars3.githubusercontent.com/u/6422482?v=4', 'gravatar_id': '', 'url': 'https://api.github.com/users/facebook-github-bot', 'html_url': 'https://github.com/facebook-github-bot', 'followers_url': 'https://api.github.com/users/facebook-github-bot/followers', 'following_url': 'https://api.github.com/users/facebook-github-bot/following{/other_user}', 'gists_url': 'https://api.github.com/users/facebook-github-bot/gists{/gist_id}', 'starred_url': 'https://api.github.com/users/facebook-github-bot/starred{/owner}{/repo}', 'subscriptions_url': 'https://api.github.com/users/facebook-github-bot/subscriptions', 'organizations_url': 'https://api.github.com/users/facebook-github-bot/orgs', 'repos_url': 'https://api.github.com/users/facebook-github-bot/repos', 'events_url': 'https://api.github.com/users/facebook-github-bot/events{/privacy}', 'received_events_url': 'https://api.github.com/users/facebook-github-bot/received_events', 'type': 'User', 'site_admin': False}",closed,3bfdffe4870dda10e8b99a77cd6e0b034adbcd2b,https://api.github.com/repos/pytorch/pytorch/commits/3bfdffe4870dda10e8b99a77cd6e0b034adbcd2b,2019-04-09T06:16:21Z,13,11,2
19002,2265409026,"{'login': 'ilia-cher', 'id': 30845429, 'node_id': 'MDQ6VXNlcjMwODQ1NDI5', 'avatar_url': 'https://avatars1.githubusercontent.com/u/30845429?v=4', 'gravatar_id': '', 'url': 'https://api.github.com/users/ilia-cher', 'html_url': 'https://github.com/ilia-cher', 'followers_url': 'https://api.github.com/users/ilia-cher/followers', 'following_url': 'https://api.github.com/users/ilia-cher/following{/other_user}', 'gists_url': 'https://api.github.com/users/ilia-cher/gists{/gist_id}', 'starred_url': 'https://api.github.com/users/ilia-cher/starred{/owner}{/repo}', 'subscriptions_url': 'https://api.github.com/users/ilia-cher/subscriptions', 'organizations_url': 'https://api.github.com/users/ilia-cher/orgs', 'repos_url': 'https://api.github.com/users/ilia-cher/repos', 'events_url': 'https://api.github.com/users/ilia-cher/events{/privacy}', 'received_events_url': 'https://api.github.com/users/ilia-cher/received_events', 'type': 'User', 'site_admin': False}",referenced,ee66cabd71ce121081f32469ecde86d09f822962,https://api.github.com/repos/pytorch/pytorch/commits/ee66cabd71ce121081f32469ecde86d09f822962,2019-04-10T09:13:58Z,1405,731,674
19002,2265409485,"{'login': 'ilia-cher', 'id': 30845429, 'node_id': 'MDQ6VXNlcjMwODQ1NDI5', 'avatar_url': 'https://avatars1.githubusercontent.com/u/30845429?v=4', 'gravatar_id': '', 'url': 'https://api.github.com/users/ilia-cher', 'html_url': 'https://github.com/ilia-cher', 'followers_url': 'https://api.github.com/users/ilia-cher/followers', 'following_url': 'https://api.github.com/users/ilia-cher/following{/other_user}', 'gists_url': 'https://api.github.com/users/ilia-cher/gists{/gist_id}', 'starred_url': 'https://api.github.com/users/ilia-cher/starred{/owner}{/repo}', 'subscriptions_url': 'https://api.github.com/users/ilia-cher/subscriptions', 'organizations_url': 'https://api.github.com/users/ilia-cher/orgs', 'repos_url': 'https://api.github.com/users/ilia-cher/repos', 'events_url': 'https://api.github.com/users/ilia-cher/events{/privacy}', 'received_events_url': 'https://api.github.com/users/ilia-cher/received_events', 'type': 'User', 'site_admin': False}",referenced,cb27d63a3d7efacfda15aad1398449ef33c352d3,https://api.github.com/repos/pytorch/pytorch/commits/cb27d63a3d7efacfda15aad1398449ef33c352d3,2019-04-10T09:14:08Z,1405,731,674
19002,2278047398,"{'login': 'ilia-cher', 'id': 30845429, 'node_id': 'MDQ6VXNlcjMwODQ1NDI5', 'avatar_url': 'https://avatars1.githubusercontent.com/u/30845429?v=4', 'gravatar_id': '', 'url': 'https://api.github.com/users/ilia-cher', 'html_url': 'https://github.com/ilia-cher', 'followers_url': 'https://api.github.com/users/ilia-cher/followers', 'following_url': 'https://api.github.com/users/ilia-cher/following{/other_user}', 'gists_url': 'https://api.github.com/users/ilia-cher/gists{/gist_id}', 'starred_url': 'https://api.github.com/users/ilia-cher/starred{/owner}{/repo}', 'subscriptions_url': 'https://api.github.com/users/ilia-cher/subscriptions', 'organizations_url': 'https://api.github.com/users/ilia-cher/orgs', 'repos_url': 'https://api.github.com/users/ilia-cher/repos', 'events_url': 'https://api.github.com/users/ilia-cher/events{/privacy}', 'received_events_url': 'https://api.github.com/users/ilia-cher/received_events', 'type': 'User', 'site_admin': False}",referenced,890876bfd34c32bb42f5e09acf98eccf310a87d2,https://api.github.com/repos/pytorch/pytorch/commits/890876bfd34c32bb42f5e09acf98eccf310a87d2,2019-04-15T22:34:51Z,1405,731,674
19002,2278048662,"{'login': 'ilia-cher', 'id': 30845429, 'node_id': 'MDQ6VXNlcjMwODQ1NDI5', 'avatar_url': 'https://avatars1.githubusercontent.com/u/30845429?v=4', 'gravatar_id': '', 'url': 'https://api.github.com/users/ilia-cher', 'html_url': 'https://github.com/ilia-cher', 'followers_url': 'https://api.github.com/users/ilia-cher/followers', 'following_url': 'https://api.github.com/users/ilia-cher/following{/other_user}', 'gists_url': 'https://api.github.com/users/ilia-cher/gists{/gist_id}', 'starred_url': 'https://api.github.com/users/ilia-cher/starred{/owner}{/repo}', 'subscriptions_url': 'https://api.github.com/users/ilia-cher/subscriptions', 'organizations_url': 'https://api.github.com/users/ilia-cher/orgs', 'repos_url': 'https://api.github.com/users/ilia-cher/repos', 'events_url': 'https://api.github.com/users/ilia-cher/events{/privacy}', 'received_events_url': 'https://api.github.com/users/ilia-cher/received_events', 'type': 'User', 'site_admin': False}",referenced,695b2570b9e0d836025cd3987de393ea2a23bb50,https://api.github.com/repos/pytorch/pytorch/commits/695b2570b9e0d836025cd3987de393ea2a23bb50,2019-04-15T22:35:43Z,24734,16297,8437
19002,2278436705,"{'login': 'ilia-cher', 'id': 30845429, 'node_id': 'MDQ6VXNlcjMwODQ1NDI5', 'avatar_url': 'https://avatars1.githubusercontent.com/u/30845429?v=4', 'gravatar_id': '', 'url': 'https://api.github.com/users/ilia-cher', 'html_url': 'https://github.com/ilia-cher', 'followers_url': 'https://api.github.com/users/ilia-cher/followers', 'following_url': 'https://api.github.com/users/ilia-cher/following{/other_user}', 'gists_url': 'https://api.github.com/users/ilia-cher/gists{/gist_id}', 'starred_url': 'https://api.github.com/users/ilia-cher/starred{/owner}{/repo}', 'subscriptions_url': 'https://api.github.com/users/ilia-cher/subscriptions', 'organizations_url': 'https://api.github.com/users/ilia-cher/orgs', 'repos_url': 'https://api.github.com/users/ilia-cher/repos', 'events_url': 'https://api.github.com/users/ilia-cher/events{/privacy}', 'received_events_url': 'https://api.github.com/users/ilia-cher/received_events', 'type': 'User', 'site_admin': False}",referenced,f2dcdf78af8ae8b18d59e017b92fe4fd98ccfd6a,https://api.github.com/repos/pytorch/pytorch/commits/f2dcdf78af8ae8b18d59e017b92fe4fd98ccfd6a,2019-04-16T03:53:48Z,342,219,123
19002,2278436820,"{'login': 'ilia-cher', 'id': 30845429, 'node_id': 'MDQ6VXNlcjMwODQ1NDI5', 'avatar_url': 'https://avatars1.githubusercontent.com/u/30845429?v=4', 'gravatar_id': '', 'url': 'https://api.github.com/users/ilia-cher', 'html_url': 'https://github.com/ilia-cher', 'followers_url': 'https://api.github.com/users/ilia-cher/followers', 'following_url': 'https://api.github.com/users/ilia-cher/following{/other_user}', 'gists_url': 'https://api.github.com/users/ilia-cher/gists{/gist_id}', 'starred_url': 'https://api.github.com/users/ilia-cher/starred{/owner}{/repo}', 'subscriptions_url': 'https://api.github.com/users/ilia-cher/subscriptions', 'organizations_url': 'https://api.github.com/users/ilia-cher/orgs', 'repos_url': 'https://api.github.com/users/ilia-cher/repos', 'events_url': 'https://api.github.com/users/ilia-cher/events{/privacy}', 'received_events_url': 'https://api.github.com/users/ilia-cher/received_events', 'type': 'User', 'site_admin': False}",referenced,77b59e0c0b21409bc113a7217bf6fd8f77fb809e,https://api.github.com/repos/pytorch/pytorch/commits/77b59e0c0b21409bc113a7217bf6fd8f77fb809e,2019-04-16T03:53:53Z,1405,731,674
19002,2278454892,"{'login': 'ilia-cher', 'id': 30845429, 'node_id': 'MDQ6VXNlcjMwODQ1NDI5', 'avatar_url': 'https://avatars1.githubusercontent.com/u/30845429?v=4', 'gravatar_id': '', 'url': 'https://api.github.com/users/ilia-cher', 'html_url': 'https://github.com/ilia-cher', 'followers_url': 'https://api.github.com/users/ilia-cher/followers', 'following_url': 'https://api.github.com/users/ilia-cher/following{/other_user}', 'gists_url': 'https://api.github.com/users/ilia-cher/gists{/gist_id}', 'starred_url': 'https://api.github.com/users/ilia-cher/starred{/owner}{/repo}', 'subscriptions_url': 'https://api.github.com/users/ilia-cher/subscriptions', 'organizations_url': 'https://api.github.com/users/ilia-cher/orgs', 'repos_url': 'https://api.github.com/users/ilia-cher/repos', 'events_url': 'https://api.github.com/users/ilia-cher/events{/privacy}', 'received_events_url': 'https://api.github.com/users/ilia-cher/received_events', 'type': 'User', 'site_admin': False}",referenced,a52236be4c94f06270a1b724943e1593d3eb20ee,https://api.github.com/repos/pytorch/pytorch/commits/a52236be4c94f06270a1b724943e1593d3eb20ee,2019-04-16T04:10:47Z,9,6,3
19002,2278454929,"{'login': 'ilia-cher', 'id': 30845429, 'node_id': 'MDQ6VXNlcjMwODQ1NDI5', 'avatar_url': 'https://avatars1.githubusercontent.com/u/30845429?v=4', 'gravatar_id': '', 'url': 'https://api.github.com/users/ilia-cher', 'html_url': 'https://github.com/ilia-cher', 'followers_url': 'https://api.github.com/users/ilia-cher/followers', 'following_url': 'https://api.github.com/users/ilia-cher/following{/other_user}', 'gists_url': 'https://api.github.com/users/ilia-cher/gists{/gist_id}', 'starred_url': 'https://api.github.com/users/ilia-cher/starred{/owner}{/repo}', 'subscriptions_url': 'https://api.github.com/users/ilia-cher/subscriptions', 'organizations_url': 'https://api.github.com/users/ilia-cher/orgs', 'repos_url': 'https://api.github.com/users/ilia-cher/repos', 'events_url': 'https://api.github.com/users/ilia-cher/events{/privacy}', 'received_events_url': 'https://api.github.com/users/ilia-cher/received_events', 'type': 'User', 'site_admin': False}",referenced,6afa0a6daecbb1bcdb9828a6687697c221bab122,https://api.github.com/repos/pytorch/pytorch/commits/6afa0a6daecbb1bcdb9828a6687697c221bab122,2019-04-16T04:10:49Z,1405,731,674
19002,2278518900,"{'login': 'ilia-cher', 'id': 30845429, 'node_id': 'MDQ6VXNlcjMwODQ1NDI5', 'avatar_url': 'https://avatars1.githubusercontent.com/u/30845429?v=4', 'gravatar_id': '', 'url': 'https://api.github.com/users/ilia-cher', 'html_url': 'https://github.com/ilia-cher', 'followers_url': 'https://api.github.com/users/ilia-cher/followers', 'following_url': 'https://api.github.com/users/ilia-cher/following{/other_user}', 'gists_url': 'https://api.github.com/users/ilia-cher/gists{/gist_id}', 'starred_url': 'https://api.github.com/users/ilia-cher/starred{/owner}{/repo}', 'subscriptions_url': 'https://api.github.com/users/ilia-cher/subscriptions', 'organizations_url': 'https://api.github.com/users/ilia-cher/orgs', 'repos_url': 'https://api.github.com/users/ilia-cher/repos', 'events_url': 'https://api.github.com/users/ilia-cher/events{/privacy}', 'received_events_url': 'https://api.github.com/users/ilia-cher/received_events', 'type': 'User', 'site_admin': False}",referenced,9b7caaf3949b34e39fa7d7cc68e784fa6b998708,https://api.github.com/repos/pytorch/pytorch/commits/9b7caaf3949b34e39fa7d7cc68e784fa6b998708,2019-04-16T05:12:42Z,3,1,2
19002,2278518912,"{'login': 'ilia-cher', 'id': 30845429, 'node_id': 'MDQ6VXNlcjMwODQ1NDI5', 'avatar_url': 'https://avatars1.githubusercontent.com/u/30845429?v=4', 'gravatar_id': '', 'url': 'https://api.github.com/users/ilia-cher', 'html_url': 'https://github.com/ilia-cher', 'followers_url': 'https://api.github.com/users/ilia-cher/followers', 'following_url': 'https://api.github.com/users/ilia-cher/following{/other_user}', 'gists_url': 'https://api.github.com/users/ilia-cher/gists{/gist_id}', 'starred_url': 'https://api.github.com/users/ilia-cher/starred{/owner}{/repo}', 'subscriptions_url': 'https://api.github.com/users/ilia-cher/subscriptions', 'organizations_url': 'https://api.github.com/users/ilia-cher/orgs', 'repos_url': 'https://api.github.com/users/ilia-cher/repos', 'events_url': 'https://api.github.com/users/ilia-cher/events{/privacy}', 'received_events_url': 'https://api.github.com/users/ilia-cher/received_events', 'type': 'User', 'site_admin': False}",referenced,8160b716e0317d361203d05f126bec957227b18d,https://api.github.com/repos/pytorch/pytorch/commits/8160b716e0317d361203d05f126bec957227b18d,2019-04-16T05:12:43Z,1405,731,674
19002,2278732197,"{'login': 'ilia-cher', 'id': 30845429, 'node_id': 'MDQ6VXNlcjMwODQ1NDI5', 'avatar_url': 'https://avatars1.githubusercontent.com/u/30845429?v=4', 'gravatar_id': '', 'url': 'https://api.github.com/users/ilia-cher', 'html_url': 'https://github.com/ilia-cher', 'followers_url': 'https://api.github.com/users/ilia-cher/followers', 'following_url': 'https://api.github.com/users/ilia-cher/following{/other_user}', 'gists_url': 'https://api.github.com/users/ilia-cher/gists{/gist_id}', 'starred_url': 'https://api.github.com/users/ilia-cher/starred{/owner}{/repo}', 'subscriptions_url': 'https://api.github.com/users/ilia-cher/subscriptions', 'organizations_url': 'https://api.github.com/users/ilia-cher/orgs', 'repos_url': 'https://api.github.com/users/ilia-cher/repos', 'events_url': 'https://api.github.com/users/ilia-cher/events{/privacy}', 'received_events_url': 'https://api.github.com/users/ilia-cher/received_events', 'type': 'User', 'site_admin': False}",referenced,aa4b931f2d358587e75839d15e5a4268d70f7fdc,https://api.github.com/repos/pytorch/pytorch/commits/aa4b931f2d358587e75839d15e5a4268d70f7fdc,2019-04-16T07:21:42Z,1405,731,674
19002,2278732287,"{'login': 'ilia-cher', 'id': 30845429, 'node_id': 'MDQ6VXNlcjMwODQ1NDI5', 'avatar_url': 'https://avatars1.githubusercontent.com/u/30845429?v=4', 'gravatar_id': '', 'url': 'https://api.github.com/users/ilia-cher', 'html_url': 'https://github.com/ilia-cher', 'followers_url': 'https://api.github.com/users/ilia-cher/followers', 'following_url': 'https://api.github.com/users/ilia-cher/following{/other_user}', 'gists_url': 'https://api.github.com/users/ilia-cher/gists{/gist_id}', 'starred_url': 'https://api.github.com/users/ilia-cher/starred{/owner}{/repo}', 'subscriptions_url': 'https://api.github.com/users/ilia-cher/subscriptions', 'organizations_url': 'https://api.github.com/users/ilia-cher/orgs', 'repos_url': 'https://api.github.com/users/ilia-cher/repos', 'events_url': 'https://api.github.com/users/ilia-cher/events{/privacy}', 'received_events_url': 'https://api.github.com/users/ilia-cher/received_events', 'type': 'User', 'site_admin': False}",referenced,1d69d50afde04de0c09ea08c2da3e0951cc71bf6,https://api.github.com/repos/pytorch/pytorch/commits/1d69d50afde04de0c09ea08c2da3e0951cc71bf6,2019-04-16T07:21:45Z,270,172,98
19002,2278797219,"{'login': 'ilia-cher', 'id': 30845429, 'node_id': 'MDQ6VXNlcjMwODQ1NDI5', 'avatar_url': 'https://avatars1.githubusercontent.com/u/30845429?v=4', 'gravatar_id': '', 'url': 'https://api.github.com/users/ilia-cher', 'html_url': 'https://github.com/ilia-cher', 'followers_url': 'https://api.github.com/users/ilia-cher/followers', 'following_url': 'https://api.github.com/users/ilia-cher/following{/other_user}', 'gists_url': 'https://api.github.com/users/ilia-cher/gists{/gist_id}', 'starred_url': 'https://api.github.com/users/ilia-cher/starred{/owner}{/repo}', 'subscriptions_url': 'https://api.github.com/users/ilia-cher/subscriptions', 'organizations_url': 'https://api.github.com/users/ilia-cher/orgs', 'repos_url': 'https://api.github.com/users/ilia-cher/repos', 'events_url': 'https://api.github.com/users/ilia-cher/events{/privacy}', 'received_events_url': 'https://api.github.com/users/ilia-cher/received_events', 'type': 'User', 'site_admin': False}",referenced,ae9d397c88e7105449fcbe399db90811c413b97a,https://api.github.com/repos/pytorch/pytorch/commits/ae9d397c88e7105449fcbe399db90811c413b97a,2019-04-16T07:50:16Z,11,9,2
19002,2278805616,"{'login': 'ilia-cher', 'id': 30845429, 'node_id': 'MDQ6VXNlcjMwODQ1NDI5', 'avatar_url': 'https://avatars1.githubusercontent.com/u/30845429?v=4', 'gravatar_id': '', 'url': 'https://api.github.com/users/ilia-cher', 'html_url': 'https://github.com/ilia-cher', 'followers_url': 'https://api.github.com/users/ilia-cher/followers', 'following_url': 'https://api.github.com/users/ilia-cher/following{/other_user}', 'gists_url': 'https://api.github.com/users/ilia-cher/gists{/gist_id}', 'starred_url': 'https://api.github.com/users/ilia-cher/starred{/owner}{/repo}', 'subscriptions_url': 'https://api.github.com/users/ilia-cher/subscriptions', 'organizations_url': 'https://api.github.com/users/ilia-cher/orgs', 'repos_url': 'https://api.github.com/users/ilia-cher/repos', 'events_url': 'https://api.github.com/users/ilia-cher/events{/privacy}', 'received_events_url': 'https://api.github.com/users/ilia-cher/received_events', 'type': 'User', 'site_admin': False}",referenced,9ff813cd556f8772cd2426bc0ffec4cd3cc3a838,https://api.github.com/repos/pytorch/pytorch/commits/9ff813cd556f8772cd2426bc0ffec4cd3cc3a838,2019-04-16T07:53:34Z,1405,731,674
19002,2278805620,"{'login': 'ilia-cher', 'id': 30845429, 'node_id': 'MDQ6VXNlcjMwODQ1NDI5', 'avatar_url': 'https://avatars1.githubusercontent.com/u/30845429?v=4', 'gravatar_id': '', 'url': 'https://api.github.com/users/ilia-cher', 'html_url': 'https://github.com/ilia-cher', 'followers_url': 'https://api.github.com/users/ilia-cher/followers', 'following_url': 'https://api.github.com/users/ilia-cher/following{/other_user}', 'gists_url': 'https://api.github.com/users/ilia-cher/gists{/gist_id}', 'starred_url': 'https://api.github.com/users/ilia-cher/starred{/owner}{/repo}', 'subscriptions_url': 'https://api.github.com/users/ilia-cher/subscriptions', 'organizations_url': 'https://api.github.com/users/ilia-cher/orgs', 'repos_url': 'https://api.github.com/users/ilia-cher/repos', 'events_url': 'https://api.github.com/users/ilia-cher/events{/privacy}', 'received_events_url': 'https://api.github.com/users/ilia-cher/received_events', 'type': 'User', 'site_admin': False}",referenced,0a6e4cefc72e976451515a910a49b3bc2f06833e,https://api.github.com/repos/pytorch/pytorch/commits/0a6e4cefc72e976451515a910a49b3bc2f06833e,2019-04-16T07:53:34Z,0,0,0
19002,2278813061,"{'login': 'ilia-cher', 'id': 30845429, 'node_id': 'MDQ6VXNlcjMwODQ1NDI5', 'avatar_url': 'https://avatars1.githubusercontent.com/u/30845429?v=4', 'gravatar_id': '', 'url': 'https://api.github.com/users/ilia-cher', 'html_url': 'https://github.com/ilia-cher', 'followers_url': 'https://api.github.com/users/ilia-cher/followers', 'following_url': 'https://api.github.com/users/ilia-cher/following{/other_user}', 'gists_url': 'https://api.github.com/users/ilia-cher/gists{/gist_id}', 'starred_url': 'https://api.github.com/users/ilia-cher/starred{/owner}{/repo}', 'subscriptions_url': 'https://api.github.com/users/ilia-cher/subscriptions', 'organizations_url': 'https://api.github.com/users/ilia-cher/orgs', 'repos_url': 'https://api.github.com/users/ilia-cher/repos', 'events_url': 'https://api.github.com/users/ilia-cher/events{/privacy}', 'received_events_url': 'https://api.github.com/users/ilia-cher/received_events', 'type': 'User', 'site_admin': False}",referenced,5b3cad7cf1f0f66a54b992177e5ba7d93a167b82,https://api.github.com/repos/pytorch/pytorch/commits/5b3cad7cf1f0f66a54b992177e5ba7d93a167b82,2019-04-16T07:56:40Z,1405,731,674
19002,2278813099,"{'login': 'ilia-cher', 'id': 30845429, 'node_id': 'MDQ6VXNlcjMwODQ1NDI5', 'avatar_url': 'https://avatars1.githubusercontent.com/u/30845429?v=4', 'gravatar_id': '', 'url': 'https://api.github.com/users/ilia-cher', 'html_url': 'https://github.com/ilia-cher', 'followers_url': 'https://api.github.com/users/ilia-cher/followers', 'following_url': 'https://api.github.com/users/ilia-cher/following{/other_user}', 'gists_url': 'https://api.github.com/users/ilia-cher/gists{/gist_id}', 'starred_url': 'https://api.github.com/users/ilia-cher/starred{/owner}{/repo}', 'subscriptions_url': 'https://api.github.com/users/ilia-cher/subscriptions', 'organizations_url': 'https://api.github.com/users/ilia-cher/orgs', 'repos_url': 'https://api.github.com/users/ilia-cher/repos', 'events_url': 'https://api.github.com/users/ilia-cher/events{/privacy}', 'received_events_url': 'https://api.github.com/users/ilia-cher/received_events', 'type': 'User', 'site_admin': False}",referenced,731b736dc0450b49bf70b63f87426283da2e6c24,https://api.github.com/repos/pytorch/pytorch/commits/731b736dc0450b49bf70b63f87426283da2e6c24,2019-04-16T07:56:42Z,0,0,0
19002,2278923744,"{'login': 'ilia-cher', 'id': 30845429, 'node_id': 'MDQ6VXNlcjMwODQ1NDI5', 'avatar_url': 'https://avatars1.githubusercontent.com/u/30845429?v=4', 'gravatar_id': '', 'url': 'https://api.github.com/users/ilia-cher', 'html_url': 'https://github.com/ilia-cher', 'followers_url': 'https://api.github.com/users/ilia-cher/followers', 'following_url': 'https://api.github.com/users/ilia-cher/following{/other_user}', 'gists_url': 'https://api.github.com/users/ilia-cher/gists{/gist_id}', 'starred_url': 'https://api.github.com/users/ilia-cher/starred{/owner}{/repo}', 'subscriptions_url': 'https://api.github.com/users/ilia-cher/subscriptions', 'organizations_url': 'https://api.github.com/users/ilia-cher/orgs', 'repos_url': 'https://api.github.com/users/ilia-cher/repos', 'events_url': 'https://api.github.com/users/ilia-cher/events{/privacy}', 'received_events_url': 'https://api.github.com/users/ilia-cher/received_events', 'type': 'User', 'site_admin': False}",referenced,5afea3fd292d5ea96fb73ccb343bb242c9286573,https://api.github.com/repos/pytorch/pytorch/commits/5afea3fd292d5ea96fb73ccb343bb242c9286573,2019-04-16T08:38:54Z,1405,731,674
19002,2278923832,"{'login': 'ilia-cher', 'id': 30845429, 'node_id': 'MDQ6VXNlcjMwODQ1NDI5', 'avatar_url': 'https://avatars1.githubusercontent.com/u/30845429?v=4', 'gravatar_id': '', 'url': 'https://api.github.com/users/ilia-cher', 'html_url': 'https://github.com/ilia-cher', 'followers_url': 'https://api.github.com/users/ilia-cher/followers', 'following_url': 'https://api.github.com/users/ilia-cher/following{/other_user}', 'gists_url': 'https://api.github.com/users/ilia-cher/gists{/gist_id}', 'starred_url': 'https://api.github.com/users/ilia-cher/starred{/owner}{/repo}', 'subscriptions_url': 'https://api.github.com/users/ilia-cher/subscriptions', 'organizations_url': 'https://api.github.com/users/ilia-cher/orgs', 'repos_url': 'https://api.github.com/users/ilia-cher/repos', 'events_url': 'https://api.github.com/users/ilia-cher/events{/privacy}', 'received_events_url': 'https://api.github.com/users/ilia-cher/received_events', 'type': 'User', 'site_admin': False}",referenced,77060623f6b06c4268428ead11b20377402ae3e5,https://api.github.com/repos/pytorch/pytorch/commits/77060623f6b06c4268428ead11b20377402ae3e5,2019-04-16T08:38:56Z,9,5,4
19002,2280719124,"{'login': 'ilia-cher', 'id': 30845429, 'node_id': 'MDQ6VXNlcjMwODQ1NDI5', 'avatar_url': 'https://avatars1.githubusercontent.com/u/30845429?v=4', 'gravatar_id': '', 'url': 'https://api.github.com/users/ilia-cher', 'html_url': 'https://github.com/ilia-cher', 'followers_url': 'https://api.github.com/users/ilia-cher/followers', 'following_url': 'https://api.github.com/users/ilia-cher/following{/other_user}', 'gists_url': 'https://api.github.com/users/ilia-cher/gists{/gist_id}', 'starred_url': 'https://api.github.com/users/ilia-cher/starred{/owner}{/repo}', 'subscriptions_url': 'https://api.github.com/users/ilia-cher/subscriptions', 'organizations_url': 'https://api.github.com/users/ilia-cher/orgs', 'repos_url': 'https://api.github.com/users/ilia-cher/repos', 'events_url': 'https://api.github.com/users/ilia-cher/events{/privacy}', 'received_events_url': 'https://api.github.com/users/ilia-cher/received_events', 'type': 'User', 'site_admin': False}",referenced,3d73b40838d4817f6ed7bec8373e4a86f003c67c,https://api.github.com/repos/pytorch/pytorch/commits/3d73b40838d4817f6ed7bec8373e4a86f003c67c,2019-04-16T19:25:47Z,23,15,8
19002,2280719171,"{'login': 'ilia-cher', 'id': 30845429, 'node_id': 'MDQ6VXNlcjMwODQ1NDI5', 'avatar_url': 'https://avatars1.githubusercontent.com/u/30845429?v=4', 'gravatar_id': '', 'url': 'https://api.github.com/users/ilia-cher', 'html_url': 'https://github.com/ilia-cher', 'followers_url': 'https://api.github.com/users/ilia-cher/followers', 'following_url': 'https://api.github.com/users/ilia-cher/following{/other_user}', 'gists_url': 'https://api.github.com/users/ilia-cher/gists{/gist_id}', 'starred_url': 'https://api.github.com/users/ilia-cher/starred{/owner}{/repo}', 'subscriptions_url': 'https://api.github.com/users/ilia-cher/subscriptions', 'organizations_url': 'https://api.github.com/users/ilia-cher/orgs', 'repos_url': 'https://api.github.com/users/ilia-cher/repos', 'events_url': 'https://api.github.com/users/ilia-cher/events{/privacy}', 'received_events_url': 'https://api.github.com/users/ilia-cher/received_events', 'type': 'User', 'site_admin': False}",referenced,a226ee79b24e36d8fcd0a0a1ddad946e20edde62,https://api.github.com/repos/pytorch/pytorch/commits/a226ee79b24e36d8fcd0a0a1ddad946e20edde62,2019-04-16T19:25:48Z,1405,731,674
19002,2281049238,"{'login': 'ilia-cher', 'id': 30845429, 'node_id': 'MDQ6VXNlcjMwODQ1NDI5', 'avatar_url': 'https://avatars1.githubusercontent.com/u/30845429?v=4', 'gravatar_id': '', 'url': 'https://api.github.com/users/ilia-cher', 'html_url': 'https://github.com/ilia-cher', 'followers_url': 'https://api.github.com/users/ilia-cher/followers', 'following_url': 'https://api.github.com/users/ilia-cher/following{/other_user}', 'gists_url': 'https://api.github.com/users/ilia-cher/gists{/gist_id}', 'starred_url': 'https://api.github.com/users/ilia-cher/starred{/owner}{/repo}', 'subscriptions_url': 'https://api.github.com/users/ilia-cher/subscriptions', 'organizations_url': 'https://api.github.com/users/ilia-cher/orgs', 'repos_url': 'https://api.github.com/users/ilia-cher/repos', 'events_url': 'https://api.github.com/users/ilia-cher/events{/privacy}', 'received_events_url': 'https://api.github.com/users/ilia-cher/received_events', 'type': 'User', 'site_admin': False}",referenced,08a62f3f4083fb8a597ab134204a21827c2e6afb,https://api.github.com/repos/pytorch/pytorch/commits/08a62f3f4083fb8a597ab134204a21827c2e6afb,2019-04-16T21:46:08Z,1099,529,570
19002,2281049255,"{'login': 'ilia-cher', 'id': 30845429, 'node_id': 'MDQ6VXNlcjMwODQ1NDI5', 'avatar_url': 'https://avatars1.githubusercontent.com/u/30845429?v=4', 'gravatar_id': '', 'url': 'https://api.github.com/users/ilia-cher', 'html_url': 'https://github.com/ilia-cher', 'followers_url': 'https://api.github.com/users/ilia-cher/followers', 'following_url': 'https://api.github.com/users/ilia-cher/following{/other_user}', 'gists_url': 'https://api.github.com/users/ilia-cher/gists{/gist_id}', 'starred_url': 'https://api.github.com/users/ilia-cher/starred{/owner}{/repo}', 'subscriptions_url': 'https://api.github.com/users/ilia-cher/subscriptions', 'organizations_url': 'https://api.github.com/users/ilia-cher/orgs', 'repos_url': 'https://api.github.com/users/ilia-cher/repos', 'events_url': 'https://api.github.com/users/ilia-cher/events{/privacy}', 'received_events_url': 'https://api.github.com/users/ilia-cher/received_events', 'type': 'User', 'site_admin': False}",referenced,19576de019cb2b5db3da13e3eaa0cb0cac462f9e,https://api.github.com/repos/pytorch/pytorch/commits/19576de019cb2b5db3da13e3eaa0cb0cac462f9e,2019-04-16T21:46:08Z,1405,731,674
19002,2281053457,"{'login': 'ilia-cher', 'id': 30845429, 'node_id': 'MDQ6VXNlcjMwODQ1NDI5', 'avatar_url': 'https://avatars1.githubusercontent.com/u/30845429?v=4', 'gravatar_id': '', 'url': 'https://api.github.com/users/ilia-cher', 'html_url': 'https://github.com/ilia-cher', 'followers_url': 'https://api.github.com/users/ilia-cher/followers', 'following_url': 'https://api.github.com/users/ilia-cher/following{/other_user}', 'gists_url': 'https://api.github.com/users/ilia-cher/gists{/gist_id}', 'starred_url': 'https://api.github.com/users/ilia-cher/starred{/owner}{/repo}', 'subscriptions_url': 'https://api.github.com/users/ilia-cher/subscriptions', 'organizations_url': 'https://api.github.com/users/ilia-cher/orgs', 'repos_url': 'https://api.github.com/users/ilia-cher/repos', 'events_url': 'https://api.github.com/users/ilia-cher/events{/privacy}', 'received_events_url': 'https://api.github.com/users/ilia-cher/received_events', 'type': 'User', 'site_admin': False}",referenced,67d95b7f0591f5488226ff2c587655a4b7d527a1,https://api.github.com/repos/pytorch/pytorch/commits/67d95b7f0591f5488226ff2c587655a4b7d527a1,2019-04-16T21:48:11Z,157,92,65
19002,2281053470,"{'login': 'ilia-cher', 'id': 30845429, 'node_id': 'MDQ6VXNlcjMwODQ1NDI5', 'avatar_url': 'https://avatars1.githubusercontent.com/u/30845429?v=4', 'gravatar_id': '', 'url': 'https://api.github.com/users/ilia-cher', 'html_url': 'https://github.com/ilia-cher', 'followers_url': 'https://api.github.com/users/ilia-cher/followers', 'following_url': 'https://api.github.com/users/ilia-cher/following{/other_user}', 'gists_url': 'https://api.github.com/users/ilia-cher/gists{/gist_id}', 'starred_url': 'https://api.github.com/users/ilia-cher/starred{/owner}{/repo}', 'subscriptions_url': 'https://api.github.com/users/ilia-cher/subscriptions', 'organizations_url': 'https://api.github.com/users/ilia-cher/orgs', 'repos_url': 'https://api.github.com/users/ilia-cher/repos', 'events_url': 'https://api.github.com/users/ilia-cher/events{/privacy}', 'received_events_url': 'https://api.github.com/users/ilia-cher/received_events', 'type': 'User', 'site_admin': False}",referenced,bfd1c701943be7b9bc2fe828d582a1c463a50e42,https://api.github.com/repos/pytorch/pytorch/commits/bfd1c701943be7b9bc2fe828d582a1c463a50e42,2019-04-16T21:48:11Z,1405,731,674
19002,2281386750,"{'login': 'ilia-cher', 'id': 30845429, 'node_id': 'MDQ6VXNlcjMwODQ1NDI5', 'avatar_url': 'https://avatars1.githubusercontent.com/u/30845429?v=4', 'gravatar_id': '', 'url': 'https://api.github.com/users/ilia-cher', 'html_url': 'https://github.com/ilia-cher', 'followers_url': 'https://api.github.com/users/ilia-cher/followers', 'following_url': 'https://api.github.com/users/ilia-cher/following{/other_user}', 'gists_url': 'https://api.github.com/users/ilia-cher/gists{/gist_id}', 'starred_url': 'https://api.github.com/users/ilia-cher/starred{/owner}{/repo}', 'subscriptions_url': 'https://api.github.com/users/ilia-cher/subscriptions', 'organizations_url': 'https://api.github.com/users/ilia-cher/orgs', 'repos_url': 'https://api.github.com/users/ilia-cher/repos', 'events_url': 'https://api.github.com/users/ilia-cher/events{/privacy}', 'received_events_url': 'https://api.github.com/users/ilia-cher/received_events', 'type': 'User', 'site_admin': False}",referenced,9ee2667f6b42264bea3683410bcef5c7b2ee114a,https://api.github.com/repos/pytorch/pytorch/commits/9ee2667f6b42264bea3683410bcef5c7b2ee114a,2019-04-17T01:53:28Z,33,24,9
18983,2257584925,"{'login': 'facebook-github-bot', 'id': 6422482, 'node_id': 'MDQ6VXNlcjY0MjI0ODI=', 'avatar_url': 'https://avatars3.githubusercontent.com/u/6422482?v=4', 'gravatar_id': '', 'url': 'https://api.github.com/users/facebook-github-bot', 'html_url': 'https://github.com/facebook-github-bot', 'followers_url': 'https://api.github.com/users/facebook-github-bot/followers', 'following_url': 'https://api.github.com/users/facebook-github-bot/following{/other_user}', 'gists_url': 'https://api.github.com/users/facebook-github-bot/gists{/gist_id}', 'starred_url': 'https://api.github.com/users/facebook-github-bot/starred{/owner}{/repo}', 'subscriptions_url': 'https://api.github.com/users/facebook-github-bot/subscriptions', 'organizations_url': 'https://api.github.com/users/facebook-github-bot/orgs', 'repos_url': 'https://api.github.com/users/facebook-github-bot/repos', 'events_url': 'https://api.github.com/users/facebook-github-bot/events{/privacy}', 'received_events_url': 'https://api.github.com/users/facebook-github-bot/received_events', 'type': 'User', 'site_admin': False}",closed,7b5b1486c91683ad6ae94e54eddda68a1e060743,https://api.github.com/repos/pytorch/pytorch/commits/7b5b1486c91683ad6ae94e54eddda68a1e060743,2019-04-06T18:45:19Z,6,6,0
18967,2438664613,"{'login': 'facebook-github-bot', 'id': 6422482, 'node_id': 'MDQ6VXNlcjY0MjI0ODI=', 'avatar_url': 'https://avatars3.githubusercontent.com/u/6422482?v=4', 'gravatar_id': '', 'url': 'https://api.github.com/users/facebook-github-bot', 'html_url': 'https://github.com/facebook-github-bot', 'followers_url': 'https://api.github.com/users/facebook-github-bot/followers', 'following_url': 'https://api.github.com/users/facebook-github-bot/following{/other_user}', 'gists_url': 'https://api.github.com/users/facebook-github-bot/gists{/gist_id}', 'starred_url': 'https://api.github.com/users/facebook-github-bot/starred{/owner}{/repo}', 'subscriptions_url': 'https://api.github.com/users/facebook-github-bot/subscriptions', 'organizations_url': 'https://api.github.com/users/facebook-github-bot/orgs', 'repos_url': 'https://api.github.com/users/facebook-github-bot/repos', 'events_url': 'https://api.github.com/users/facebook-github-bot/events{/privacy}', 'received_events_url': 'https://api.github.com/users/facebook-github-bot/received_events', 'type': 'User', 'site_admin': False}",closed,6ff0c6ca3fa3d5bd8eae73d32465ca5614244918,https://api.github.com/repos/pytorch/pytorch/commits/6ff0c6ca3fa3d5bd8eae73d32465ca5614244918,2019-06-25T19:21:53Z,12176,5,12171
18873,2277686853,"{'login': 'facebook-github-bot', 'id': 6422482, 'node_id': 'MDQ6VXNlcjY0MjI0ODI=', 'avatar_url': 'https://avatars3.githubusercontent.com/u/6422482?v=4', 'gravatar_id': '', 'url': 'https://api.github.com/users/facebook-github-bot', 'html_url': 'https://github.com/facebook-github-bot', 'followers_url': 'https://api.github.com/users/facebook-github-bot/followers', 'following_url': 'https://api.github.com/users/facebook-github-bot/following{/other_user}', 'gists_url': 'https://api.github.com/users/facebook-github-bot/gists{/gist_id}', 'starred_url': 'https://api.github.com/users/facebook-github-bot/starred{/owner}{/repo}', 'subscriptions_url': 'https://api.github.com/users/facebook-github-bot/subscriptions', 'organizations_url': 'https://api.github.com/users/facebook-github-bot/orgs', 'repos_url': 'https://api.github.com/users/facebook-github-bot/repos', 'events_url': 'https://api.github.com/users/facebook-github-bot/events{/privacy}', 'received_events_url': 'https://api.github.com/users/facebook-github-bot/received_events', 'type': 'User', 'site_admin': False}",closed,00148825fc35ddada2cfc59a30d904e0d8cace7c,https://api.github.com/repos/pytorch/pytorch/commits/00148825fc35ddada2cfc59a30d904e0d8cace7c,2019-04-15T19:50:53Z,83,62,21
18862,2349898477,"{'login': 'facebook-github-bot', 'id': 6422482, 'node_id': 'MDQ6VXNlcjY0MjI0ODI=', 'avatar_url': 'https://avatars3.githubusercontent.com/u/6422482?v=4', 'gravatar_id': '', 'url': 'https://api.github.com/users/facebook-github-bot', 'html_url': 'https://github.com/facebook-github-bot', 'followers_url': 'https://api.github.com/users/facebook-github-bot/followers', 'following_url': 'https://api.github.com/users/facebook-github-bot/following{/other_user}', 'gists_url': 'https://api.github.com/users/facebook-github-bot/gists{/gist_id}', 'starred_url': 'https://api.github.com/users/facebook-github-bot/starred{/owner}{/repo}', 'subscriptions_url': 'https://api.github.com/users/facebook-github-bot/subscriptions', 'organizations_url': 'https://api.github.com/users/facebook-github-bot/orgs', 'repos_url': 'https://api.github.com/users/facebook-github-bot/repos', 'events_url': 'https://api.github.com/users/facebook-github-bot/events{/privacy}', 'received_events_url': 'https://api.github.com/users/facebook-github-bot/received_events', 'type': 'User', 'site_admin': False}",referenced,8c9f4c560a4dae626d825b2eab55fb3acb1263fa,https://api.github.com/repos/pytorch/pytorch/commits/8c9f4c560a4dae626d825b2eab55fb3acb1263fa,2019-05-17T16:46:59Z,121,120,1
18851,2453759712,"{'login': 'facebook-github-bot', 'id': 6422482, 'node_id': 'MDQ6VXNlcjY0MjI0ODI=', 'avatar_url': 'https://avatars3.githubusercontent.com/u/6422482?v=4', 'gravatar_id': '', 'url': 'https://api.github.com/users/facebook-github-bot', 'html_url': 'https://github.com/facebook-github-bot', 'followers_url': 'https://api.github.com/users/facebook-github-bot/followers', 'following_url': 'https://api.github.com/users/facebook-github-bot/following{/other_user}', 'gists_url': 'https://api.github.com/users/facebook-github-bot/gists{/gist_id}', 'starred_url': 'https://api.github.com/users/facebook-github-bot/starred{/owner}{/repo}', 'subscriptions_url': 'https://api.github.com/users/facebook-github-bot/subscriptions', 'organizations_url': 'https://api.github.com/users/facebook-github-bot/orgs', 'repos_url': 'https://api.github.com/users/facebook-github-bot/repos', 'events_url': 'https://api.github.com/users/facebook-github-bot/events{/privacy}', 'received_events_url': 'https://api.github.com/users/facebook-github-bot/received_events', 'type': 'User', 'site_admin': False}",closed,0ffda97aa4bacc1b00bf93d5d2bf25d46601ae17,https://api.github.com/repos/pytorch/pytorch/commits/0ffda97aa4bacc1b00bf93d5d2bf25d46601ae17,2019-07-02T09:42:30Z,180,103,77
18823,2261106363,"{'login': 'facebook-github-bot', 'id': 6422482, 'node_id': 'MDQ6VXNlcjY0MjI0ODI=', 'avatar_url': 'https://avatars3.githubusercontent.com/u/6422482?v=4', 'gravatar_id': '', 'url': 'https://api.github.com/users/facebook-github-bot', 'html_url': 'https://github.com/facebook-github-bot', 'followers_url': 'https://api.github.com/users/facebook-github-bot/followers', 'following_url': 'https://api.github.com/users/facebook-github-bot/following{/other_user}', 'gists_url': 'https://api.github.com/users/facebook-github-bot/gists{/gist_id}', 'starred_url': 'https://api.github.com/users/facebook-github-bot/starred{/owner}{/repo}', 'subscriptions_url': 'https://api.github.com/users/facebook-github-bot/subscriptions', 'organizations_url': 'https://api.github.com/users/facebook-github-bot/orgs', 'repos_url': 'https://api.github.com/users/facebook-github-bot/repos', 'events_url': 'https://api.github.com/users/facebook-github-bot/events{/privacy}', 'received_events_url': 'https://api.github.com/users/facebook-github-bot/received_events', 'type': 'User', 'site_admin': False}",referenced,930fb2f31986a716f9588aad4dd372c28550d7cb,https://api.github.com/repos/pytorch/pytorch/commits/930fb2f31986a716f9588aad4dd372c28550d7cb,2019-04-08T21:52:28Z,20,18,2
18793,2260247042,"{'login': 'ezyang', 'id': 13564, 'node_id': 'MDQ6VXNlcjEzNTY0', 'avatar_url': 'https://avatars0.githubusercontent.com/u/13564?v=4', 'gravatar_id': '', 'url': 'https://api.github.com/users/ezyang', 'html_url': 'https://github.com/ezyang', 'followers_url': 'https://api.github.com/users/ezyang/followers', 'following_url': 'https://api.github.com/users/ezyang/following{/other_user}', 'gists_url': 'https://api.github.com/users/ezyang/gists{/gist_id}', 'starred_url': 'https://api.github.com/users/ezyang/starred{/owner}{/repo}', 'subscriptions_url': 'https://api.github.com/users/ezyang/subscriptions', 'organizations_url': 'https://api.github.com/users/ezyang/orgs', 'repos_url': 'https://api.github.com/users/ezyang/repos', 'events_url': 'https://api.github.com/users/ezyang/events{/privacy}', 'received_events_url': 'https://api.github.com/users/ezyang/received_events', 'type': 'User', 'site_admin': False}",referenced,d9a5b1d5bca22f523114b4f1d1e23c6f6ebfea51,https://api.github.com/repos/pytorch/pytorch/commits/d9a5b1d5bca22f523114b4f1d1e23c6f6ebfea51,2019-04-08T16:15:48Z,10,5,5
18793,2260247166,"{'login': 'ezyang', 'id': 13564, 'node_id': 'MDQ6VXNlcjEzNTY0', 'avatar_url': 'https://avatars0.githubusercontent.com/u/13564?v=4', 'gravatar_id': '', 'url': 'https://api.github.com/users/ezyang', 'html_url': 'https://github.com/ezyang', 'followers_url': 'https://api.github.com/users/ezyang/followers', 'following_url': 'https://api.github.com/users/ezyang/following{/other_user}', 'gists_url': 'https://api.github.com/users/ezyang/gists{/gist_id}', 'starred_url': 'https://api.github.com/users/ezyang/starred{/owner}{/repo}', 'subscriptions_url': 'https://api.github.com/users/ezyang/subscriptions', 'organizations_url': 'https://api.github.com/users/ezyang/orgs', 'repos_url': 'https://api.github.com/users/ezyang/repos', 'events_url': 'https://api.github.com/users/ezyang/events{/privacy}', 'received_events_url': 'https://api.github.com/users/ezyang/received_events', 'type': 'User', 'site_admin': False}",referenced,8f31e51b79daba11939aa7992450984054713b9c,https://api.github.com/repos/pytorch/pytorch/commits/8f31e51b79daba11939aa7992450984054713b9c,2019-04-08T16:15:51Z,10,5,5
18793,2263855336,"{'login': 'facebook-github-bot', 'id': 6422482, 'node_id': 'MDQ6VXNlcjY0MjI0ODI=', 'avatar_url': 'https://avatars3.githubusercontent.com/u/6422482?v=4', 'gravatar_id': '', 'url': 'https://api.github.com/users/facebook-github-bot', 'html_url': 'https://github.com/facebook-github-bot', 'followers_url': 'https://api.github.com/users/facebook-github-bot/followers', 'following_url': 'https://api.github.com/users/facebook-github-bot/following{/other_user}', 'gists_url': 'https://api.github.com/users/facebook-github-bot/gists{/gist_id}', 'starred_url': 'https://api.github.com/users/facebook-github-bot/starred{/owner}{/repo}', 'subscriptions_url': 'https://api.github.com/users/facebook-github-bot/subscriptions', 'organizations_url': 'https://api.github.com/users/facebook-github-bot/orgs', 'repos_url': 'https://api.github.com/users/facebook-github-bot/repos', 'events_url': 'https://api.github.com/users/facebook-github-bot/events{/privacy}', 'received_events_url': 'https://api.github.com/users/facebook-github-bot/received_events', 'type': 'User', 'site_admin': False}",closed,ad45d0920289c2fca6707df14d3c739936484571,https://api.github.com/repos/pytorch/pytorch/commits/ad45d0920289c2fca6707df14d3c739936484571,2019-04-09T18:56:19Z,10,5,5
18725,2260351744,"{'login': 'facebook-github-bot', 'id': 6422482, 'node_id': 'MDQ6VXNlcjY0MjI0ODI=', 'avatar_url': 'https://avatars3.githubusercontent.com/u/6422482?v=4', 'gravatar_id': '', 'url': 'https://api.github.com/users/facebook-github-bot', 'html_url': 'https://github.com/facebook-github-bot', 'followers_url': 'https://api.github.com/users/facebook-github-bot/followers', 'following_url': 'https://api.github.com/users/facebook-github-bot/following{/other_user}', 'gists_url': 'https://api.github.com/users/facebook-github-bot/gists{/gist_id}', 'starred_url': 'https://api.github.com/users/facebook-github-bot/starred{/owner}{/repo}', 'subscriptions_url': 'https://api.github.com/users/facebook-github-bot/subscriptions', 'organizations_url': 'https://api.github.com/users/facebook-github-bot/orgs', 'repos_url': 'https://api.github.com/users/facebook-github-bot/repos', 'events_url': 'https://api.github.com/users/facebook-github-bot/events{/privacy}', 'received_events_url': 'https://api.github.com/users/facebook-github-bot/received_events', 'type': 'User', 'site_admin': False}",closed,0565141728abe8d9235538157077973e2aaa8081,https://api.github.com/repos/pytorch/pytorch/commits/0565141728abe8d9235538157077973e2aaa8081,2019-04-08T16:55:03Z,107,107,0
18724,2451851409,"{'login': 'facebook-github-bot', 'id': 6422482, 'node_id': 'MDQ6VXNlcjY0MjI0ODI=', 'avatar_url': 'https://avatars3.githubusercontent.com/u/6422482?v=4', 'gravatar_id': '', 'url': 'https://api.github.com/users/facebook-github-bot', 'html_url': 'https://github.com/facebook-github-bot', 'followers_url': 'https://api.github.com/users/facebook-github-bot/followers', 'following_url': 'https://api.github.com/users/facebook-github-bot/following{/other_user}', 'gists_url': 'https://api.github.com/users/facebook-github-bot/gists{/gist_id}', 'starred_url': 'https://api.github.com/users/facebook-github-bot/starred{/owner}{/repo}', 'subscriptions_url': 'https://api.github.com/users/facebook-github-bot/subscriptions', 'organizations_url': 'https://api.github.com/users/facebook-github-bot/orgs', 'repos_url': 'https://api.github.com/users/facebook-github-bot/repos', 'events_url': 'https://api.github.com/users/facebook-github-bot/events{/privacy}', 'received_events_url': 'https://api.github.com/users/facebook-github-bot/received_events', 'type': 'User', 'site_admin': False}",closed,bfeff1eb8f90aa1ff7e4f6bafe9945ad409e2d97,https://api.github.com/repos/pytorch/pytorch/commits/bfeff1eb8f90aa1ff7e4f6bafe9945ad409e2d97,2019-07-01T16:52:36Z,2244,2240,4
18701,2250239860,"{'login': 'facebook-github-bot', 'id': 6422482, 'node_id': 'MDQ6VXNlcjY0MjI0ODI=', 'avatar_url': 'https://avatars3.githubusercontent.com/u/6422482?v=4', 'gravatar_id': '', 'url': 'https://api.github.com/users/facebook-github-bot', 'html_url': 'https://github.com/facebook-github-bot', 'followers_url': 'https://api.github.com/users/facebook-github-bot/followers', 'following_url': 'https://api.github.com/users/facebook-github-bot/following{/other_user}', 'gists_url': 'https://api.github.com/users/facebook-github-bot/gists{/gist_id}', 'starred_url': 'https://api.github.com/users/facebook-github-bot/starred{/owner}{/repo}', 'subscriptions_url': 'https://api.github.com/users/facebook-github-bot/subscriptions', 'organizations_url': 'https://api.github.com/users/facebook-github-bot/orgs', 'repos_url': 'https://api.github.com/users/facebook-github-bot/repos', 'events_url': 'https://api.github.com/users/facebook-github-bot/events{/privacy}', 'received_events_url': 'https://api.github.com/users/facebook-github-bot/received_events', 'type': 'User', 'site_admin': False}",closed,5e33085f270edd4ee17db47eb7cd0d2fc0cdb196,https://api.github.com/repos/pytorch/pytorch/commits/5e33085f270edd4ee17db47eb7cd0d2fc0cdb196,2019-04-03T15:27:07Z,65,38,27
18700,2260219615,"{'login': 'ezyang', 'id': 13564, 'node_id': 'MDQ6VXNlcjEzNTY0', 'avatar_url': 'https://avatars0.githubusercontent.com/u/13564?v=4', 'gravatar_id': '', 'url': 'https://api.github.com/users/ezyang', 'html_url': 'https://github.com/ezyang', 'followers_url': 'https://api.github.com/users/ezyang/followers', 'following_url': 'https://api.github.com/users/ezyang/following{/other_user}', 'gists_url': 'https://api.github.com/users/ezyang/gists{/gist_id}', 'starred_url': 'https://api.github.com/users/ezyang/starred{/owner}{/repo}', 'subscriptions_url': 'https://api.github.com/users/ezyang/subscriptions', 'organizations_url': 'https://api.github.com/users/ezyang/orgs', 'repos_url': 'https://api.github.com/users/ezyang/repos', 'events_url': 'https://api.github.com/users/ezyang/events{/privacy}', 'received_events_url': 'https://api.github.com/users/ezyang/received_events', 'type': 'User', 'site_admin': False}",referenced,dc8f86cb7873ab4cf45d2ed1e0542c3987020840,https://api.github.com/repos/pytorch/pytorch/commits/dc8f86cb7873ab4cf45d2ed1e0542c3987020840,2019-04-08T16:06:26Z,1,1,0
18700,2260219649,"{'login': 'ezyang', 'id': 13564, 'node_id': 'MDQ6VXNlcjEzNTY0', 'avatar_url': 'https://avatars0.githubusercontent.com/u/13564?v=4', 'gravatar_id': '', 'url': 'https://api.github.com/users/ezyang', 'html_url': 'https://github.com/ezyang', 'followers_url': 'https://api.github.com/users/ezyang/followers', 'following_url': 'https://api.github.com/users/ezyang/following{/other_user}', 'gists_url': 'https://api.github.com/users/ezyang/gists{/gist_id}', 'starred_url': 'https://api.github.com/users/ezyang/starred{/owner}{/repo}', 'subscriptions_url': 'https://api.github.com/users/ezyang/subscriptions', 'organizations_url': 'https://api.github.com/users/ezyang/orgs', 'repos_url': 'https://api.github.com/users/ezyang/repos', 'events_url': 'https://api.github.com/users/ezyang/events{/privacy}', 'received_events_url': 'https://api.github.com/users/ezyang/received_events', 'type': 'User', 'site_admin': False}",referenced,84d36f8d27912d1d094d5672154b82187dd88761,https://api.github.com/repos/pytorch/pytorch/commits/84d36f8d27912d1d094d5672154b82187dd88761,2019-04-08T16:06:26Z,1,1,0
18700,2263066444,"{'login': 'facebook-github-bot', 'id': 6422482, 'node_id': 'MDQ6VXNlcjY0MjI0ODI=', 'avatar_url': 'https://avatars3.githubusercontent.com/u/6422482?v=4', 'gravatar_id': '', 'url': 'https://api.github.com/users/facebook-github-bot', 'html_url': 'https://github.com/facebook-github-bot', 'followers_url': 'https://api.github.com/users/facebook-github-bot/followers', 'following_url': 'https://api.github.com/users/facebook-github-bot/following{/other_user}', 'gists_url': 'https://api.github.com/users/facebook-github-bot/gists{/gist_id}', 'starred_url': 'https://api.github.com/users/facebook-github-bot/starred{/owner}{/repo}', 'subscriptions_url': 'https://api.github.com/users/facebook-github-bot/subscriptions', 'organizations_url': 'https://api.github.com/users/facebook-github-bot/orgs', 'repos_url': 'https://api.github.com/users/facebook-github-bot/repos', 'events_url': 'https://api.github.com/users/facebook-github-bot/events{/privacy}', 'received_events_url': 'https://api.github.com/users/facebook-github-bot/received_events', 'type': 'User', 'site_admin': False}",closed,5f24f9a29b678603b0cd783cdd2a03b6b2085bd2,https://api.github.com/repos/pytorch/pytorch/commits/5f24f9a29b678603b0cd783cdd2a03b6b2085bd2,2019-04-09T14:36:52Z,1,1,0
18689,2250490197,"{'login': 'facebook-github-bot', 'id': 6422482, 'node_id': 'MDQ6VXNlcjY0MjI0ODI=', 'avatar_url': 'https://avatars3.githubusercontent.com/u/6422482?v=4', 'gravatar_id': '', 'url': 'https://api.github.com/users/facebook-github-bot', 'html_url': 'https://github.com/facebook-github-bot', 'followers_url': 'https://api.github.com/users/facebook-github-bot/followers', 'following_url': 'https://api.github.com/users/facebook-github-bot/following{/other_user}', 'gists_url': 'https://api.github.com/users/facebook-github-bot/gists{/gist_id}', 'starred_url': 'https://api.github.com/users/facebook-github-bot/starred{/owner}{/repo}', 'subscriptions_url': 'https://api.github.com/users/facebook-github-bot/subscriptions', 'organizations_url': 'https://api.github.com/users/facebook-github-bot/orgs', 'repos_url': 'https://api.github.com/users/facebook-github-bot/repos', 'events_url': 'https://api.github.com/users/facebook-github-bot/events{/privacy}', 'received_events_url': 'https://api.github.com/users/facebook-github-bot/received_events', 'type': 'User', 'site_admin': False}",referenced,c0ad6747a9b3d011ef5d1b44d08a065188a4ee19,https://api.github.com/repos/pytorch/pytorch/commits/c0ad6747a9b3d011ef5d1b44d08a065188a4ee19,2019-04-03T16:52:58Z,5,4,1
18671,2244982108,"{'login': 'facebook-github-bot', 'id': 6422482, 'node_id': 'MDQ6VXNlcjY0MjI0ODI=', 'avatar_url': 'https://avatars3.githubusercontent.com/u/6422482?v=4', 'gravatar_id': '', 'url': 'https://api.github.com/users/facebook-github-bot', 'html_url': 'https://github.com/facebook-github-bot', 'followers_url': 'https://api.github.com/users/facebook-github-bot/followers', 'following_url': 'https://api.github.com/users/facebook-github-bot/following{/other_user}', 'gists_url': 'https://api.github.com/users/facebook-github-bot/gists{/gist_id}', 'starred_url': 'https://api.github.com/users/facebook-github-bot/starred{/owner}{/repo}', 'subscriptions_url': 'https://api.github.com/users/facebook-github-bot/subscriptions', 'organizations_url': 'https://api.github.com/users/facebook-github-bot/orgs', 'repos_url': 'https://api.github.com/users/facebook-github-bot/repos', 'events_url': 'https://api.github.com/users/facebook-github-bot/events{/privacy}', 'received_events_url': 'https://api.github.com/users/facebook-github-bot/received_events', 'type': 'User', 'site_admin': False}",closed,8e873ce273c17cfc45f3c24043474e1b62222bb1,https://api.github.com/repos/pytorch/pytorch/commits/8e873ce273c17cfc45f3c24043474e1b62222bb1,2019-04-02T00:36:53Z,14,11,3
18659,2249912276,"{'login': 'ezyang', 'id': 13564, 'node_id': 'MDQ6VXNlcjEzNTY0', 'avatar_url': 'https://avatars0.githubusercontent.com/u/13564?v=4', 'gravatar_id': '', 'url': 'https://api.github.com/users/ezyang', 'html_url': 'https://github.com/ezyang', 'followers_url': 'https://api.github.com/users/ezyang/followers', 'following_url': 'https://api.github.com/users/ezyang/following{/other_user}', 'gists_url': 'https://api.github.com/users/ezyang/gists{/gist_id}', 'starred_url': 'https://api.github.com/users/ezyang/starred{/owner}{/repo}', 'subscriptions_url': 'https://api.github.com/users/ezyang/subscriptions', 'organizations_url': 'https://api.github.com/users/ezyang/orgs', 'repos_url': 'https://api.github.com/users/ezyang/repos', 'events_url': 'https://api.github.com/users/ezyang/events{/privacy}', 'received_events_url': 'https://api.github.com/users/ezyang/received_events', 'type': 'User', 'site_admin': False}",referenced,8ecb42e7ecf55acebb87ce2e37bac522e52916f6,https://api.github.com/repos/pytorch/pytorch/commits/8ecb42e7ecf55acebb87ce2e37bac522e52916f6,2019-04-03T13:53:52Z,62,12,50
18659,2249912393,"{'login': 'ezyang', 'id': 13564, 'node_id': 'MDQ6VXNlcjEzNTY0', 'avatar_url': 'https://avatars0.githubusercontent.com/u/13564?v=4', 'gravatar_id': '', 'url': 'https://api.github.com/users/ezyang', 'html_url': 'https://github.com/ezyang', 'followers_url': 'https://api.github.com/users/ezyang/followers', 'following_url': 'https://api.github.com/users/ezyang/following{/other_user}', 'gists_url': 'https://api.github.com/users/ezyang/gists{/gist_id}', 'starred_url': 'https://api.github.com/users/ezyang/starred{/owner}{/repo}', 'subscriptions_url': 'https://api.github.com/users/ezyang/subscriptions', 'organizations_url': 'https://api.github.com/users/ezyang/orgs', 'repos_url': 'https://api.github.com/users/ezyang/repos', 'events_url': 'https://api.github.com/users/ezyang/events{/privacy}', 'received_events_url': 'https://api.github.com/users/ezyang/received_events', 'type': 'User', 'site_admin': False}",referenced,d882c0f49b7744f92d9793782c2c1376ed6eef2e,https://api.github.com/repos/pytorch/pytorch/commits/d882c0f49b7744f92d9793782c2c1376ed6eef2e,2019-04-03T13:53:54Z,148,76,72
18659,2249986019,"{'login': 'ezyang', 'id': 13564, 'node_id': 'MDQ6VXNlcjEzNTY0', 'avatar_url': 'https://avatars0.githubusercontent.com/u/13564?v=4', 'gravatar_id': '', 'url': 'https://api.github.com/users/ezyang', 'html_url': 'https://github.com/ezyang', 'followers_url': 'https://api.github.com/users/ezyang/followers', 'following_url': 'https://api.github.com/users/ezyang/following{/other_user}', 'gists_url': 'https://api.github.com/users/ezyang/gists{/gist_id}', 'starred_url': 'https://api.github.com/users/ezyang/starred{/owner}{/repo}', 'subscriptions_url': 'https://api.github.com/users/ezyang/subscriptions', 'organizations_url': 'https://api.github.com/users/ezyang/orgs', 'repos_url': 'https://api.github.com/users/ezyang/repos', 'events_url': 'https://api.github.com/users/ezyang/events{/privacy}', 'received_events_url': 'https://api.github.com/users/ezyang/received_events', 'type': 'User', 'site_admin': False}",referenced,3654366af5cd6f701b87dd867aee68a7a582ee42,https://api.github.com/repos/pytorch/pytorch/commits/3654366af5cd6f701b87dd867aee68a7a582ee42,2019-04-03T14:15:34Z,38,32,6
18659,2249986289,"{'login': 'ezyang', 'id': 13564, 'node_id': 'MDQ6VXNlcjEzNTY0', 'avatar_url': 'https://avatars0.githubusercontent.com/u/13564?v=4', 'gravatar_id': '', 'url': 'https://api.github.com/users/ezyang', 'html_url': 'https://github.com/ezyang', 'followers_url': 'https://api.github.com/users/ezyang/followers', 'following_url': 'https://api.github.com/users/ezyang/following{/other_user}', 'gists_url': 'https://api.github.com/users/ezyang/gists{/gist_id}', 'starred_url': 'https://api.github.com/users/ezyang/starred{/owner}{/repo}', 'subscriptions_url': 'https://api.github.com/users/ezyang/subscriptions', 'organizations_url': 'https://api.github.com/users/ezyang/orgs', 'repos_url': 'https://api.github.com/users/ezyang/repos', 'events_url': 'https://api.github.com/users/ezyang/events{/privacy}', 'received_events_url': 'https://api.github.com/users/ezyang/received_events', 'type': 'User', 'site_admin': False}",referenced,cbd646772d86f4165499641779584cf2484e1517,https://api.github.com/repos/pytorch/pytorch/commits/cbd646772d86f4165499641779584cf2484e1517,2019-04-03T14:15:38Z,178,104,74
18659,2250092744,"{'login': 'ezyang', 'id': 13564, 'node_id': 'MDQ6VXNlcjEzNTY0', 'avatar_url': 'https://avatars0.githubusercontent.com/u/13564?v=4', 'gravatar_id': '', 'url': 'https://api.github.com/users/ezyang', 'html_url': 'https://github.com/ezyang', 'followers_url': 'https://api.github.com/users/ezyang/followers', 'following_url': 'https://api.github.com/users/ezyang/following{/other_user}', 'gists_url': 'https://api.github.com/users/ezyang/gists{/gist_id}', 'starred_url': 'https://api.github.com/users/ezyang/starred{/owner}{/repo}', 'subscriptions_url': 'https://api.github.com/users/ezyang/subscriptions', 'organizations_url': 'https://api.github.com/users/ezyang/orgs', 'repos_url': 'https://api.github.com/users/ezyang/repos', 'events_url': 'https://api.github.com/users/ezyang/events{/privacy}', 'received_events_url': 'https://api.github.com/users/ezyang/received_events', 'type': 'User', 'site_admin': False}",referenced,33e964271a885f2f4ba6471f1b07487054f2077c,https://api.github.com/repos/pytorch/pytorch/commits/33e964271a885f2f4ba6471f1b07487054f2077c,2019-04-03T14:45:48Z,2930,2064,866
18659,2250092954,"{'login': 'ezyang', 'id': 13564, 'node_id': 'MDQ6VXNlcjEzNTY0', 'avatar_url': 'https://avatars0.githubusercontent.com/u/13564?v=4', 'gravatar_id': '', 'url': 'https://api.github.com/users/ezyang', 'html_url': 'https://github.com/ezyang', 'followers_url': 'https://api.github.com/users/ezyang/followers', 'following_url': 'https://api.github.com/users/ezyang/following{/other_user}', 'gists_url': 'https://api.github.com/users/ezyang/gists{/gist_id}', 'starred_url': 'https://api.github.com/users/ezyang/starred{/owner}{/repo}', 'subscriptions_url': 'https://api.github.com/users/ezyang/subscriptions', 'organizations_url': 'https://api.github.com/users/ezyang/orgs', 'repos_url': 'https://api.github.com/users/ezyang/repos', 'events_url': 'https://api.github.com/users/ezyang/events{/privacy}', 'received_events_url': 'https://api.github.com/users/ezyang/received_events', 'type': 'User', 'site_admin': False}",referenced,8b88872015131ec2e144b9657e6736168b3d9383,https://api.github.com/repos/pytorch/pytorch/commits/8b88872015131ec2e144b9657e6736168b3d9383,2019-04-03T14:45:52Z,194,112,82
18659,2250378309,"{'login': 'ezyang', 'id': 13564, 'node_id': 'MDQ6VXNlcjEzNTY0', 'avatar_url': 'https://avatars0.githubusercontent.com/u/13564?v=4', 'gravatar_id': '', 'url': 'https://api.github.com/users/ezyang', 'html_url': 'https://github.com/ezyang', 'followers_url': 'https://api.github.com/users/ezyang/followers', 'following_url': 'https://api.github.com/users/ezyang/following{/other_user}', 'gists_url': 'https://api.github.com/users/ezyang/gists{/gist_id}', 'starred_url': 'https://api.github.com/users/ezyang/starred{/owner}{/repo}', 'subscriptions_url': 'https://api.github.com/users/ezyang/subscriptions', 'organizations_url': 'https://api.github.com/users/ezyang/orgs', 'repos_url': 'https://api.github.com/users/ezyang/repos', 'events_url': 'https://api.github.com/users/ezyang/events{/privacy}', 'received_events_url': 'https://api.github.com/users/ezyang/received_events', 'type': 'User', 'site_admin': False}",referenced,b841f583295cd7bcff61536769587ae461ad8ba2,https://api.github.com/repos/pytorch/pytorch/commits/b841f583295cd7bcff61536769587ae461ad8ba2,2019-04-03T16:10:55Z,6,0,6
18659,2250378557,"{'login': 'ezyang', 'id': 13564, 'node_id': 'MDQ6VXNlcjEzNTY0', 'avatar_url': 'https://avatars0.githubusercontent.com/u/13564?v=4', 'gravatar_id': '', 'url': 'https://api.github.com/users/ezyang', 'html_url': 'https://github.com/ezyang', 'followers_url': 'https://api.github.com/users/ezyang/followers', 'following_url': 'https://api.github.com/users/ezyang/following{/other_user}', 'gists_url': 'https://api.github.com/users/ezyang/gists{/gist_id}', 'starred_url': 'https://api.github.com/users/ezyang/starred{/owner}{/repo}', 'subscriptions_url': 'https://api.github.com/users/ezyang/subscriptions', 'organizations_url': 'https://api.github.com/users/ezyang/orgs', 'repos_url': 'https://api.github.com/users/ezyang/repos', 'events_url': 'https://api.github.com/users/ezyang/events{/privacy}', 'received_events_url': 'https://api.github.com/users/ezyang/received_events', 'type': 'User', 'site_admin': False}",referenced,1c92f98b091232c0045a2e1db75d19c1f258ac1f,https://api.github.com/repos/pytorch/pytorch/commits/1c92f98b091232c0045a2e1db75d19c1f258ac1f,2019-04-03T16:10:59Z,196,110,86
18657,2560858305,"{'login': 'xuhdev', 'id': 325476, 'node_id': 'MDQ6VXNlcjMyNTQ3Ng==', 'avatar_url': 'https://avatars1.githubusercontent.com/u/325476?v=4', 'gravatar_id': '', 'url': 'https://api.github.com/users/xuhdev', 'html_url': 'https://github.com/xuhdev', 'followers_url': 'https://api.github.com/users/xuhdev/followers', 'following_url': 'https://api.github.com/users/xuhdev/following{/other_user}', 'gists_url': 'https://api.github.com/users/xuhdev/gists{/gist_id}', 'starred_url': 'https://api.github.com/users/xuhdev/starred{/owner}{/repo}', 'subscriptions_url': 'https://api.github.com/users/xuhdev/subscriptions', 'organizations_url': 'https://api.github.com/users/xuhdev/orgs', 'repos_url': 'https://api.github.com/users/xuhdev/repos', 'events_url': 'https://api.github.com/users/xuhdev/events{/privacy}', 'received_events_url': 'https://api.github.com/users/xuhdev/received_events', 'type': 'User', 'site_admin': False}",referenced,cd207737017db8c81584763207df20bc6110ed75,https://api.github.com/repos/pytorch/pytorch/commits/cd207737017db8c81584763207df20bc6110ed75,2019-08-15T22:27:51Z,174,167,7
18657,2560858624,"{'login': 'facebook-github-bot', 'id': 6422482, 'node_id': 'MDQ6VXNlcjY0MjI0ODI=', 'avatar_url': 'https://avatars3.githubusercontent.com/u/6422482?v=4', 'gravatar_id': '', 'url': 'https://api.github.com/users/facebook-github-bot', 'html_url': 'https://github.com/facebook-github-bot', 'followers_url': 'https://api.github.com/users/facebook-github-bot/followers', 'following_url': 'https://api.github.com/users/facebook-github-bot/following{/other_user}', 'gists_url': 'https://api.github.com/users/facebook-github-bot/gists{/gist_id}', 'starred_url': 'https://api.github.com/users/facebook-github-bot/starred{/owner}{/repo}', 'subscriptions_url': 'https://api.github.com/users/facebook-github-bot/subscriptions', 'organizations_url': 'https://api.github.com/users/facebook-github-bot/orgs', 'repos_url': 'https://api.github.com/users/facebook-github-bot/repos', 'events_url': 'https://api.github.com/users/facebook-github-bot/events{/privacy}', 'received_events_url': 'https://api.github.com/users/facebook-github-bot/received_events', 'type': 'User', 'site_admin': False}",closed,cd207737017db8c81584763207df20bc6110ed75,https://api.github.com/repos/pytorch/pytorch/commits/cd207737017db8c81584763207df20bc6110ed75,2019-08-15T22:28:02Z,174,167,7
18619,2497045723,"{'login': 'ezyang', 'id': 13564, 'node_id': 'MDQ6VXNlcjEzNTY0', 'avatar_url': 'https://avatars0.githubusercontent.com/u/13564?v=4', 'gravatar_id': '', 'url': 'https://api.github.com/users/ezyang', 'html_url': 'https://github.com/ezyang', 'followers_url': 'https://api.github.com/users/ezyang/followers', 'following_url': 'https://api.github.com/users/ezyang/following{/other_user}', 'gists_url': 'https://api.github.com/users/ezyang/gists{/gist_id}', 'starred_url': 'https://api.github.com/users/ezyang/starred{/owner}{/repo}', 'subscriptions_url': 'https://api.github.com/users/ezyang/subscriptions', 'organizations_url': 'https://api.github.com/users/ezyang/orgs', 'repos_url': 'https://api.github.com/users/ezyang/repos', 'events_url': 'https://api.github.com/users/ezyang/events{/privacy}', 'received_events_url': 'https://api.github.com/users/ezyang/received_events', 'type': 'User', 'site_admin': False}",referenced,05c281552739df0b69ba0cf789fcadbf56aa7026,https://api.github.com/repos/pytorch/pytorch/commits/05c281552739df0b69ba0cf789fcadbf56aa7026,2019-07-19T21:26:15Z,597,98,499
18619,2500027287,"{'login': 'ezyang', 'id': 13564, 'node_id': 'MDQ6VXNlcjEzNTY0', 'avatar_url': 'https://avatars0.githubusercontent.com/u/13564?v=4', 'gravatar_id': '', 'url': 'https://api.github.com/users/ezyang', 'html_url': 'https://github.com/ezyang', 'followers_url': 'https://api.github.com/users/ezyang/followers', 'following_url': 'https://api.github.com/users/ezyang/following{/other_user}', 'gists_url': 'https://api.github.com/users/ezyang/gists{/gist_id}', 'starred_url': 'https://api.github.com/users/ezyang/starred{/owner}{/repo}', 'subscriptions_url': 'https://api.github.com/users/ezyang/subscriptions', 'organizations_url': 'https://api.github.com/users/ezyang/orgs', 'repos_url': 'https://api.github.com/users/ezyang/repos', 'events_url': 'https://api.github.com/users/ezyang/events{/privacy}', 'received_events_url': 'https://api.github.com/users/ezyang/received_events', 'type': 'User', 'site_admin': False}",referenced,a4c417cd7088ecc24c3c603e198ef71338fea95b,https://api.github.com/repos/pytorch/pytorch/commits/a4c417cd7088ecc24c3c603e198ef71338fea95b,2019-07-22T14:25:13Z,6496,5809,687
18619,2500589650,"{'login': 'ezyang', 'id': 13564, 'node_id': 'MDQ6VXNlcjEzNTY0', 'avatar_url': 'https://avatars0.githubusercontent.com/u/13564?v=4', 'gravatar_id': '', 'url': 'https://api.github.com/users/ezyang', 'html_url': 'https://github.com/ezyang', 'followers_url': 'https://api.github.com/users/ezyang/followers', 'following_url': 'https://api.github.com/users/ezyang/following{/other_user}', 'gists_url': 'https://api.github.com/users/ezyang/gists{/gist_id}', 'starred_url': 'https://api.github.com/users/ezyang/starred{/owner}{/repo}', 'subscriptions_url': 'https://api.github.com/users/ezyang/subscriptions', 'organizations_url': 'https://api.github.com/users/ezyang/orgs', 'repos_url': 'https://api.github.com/users/ezyang/repos', 'events_url': 'https://api.github.com/users/ezyang/events{/privacy}', 'received_events_url': 'https://api.github.com/users/ezyang/received_events', 'type': 'User', 'site_admin': False}",referenced,ffb57eb527c6799bcc58563f02d70cd94ef66ef5,https://api.github.com/repos/pytorch/pytorch/commits/ffb57eb527c6799bcc58563f02d70cd94ef66ef5,2019-07-22T17:48:45Z,119,80,39
18591,2251213267,"{'login': 'facebook-github-bot', 'id': 6422482, 'node_id': 'MDQ6VXNlcjY0MjI0ODI=', 'avatar_url': 'https://avatars3.githubusercontent.com/u/6422482?v=4', 'gravatar_id': '', 'url': 'https://api.github.com/users/facebook-github-bot', 'html_url': 'https://github.com/facebook-github-bot', 'followers_url': 'https://api.github.com/users/facebook-github-bot/followers', 'following_url': 'https://api.github.com/users/facebook-github-bot/following{/other_user}', 'gists_url': 'https://api.github.com/users/facebook-github-bot/gists{/gist_id}', 'starred_url': 'https://api.github.com/users/facebook-github-bot/starred{/owner}{/repo}', 'subscriptions_url': 'https://api.github.com/users/facebook-github-bot/subscriptions', 'organizations_url': 'https://api.github.com/users/facebook-github-bot/orgs', 'repos_url': 'https://api.github.com/users/facebook-github-bot/repos', 'events_url': 'https://api.github.com/users/facebook-github-bot/events{/privacy}', 'received_events_url': 'https://api.github.com/users/facebook-github-bot/received_events', 'type': 'User', 'site_admin': False}",referenced,7ae0263e1bf1482cba79361f991d11a85b35cde6,https://api.github.com/repos/pytorch/pytorch/commits/7ae0263e1bf1482cba79361f991d11a85b35cde6,2019-04-03T21:45:49Z,350,328,22
18534,2239278617,"{'login': 'facebook-github-bot', 'id': 6422482, 'node_id': 'MDQ6VXNlcjY0MjI0ODI=', 'avatar_url': 'https://avatars3.githubusercontent.com/u/6422482?v=4', 'gravatar_id': '', 'url': 'https://api.github.com/users/facebook-github-bot', 'html_url': 'https://github.com/facebook-github-bot', 'followers_url': 'https://api.github.com/users/facebook-github-bot/followers', 'following_url': 'https://api.github.com/users/facebook-github-bot/following{/other_user}', 'gists_url': 'https://api.github.com/users/facebook-github-bot/gists{/gist_id}', 'starred_url': 'https://api.github.com/users/facebook-github-bot/starred{/owner}{/repo}', 'subscriptions_url': 'https://api.github.com/users/facebook-github-bot/subscriptions', 'organizations_url': 'https://api.github.com/users/facebook-github-bot/orgs', 'repos_url': 'https://api.github.com/users/facebook-github-bot/repos', 'events_url': 'https://api.github.com/users/facebook-github-bot/events{/privacy}', 'received_events_url': 'https://api.github.com/users/facebook-github-bot/received_events', 'type': 'User', 'site_admin': False}",closed,c189eba3e139aca43974e63dba9fb972e88c9d74,https://api.github.com/repos/pytorch/pytorch/commits/c189eba3e139aca43974e63dba9fb972e88c9d74,2019-03-29T13:44:58Z,6,5,1
18525,2596113521,"{'login': 'facebook-github-bot', 'id': 6422482, 'node_id': 'MDQ6VXNlcjY0MjI0ODI=', 'avatar_url': 'https://avatars3.githubusercontent.com/u/6422482?v=4', 'gravatar_id': '', 'url': 'https://api.github.com/users/facebook-github-bot', 'html_url': 'https://github.com/facebook-github-bot', 'followers_url': 'https://api.github.com/users/facebook-github-bot/followers', 'following_url': 'https://api.github.com/users/facebook-github-bot/following{/other_user}', 'gists_url': 'https://api.github.com/users/facebook-github-bot/gists{/gist_id}', 'starred_url': 'https://api.github.com/users/facebook-github-bot/starred{/owner}{/repo}', 'subscriptions_url': 'https://api.github.com/users/facebook-github-bot/subscriptions', 'organizations_url': 'https://api.github.com/users/facebook-github-bot/orgs', 'repos_url': 'https://api.github.com/users/facebook-github-bot/repos', 'events_url': 'https://api.github.com/users/facebook-github-bot/events{/privacy}', 'received_events_url': 'https://api.github.com/users/facebook-github-bot/received_events', 'type': 'User', 'site_admin': False}",referenced,8986b9e38d78a4cc045eef69e8ee6868244aa319,https://api.github.com/repos/pytorch/pytorch/commits/8986b9e38d78a4cc045eef69e8ee6868244aa319,2019-08-30T06:16:58Z,10,8,2
18518,2263640597,"{'login': 'facebook-github-bot', 'id': 6422482, 'node_id': 'MDQ6VXNlcjY0MjI0ODI=', 'avatar_url': 'https://avatars3.githubusercontent.com/u/6422482?v=4', 'gravatar_id': '', 'url': 'https://api.github.com/users/facebook-github-bot', 'html_url': 'https://github.com/facebook-github-bot', 'followers_url': 'https://api.github.com/users/facebook-github-bot/followers', 'following_url': 'https://api.github.com/users/facebook-github-bot/following{/other_user}', 'gists_url': 'https://api.github.com/users/facebook-github-bot/gists{/gist_id}', 'starred_url': 'https://api.github.com/users/facebook-github-bot/starred{/owner}{/repo}', 'subscriptions_url': 'https://api.github.com/users/facebook-github-bot/subscriptions', 'organizations_url': 'https://api.github.com/users/facebook-github-bot/orgs', 'repos_url': 'https://api.github.com/users/facebook-github-bot/repos', 'events_url': 'https://api.github.com/users/facebook-github-bot/events{/privacy}', 'received_events_url': 'https://api.github.com/users/facebook-github-bot/received_events', 'type': 'User', 'site_admin': False}",closed,31ff0ecd2b400b4863741bcbc41748f2ad01745c,https://api.github.com/repos/pytorch/pytorch/commits/31ff0ecd2b400b4863741bcbc41748f2ad01745c,2019-04-09T17:41:06Z,10,8,2
18490,2256513622,"{'login': 'facebook-github-bot', 'id': 6422482, 'node_id': 'MDQ6VXNlcjY0MjI0ODI=', 'avatar_url': 'https://avatars3.githubusercontent.com/u/6422482?v=4', 'gravatar_id': '', 'url': 'https://api.github.com/users/facebook-github-bot', 'html_url': 'https://github.com/facebook-github-bot', 'followers_url': 'https://api.github.com/users/facebook-github-bot/followers', 'following_url': 'https://api.github.com/users/facebook-github-bot/following{/other_user}', 'gists_url': 'https://api.github.com/users/facebook-github-bot/gists{/gist_id}', 'starred_url': 'https://api.github.com/users/facebook-github-bot/starred{/owner}{/repo}', 'subscriptions_url': 'https://api.github.com/users/facebook-github-bot/subscriptions', 'organizations_url': 'https://api.github.com/users/facebook-github-bot/orgs', 'repos_url': 'https://api.github.com/users/facebook-github-bot/repos', 'events_url': 'https://api.github.com/users/facebook-github-bot/events{/privacy}', 'received_events_url': 'https://api.github.com/users/facebook-github-bot/received_events', 'type': 'User', 'site_admin': False}",closed,fefa6d305ea3e820afe64cec015d2f6746d9ca88,https://api.github.com/repos/pytorch/pytorch/commits/fefa6d305ea3e820afe64cec015d2f6746d9ca88,2019-04-05T17:50:32Z,162,138,24
18461,2233420044,"{'login': 'facebook-github-bot', 'id': 6422482, 'node_id': 'MDQ6VXNlcjY0MjI0ODI=', 'avatar_url': 'https://avatars3.githubusercontent.com/u/6422482?v=4', 'gravatar_id': '', 'url': 'https://api.github.com/users/facebook-github-bot', 'html_url': 'https://github.com/facebook-github-bot', 'followers_url': 'https://api.github.com/users/facebook-github-bot/followers', 'following_url': 'https://api.github.com/users/facebook-github-bot/following{/other_user}', 'gists_url': 'https://api.github.com/users/facebook-github-bot/gists{/gist_id}', 'starred_url': 'https://api.github.com/users/facebook-github-bot/starred{/owner}{/repo}', 'subscriptions_url': 'https://api.github.com/users/facebook-github-bot/subscriptions', 'organizations_url': 'https://api.github.com/users/facebook-github-bot/orgs', 'repos_url': 'https://api.github.com/users/facebook-github-bot/repos', 'events_url': 'https://api.github.com/users/facebook-github-bot/events{/privacy}', 'received_events_url': 'https://api.github.com/users/facebook-github-bot/received_events', 'type': 'User', 'site_admin': False}",closed,85d78a0532225fa195ad4d15285b685ee44bd63b,https://api.github.com/repos/pytorch/pytorch/commits/85d78a0532225fa195ad4d15285b685ee44bd63b,2019-03-27T15:00:56Z,2,1,1
18450,2231385238,"{'login': 'facebook-github-bot', 'id': 6422482, 'node_id': 'MDQ6VXNlcjY0MjI0ODI=', 'avatar_url': 'https://avatars3.githubusercontent.com/u/6422482?v=4', 'gravatar_id': '', 'url': 'https://api.github.com/users/facebook-github-bot', 'html_url': 'https://github.com/facebook-github-bot', 'followers_url': 'https://api.github.com/users/facebook-github-bot/followers', 'following_url': 'https://api.github.com/users/facebook-github-bot/following{/other_user}', 'gists_url': 'https://api.github.com/users/facebook-github-bot/gists{/gist_id}', 'starred_url': 'https://api.github.com/users/facebook-github-bot/starred{/owner}{/repo}', 'subscriptions_url': 'https://api.github.com/users/facebook-github-bot/subscriptions', 'organizations_url': 'https://api.github.com/users/facebook-github-bot/orgs', 'repos_url': 'https://api.github.com/users/facebook-github-bot/repos', 'events_url': 'https://api.github.com/users/facebook-github-bot/events{/privacy}', 'received_events_url': 'https://api.github.com/users/facebook-github-bot/received_events', 'type': 'User', 'site_admin': False}",referenced,5292685d2f144d9781ab8b7991c0a1153098a477,https://api.github.com/repos/pytorch/pytorch/commits/5292685d2f144d9781ab8b7991c0a1153098a477,2019-03-26T22:33:53Z,180,112,68
18448,2231385236,"{'login': 'facebook-github-bot', 'id': 6422482, 'node_id': 'MDQ6VXNlcjY0MjI0ODI=', 'avatar_url': 'https://avatars3.githubusercontent.com/u/6422482?v=4', 'gravatar_id': '', 'url': 'https://api.github.com/users/facebook-github-bot', 'html_url': 'https://github.com/facebook-github-bot', 'followers_url': 'https://api.github.com/users/facebook-github-bot/followers', 'following_url': 'https://api.github.com/users/facebook-github-bot/following{/other_user}', 'gists_url': 'https://api.github.com/users/facebook-github-bot/gists{/gist_id}', 'starred_url': 'https://api.github.com/users/facebook-github-bot/starred{/owner}{/repo}', 'subscriptions_url': 'https://api.github.com/users/facebook-github-bot/subscriptions', 'organizations_url': 'https://api.github.com/users/facebook-github-bot/orgs', 'repos_url': 'https://api.github.com/users/facebook-github-bot/repos', 'events_url': 'https://api.github.com/users/facebook-github-bot/events{/privacy}', 'received_events_url': 'https://api.github.com/users/facebook-github-bot/received_events', 'type': 'User', 'site_admin': False}",closed,5292685d2f144d9781ab8b7991c0a1153098a477,https://api.github.com/repos/pytorch/pytorch/commits/5292685d2f144d9781ab8b7991c0a1153098a477,2019-03-26T22:33:53Z,180,112,68
18440,2376217239,"{'login': 'facebook-github-bot', 'id': 6422482, 'node_id': 'MDQ6VXNlcjY0MjI0ODI=', 'avatar_url': 'https://avatars3.githubusercontent.com/u/6422482?v=4', 'gravatar_id': '', 'url': 'https://api.github.com/users/facebook-github-bot', 'html_url': 'https://github.com/facebook-github-bot', 'followers_url': 'https://api.github.com/users/facebook-github-bot/followers', 'following_url': 'https://api.github.com/users/facebook-github-bot/following{/other_user}', 'gists_url': 'https://api.github.com/users/facebook-github-bot/gists{/gist_id}', 'starred_url': 'https://api.github.com/users/facebook-github-bot/starred{/owner}{/repo}', 'subscriptions_url': 'https://api.github.com/users/facebook-github-bot/subscriptions', 'organizations_url': 'https://api.github.com/users/facebook-github-bot/orgs', 'repos_url': 'https://api.github.com/users/facebook-github-bot/repos', 'events_url': 'https://api.github.com/users/facebook-github-bot/events{/privacy}', 'received_events_url': 'https://api.github.com/users/facebook-github-bot/received_events', 'type': 'User', 'site_admin': False}",closed,dd903eb64522827f947adaa97419298fd87a922e,https://api.github.com/repos/pytorch/pytorch/commits/dd903eb64522827f947adaa97419298fd87a922e,2019-05-29T19:34:17Z,146,137,9
18425,2263165091,"{'login': 'facebook-github-bot', 'id': 6422482, 'node_id': 'MDQ6VXNlcjY0MjI0ODI=', 'avatar_url': 'https://avatars3.githubusercontent.com/u/6422482?v=4', 'gravatar_id': '', 'url': 'https://api.github.com/users/facebook-github-bot', 'html_url': 'https://github.com/facebook-github-bot', 'followers_url': 'https://api.github.com/users/facebook-github-bot/followers', 'following_url': 'https://api.github.com/users/facebook-github-bot/following{/other_user}', 'gists_url': 'https://api.github.com/users/facebook-github-bot/gists{/gist_id}', 'starred_url': 'https://api.github.com/users/facebook-github-bot/starred{/owner}{/repo}', 'subscriptions_url': 'https://api.github.com/users/facebook-github-bot/subscriptions', 'organizations_url': 'https://api.github.com/users/facebook-github-bot/orgs', 'repos_url': 'https://api.github.com/users/facebook-github-bot/repos', 'events_url': 'https://api.github.com/users/facebook-github-bot/events{/privacy}', 'received_events_url': 'https://api.github.com/users/facebook-github-bot/received_events', 'type': 'User', 'site_admin': False}",referenced,17adce1b6945b647673bf2913b3a08c367bb0097,https://api.github.com/repos/pytorch/pytorch/commits/17adce1b6945b647673bf2913b3a08c367bb0097,2019-04-09T15:05:07Z,6,6,0
18419,2226718747,"{'login': 'facebook-github-bot', 'id': 6422482, 'node_id': 'MDQ6VXNlcjY0MjI0ODI=', 'avatar_url': 'https://avatars3.githubusercontent.com/u/6422482?v=4', 'gravatar_id': '', 'url': 'https://api.github.com/users/facebook-github-bot', 'html_url': 'https://github.com/facebook-github-bot', 'followers_url': 'https://api.github.com/users/facebook-github-bot/followers', 'following_url': 'https://api.github.com/users/facebook-github-bot/following{/other_user}', 'gists_url': 'https://api.github.com/users/facebook-github-bot/gists{/gist_id}', 'starred_url': 'https://api.github.com/users/facebook-github-bot/starred{/owner}{/repo}', 'subscriptions_url': 'https://api.github.com/users/facebook-github-bot/subscriptions', 'organizations_url': 'https://api.github.com/users/facebook-github-bot/orgs', 'repos_url': 'https://api.github.com/users/facebook-github-bot/repos', 'events_url': 'https://api.github.com/users/facebook-github-bot/events{/privacy}', 'received_events_url': 'https://api.github.com/users/facebook-github-bot/received_events', 'type': 'User', 'site_admin': False}",closed,a4f83fff2b7fb0e7ca7b584648c98165b2576ed4,https://api.github.com/repos/pytorch/pytorch/commits/a4f83fff2b7fb0e7ca7b584648c98165b2576ed4,2019-03-25T14:29:24Z,4,3,1
18416,2231758775,"{'login': 'facebook-github-bot', 'id': 6422482, 'node_id': 'MDQ6VXNlcjY0MjI0ODI=', 'avatar_url': 'https://avatars3.githubusercontent.com/u/6422482?v=4', 'gravatar_id': '', 'url': 'https://api.github.com/users/facebook-github-bot', 'html_url': 'https://github.com/facebook-github-bot', 'followers_url': 'https://api.github.com/users/facebook-github-bot/followers', 'following_url': 'https://api.github.com/users/facebook-github-bot/following{/other_user}', 'gists_url': 'https://api.github.com/users/facebook-github-bot/gists{/gist_id}', 'starred_url': 'https://api.github.com/users/facebook-github-bot/starred{/owner}{/repo}', 'subscriptions_url': 'https://api.github.com/users/facebook-github-bot/subscriptions', 'organizations_url': 'https://api.github.com/users/facebook-github-bot/orgs', 'repos_url': 'https://api.github.com/users/facebook-github-bot/repos', 'events_url': 'https://api.github.com/users/facebook-github-bot/events{/privacy}', 'received_events_url': 'https://api.github.com/users/facebook-github-bot/received_events', 'type': 'User', 'site_admin': False}",closed,d5861aa55ce1c39350084f2761bbc3211243cd1a,https://api.github.com/repos/pytorch/pytorch/commits/d5861aa55ce1c39350084f2761bbc3211243cd1a,2019-03-27T02:54:51Z,5,5,0
18408,2376413697,"{'login': 'facebook-github-bot', 'id': 6422482, 'node_id': 'MDQ6VXNlcjY0MjI0ODI=', 'avatar_url': 'https://avatars3.githubusercontent.com/u/6422482?v=4', 'gravatar_id': '', 'url': 'https://api.github.com/users/facebook-github-bot', 'html_url': 'https://github.com/facebook-github-bot', 'followers_url': 'https://api.github.com/users/facebook-github-bot/followers', 'following_url': 'https://api.github.com/users/facebook-github-bot/following{/other_user}', 'gists_url': 'https://api.github.com/users/facebook-github-bot/gists{/gist_id}', 'starred_url': 'https://api.github.com/users/facebook-github-bot/starred{/owner}{/repo}', 'subscriptions_url': 'https://api.github.com/users/facebook-github-bot/subscriptions', 'organizations_url': 'https://api.github.com/users/facebook-github-bot/orgs', 'repos_url': 'https://api.github.com/users/facebook-github-bot/repos', 'events_url': 'https://api.github.com/users/facebook-github-bot/events{/privacy}', 'received_events_url': 'https://api.github.com/users/facebook-github-bot/received_events', 'type': 'User', 'site_admin': False}",closed,0ffd20c268340c0d7fe0b388a6960ff2b271808a,https://api.github.com/repos/pytorch/pytorch/commits/0ffd20c268340c0d7fe0b388a6960ff2b271808a,2019-05-29T20:52:57Z,75,74,1
18405,2228467599,"{'login': 'facebook-github-bot', 'id': 6422482, 'node_id': 'MDQ6VXNlcjY0MjI0ODI=', 'avatar_url': 'https://avatars3.githubusercontent.com/u/6422482?v=4', 'gravatar_id': '', 'url': 'https://api.github.com/users/facebook-github-bot', 'html_url': 'https://github.com/facebook-github-bot', 'followers_url': 'https://api.github.com/users/facebook-github-bot/followers', 'following_url': 'https://api.github.com/users/facebook-github-bot/following{/other_user}', 'gists_url': 'https://api.github.com/users/facebook-github-bot/gists{/gist_id}', 'starred_url': 'https://api.github.com/users/facebook-github-bot/starred{/owner}{/repo}', 'subscriptions_url': 'https://api.github.com/users/facebook-github-bot/subscriptions', 'organizations_url': 'https://api.github.com/users/facebook-github-bot/orgs', 'repos_url': 'https://api.github.com/users/facebook-github-bot/repos', 'events_url': 'https://api.github.com/users/facebook-github-bot/events{/privacy}', 'received_events_url': 'https://api.github.com/users/facebook-github-bot/received_events', 'type': 'User', 'site_admin': False}",referenced,e2730ddb21164f1cb36330289ab2cd0629c06dc8,https://api.github.com/repos/pytorch/pytorch/commits/e2730ddb21164f1cb36330289ab2cd0629c06dc8,2019-03-26T03:40:03Z,282,214,68
18389,2225054172,"{'login': 'facebook-github-bot', 'id': 6422482, 'node_id': 'MDQ6VXNlcjY0MjI0ODI=', 'avatar_url': 'https://avatars3.githubusercontent.com/u/6422482?v=4', 'gravatar_id': '', 'url': 'https://api.github.com/users/facebook-github-bot', 'html_url': 'https://github.com/facebook-github-bot', 'followers_url': 'https://api.github.com/users/facebook-github-bot/followers', 'following_url': 'https://api.github.com/users/facebook-github-bot/following{/other_user}', 'gists_url': 'https://api.github.com/users/facebook-github-bot/gists{/gist_id}', 'starred_url': 'https://api.github.com/users/facebook-github-bot/starred{/owner}{/repo}', 'subscriptions_url': 'https://api.github.com/users/facebook-github-bot/subscriptions', 'organizations_url': 'https://api.github.com/users/facebook-github-bot/orgs', 'repos_url': 'https://api.github.com/users/facebook-github-bot/repos', 'events_url': 'https://api.github.com/users/facebook-github-bot/events{/privacy}', 'received_events_url': 'https://api.github.com/users/facebook-github-bot/received_events', 'type': 'User', 'site_admin': False}",closed,92c9fef860fca1084f4219dfa1debdc920156418,https://api.github.com/repos/pytorch/pytorch/commits/92c9fef860fca1084f4219dfa1debdc920156418,2019-03-24T20:17:08Z,2,1,1
18388,2240654052,"{'login': 'facebook-github-bot', 'id': 6422482, 'node_id': 'MDQ6VXNlcjY0MjI0ODI=', 'avatar_url': 'https://avatars3.githubusercontent.com/u/6422482?v=4', 'gravatar_id': '', 'url': 'https://api.github.com/users/facebook-github-bot', 'html_url': 'https://github.com/facebook-github-bot', 'followers_url': 'https://api.github.com/users/facebook-github-bot/followers', 'following_url': 'https://api.github.com/users/facebook-github-bot/following{/other_user}', 'gists_url': 'https://api.github.com/users/facebook-github-bot/gists{/gist_id}', 'starred_url': 'https://api.github.com/users/facebook-github-bot/starred{/owner}{/repo}', 'subscriptions_url': 'https://api.github.com/users/facebook-github-bot/subscriptions', 'organizations_url': 'https://api.github.com/users/facebook-github-bot/orgs', 'repos_url': 'https://api.github.com/users/facebook-github-bot/repos', 'events_url': 'https://api.github.com/users/facebook-github-bot/events{/privacy}', 'received_events_url': 'https://api.github.com/users/facebook-github-bot/received_events', 'type': 'User', 'site_admin': False}",closed,81b73951f1aa081338807bdc10983dc4663938ea,https://api.github.com/repos/pytorch/pytorch/commits/81b73951f1aa081338807bdc10983dc4663938ea,2019-03-29T23:17:19Z,11,11,0
18382,2257800180,"{'login': 'facebook-github-bot', 'id': 6422482, 'node_id': 'MDQ6VXNlcjY0MjI0ODI=', 'avatar_url': 'https://avatars3.githubusercontent.com/u/6422482?v=4', 'gravatar_id': '', 'url': 'https://api.github.com/users/facebook-github-bot', 'html_url': 'https://github.com/facebook-github-bot', 'followers_url': 'https://api.github.com/users/facebook-github-bot/followers', 'following_url': 'https://api.github.com/users/facebook-github-bot/following{/other_user}', 'gists_url': 'https://api.github.com/users/facebook-github-bot/gists{/gist_id}', 'starred_url': 'https://api.github.com/users/facebook-github-bot/starred{/owner}{/repo}', 'subscriptions_url': 'https://api.github.com/users/facebook-github-bot/subscriptions', 'organizations_url': 'https://api.github.com/users/facebook-github-bot/orgs', 'repos_url': 'https://api.github.com/users/facebook-github-bot/repos', 'events_url': 'https://api.github.com/users/facebook-github-bot/events{/privacy}', 'received_events_url': 'https://api.github.com/users/facebook-github-bot/received_events', 'type': 'User', 'site_admin': False}",closed,79533ef097bf3ff2f1d85782ae1f279fe15e8686,https://api.github.com/repos/pytorch/pytorch/commits/79533ef097bf3ff2f1d85782ae1f279fe15e8686,2019-04-07T07:14:55Z,94,46,48
18381,2251442038,"{'login': 'facebook-github-bot', 'id': 6422482, 'node_id': 'MDQ6VXNlcjY0MjI0ODI=', 'avatar_url': 'https://avatars3.githubusercontent.com/u/6422482?v=4', 'gravatar_id': '', 'url': 'https://api.github.com/users/facebook-github-bot', 'html_url': 'https://github.com/facebook-github-bot', 'followers_url': 'https://api.github.com/users/facebook-github-bot/followers', 'following_url': 'https://api.github.com/users/facebook-github-bot/following{/other_user}', 'gists_url': 'https://api.github.com/users/facebook-github-bot/gists{/gist_id}', 'starred_url': 'https://api.github.com/users/facebook-github-bot/starred{/owner}{/repo}', 'subscriptions_url': 'https://api.github.com/users/facebook-github-bot/subscriptions', 'organizations_url': 'https://api.github.com/users/facebook-github-bot/orgs', 'repos_url': 'https://api.github.com/users/facebook-github-bot/repos', 'events_url': 'https://api.github.com/users/facebook-github-bot/events{/privacy}', 'received_events_url': 'https://api.github.com/users/facebook-github-bot/received_events', 'type': 'User', 'site_admin': False}",referenced,b80a4fa201d4a7755bfb82b7fbd502297cef41db,https://api.github.com/repos/pytorch/pytorch/commits/b80a4fa201d4a7755bfb82b7fbd502297cef41db,2019-04-04T00:14:38Z,210,127,83
18363,2231377840,"{'login': 'facebook-github-bot', 'id': 6422482, 'node_id': 'MDQ6VXNlcjY0MjI0ODI=', 'avatar_url': 'https://avatars3.githubusercontent.com/u/6422482?v=4', 'gravatar_id': '', 'url': 'https://api.github.com/users/facebook-github-bot', 'html_url': 'https://github.com/facebook-github-bot', 'followers_url': 'https://api.github.com/users/facebook-github-bot/followers', 'following_url': 'https://api.github.com/users/facebook-github-bot/following{/other_user}', 'gists_url': 'https://api.github.com/users/facebook-github-bot/gists{/gist_id}', 'starred_url': 'https://api.github.com/users/facebook-github-bot/starred{/owner}{/repo}', 'subscriptions_url': 'https://api.github.com/users/facebook-github-bot/subscriptions', 'organizations_url': 'https://api.github.com/users/facebook-github-bot/orgs', 'repos_url': 'https://api.github.com/users/facebook-github-bot/repos', 'events_url': 'https://api.github.com/users/facebook-github-bot/events{/privacy}', 'received_events_url': 'https://api.github.com/users/facebook-github-bot/received_events', 'type': 'User', 'site_admin': False}",closed,436723122e646b1100a07f04a59043a58a8bd1f0,https://api.github.com/repos/pytorch/pytorch/commits/436723122e646b1100a07f04a59043a58a8bd1f0,2019-03-26T22:29:19Z,38,36,2
18359,2244952684,"{'login': 'facebook-github-bot', 'id': 6422482, 'node_id': 'MDQ6VXNlcjY0MjI0ODI=', 'avatar_url': 'https://avatars3.githubusercontent.com/u/6422482?v=4', 'gravatar_id': '', 'url': 'https://api.github.com/users/facebook-github-bot', 'html_url': 'https://github.com/facebook-github-bot', 'followers_url': 'https://api.github.com/users/facebook-github-bot/followers', 'following_url': 'https://api.github.com/users/facebook-github-bot/following{/other_user}', 'gists_url': 'https://api.github.com/users/facebook-github-bot/gists{/gist_id}', 'starred_url': 'https://api.github.com/users/facebook-github-bot/starred{/owner}{/repo}', 'subscriptions_url': 'https://api.github.com/users/facebook-github-bot/subscriptions', 'organizations_url': 'https://api.github.com/users/facebook-github-bot/orgs', 'repos_url': 'https://api.github.com/users/facebook-github-bot/repos', 'events_url': 'https://api.github.com/users/facebook-github-bot/events{/privacy}', 'received_events_url': 'https://api.github.com/users/facebook-github-bot/received_events', 'type': 'User', 'site_admin': False}",closed,fc6296d7775a44b65ff83ae64d9804b69e08f5d3,https://api.github.com/repos/pytorch/pytorch/commits/fc6296d7775a44b65ff83ae64d9804b69e08f5d3,2019-04-02T00:12:57Z,2,1,1
18359,2250951143,"{'login': 'facebook-github-bot', 'id': 6422482, 'node_id': 'MDQ6VXNlcjY0MjI0ODI=', 'avatar_url': 'https://avatars3.githubusercontent.com/u/6422482?v=4', 'gravatar_id': '', 'url': 'https://api.github.com/users/facebook-github-bot', 'html_url': 'https://github.com/facebook-github-bot', 'followers_url': 'https://api.github.com/users/facebook-github-bot/followers', 'following_url': 'https://api.github.com/users/facebook-github-bot/following{/other_user}', 'gists_url': 'https://api.github.com/users/facebook-github-bot/gists{/gist_id}', 'starred_url': 'https://api.github.com/users/facebook-github-bot/starred{/owner}{/repo}', 'subscriptions_url': 'https://api.github.com/users/facebook-github-bot/subscriptions', 'organizations_url': 'https://api.github.com/users/facebook-github-bot/orgs', 'repos_url': 'https://api.github.com/users/facebook-github-bot/repos', 'events_url': 'https://api.github.com/users/facebook-github-bot/events{/privacy}', 'received_events_url': 'https://api.github.com/users/facebook-github-bot/received_events', 'type': 'User', 'site_admin': False}",referenced,8711df89ccd8ef24b14a139a2aa4c61fbd126d46,https://api.github.com/repos/pytorch/pytorch/commits/8711df89ccd8ef24b14a139a2aa4c61fbd126d46,2019-04-03T19:55:17Z,10,4,6
18353,2418296116,"{'login': 'facebook-github-bot', 'id': 6422482, 'node_id': 'MDQ6VXNlcjY0MjI0ODI=', 'avatar_url': 'https://avatars3.githubusercontent.com/u/6422482?v=4', 'gravatar_id': '', 'url': 'https://api.github.com/users/facebook-github-bot', 'html_url': 'https://github.com/facebook-github-bot', 'followers_url': 'https://api.github.com/users/facebook-github-bot/followers', 'following_url': 'https://api.github.com/users/facebook-github-bot/following{/other_user}', 'gists_url': 'https://api.github.com/users/facebook-github-bot/gists{/gist_id}', 'starred_url': 'https://api.github.com/users/facebook-github-bot/starred{/owner}{/repo}', 'subscriptions_url': 'https://api.github.com/users/facebook-github-bot/subscriptions', 'organizations_url': 'https://api.github.com/users/facebook-github-bot/orgs', 'repos_url': 'https://api.github.com/users/facebook-github-bot/repos', 'events_url': 'https://api.github.com/users/facebook-github-bot/events{/privacy}', 'received_events_url': 'https://api.github.com/users/facebook-github-bot/received_events', 'type': 'User', 'site_admin': False}",referenced,0f675f9cbc71f59eaff9930a6ee3c62176b18017,https://api.github.com/repos/pytorch/pytorch/commits/0f675f9cbc71f59eaff9930a6ee3c62176b18017,2019-06-17T17:09:08Z,3005,1876,1129
18353,2427548834,"{'login': 'facebook-github-bot', 'id': 6422482, 'node_id': 'MDQ6VXNlcjY0MjI0ODI=', 'avatar_url': 'https://avatars3.githubusercontent.com/u/6422482?v=4', 'gravatar_id': '', 'url': 'https://api.github.com/users/facebook-github-bot', 'html_url': 'https://github.com/facebook-github-bot', 'followers_url': 'https://api.github.com/users/facebook-github-bot/followers', 'following_url': 'https://api.github.com/users/facebook-github-bot/following{/other_user}', 'gists_url': 'https://api.github.com/users/facebook-github-bot/gists{/gist_id}', 'starred_url': 'https://api.github.com/users/facebook-github-bot/starred{/owner}{/repo}', 'subscriptions_url': 'https://api.github.com/users/facebook-github-bot/subscriptions', 'organizations_url': 'https://api.github.com/users/facebook-github-bot/orgs', 'repos_url': 'https://api.github.com/users/facebook-github-bot/repos', 'events_url': 'https://api.github.com/users/facebook-github-bot/events{/privacy}', 'received_events_url': 'https://api.github.com/users/facebook-github-bot/received_events', 'type': 'User', 'site_admin': False}",referenced,f8f583cbae492a1cbe6ae2e5cabdfaf2431a4175,https://api.github.com/repos/pytorch/pytorch/commits/f8f583cbae492a1cbe6ae2e5cabdfaf2431a4175,2019-06-20T14:14:26Z,3740,2380,1360
18353,2438346231,"{'login': 'facebook-github-bot', 'id': 6422482, 'node_id': 'MDQ6VXNlcjY0MjI0ODI=', 'avatar_url': 'https://avatars3.githubusercontent.com/u/6422482?v=4', 'gravatar_id': '', 'url': 'https://api.github.com/users/facebook-github-bot', 'html_url': 'https://github.com/facebook-github-bot', 'followers_url': 'https://api.github.com/users/facebook-github-bot/followers', 'following_url': 'https://api.github.com/users/facebook-github-bot/following{/other_user}', 'gists_url': 'https://api.github.com/users/facebook-github-bot/gists{/gist_id}', 'starred_url': 'https://api.github.com/users/facebook-github-bot/starred{/owner}{/repo}', 'subscriptions_url': 'https://api.github.com/users/facebook-github-bot/subscriptions', 'organizations_url': 'https://api.github.com/users/facebook-github-bot/orgs', 'repos_url': 'https://api.github.com/users/facebook-github-bot/repos', 'events_url': 'https://api.github.com/users/facebook-github-bot/events{/privacy}', 'received_events_url': 'https://api.github.com/users/facebook-github-bot/received_events', 'type': 'User', 'site_admin': False}",closed,7daa96a3ce14bfee5b5c830d4954fc29438a85f1,https://api.github.com/repos/pytorch/pytorch/commits/7daa96a3ce14bfee5b5c830d4954fc29438a85f1,2019-06-25T17:25:04Z,3423,2126,1297
18293,2228421387,"{'login': 'facebook-github-bot', 'id': 6422482, 'node_id': 'MDQ6VXNlcjY0MjI0ODI=', 'avatar_url': 'https://avatars3.githubusercontent.com/u/6422482?v=4', 'gravatar_id': '', 'url': 'https://api.github.com/users/facebook-github-bot', 'html_url': 'https://github.com/facebook-github-bot', 'followers_url': 'https://api.github.com/users/facebook-github-bot/followers', 'following_url': 'https://api.github.com/users/facebook-github-bot/following{/other_user}', 'gists_url': 'https://api.github.com/users/facebook-github-bot/gists{/gist_id}', 'starred_url': 'https://api.github.com/users/facebook-github-bot/starred{/owner}{/repo}', 'subscriptions_url': 'https://api.github.com/users/facebook-github-bot/subscriptions', 'organizations_url': 'https://api.github.com/users/facebook-github-bot/orgs', 'repos_url': 'https://api.github.com/users/facebook-github-bot/repos', 'events_url': 'https://api.github.com/users/facebook-github-bot/events{/privacy}', 'received_events_url': 'https://api.github.com/users/facebook-github-bot/received_events', 'type': 'User', 'site_admin': False}",closed,a40e0a7f2d235586237122e92561eef13169bb8f,https://api.github.com/repos/pytorch/pytorch/commits/a40e0a7f2d235586237122e92561eef13169bb8f,2019-03-26T03:01:27Z,16,10,6
18275,2402375199,"{'login': 'facebook-github-bot', 'id': 6422482, 'node_id': 'MDQ6VXNlcjY0MjI0ODI=', 'avatar_url': 'https://avatars3.githubusercontent.com/u/6422482?v=4', 'gravatar_id': '', 'url': 'https://api.github.com/users/facebook-github-bot', 'html_url': 'https://github.com/facebook-github-bot', 'followers_url': 'https://api.github.com/users/facebook-github-bot/followers', 'following_url': 'https://api.github.com/users/facebook-github-bot/following{/other_user}', 'gists_url': 'https://api.github.com/users/facebook-github-bot/gists{/gist_id}', 'starred_url': 'https://api.github.com/users/facebook-github-bot/starred{/owner}{/repo}', 'subscriptions_url': 'https://api.github.com/users/facebook-github-bot/subscriptions', 'organizations_url': 'https://api.github.com/users/facebook-github-bot/orgs', 'repos_url': 'https://api.github.com/users/facebook-github-bot/repos', 'events_url': 'https://api.github.com/users/facebook-github-bot/events{/privacy}', 'received_events_url': 'https://api.github.com/users/facebook-github-bot/received_events', 'type': 'User', 'site_admin': False}",referenced,8b9b215dc50915ade01611448e672ae4235f50bb,https://api.github.com/repos/pytorch/pytorch/commits/8b9b215dc50915ade01611448e672ae4235f50bb,2019-06-10T22:21:23Z,222,212,10
18275,2666388854,"{'login': 'facebook-github-bot', 'id': 6422482, 'node_id': 'MDQ6VXNlcjY0MjI0ODI=', 'avatar_url': 'https://avatars3.githubusercontent.com/u/6422482?v=4', 'gravatar_id': '', 'url': 'https://api.github.com/users/facebook-github-bot', 'html_url': 'https://github.com/facebook-github-bot', 'followers_url': 'https://api.github.com/users/facebook-github-bot/followers', 'following_url': 'https://api.github.com/users/facebook-github-bot/following{/other_user}', 'gists_url': 'https://api.github.com/users/facebook-github-bot/gists{/gist_id}', 'starred_url': 'https://api.github.com/users/facebook-github-bot/starred{/owner}{/repo}', 'subscriptions_url': 'https://api.github.com/users/facebook-github-bot/subscriptions', 'organizations_url': 'https://api.github.com/users/facebook-github-bot/orgs', 'repos_url': 'https://api.github.com/users/facebook-github-bot/repos', 'events_url': 'https://api.github.com/users/facebook-github-bot/events{/privacy}', 'received_events_url': 'https://api.github.com/users/facebook-github-bot/received_events', 'type': 'User', 'site_admin': False}",referenced,43b07ff2c40f3520c24d88cf83a5a982ee5f60fd,https://api.github.com/repos/pytorch/pytorch/commits/43b07ff2c40f3520c24d88cf83a5a982ee5f60fd,2019-09-26T19:08:37Z,19,16,3
18270,2322411067,"{'login': 'facebook-github-bot', 'id': 6422482, 'node_id': 'MDQ6VXNlcjY0MjI0ODI=', 'avatar_url': 'https://avatars3.githubusercontent.com/u/6422482?v=4', 'gravatar_id': '', 'url': 'https://api.github.com/users/facebook-github-bot', 'html_url': 'https://github.com/facebook-github-bot', 'followers_url': 'https://api.github.com/users/facebook-github-bot/followers', 'following_url': 'https://api.github.com/users/facebook-github-bot/following{/other_user}', 'gists_url': 'https://api.github.com/users/facebook-github-bot/gists{/gist_id}', 'starred_url': 'https://api.github.com/users/facebook-github-bot/starred{/owner}{/repo}', 'subscriptions_url': 'https://api.github.com/users/facebook-github-bot/subscriptions', 'organizations_url': 'https://api.github.com/users/facebook-github-bot/orgs', 'repos_url': 'https://api.github.com/users/facebook-github-bot/repos', 'events_url': 'https://api.github.com/users/facebook-github-bot/events{/privacy}', 'received_events_url': 'https://api.github.com/users/facebook-github-bot/received_events', 'type': 'User', 'site_admin': False}",referenced,5c9ab6f411c31e6c8f92ccca2608459f2ce963d8,https://api.github.com/repos/pytorch/pytorch/commits/5c9ab6f411c31e6c8f92ccca2608459f2ce963d8,2019-05-06T22:36:59Z,385,326,59
18263,2228473843,"{'login': 'facebook-github-bot', 'id': 6422482, 'node_id': 'MDQ6VXNlcjY0MjI0ODI=', 'avatar_url': 'https://avatars3.githubusercontent.com/u/6422482?v=4', 'gravatar_id': '', 'url': 'https://api.github.com/users/facebook-github-bot', 'html_url': 'https://github.com/facebook-github-bot', 'followers_url': 'https://api.github.com/users/facebook-github-bot/followers', 'following_url': 'https://api.github.com/users/facebook-github-bot/following{/other_user}', 'gists_url': 'https://api.github.com/users/facebook-github-bot/gists{/gist_id}', 'starred_url': 'https://api.github.com/users/facebook-github-bot/starred{/owner}{/repo}', 'subscriptions_url': 'https://api.github.com/users/facebook-github-bot/subscriptions', 'organizations_url': 'https://api.github.com/users/facebook-github-bot/orgs', 'repos_url': 'https://api.github.com/users/facebook-github-bot/repos', 'events_url': 'https://api.github.com/users/facebook-github-bot/events{/privacy}', 'received_events_url': 'https://api.github.com/users/facebook-github-bot/received_events', 'type': 'User', 'site_admin': False}",closed,bf2a30cb22afe88b696b41edad6c2c147f9425f2,https://api.github.com/repos/pytorch/pytorch/commits/bf2a30cb22afe88b696b41edad6c2c147f9425f2,2019-03-26T03:45:18Z,34,30,4
18254,2395634077,"{'login': 'facebook-github-bot', 'id': 6422482, 'node_id': 'MDQ6VXNlcjY0MjI0ODI=', 'avatar_url': 'https://avatars3.githubusercontent.com/u/6422482?v=4', 'gravatar_id': '', 'url': 'https://api.github.com/users/facebook-github-bot', 'html_url': 'https://github.com/facebook-github-bot', 'followers_url': 'https://api.github.com/users/facebook-github-bot/followers', 'following_url': 'https://api.github.com/users/facebook-github-bot/following{/other_user}', 'gists_url': 'https://api.github.com/users/facebook-github-bot/gists{/gist_id}', 'starred_url': 'https://api.github.com/users/facebook-github-bot/starred{/owner}{/repo}', 'subscriptions_url': 'https://api.github.com/users/facebook-github-bot/subscriptions', 'organizations_url': 'https://api.github.com/users/facebook-github-bot/orgs', 'repos_url': 'https://api.github.com/users/facebook-github-bot/repos', 'events_url': 'https://api.github.com/users/facebook-github-bot/events{/privacy}', 'received_events_url': 'https://api.github.com/users/facebook-github-bot/received_events', 'type': 'User', 'site_admin': False}",closed,c5d5d45f40969cbddbb7f87da343dfd422503c1c,https://api.github.com/repos/pytorch/pytorch/commits/c5d5d45f40969cbddbb7f87da343dfd422503c1c,2019-06-06T21:01:59Z,3,2,1
18249,2240911319,"{'login': 'facebook-github-bot', 'id': 6422482, 'node_id': 'MDQ6VXNlcjY0MjI0ODI=', 'avatar_url': 'https://avatars3.githubusercontent.com/u/6422482?v=4', 'gravatar_id': '', 'url': 'https://api.github.com/users/facebook-github-bot', 'html_url': 'https://github.com/facebook-github-bot', 'followers_url': 'https://api.github.com/users/facebook-github-bot/followers', 'following_url': 'https://api.github.com/users/facebook-github-bot/following{/other_user}', 'gists_url': 'https://api.github.com/users/facebook-github-bot/gists{/gist_id}', 'starred_url': 'https://api.github.com/users/facebook-github-bot/starred{/owner}{/repo}', 'subscriptions_url': 'https://api.github.com/users/facebook-github-bot/subscriptions', 'organizations_url': 'https://api.github.com/users/facebook-github-bot/orgs', 'repos_url': 'https://api.github.com/users/facebook-github-bot/repos', 'events_url': 'https://api.github.com/users/facebook-github-bot/events{/privacy}', 'received_events_url': 'https://api.github.com/users/facebook-github-bot/received_events', 'type': 'User', 'site_admin': False}",closed,96456bfa4cf9394c9c926b143cf724a09901908d,https://api.github.com/repos/pytorch/pytorch/commits/96456bfa4cf9394c9c926b143cf724a09901908d,2019-03-30T08:29:12Z,72,54,18
18232,2218319394,"{'login': 'facebook-github-bot', 'id': 6422482, 'node_id': 'MDQ6VXNlcjY0MjI0ODI=', 'avatar_url': 'https://avatars3.githubusercontent.com/u/6422482?v=4', 'gravatar_id': '', 'url': 'https://api.github.com/users/facebook-github-bot', 'html_url': 'https://github.com/facebook-github-bot', 'followers_url': 'https://api.github.com/users/facebook-github-bot/followers', 'following_url': 'https://api.github.com/users/facebook-github-bot/following{/other_user}', 'gists_url': 'https://api.github.com/users/facebook-github-bot/gists{/gist_id}', 'starred_url': 'https://api.github.com/users/facebook-github-bot/starred{/owner}{/repo}', 'subscriptions_url': 'https://api.github.com/users/facebook-github-bot/subscriptions', 'organizations_url': 'https://api.github.com/users/facebook-github-bot/orgs', 'repos_url': 'https://api.github.com/users/facebook-github-bot/repos', 'events_url': 'https://api.github.com/users/facebook-github-bot/events{/privacy}', 'received_events_url': 'https://api.github.com/users/facebook-github-bot/received_events', 'type': 'User', 'site_admin': False}",closed,fd35814348c9738cee76847f56575a7155bdf5e8,https://api.github.com/repos/pytorch/pytorch/commits/fd35814348c9738cee76847f56575a7155bdf5e8,2019-03-20T21:59:11Z,58,58,0
18215,2435745487,"{'login': 'facebook-github-bot', 'id': 6422482, 'node_id': 'MDQ6VXNlcjY0MjI0ODI=', 'avatar_url': 'https://avatars3.githubusercontent.com/u/6422482?v=4', 'gravatar_id': '', 'url': 'https://api.github.com/users/facebook-github-bot', 'html_url': 'https://github.com/facebook-github-bot', 'followers_url': 'https://api.github.com/users/facebook-github-bot/followers', 'following_url': 'https://api.github.com/users/facebook-github-bot/following{/other_user}', 'gists_url': 'https://api.github.com/users/facebook-github-bot/gists{/gist_id}', 'starred_url': 'https://api.github.com/users/facebook-github-bot/starred{/owner}{/repo}', 'subscriptions_url': 'https://api.github.com/users/facebook-github-bot/subscriptions', 'organizations_url': 'https://api.github.com/users/facebook-github-bot/orgs', 'repos_url': 'https://api.github.com/users/facebook-github-bot/repos', 'events_url': 'https://api.github.com/users/facebook-github-bot/events{/privacy}', 'received_events_url': 'https://api.github.com/users/facebook-github-bot/received_events', 'type': 'User', 'site_admin': False}",referenced,0ac28c89661e53de90a99195e2c5e81c8145a714,https://api.github.com/repos/pytorch/pytorch/commits/0ac28c89661e53de90a99195e2c5e81c8145a714,2019-06-24T22:29:46Z,32,26,6
18215,2524250393,"{'login': 'facebook-github-bot', 'id': 6422482, 'node_id': 'MDQ6VXNlcjY0MjI0ODI=', 'avatar_url': 'https://avatars3.githubusercontent.com/u/6422482?v=4', 'gravatar_id': '', 'url': 'https://api.github.com/users/facebook-github-bot', 'html_url': 'https://github.com/facebook-github-bot', 'followers_url': 'https://api.github.com/users/facebook-github-bot/followers', 'following_url': 'https://api.github.com/users/facebook-github-bot/following{/other_user}', 'gists_url': 'https://api.github.com/users/facebook-github-bot/gists{/gist_id}', 'starred_url': 'https://api.github.com/users/facebook-github-bot/starred{/owner}{/repo}', 'subscriptions_url': 'https://api.github.com/users/facebook-github-bot/subscriptions', 'organizations_url': 'https://api.github.com/users/facebook-github-bot/orgs', 'repos_url': 'https://api.github.com/users/facebook-github-bot/repos', 'events_url': 'https://api.github.com/users/facebook-github-bot/events{/privacy}', 'received_events_url': 'https://api.github.com/users/facebook-github-bot/received_events', 'type': 'User', 'site_admin': False}",closed,2e40857dad7e83370fbf4ce414848fa54606319c,https://api.github.com/repos/pytorch/pytorch/commits/2e40857dad7e83370fbf4ce414848fa54606319c,2019-07-31T19:06:35Z,183,133,50
18215,2528455265,"{'login': 'soumith', 'id': 1310570, 'node_id': 'MDQ6VXNlcjEzMTA1NzA=', 'avatar_url': 'https://avatars0.githubusercontent.com/u/1310570?v=4', 'gravatar_id': '', 'url': 'https://api.github.com/users/soumith', 'html_url': 'https://github.com/soumith', 'followers_url': 'https://api.github.com/users/soumith/followers', 'following_url': 'https://api.github.com/users/soumith/following{/other_user}', 'gists_url': 'https://api.github.com/users/soumith/gists{/gist_id}', 'starred_url': 'https://api.github.com/users/soumith/starred{/owner}{/repo}', 'subscriptions_url': 'https://api.github.com/users/soumith/subscriptions', 'organizations_url': 'https://api.github.com/users/soumith/orgs', 'repos_url': 'https://api.github.com/users/soumith/repos', 'events_url': 'https://api.github.com/users/soumith/events{/privacy}', 'received_events_url': 'https://api.github.com/users/soumith/received_events', 'type': 'User', 'site_admin': False}",referenced,6f5fb78e9ed7ee7b6a1dd7cacd0ba429206daedc,https://api.github.com/repos/pytorch/pytorch/commits/6f5fb78e9ed7ee7b6a1dd7cacd0ba429206daedc,2019-08-02T04:14:15Z,183,133,50
18214,2217414675,"{'login': 'facebook-github-bot', 'id': 6422482, 'node_id': 'MDQ6VXNlcjY0MjI0ODI=', 'avatar_url': 'https://avatars3.githubusercontent.com/u/6422482?v=4', 'gravatar_id': '', 'url': 'https://api.github.com/users/facebook-github-bot', 'html_url': 'https://github.com/facebook-github-bot', 'followers_url': 'https://api.github.com/users/facebook-github-bot/followers', 'following_url': 'https://api.github.com/users/facebook-github-bot/following{/other_user}', 'gists_url': 'https://api.github.com/users/facebook-github-bot/gists{/gist_id}', 'starred_url': 'https://api.github.com/users/facebook-github-bot/starred{/owner}{/repo}', 'subscriptions_url': 'https://api.github.com/users/facebook-github-bot/subscriptions', 'organizations_url': 'https://api.github.com/users/facebook-github-bot/orgs', 'repos_url': 'https://api.github.com/users/facebook-github-bot/repos', 'events_url': 'https://api.github.com/users/facebook-github-bot/events{/privacy}', 'received_events_url': 'https://api.github.com/users/facebook-github-bot/received_events', 'type': 'User', 'site_admin': False}",closed,19c13eee39ae0befa8e3698ef3ec4ff5d04cdd18,https://api.github.com/repos/pytorch/pytorch/commits/19c13eee39ae0befa8e3698ef3ec4ff5d04cdd18,2019-03-20T16:23:14Z,13,10,3
18142,2287545188,"{'login': 'facebook-github-bot', 'id': 6422482, 'node_id': 'MDQ6VXNlcjY0MjI0ODI=', 'avatar_url': 'https://avatars3.githubusercontent.com/u/6422482?v=4', 'gravatar_id': '', 'url': 'https://api.github.com/users/facebook-github-bot', 'html_url': 'https://github.com/facebook-github-bot', 'followers_url': 'https://api.github.com/users/facebook-github-bot/followers', 'following_url': 'https://api.github.com/users/facebook-github-bot/following{/other_user}', 'gists_url': 'https://api.github.com/users/facebook-github-bot/gists{/gist_id}', 'starred_url': 'https://api.github.com/users/facebook-github-bot/starred{/owner}{/repo}', 'subscriptions_url': 'https://api.github.com/users/facebook-github-bot/subscriptions', 'organizations_url': 'https://api.github.com/users/facebook-github-bot/orgs', 'repos_url': 'https://api.github.com/users/facebook-github-bot/repos', 'events_url': 'https://api.github.com/users/facebook-github-bot/events{/privacy}', 'received_events_url': 'https://api.github.com/users/facebook-github-bot/received_events', 'type': 'User', 'site_admin': False}",closed,9034b66f14096d39eb1a2bb8e273f4b78f93e58d,https://api.github.com/repos/pytorch/pytorch/commits/9034b66f14096d39eb1a2bb8e273f4b78f93e58d,2019-04-19T06:42:33Z,5,5,0
18108,2223849726,"{'login': 'ezyang', 'id': 13564, 'node_id': 'MDQ6VXNlcjEzNTY0', 'avatar_url': 'https://avatars0.githubusercontent.com/u/13564?v=4', 'gravatar_id': '', 'url': 'https://api.github.com/users/ezyang', 'html_url': 'https://github.com/ezyang', 'followers_url': 'https://api.github.com/users/ezyang/followers', 'following_url': 'https://api.github.com/users/ezyang/following{/other_user}', 'gists_url': 'https://api.github.com/users/ezyang/gists{/gist_id}', 'starred_url': 'https://api.github.com/users/ezyang/starred{/owner}{/repo}', 'subscriptions_url': 'https://api.github.com/users/ezyang/subscriptions', 'organizations_url': 'https://api.github.com/users/ezyang/orgs', 'repos_url': 'https://api.github.com/users/ezyang/repos', 'events_url': 'https://api.github.com/users/ezyang/events{/privacy}', 'received_events_url': 'https://api.github.com/users/ezyang/received_events', 'type': 'User', 'site_admin': False}",referenced,fe6eab143c5c23fb46e6b0377db43acd9c596275,https://api.github.com/repos/pytorch/pytorch/commits/fe6eab143c5c23fb46e6b0377db43acd9c596275,2019-03-22T21:20:19Z,35,34,1
18108,2225368635,"{'login': 'ezyang', 'id': 13564, 'node_id': 'MDQ6VXNlcjEzNTY0', 'avatar_url': 'https://avatars0.githubusercontent.com/u/13564?v=4', 'gravatar_id': '', 'url': 'https://api.github.com/users/ezyang', 'html_url': 'https://github.com/ezyang', 'followers_url': 'https://api.github.com/users/ezyang/followers', 'following_url': 'https://api.github.com/users/ezyang/following{/other_user}', 'gists_url': 'https://api.github.com/users/ezyang/gists{/gist_id}', 'starred_url': 'https://api.github.com/users/ezyang/starred{/owner}{/repo}', 'subscriptions_url': 'https://api.github.com/users/ezyang/subscriptions', 'organizations_url': 'https://api.github.com/users/ezyang/orgs', 'repos_url': 'https://api.github.com/users/ezyang/repos', 'events_url': 'https://api.github.com/users/ezyang/events{/privacy}', 'received_events_url': 'https://api.github.com/users/ezyang/received_events', 'type': 'User', 'site_admin': False}",referenced,5614f495fd7e2a712a6163e3933fc8520734dd06,https://api.github.com/repos/pytorch/pytorch/commits/5614f495fd7e2a712a6163e3933fc8520734dd06,2019-03-25T03:53:08Z,392,230,162
18108,2226654988,"{'login': 'ezyang', 'id': 13564, 'node_id': 'MDQ6VXNlcjEzNTY0', 'avatar_url': 'https://avatars0.githubusercontent.com/u/13564?v=4', 'gravatar_id': '', 'url': 'https://api.github.com/users/ezyang', 'html_url': 'https://github.com/ezyang', 'followers_url': 'https://api.github.com/users/ezyang/followers', 'following_url': 'https://api.github.com/users/ezyang/following{/other_user}', 'gists_url': 'https://api.github.com/users/ezyang/gists{/gist_id}', 'starred_url': 'https://api.github.com/users/ezyang/starred{/owner}{/repo}', 'subscriptions_url': 'https://api.github.com/users/ezyang/subscriptions', 'organizations_url': 'https://api.github.com/users/ezyang/orgs', 'repos_url': 'https://api.github.com/users/ezyang/repos', 'events_url': 'https://api.github.com/users/ezyang/events{/privacy}', 'received_events_url': 'https://api.github.com/users/ezyang/received_events', 'type': 'User', 'site_admin': False}",referenced,becaef625f771410f4b34b34af1ee5901049f958,https://api.github.com/repos/pytorch/pytorch/commits/becaef625f771410f4b34b34af1ee5901049f958,2019-03-25T14:10:59Z,172,108,64
18108,2227359502,"{'login': 'facebook-github-bot', 'id': 6422482, 'node_id': 'MDQ6VXNlcjY0MjI0ODI=', 'avatar_url': 'https://avatars3.githubusercontent.com/u/6422482?v=4', 'gravatar_id': '', 'url': 'https://api.github.com/users/facebook-github-bot', 'html_url': 'https://github.com/facebook-github-bot', 'followers_url': 'https://api.github.com/users/facebook-github-bot/followers', 'following_url': 'https://api.github.com/users/facebook-github-bot/following{/other_user}', 'gists_url': 'https://api.github.com/users/facebook-github-bot/gists{/gist_id}', 'starred_url': 'https://api.github.com/users/facebook-github-bot/starred{/owner}{/repo}', 'subscriptions_url': 'https://api.github.com/users/facebook-github-bot/subscriptions', 'organizations_url': 'https://api.github.com/users/facebook-github-bot/orgs', 'repos_url': 'https://api.github.com/users/facebook-github-bot/repos', 'events_url': 'https://api.github.com/users/facebook-github-bot/events{/privacy}', 'received_events_url': 'https://api.github.com/users/facebook-github-bot/received_events', 'type': 'User', 'site_admin': False}",closed,50df3e5e2e2c51db6389b5c47c048f9db112c5c3,https://api.github.com/repos/pytorch/pytorch/commits/50df3e5e2e2c51db6389b5c47c048f9db112c5c3,2019-03-25T17:40:52Z,41,40,1
18078,2214974876,"{'login': 'facebook-github-bot', 'id': 6422482, 'node_id': 'MDQ6VXNlcjY0MjI0ODI=', 'avatar_url': 'https://avatars3.githubusercontent.com/u/6422482?v=4', 'gravatar_id': '', 'url': 'https://api.github.com/users/facebook-github-bot', 'html_url': 'https://github.com/facebook-github-bot', 'followers_url': 'https://api.github.com/users/facebook-github-bot/followers', 'following_url': 'https://api.github.com/users/facebook-github-bot/following{/other_user}', 'gists_url': 'https://api.github.com/users/facebook-github-bot/gists{/gist_id}', 'starred_url': 'https://api.github.com/users/facebook-github-bot/starred{/owner}{/repo}', 'subscriptions_url': 'https://api.github.com/users/facebook-github-bot/subscriptions', 'organizations_url': 'https://api.github.com/users/facebook-github-bot/orgs', 'repos_url': 'https://api.github.com/users/facebook-github-bot/repos', 'events_url': 'https://api.github.com/users/facebook-github-bot/events{/privacy}', 'received_events_url': 'https://api.github.com/users/facebook-github-bot/received_events', 'type': 'User', 'site_admin': False}",closed,f212fd9fd64d4ad9f28444ee44a070a36b7477ac,https://api.github.com/repos/pytorch/pytorch/commits/f212fd9fd64d4ad9f28444ee44a070a36b7477ac,2019-03-19T20:43:19Z,132,116,16
18074,2250938275,"{'login': 'facebook-github-bot', 'id': 6422482, 'node_id': 'MDQ6VXNlcjY0MjI0ODI=', 'avatar_url': 'https://avatars3.githubusercontent.com/u/6422482?v=4', 'gravatar_id': '', 'url': 'https://api.github.com/users/facebook-github-bot', 'html_url': 'https://github.com/facebook-github-bot', 'followers_url': 'https://api.github.com/users/facebook-github-bot/followers', 'following_url': 'https://api.github.com/users/facebook-github-bot/following{/other_user}', 'gists_url': 'https://api.github.com/users/facebook-github-bot/gists{/gist_id}', 'starred_url': 'https://api.github.com/users/facebook-github-bot/starred{/owner}{/repo}', 'subscriptions_url': 'https://api.github.com/users/facebook-github-bot/subscriptions', 'organizations_url': 'https://api.github.com/users/facebook-github-bot/orgs', 'repos_url': 'https://api.github.com/users/facebook-github-bot/repos', 'events_url': 'https://api.github.com/users/facebook-github-bot/events{/privacy}', 'received_events_url': 'https://api.github.com/users/facebook-github-bot/received_events', 'type': 'User', 'site_admin': False}",closed,b5d8844bbee40410ea981464da7186ce31ad0311,https://api.github.com/repos/pytorch/pytorch/commits/b5d8844bbee40410ea981464da7186ce31ad0311,2019-04-03T19:50:04Z,18,12,6
18065,2337856815,"{'login': 'facebook-github-bot', 'id': 6422482, 'node_id': 'MDQ6VXNlcjY0MjI0ODI=', 'avatar_url': 'https://avatars3.githubusercontent.com/u/6422482?v=4', 'gravatar_id': '', 'url': 'https://api.github.com/users/facebook-github-bot', 'html_url': 'https://github.com/facebook-github-bot', 'followers_url': 'https://api.github.com/users/facebook-github-bot/followers', 'following_url': 'https://api.github.com/users/facebook-github-bot/following{/other_user}', 'gists_url': 'https://api.github.com/users/facebook-github-bot/gists{/gist_id}', 'starred_url': 'https://api.github.com/users/facebook-github-bot/starred{/owner}{/repo}', 'subscriptions_url': 'https://api.github.com/users/facebook-github-bot/subscriptions', 'organizations_url': 'https://api.github.com/users/facebook-github-bot/orgs', 'repos_url': 'https://api.github.com/users/facebook-github-bot/repos', 'events_url': 'https://api.github.com/users/facebook-github-bot/events{/privacy}', 'received_events_url': 'https://api.github.com/users/facebook-github-bot/received_events', 'type': 'User', 'site_admin': False}",closed,7799ea5eb3464b5096e745a577bdd430791d9da4,https://api.github.com/repos/pytorch/pytorch/commits/7799ea5eb3464b5096e745a577bdd430791d9da4,2019-05-13T18:31:52Z,1621,841,780
18064,2294325828,"{'login': 'facebook-github-bot', 'id': 6422482, 'node_id': 'MDQ6VXNlcjY0MjI0ODI=', 'avatar_url': 'https://avatars3.githubusercontent.com/u/6422482?v=4', 'gravatar_id': '', 'url': 'https://api.github.com/users/facebook-github-bot', 'html_url': 'https://github.com/facebook-github-bot', 'followers_url': 'https://api.github.com/users/facebook-github-bot/followers', 'following_url': 'https://api.github.com/users/facebook-github-bot/following{/other_user}', 'gists_url': 'https://api.github.com/users/facebook-github-bot/gists{/gist_id}', 'starred_url': 'https://api.github.com/users/facebook-github-bot/starred{/owner}{/repo}', 'subscriptions_url': 'https://api.github.com/users/facebook-github-bot/subscriptions', 'organizations_url': 'https://api.github.com/users/facebook-github-bot/orgs', 'repos_url': 'https://api.github.com/users/facebook-github-bot/repos', 'events_url': 'https://api.github.com/users/facebook-github-bot/events{/privacy}', 'received_events_url': 'https://api.github.com/users/facebook-github-bot/received_events', 'type': 'User', 'site_admin': False}",referenced,75ce5173a9c3db50c9a96608d267aed60e017c67,https://api.github.com/repos/pytorch/pytorch/commits/75ce5173a9c3db50c9a96608d267aed60e017c67,2019-04-23T14:39:31Z,1546,847,699
18057,2215578016,"{'login': 'facebook-github-bot', 'id': 6422482, 'node_id': 'MDQ6VXNlcjY0MjI0ODI=', 'avatar_url': 'https://avatars3.githubusercontent.com/u/6422482?v=4', 'gravatar_id': '', 'url': 'https://api.github.com/users/facebook-github-bot', 'html_url': 'https://github.com/facebook-github-bot', 'followers_url': 'https://api.github.com/users/facebook-github-bot/followers', 'following_url': 'https://api.github.com/users/facebook-github-bot/following{/other_user}', 'gists_url': 'https://api.github.com/users/facebook-github-bot/gists{/gist_id}', 'starred_url': 'https://api.github.com/users/facebook-github-bot/starred{/owner}{/repo}', 'subscriptions_url': 'https://api.github.com/users/facebook-github-bot/subscriptions', 'organizations_url': 'https://api.github.com/users/facebook-github-bot/orgs', 'repos_url': 'https://api.github.com/users/facebook-github-bot/repos', 'events_url': 'https://api.github.com/users/facebook-github-bot/events{/privacy}', 'received_events_url': 'https://api.github.com/users/facebook-github-bot/received_events', 'type': 'User', 'site_admin': False}",closed,8895bfba6aac8ca99c6d4483fa9b8b32c8a95c83,https://api.github.com/repos/pytorch/pytorch/commits/8895bfba6aac8ca99c6d4483fa9b8b32c8a95c83,2019-03-20T03:11:00Z,15,12,3
18003,2328774132,"{'login': 'facebook-github-bot', 'id': 6422482, 'node_id': 'MDQ6VXNlcjY0MjI0ODI=', 'avatar_url': 'https://avatars3.githubusercontent.com/u/6422482?v=4', 'gravatar_id': '', 'url': 'https://api.github.com/users/facebook-github-bot', 'html_url': 'https://github.com/facebook-github-bot', 'followers_url': 'https://api.github.com/users/facebook-github-bot/followers', 'following_url': 'https://api.github.com/users/facebook-github-bot/following{/other_user}', 'gists_url': 'https://api.github.com/users/facebook-github-bot/gists{/gist_id}', 'starred_url': 'https://api.github.com/users/facebook-github-bot/starred{/owner}{/repo}', 'subscriptions_url': 'https://api.github.com/users/facebook-github-bot/subscriptions', 'organizations_url': 'https://api.github.com/users/facebook-github-bot/orgs', 'repos_url': 'https://api.github.com/users/facebook-github-bot/repos', 'events_url': 'https://api.github.com/users/facebook-github-bot/events{/privacy}', 'received_events_url': 'https://api.github.com/users/facebook-github-bot/received_events', 'type': 'User', 'site_admin': False}",closed,8ebb86dd3a256a452ab96336b3f4b6b86a769247,https://api.github.com/repos/pytorch/pytorch/commits/8ebb86dd3a256a452ab96336b3f4b6b86a769247,2019-05-08T23:55:01Z,417,360,57
17998,2500947976,"{'login': 'facebook-github-bot', 'id': 6422482, 'node_id': 'MDQ6VXNlcjY0MjI0ODI=', 'avatar_url': 'https://avatars3.githubusercontent.com/u/6422482?v=4', 'gravatar_id': '', 'url': 'https://api.github.com/users/facebook-github-bot', 'html_url': 'https://github.com/facebook-github-bot', 'followers_url': 'https://api.github.com/users/facebook-github-bot/followers', 'following_url': 'https://api.github.com/users/facebook-github-bot/following{/other_user}', 'gists_url': 'https://api.github.com/users/facebook-github-bot/gists{/gist_id}', 'starred_url': 'https://api.github.com/users/facebook-github-bot/starred{/owner}{/repo}', 'subscriptions_url': 'https://api.github.com/users/facebook-github-bot/subscriptions', 'organizations_url': 'https://api.github.com/users/facebook-github-bot/orgs', 'repos_url': 'https://api.github.com/users/facebook-github-bot/repos', 'events_url': 'https://api.github.com/users/facebook-github-bot/events{/privacy}', 'received_events_url': 'https://api.github.com/users/facebook-github-bot/received_events', 'type': 'User', 'site_admin': False}",referenced,965b97f5f0313ac170cbd7772cf345d50fe6314c,https://api.github.com/repos/pytorch/pytorch/commits/965b97f5f0313ac170cbd7772cf345d50fe6314c,2019-07-22T20:02:48Z,246,244,2
17988,2203572346,"{'login': 'facebook-github-bot', 'id': 6422482, 'node_id': 'MDQ6VXNlcjY0MjI0ODI=', 'avatar_url': 'https://avatars3.githubusercontent.com/u/6422482?v=4', 'gravatar_id': '', 'url': 'https://api.github.com/users/facebook-github-bot', 'html_url': 'https://github.com/facebook-github-bot', 'followers_url': 'https://api.github.com/users/facebook-github-bot/followers', 'following_url': 'https://api.github.com/users/facebook-github-bot/following{/other_user}', 'gists_url': 'https://api.github.com/users/facebook-github-bot/gists{/gist_id}', 'starred_url': 'https://api.github.com/users/facebook-github-bot/starred{/owner}{/repo}', 'subscriptions_url': 'https://api.github.com/users/facebook-github-bot/subscriptions', 'organizations_url': 'https://api.github.com/users/facebook-github-bot/orgs', 'repos_url': 'https://api.github.com/users/facebook-github-bot/repos', 'events_url': 'https://api.github.com/users/facebook-github-bot/events{/privacy}', 'received_events_url': 'https://api.github.com/users/facebook-github-bot/received_events', 'type': 'User', 'site_admin': False}",closed,40a3e14ade39ba1a32b99c5ff06aa4bd8dae8132,https://api.github.com/repos/pytorch/pytorch/commits/40a3e14ade39ba1a32b99c5ff06aa4bd8dae8132,2019-03-14T14:24:49Z,3,3,0
17962,2250938255,"{'login': 'facebook-github-bot', 'id': 6422482, 'node_id': 'MDQ6VXNlcjY0MjI0ODI=', 'avatar_url': 'https://avatars3.githubusercontent.com/u/6422482?v=4', 'gravatar_id': '', 'url': 'https://api.github.com/users/facebook-github-bot', 'html_url': 'https://github.com/facebook-github-bot', 'followers_url': 'https://api.github.com/users/facebook-github-bot/followers', 'following_url': 'https://api.github.com/users/facebook-github-bot/following{/other_user}', 'gists_url': 'https://api.github.com/users/facebook-github-bot/gists{/gist_id}', 'starred_url': 'https://api.github.com/users/facebook-github-bot/starred{/owner}{/repo}', 'subscriptions_url': 'https://api.github.com/users/facebook-github-bot/subscriptions', 'organizations_url': 'https://api.github.com/users/facebook-github-bot/orgs', 'repos_url': 'https://api.github.com/users/facebook-github-bot/repos', 'events_url': 'https://api.github.com/users/facebook-github-bot/events{/privacy}', 'received_events_url': 'https://api.github.com/users/facebook-github-bot/received_events', 'type': 'User', 'site_admin': False}",closed,a21e256e8db77a339e0e1975a4ea41b671f3b0d9,https://api.github.com/repos/pytorch/pytorch/commits/a21e256e8db77a339e0e1975a4ea41b671f3b0d9,2019-04-03T19:50:03Z,50,31,19
17950,2224135349,"{'login': 'facebook-github-bot', 'id': 6422482, 'node_id': 'MDQ6VXNlcjY0MjI0ODI=', 'avatar_url': 'https://avatars3.githubusercontent.com/u/6422482?v=4', 'gravatar_id': '', 'url': 'https://api.github.com/users/facebook-github-bot', 'html_url': 'https://github.com/facebook-github-bot', 'followers_url': 'https://api.github.com/users/facebook-github-bot/followers', 'following_url': 'https://api.github.com/users/facebook-github-bot/following{/other_user}', 'gists_url': 'https://api.github.com/users/facebook-github-bot/gists{/gist_id}', 'starred_url': 'https://api.github.com/users/facebook-github-bot/starred{/owner}{/repo}', 'subscriptions_url': 'https://api.github.com/users/facebook-github-bot/subscriptions', 'organizations_url': 'https://api.github.com/users/facebook-github-bot/orgs', 'repos_url': 'https://api.github.com/users/facebook-github-bot/repos', 'events_url': 'https://api.github.com/users/facebook-github-bot/events{/privacy}', 'received_events_url': 'https://api.github.com/users/facebook-github-bot/received_events', 'type': 'User', 'site_admin': False}",closed,7be05b822c01e8db5e23c8a213ba2e83d17b0bd2,https://api.github.com/repos/pytorch/pytorch/commits/7be05b822c01e8db5e23c8a213ba2e83d17b0bd2,2019-03-23T02:37:03Z,166,106,60
17937,2199144891,"{'login': 'facebook-github-bot', 'id': 6422482, 'node_id': 'MDQ6VXNlcjY0MjI0ODI=', 'avatar_url': 'https://avatars3.githubusercontent.com/u/6422482?v=4', 'gravatar_id': '', 'url': 'https://api.github.com/users/facebook-github-bot', 'html_url': 'https://github.com/facebook-github-bot', 'followers_url': 'https://api.github.com/users/facebook-github-bot/followers', 'following_url': 'https://api.github.com/users/facebook-github-bot/following{/other_user}', 'gists_url': 'https://api.github.com/users/facebook-github-bot/gists{/gist_id}', 'starred_url': 'https://api.github.com/users/facebook-github-bot/starred{/owner}{/repo}', 'subscriptions_url': 'https://api.github.com/users/facebook-github-bot/subscriptions', 'organizations_url': 'https://api.github.com/users/facebook-github-bot/orgs', 'repos_url': 'https://api.github.com/users/facebook-github-bot/repos', 'events_url': 'https://api.github.com/users/facebook-github-bot/events{/privacy}', 'received_events_url': 'https://api.github.com/users/facebook-github-bot/received_events', 'type': 'User', 'site_admin': False}",closed,b21e9e4dae4ba439f7408e6d25b94bc8c6734d51,https://api.github.com/repos/pytorch/pytorch/commits/b21e9e4dae4ba439f7408e6d25b94bc8c6734d51,2019-03-13T04:50:13Z,20,16,4
17919,2224135350,"{'login': 'facebook-github-bot', 'id': 6422482, 'node_id': 'MDQ6VXNlcjY0MjI0ODI=', 'avatar_url': 'https://avatars3.githubusercontent.com/u/6422482?v=4', 'gravatar_id': '', 'url': 'https://api.github.com/users/facebook-github-bot', 'html_url': 'https://github.com/facebook-github-bot', 'followers_url': 'https://api.github.com/users/facebook-github-bot/followers', 'following_url': 'https://api.github.com/users/facebook-github-bot/following{/other_user}', 'gists_url': 'https://api.github.com/users/facebook-github-bot/gists{/gist_id}', 'starred_url': 'https://api.github.com/users/facebook-github-bot/starred{/owner}{/repo}', 'subscriptions_url': 'https://api.github.com/users/facebook-github-bot/subscriptions', 'organizations_url': 'https://api.github.com/users/facebook-github-bot/orgs', 'repos_url': 'https://api.github.com/users/facebook-github-bot/repos', 'events_url': 'https://api.github.com/users/facebook-github-bot/events{/privacy}', 'received_events_url': 'https://api.github.com/users/facebook-github-bot/received_events', 'type': 'User', 'site_admin': False}",referenced,7be05b822c01e8db5e23c8a213ba2e83d17b0bd2,https://api.github.com/repos/pytorch/pytorch/commits/7be05b822c01e8db5e23c8a213ba2e83d17b0bd2,2019-03-23T02:37:03Z,166,106,60
17918,2836304633,"{'login': 'facebook-github-bot', 'id': 6422482, 'node_id': 'MDQ6VXNlcjY0MjI0ODI=', 'avatar_url': 'https://avatars3.githubusercontent.com/u/6422482?v=4', 'gravatar_id': '', 'url': 'https://api.github.com/users/facebook-github-bot', 'html_url': 'https://github.com/facebook-github-bot', 'followers_url': 'https://api.github.com/users/facebook-github-bot/followers', 'following_url': 'https://api.github.com/users/facebook-github-bot/following{/other_user}', 'gists_url': 'https://api.github.com/users/facebook-github-bot/gists{/gist_id}', 'starred_url': 'https://api.github.com/users/facebook-github-bot/starred{/owner}{/repo}', 'subscriptions_url': 'https://api.github.com/users/facebook-github-bot/subscriptions', 'organizations_url': 'https://api.github.com/users/facebook-github-bot/orgs', 'repos_url': 'https://api.github.com/users/facebook-github-bot/repos', 'events_url': 'https://api.github.com/users/facebook-github-bot/events{/privacy}', 'received_events_url': 'https://api.github.com/users/facebook-github-bot/received_events', 'type': 'User', 'site_admin': False}",closed,1e8ed021c6bbb74be3af23278c39ecdf68e57541,https://api.github.com/repos/pytorch/pytorch/commits/1e8ed021c6bbb74be3af23278c39ecdf68e57541,2019-11-27T16:34:57Z,35,32,3
17913,2267490886,"{'login': 'ezyang', 'id': 13564, 'node_id': 'MDQ6VXNlcjEzNTY0', 'avatar_url': 'https://avatars0.githubusercontent.com/u/13564?v=4', 'gravatar_id': '', 'url': 'https://api.github.com/users/ezyang', 'html_url': 'https://github.com/ezyang', 'followers_url': 'https://api.github.com/users/ezyang/followers', 'following_url': 'https://api.github.com/users/ezyang/following{/other_user}', 'gists_url': 'https://api.github.com/users/ezyang/gists{/gist_id}', 'starred_url': 'https://api.github.com/users/ezyang/starred{/owner}{/repo}', 'subscriptions_url': 'https://api.github.com/users/ezyang/subscriptions', 'organizations_url': 'https://api.github.com/users/ezyang/orgs', 'repos_url': 'https://api.github.com/users/ezyang/repos', 'events_url': 'https://api.github.com/users/ezyang/events{/privacy}', 'received_events_url': 'https://api.github.com/users/ezyang/received_events', 'type': 'User', 'site_admin': False}",referenced,a2d58a50b81b3554d347ae25107fc7a4c75a6e18,https://api.github.com/repos/pytorch/pytorch/commits/a2d58a50b81b3554d347ae25107fc7a4c75a6e18,2019-04-10T21:45:42Z,571,41,530
17913,2267491009,"{'login': 'ezyang', 'id': 13564, 'node_id': 'MDQ6VXNlcjEzNTY0', 'avatar_url': 'https://avatars0.githubusercontent.com/u/13564?v=4', 'gravatar_id': '', 'url': 'https://api.github.com/users/ezyang', 'html_url': 'https://github.com/ezyang', 'followers_url': 'https://api.github.com/users/ezyang/followers', 'following_url': 'https://api.github.com/users/ezyang/following{/other_user}', 'gists_url': 'https://api.github.com/users/ezyang/gists{/gist_id}', 'starred_url': 'https://api.github.com/users/ezyang/starred{/owner}{/repo}', 'subscriptions_url': 'https://api.github.com/users/ezyang/subscriptions', 'organizations_url': 'https://api.github.com/users/ezyang/orgs', 'repos_url': 'https://api.github.com/users/ezyang/repos', 'events_url': 'https://api.github.com/users/ezyang/events{/privacy}', 'received_events_url': 'https://api.github.com/users/ezyang/received_events', 'type': 'User', 'site_admin': False}",referenced,e75f00d4b9adb0f5a45cccfc5ba42709a8e59f8c,https://api.github.com/repos/pytorch/pytorch/commits/e75f00d4b9adb0f5a45cccfc5ba42709a8e59f8c,2019-04-10T21:45:46Z,571,41,530
17913,2294745602,"{'login': 'facebook-github-bot', 'id': 6422482, 'node_id': 'MDQ6VXNlcjY0MjI0ODI=', 'avatar_url': 'https://avatars3.githubusercontent.com/u/6422482?v=4', 'gravatar_id': '', 'url': 'https://api.github.com/users/facebook-github-bot', 'html_url': 'https://github.com/facebook-github-bot', 'followers_url': 'https://api.github.com/users/facebook-github-bot/followers', 'following_url': 'https://api.github.com/users/facebook-github-bot/following{/other_user}', 'gists_url': 'https://api.github.com/users/facebook-github-bot/gists{/gist_id}', 'starred_url': 'https://api.github.com/users/facebook-github-bot/starred{/owner}{/repo}', 'subscriptions_url': 'https://api.github.com/users/facebook-github-bot/subscriptions', 'organizations_url': 'https://api.github.com/users/facebook-github-bot/orgs', 'repos_url': 'https://api.github.com/users/facebook-github-bot/repos', 'events_url': 'https://api.github.com/users/facebook-github-bot/events{/privacy}', 'received_events_url': 'https://api.github.com/users/facebook-github-bot/received_events', 'type': 'User', 'site_admin': False}",closed,e3f150462185239f5a92d39916c3e3ca12fe80e0,https://api.github.com/repos/pytorch/pytorch/commits/e3f150462185239f5a92d39916c3e3ca12fe80e0,2019-04-23T16:56:42Z,16,13,3
17893,2594450518,"{'login': 'CamiWilliams', 'id': 5103945, 'node_id': 'MDQ6VXNlcjUxMDM5NDU=', 'avatar_url': 'https://avatars1.githubusercontent.com/u/5103945?v=4', 'gravatar_id': '', 'url': 'https://api.github.com/users/CamiWilliams', 'html_url': 'https://github.com/CamiWilliams', 'followers_url': 'https://api.github.com/users/CamiWilliams/followers', 'following_url': 'https://api.github.com/users/CamiWilliams/following{/other_user}', 'gists_url': 'https://api.github.com/users/CamiWilliams/gists{/gist_id}', 'starred_url': 'https://api.github.com/users/CamiWilliams/starred{/owner}{/repo}', 'subscriptions_url': 'https://api.github.com/users/CamiWilliams/subscriptions', 'organizations_url': 'https://api.github.com/users/CamiWilliams/orgs', 'repos_url': 'https://api.github.com/users/CamiWilliams/repos', 'events_url': 'https://api.github.com/users/CamiWilliams/events{/privacy}', 'received_events_url': 'https://api.github.com/users/CamiWilliams/received_events', 'type': 'User', 'site_admin': False}",referenced,4699a854b734a15356a366d9b6555d18851a5b71,https://api.github.com/repos/pytorch/pytorch/commits/4699a854b734a15356a366d9b6555d18851a5b71,2019-08-29T15:36:46Z,21,20,1
17893,2597375333,"{'login': 'facebook-github-bot', 'id': 6422482, 'node_id': 'MDQ6VXNlcjY0MjI0ODI=', 'avatar_url': 'https://avatars3.githubusercontent.com/u/6422482?v=4', 'gravatar_id': '', 'url': 'https://api.github.com/users/facebook-github-bot', 'html_url': 'https://github.com/facebook-github-bot', 'followers_url': 'https://api.github.com/users/facebook-github-bot/followers', 'following_url': 'https://api.github.com/users/facebook-github-bot/following{/other_user}', 'gists_url': 'https://api.github.com/users/facebook-github-bot/gists{/gist_id}', 'starred_url': 'https://api.github.com/users/facebook-github-bot/starred{/owner}{/repo}', 'subscriptions_url': 'https://api.github.com/users/facebook-github-bot/subscriptions', 'organizations_url': 'https://api.github.com/users/facebook-github-bot/orgs', 'repos_url': 'https://api.github.com/users/facebook-github-bot/repos', 'events_url': 'https://api.github.com/users/facebook-github-bot/events{/privacy}', 'received_events_url': 'https://api.github.com/users/facebook-github-bot/received_events', 'type': 'User', 'site_admin': False}",closed,05bf74a8904c6b3b054f33a79898d784848a5544,https://api.github.com/repos/pytorch/pytorch/commits/05bf74a8904c6b3b054f33a79898d784848a5544,2019-08-30T14:31:27Z,21,20,1
17882,2571672399,"{'login': 'facebook-github-bot', 'id': 6422482, 'node_id': 'MDQ6VXNlcjY0MjI0ODI=', 'avatar_url': 'https://avatars3.githubusercontent.com/u/6422482?v=4', 'gravatar_id': '', 'url': 'https://api.github.com/users/facebook-github-bot', 'html_url': 'https://github.com/facebook-github-bot', 'followers_url': 'https://api.github.com/users/facebook-github-bot/followers', 'following_url': 'https://api.github.com/users/facebook-github-bot/following{/other_user}', 'gists_url': 'https://api.github.com/users/facebook-github-bot/gists{/gist_id}', 'starred_url': 'https://api.github.com/users/facebook-github-bot/starred{/owner}{/repo}', 'subscriptions_url': 'https://api.github.com/users/facebook-github-bot/subscriptions', 'organizations_url': 'https://api.github.com/users/facebook-github-bot/orgs', 'repos_url': 'https://api.github.com/users/facebook-github-bot/repos', 'events_url': 'https://api.github.com/users/facebook-github-bot/events{/privacy}', 'received_events_url': 'https://api.github.com/users/facebook-github-bot/received_events', 'type': 'User', 'site_admin': False}",referenced,0a23151293d217c97d53e9dff57d6dda08b99734,https://api.github.com/repos/pytorch/pytorch/commits/0a23151293d217c97d53e9dff57d6dda08b99734,2019-08-21T03:37:49Z,666,627,39
17882,2578101508,"{'login': 'facebook-github-bot', 'id': 6422482, 'node_id': 'MDQ6VXNlcjY0MjI0ODI=', 'avatar_url': 'https://avatars3.githubusercontent.com/u/6422482?v=4', 'gravatar_id': '', 'url': 'https://api.github.com/users/facebook-github-bot', 'html_url': 'https://github.com/facebook-github-bot', 'followers_url': 'https://api.github.com/users/facebook-github-bot/followers', 'following_url': 'https://api.github.com/users/facebook-github-bot/following{/other_user}', 'gists_url': 'https://api.github.com/users/facebook-github-bot/gists{/gist_id}', 'starred_url': 'https://api.github.com/users/facebook-github-bot/starred{/owner}{/repo}', 'subscriptions_url': 'https://api.github.com/users/facebook-github-bot/subscriptions', 'organizations_url': 'https://api.github.com/users/facebook-github-bot/orgs', 'repos_url': 'https://api.github.com/users/facebook-github-bot/repos', 'events_url': 'https://api.github.com/users/facebook-github-bot/events{/privacy}', 'received_events_url': 'https://api.github.com/users/facebook-github-bot/received_events', 'type': 'User', 'site_admin': False}",referenced,149c646b7450296fc740ad476c438abde228bbe8,https://api.github.com/repos/pytorch/pytorch/commits/149c646b7450296fc740ad476c438abde228bbe8,2019-08-22T23:12:53Z,666,627,39
17843,2353201442,"{'login': 'facebook-github-bot', 'id': 6422482, 'node_id': 'MDQ6VXNlcjY0MjI0ODI=', 'avatar_url': 'https://avatars3.githubusercontent.com/u/6422482?v=4', 'gravatar_id': '', 'url': 'https://api.github.com/users/facebook-github-bot', 'html_url': 'https://github.com/facebook-github-bot', 'followers_url': 'https://api.github.com/users/facebook-github-bot/followers', 'following_url': 'https://api.github.com/users/facebook-github-bot/following{/other_user}', 'gists_url': 'https://api.github.com/users/facebook-github-bot/gists{/gist_id}', 'starred_url': 'https://api.github.com/users/facebook-github-bot/starred{/owner}{/repo}', 'subscriptions_url': 'https://api.github.com/users/facebook-github-bot/subscriptions', 'organizations_url': 'https://api.github.com/users/facebook-github-bot/orgs', 'repos_url': 'https://api.github.com/users/facebook-github-bot/repos', 'events_url': 'https://api.github.com/users/facebook-github-bot/events{/privacy}', 'received_events_url': 'https://api.github.com/users/facebook-github-bot/received_events', 'type': 'User', 'site_admin': False}",closed,071971476d7431a24e527bdc181981678055a95d,https://api.github.com/repos/pytorch/pytorch/commits/071971476d7431a24e527bdc181981678055a95d,2019-05-20T13:55:14Z,29,26,3
17801,2218433686,"{'login': 'facebook-github-bot', 'id': 6422482, 'node_id': 'MDQ6VXNlcjY0MjI0ODI=', 'avatar_url': 'https://avatars3.githubusercontent.com/u/6422482?v=4', 'gravatar_id': '', 'url': 'https://api.github.com/users/facebook-github-bot', 'html_url': 'https://github.com/facebook-github-bot', 'followers_url': 'https://api.github.com/users/facebook-github-bot/followers', 'following_url': 'https://api.github.com/users/facebook-github-bot/following{/other_user}', 'gists_url': 'https://api.github.com/users/facebook-github-bot/gists{/gist_id}', 'starred_url': 'https://api.github.com/users/facebook-github-bot/starred{/owner}{/repo}', 'subscriptions_url': 'https://api.github.com/users/facebook-github-bot/subscriptions', 'organizations_url': 'https://api.github.com/users/facebook-github-bot/orgs', 'repos_url': 'https://api.github.com/users/facebook-github-bot/repos', 'events_url': 'https://api.github.com/users/facebook-github-bot/events{/privacy}', 'received_events_url': 'https://api.github.com/users/facebook-github-bot/received_events', 'type': 'User', 'site_admin': False}",closed,ebc9f75895eb5b8514f65aebd5904b6caabc4b0b,https://api.github.com/repos/pytorch/pytorch/commits/ebc9f75895eb5b8514f65aebd5904b6caabc4b0b,2019-03-20T23:05:20Z,9,6,3
17757,2244687512,"{'login': 'facebook-github-bot', 'id': 6422482, 'node_id': 'MDQ6VXNlcjY0MjI0ODI=', 'avatar_url': 'https://avatars3.githubusercontent.com/u/6422482?v=4', 'gravatar_id': '', 'url': 'https://api.github.com/users/facebook-github-bot', 'html_url': 'https://github.com/facebook-github-bot', 'followers_url': 'https://api.github.com/users/facebook-github-bot/followers', 'following_url': 'https://api.github.com/users/facebook-github-bot/following{/other_user}', 'gists_url': 'https://api.github.com/users/facebook-github-bot/gists{/gist_id}', 'starred_url': 'https://api.github.com/users/facebook-github-bot/starred{/owner}{/repo}', 'subscriptions_url': 'https://api.github.com/users/facebook-github-bot/subscriptions', 'organizations_url': 'https://api.github.com/users/facebook-github-bot/orgs', 'repos_url': 'https://api.github.com/users/facebook-github-bot/repos', 'events_url': 'https://api.github.com/users/facebook-github-bot/events{/privacy}', 'received_events_url': 'https://api.github.com/users/facebook-github-bot/received_events', 'type': 'User', 'site_admin': False}",referenced,bdfdf6c2b936bc5ae34c6fe52dfbb92847ae4205,https://api.github.com/repos/pytorch/pytorch/commits/bdfdf6c2b936bc5ae34c6fe52dfbb92847ae4205,2019-04-01T21:32:25Z,590,590,0
17757,2331478689,"{'login': 'facebook-github-bot', 'id': 6422482, 'node_id': 'MDQ6VXNlcjY0MjI0ODI=', 'avatar_url': 'https://avatars3.githubusercontent.com/u/6422482?v=4', 'gravatar_id': '', 'url': 'https://api.github.com/users/facebook-github-bot', 'html_url': 'https://github.com/facebook-github-bot', 'followers_url': 'https://api.github.com/users/facebook-github-bot/followers', 'following_url': 'https://api.github.com/users/facebook-github-bot/following{/other_user}', 'gists_url': 'https://api.github.com/users/facebook-github-bot/gists{/gist_id}', 'starred_url': 'https://api.github.com/users/facebook-github-bot/starred{/owner}{/repo}', 'subscriptions_url': 'https://api.github.com/users/facebook-github-bot/subscriptions', 'organizations_url': 'https://api.github.com/users/facebook-github-bot/orgs', 'repos_url': 'https://api.github.com/users/facebook-github-bot/repos', 'events_url': 'https://api.github.com/users/facebook-github-bot/events{/privacy}', 'received_events_url': 'https://api.github.com/users/facebook-github-bot/received_events', 'type': 'User', 'site_admin': False}",referenced,caa0d0c50a25b6287de58e7012c9c26f727245b6,https://api.github.com/repos/pytorch/pytorch/commits/caa0d0c50a25b6287de58e7012c9c26f727245b6,2019-05-09T21:13:27Z,188,186,2
17757,2331478714,"{'login': 'facebook-github-bot', 'id': 6422482, 'node_id': 'MDQ6VXNlcjY0MjI0ODI=', 'avatar_url': 'https://avatars3.githubusercontent.com/u/6422482?v=4', 'gravatar_id': '', 'url': 'https://api.github.com/users/facebook-github-bot', 'html_url': 'https://github.com/facebook-github-bot', 'followers_url': 'https://api.github.com/users/facebook-github-bot/followers', 'following_url': 'https://api.github.com/users/facebook-github-bot/following{/other_user}', 'gists_url': 'https://api.github.com/users/facebook-github-bot/gists{/gist_id}', 'starred_url': 'https://api.github.com/users/facebook-github-bot/starred{/owner}{/repo}', 'subscriptions_url': 'https://api.github.com/users/facebook-github-bot/subscriptions', 'organizations_url': 'https://api.github.com/users/facebook-github-bot/orgs', 'repos_url': 'https://api.github.com/users/facebook-github-bot/repos', 'events_url': 'https://api.github.com/users/facebook-github-bot/events{/privacy}', 'received_events_url': 'https://api.github.com/users/facebook-github-bot/received_events', 'type': 'User', 'site_admin': False}",closed,558c6c4d8ab76f1c8e075a230af584258c9c89e8,https://api.github.com/repos/pytorch/pytorch/commits/558c6c4d8ab76f1c8e075a230af584258c9c89e8,2019-05-09T21:13:28Z,36,22,14
17750,2414070699,"{'login': 'facebook-github-bot', 'id': 6422482, 'node_id': 'MDQ6VXNlcjY0MjI0ODI=', 'avatar_url': 'https://avatars3.githubusercontent.com/u/6422482?v=4', 'gravatar_id': '', 'url': 'https://api.github.com/users/facebook-github-bot', 'html_url': 'https://github.com/facebook-github-bot', 'followers_url': 'https://api.github.com/users/facebook-github-bot/followers', 'following_url': 'https://api.github.com/users/facebook-github-bot/following{/other_user}', 'gists_url': 'https://api.github.com/users/facebook-github-bot/gists{/gist_id}', 'starred_url': 'https://api.github.com/users/facebook-github-bot/starred{/owner}{/repo}', 'subscriptions_url': 'https://api.github.com/users/facebook-github-bot/subscriptions', 'organizations_url': 'https://api.github.com/users/facebook-github-bot/orgs', 'repos_url': 'https://api.github.com/users/facebook-github-bot/repos', 'events_url': 'https://api.github.com/users/facebook-github-bot/events{/privacy}', 'received_events_url': 'https://api.github.com/users/facebook-github-bot/received_events', 'type': 'User', 'site_admin': False}",referenced,deb2140c6e1e4e7be928c4a66a92b5ccfbad1210,https://api.github.com/repos/pytorch/pytorch/commits/deb2140c6e1e4e7be928c4a66a92b5ccfbad1210,2019-06-14T15:37:15Z,52,44,8
17683,2212159444,"{'login': 'facebook-github-bot', 'id': 6422482, 'node_id': 'MDQ6VXNlcjY0MjI0ODI=', 'avatar_url': 'https://avatars3.githubusercontent.com/u/6422482?v=4', 'gravatar_id': '', 'url': 'https://api.github.com/users/facebook-github-bot', 'html_url': 'https://github.com/facebook-github-bot', 'followers_url': 'https://api.github.com/users/facebook-github-bot/followers', 'following_url': 'https://api.github.com/users/facebook-github-bot/following{/other_user}', 'gists_url': 'https://api.github.com/users/facebook-github-bot/gists{/gist_id}', 'starred_url': 'https://api.github.com/users/facebook-github-bot/starred{/owner}{/repo}', 'subscriptions_url': 'https://api.github.com/users/facebook-github-bot/subscriptions', 'organizations_url': 'https://api.github.com/users/facebook-github-bot/orgs', 'repos_url': 'https://api.github.com/users/facebook-github-bot/repos', 'events_url': 'https://api.github.com/users/facebook-github-bot/events{/privacy}', 'received_events_url': 'https://api.github.com/users/facebook-github-bot/received_events', 'type': 'User', 'site_admin': False}",closed,3d44305e9d3f0ecb9eb126dbf0125a0cdc513b2d,https://api.github.com/repos/pytorch/pytorch/commits/3d44305e9d3f0ecb9eb126dbf0125a0cdc513b2d,2019-03-19T01:20:13Z,872,864,8
17669,2183052317,"{'login': 'facebook-github-bot', 'id': 6422482, 'node_id': 'MDQ6VXNlcjY0MjI0ODI=', 'avatar_url': 'https://avatars3.githubusercontent.com/u/6422482?v=4', 'gravatar_id': '', 'url': 'https://api.github.com/users/facebook-github-bot', 'html_url': 'https://github.com/facebook-github-bot', 'followers_url': 'https://api.github.com/users/facebook-github-bot/followers', 'following_url': 'https://api.github.com/users/facebook-github-bot/following{/other_user}', 'gists_url': 'https://api.github.com/users/facebook-github-bot/gists{/gist_id}', 'starred_url': 'https://api.github.com/users/facebook-github-bot/starred{/owner}{/repo}', 'subscriptions_url': 'https://api.github.com/users/facebook-github-bot/subscriptions', 'organizations_url': 'https://api.github.com/users/facebook-github-bot/orgs', 'repos_url': 'https://api.github.com/users/facebook-github-bot/repos', 'events_url': 'https://api.github.com/users/facebook-github-bot/events{/privacy}', 'received_events_url': 'https://api.github.com/users/facebook-github-bot/received_events', 'type': 'User', 'site_admin': False}",closed,fefaebabba293dd1f06e712404652a2764dcd310,https://api.github.com/repos/pytorch/pytorch/commits/fefaebabba293dd1f06e712404652a2764dcd310,2019-03-06T04:52:32Z,13,6,7
17662,2261106366,"{'login': 'facebook-github-bot', 'id': 6422482, 'node_id': 'MDQ6VXNlcjY0MjI0ODI=', 'avatar_url': 'https://avatars3.githubusercontent.com/u/6422482?v=4', 'gravatar_id': '', 'url': 'https://api.github.com/users/facebook-github-bot', 'html_url': 'https://github.com/facebook-github-bot', 'followers_url': 'https://api.github.com/users/facebook-github-bot/followers', 'following_url': 'https://api.github.com/users/facebook-github-bot/following{/other_user}', 'gists_url': 'https://api.github.com/users/facebook-github-bot/gists{/gist_id}', 'starred_url': 'https://api.github.com/users/facebook-github-bot/starred{/owner}{/repo}', 'subscriptions_url': 'https://api.github.com/users/facebook-github-bot/subscriptions', 'organizations_url': 'https://api.github.com/users/facebook-github-bot/orgs', 'repos_url': 'https://api.github.com/users/facebook-github-bot/repos', 'events_url': 'https://api.github.com/users/facebook-github-bot/events{/privacy}', 'received_events_url': 'https://api.github.com/users/facebook-github-bot/received_events', 'type': 'User', 'site_admin': False}",referenced,930fb2f31986a716f9588aad4dd372c28550d7cb,https://api.github.com/repos/pytorch/pytorch/commits/930fb2f31986a716f9588aad4dd372c28550d7cb,2019-04-08T21:52:28Z,20,18,2
17657,2185063629,"{'login': 'facebook-github-bot', 'id': 6422482, 'node_id': 'MDQ6VXNlcjY0MjI0ODI=', 'avatar_url': 'https://avatars3.githubusercontent.com/u/6422482?v=4', 'gravatar_id': '', 'url': 'https://api.github.com/users/facebook-github-bot', 'html_url': 'https://github.com/facebook-github-bot', 'followers_url': 'https://api.github.com/users/facebook-github-bot/followers', 'following_url': 'https://api.github.com/users/facebook-github-bot/following{/other_user}', 'gists_url': 'https://api.github.com/users/facebook-github-bot/gists{/gist_id}', 'starred_url': 'https://api.github.com/users/facebook-github-bot/starred{/owner}{/repo}', 'subscriptions_url': 'https://api.github.com/users/facebook-github-bot/subscriptions', 'organizations_url': 'https://api.github.com/users/facebook-github-bot/orgs', 'repos_url': 'https://api.github.com/users/facebook-github-bot/repos', 'events_url': 'https://api.github.com/users/facebook-github-bot/events{/privacy}', 'received_events_url': 'https://api.github.com/users/facebook-github-bot/received_events', 'type': 'User', 'site_admin': False}",closed,08fb9021da32e73bd7dec73104eea6a76dd44439,https://api.github.com/repos/pytorch/pytorch/commits/08fb9021da32e73bd7dec73104eea6a76dd44439,2019-03-06T18:50:34Z,5,5,0
17652,2197995274,"{'login': 'facebook-github-bot', 'id': 6422482, 'node_id': 'MDQ6VXNlcjY0MjI0ODI=', 'avatar_url': 'https://avatars3.githubusercontent.com/u/6422482?v=4', 'gravatar_id': '', 'url': 'https://api.github.com/users/facebook-github-bot', 'html_url': 'https://github.com/facebook-github-bot', 'followers_url': 'https://api.github.com/users/facebook-github-bot/followers', 'following_url': 'https://api.github.com/users/facebook-github-bot/following{/other_user}', 'gists_url': 'https://api.github.com/users/facebook-github-bot/gists{/gist_id}', 'starred_url': 'https://api.github.com/users/facebook-github-bot/starred{/owner}{/repo}', 'subscriptions_url': 'https://api.github.com/users/facebook-github-bot/subscriptions', 'organizations_url': 'https://api.github.com/users/facebook-github-bot/orgs', 'repos_url': 'https://api.github.com/users/facebook-github-bot/repos', 'events_url': 'https://api.github.com/users/facebook-github-bot/events{/privacy}', 'received_events_url': 'https://api.github.com/users/facebook-github-bot/received_events', 'type': 'User', 'site_admin': False}",closed,abab9c1d78d6eb0eb9af2bad5212a9707272f305,https://api.github.com/repos/pytorch/pytorch/commits/abab9c1d78d6eb0eb9af2bad5212a9707272f305,2019-03-12T17:54:48Z,144,106,38
17650,2185159024,"{'login': 'facebook-github-bot', 'id': 6422482, 'node_id': 'MDQ6VXNlcjY0MjI0ODI=', 'avatar_url': 'https://avatars3.githubusercontent.com/u/6422482?v=4', 'gravatar_id': '', 'url': 'https://api.github.com/users/facebook-github-bot', 'html_url': 'https://github.com/facebook-github-bot', 'followers_url': 'https://api.github.com/users/facebook-github-bot/followers', 'following_url': 'https://api.github.com/users/facebook-github-bot/following{/other_user}', 'gists_url': 'https://api.github.com/users/facebook-github-bot/gists{/gist_id}', 'starred_url': 'https://api.github.com/users/facebook-github-bot/starred{/owner}{/repo}', 'subscriptions_url': 'https://api.github.com/users/facebook-github-bot/subscriptions', 'organizations_url': 'https://api.github.com/users/facebook-github-bot/orgs', 'repos_url': 'https://api.github.com/users/facebook-github-bot/repos', 'events_url': 'https://api.github.com/users/facebook-github-bot/events{/privacy}', 'received_events_url': 'https://api.github.com/users/facebook-github-bot/received_events', 'type': 'User', 'site_admin': False}",referenced,10ea02facf024ad728c3d80de7c8b8ce0b0099c9,https://api.github.com/repos/pytorch/pytorch/commits/10ea02facf024ad728c3d80de7c8b8ce0b0099c9,2019-03-06T19:27:50Z,27,27,0
17639,2244860165,"{'login': 'facebook-github-bot', 'id': 6422482, 'node_id': 'MDQ6VXNlcjY0MjI0ODI=', 'avatar_url': 'https://avatars3.githubusercontent.com/u/6422482?v=4', 'gravatar_id': '', 'url': 'https://api.github.com/users/facebook-github-bot', 'html_url': 'https://github.com/facebook-github-bot', 'followers_url': 'https://api.github.com/users/facebook-github-bot/followers', 'following_url': 'https://api.github.com/users/facebook-github-bot/following{/other_user}', 'gists_url': 'https://api.github.com/users/facebook-github-bot/gists{/gist_id}', 'starred_url': 'https://api.github.com/users/facebook-github-bot/starred{/owner}{/repo}', 'subscriptions_url': 'https://api.github.com/users/facebook-github-bot/subscriptions', 'organizations_url': 'https://api.github.com/users/facebook-github-bot/orgs', 'repos_url': 'https://api.github.com/users/facebook-github-bot/repos', 'events_url': 'https://api.github.com/users/facebook-github-bot/events{/privacy}', 'received_events_url': 'https://api.github.com/users/facebook-github-bot/received_events', 'type': 'User', 'site_admin': False}",closed,1b25fdbcd0cd838096dbb8aa3943255e96556dc4,https://api.github.com/repos/pytorch/pytorch/commits/1b25fdbcd0cd838096dbb8aa3943255e96556dc4,2019-04-01T23:06:08Z,185,179,6
17609,2196401002,"{'login': 'facebook-github-bot', 'id': 6422482, 'node_id': 'MDQ6VXNlcjY0MjI0ODI=', 'avatar_url': 'https://avatars3.githubusercontent.com/u/6422482?v=4', 'gravatar_id': '', 'url': 'https://api.github.com/users/facebook-github-bot', 'html_url': 'https://github.com/facebook-github-bot', 'followers_url': 'https://api.github.com/users/facebook-github-bot/followers', 'following_url': 'https://api.github.com/users/facebook-github-bot/following{/other_user}', 'gists_url': 'https://api.github.com/users/facebook-github-bot/gists{/gist_id}', 'starred_url': 'https://api.github.com/users/facebook-github-bot/starred{/owner}{/repo}', 'subscriptions_url': 'https://api.github.com/users/facebook-github-bot/subscriptions', 'organizations_url': 'https://api.github.com/users/facebook-github-bot/orgs', 'repos_url': 'https://api.github.com/users/facebook-github-bot/repos', 'events_url': 'https://api.github.com/users/facebook-github-bot/events{/privacy}', 'received_events_url': 'https://api.github.com/users/facebook-github-bot/received_events', 'type': 'User', 'site_admin': False}",referenced,af2e347164462b9ba93a8ed084f5c6e0f5782c91,https://api.github.com/repos/pytorch/pytorch/commits/af2e347164462b9ba93a8ed084f5c6e0f5782c91,2019-03-12T08:52:56Z,45,29,16
17583,2190848826,"{'login': 'facebook-github-bot', 'id': 6422482, 'node_id': 'MDQ6VXNlcjY0MjI0ODI=', 'avatar_url': 'https://avatars3.githubusercontent.com/u/6422482?v=4', 'gravatar_id': '', 'url': 'https://api.github.com/users/facebook-github-bot', 'html_url': 'https://github.com/facebook-github-bot', 'followers_url': 'https://api.github.com/users/facebook-github-bot/followers', 'following_url': 'https://api.github.com/users/facebook-github-bot/following{/other_user}', 'gists_url': 'https://api.github.com/users/facebook-github-bot/gists{/gist_id}', 'starred_url': 'https://api.github.com/users/facebook-github-bot/starred{/owner}{/repo}', 'subscriptions_url': 'https://api.github.com/users/facebook-github-bot/subscriptions', 'organizations_url': 'https://api.github.com/users/facebook-github-bot/orgs', 'repos_url': 'https://api.github.com/users/facebook-github-bot/repos', 'events_url': 'https://api.github.com/users/facebook-github-bot/events{/privacy}', 'received_events_url': 'https://api.github.com/users/facebook-github-bot/received_events', 'type': 'User', 'site_admin': False}",referenced,667763a63add80ac136dc5c138d6f79509744643,https://api.github.com/repos/pytorch/pytorch/commits/667763a63add80ac136dc5c138d6f79509744643,2019-03-08T18:38:54Z,9,6,3
17583,2223959899,"{'login': 'facebook-github-bot', 'id': 6422482, 'node_id': 'MDQ6VXNlcjY0MjI0ODI=', 'avatar_url': 'https://avatars3.githubusercontent.com/u/6422482?v=4', 'gravatar_id': '', 'url': 'https://api.github.com/users/facebook-github-bot', 'html_url': 'https://github.com/facebook-github-bot', 'followers_url': 'https://api.github.com/users/facebook-github-bot/followers', 'following_url': 'https://api.github.com/users/facebook-github-bot/following{/other_user}', 'gists_url': 'https://api.github.com/users/facebook-github-bot/gists{/gist_id}', 'starred_url': 'https://api.github.com/users/facebook-github-bot/starred{/owner}{/repo}', 'subscriptions_url': 'https://api.github.com/users/facebook-github-bot/subscriptions', 'organizations_url': 'https://api.github.com/users/facebook-github-bot/orgs', 'repos_url': 'https://api.github.com/users/facebook-github-bot/repos', 'events_url': 'https://api.github.com/users/facebook-github-bot/events{/privacy}', 'received_events_url': 'https://api.github.com/users/facebook-github-bot/received_events', 'type': 'User', 'site_admin': False}",referenced,3badea6eb3b835814990291368b03fe63cf29e00,https://api.github.com/repos/pytorch/pytorch/commits/3badea6eb3b835814990291368b03fe63cf29e00,2019-03-22T22:31:12Z,41,33,8
17574,2176422413,"{'login': 'facebook-github-bot', 'id': 6422482, 'node_id': 'MDQ6VXNlcjY0MjI0ODI=', 'avatar_url': 'https://avatars3.githubusercontent.com/u/6422482?v=4', 'gravatar_id': '', 'url': 'https://api.github.com/users/facebook-github-bot', 'html_url': 'https://github.com/facebook-github-bot', 'followers_url': 'https://api.github.com/users/facebook-github-bot/followers', 'following_url': 'https://api.github.com/users/facebook-github-bot/following{/other_user}', 'gists_url': 'https://api.github.com/users/facebook-github-bot/gists{/gist_id}', 'starred_url': 'https://api.github.com/users/facebook-github-bot/starred{/owner}{/repo}', 'subscriptions_url': 'https://api.github.com/users/facebook-github-bot/subscriptions', 'organizations_url': 'https://api.github.com/users/facebook-github-bot/orgs', 'repos_url': 'https://api.github.com/users/facebook-github-bot/repos', 'events_url': 'https://api.github.com/users/facebook-github-bot/events{/privacy}', 'received_events_url': 'https://api.github.com/users/facebook-github-bot/received_events', 'type': 'User', 'site_admin': False}",referenced,7a51c03a30100e89ccabb3e517d633ec6f47db76,https://api.github.com/repos/pytorch/pytorch/commits/7a51c03a30100e89ccabb3e517d633ec6f47db76,2019-03-03T18:10:58Z,2,1,1
17572,2317512641,"{'login': 'facebook-github-bot', 'id': 6422482, 'node_id': 'MDQ6VXNlcjY0MjI0ODI=', 'avatar_url': 'https://avatars3.githubusercontent.com/u/6422482?v=4', 'gravatar_id': '', 'url': 'https://api.github.com/users/facebook-github-bot', 'html_url': 'https://github.com/facebook-github-bot', 'followers_url': 'https://api.github.com/users/facebook-github-bot/followers', 'following_url': 'https://api.github.com/users/facebook-github-bot/following{/other_user}', 'gists_url': 'https://api.github.com/users/facebook-github-bot/gists{/gist_id}', 'starred_url': 'https://api.github.com/users/facebook-github-bot/starred{/owner}{/repo}', 'subscriptions_url': 'https://api.github.com/users/facebook-github-bot/subscriptions', 'organizations_url': 'https://api.github.com/users/facebook-github-bot/orgs', 'repos_url': 'https://api.github.com/users/facebook-github-bot/repos', 'events_url': 'https://api.github.com/users/facebook-github-bot/events{/privacy}', 'received_events_url': 'https://api.github.com/users/facebook-github-bot/received_events', 'type': 'User', 'site_admin': False}",closed,0e77c0f5de4d9d8ee63fc040de14578ca4eb6537,https://api.github.com/repos/pytorch/pytorch/commits/0e77c0f5de4d9d8ee63fc040de14578ca4eb6537,2019-05-03T14:15:45Z,2,1,1
17571,2527232633,"{'login': 'facebook-github-bot', 'id': 6422482, 'node_id': 'MDQ6VXNlcjY0MjI0ODI=', 'avatar_url': 'https://avatars3.githubusercontent.com/u/6422482?v=4', 'gravatar_id': '', 'url': 'https://api.github.com/users/facebook-github-bot', 'html_url': 'https://github.com/facebook-github-bot', 'followers_url': 'https://api.github.com/users/facebook-github-bot/followers', 'following_url': 'https://api.github.com/users/facebook-github-bot/following{/other_user}', 'gists_url': 'https://api.github.com/users/facebook-github-bot/gists{/gist_id}', 'starred_url': 'https://api.github.com/users/facebook-github-bot/starred{/owner}{/repo}', 'subscriptions_url': 'https://api.github.com/users/facebook-github-bot/subscriptions', 'organizations_url': 'https://api.github.com/users/facebook-github-bot/orgs', 'repos_url': 'https://api.github.com/users/facebook-github-bot/repos', 'events_url': 'https://api.github.com/users/facebook-github-bot/events{/privacy}', 'received_events_url': 'https://api.github.com/users/facebook-github-bot/received_events', 'type': 'User', 'site_admin': False}",closed,029c8e7754625c4652a169888ea2c5806e043520,https://api.github.com/repos/pytorch/pytorch/commits/029c8e7754625c4652a169888ea2c5806e043520,2019-08-01T16:54:25Z,82,80,2
17558,2205135790,"{'login': 'facebook-github-bot', 'id': 6422482, 'node_id': 'MDQ6VXNlcjY0MjI0ODI=', 'avatar_url': 'https://avatars3.githubusercontent.com/u/6422482?v=4', 'gravatar_id': '', 'url': 'https://api.github.com/users/facebook-github-bot', 'html_url': 'https://github.com/facebook-github-bot', 'followers_url': 'https://api.github.com/users/facebook-github-bot/followers', 'following_url': 'https://api.github.com/users/facebook-github-bot/following{/other_user}', 'gists_url': 'https://api.github.com/users/facebook-github-bot/gists{/gist_id}', 'starred_url': 'https://api.github.com/users/facebook-github-bot/starred{/owner}{/repo}', 'subscriptions_url': 'https://api.github.com/users/facebook-github-bot/subscriptions', 'organizations_url': 'https://api.github.com/users/facebook-github-bot/orgs', 'repos_url': 'https://api.github.com/users/facebook-github-bot/repos', 'events_url': 'https://api.github.com/users/facebook-github-bot/events{/privacy}', 'received_events_url': 'https://api.github.com/users/facebook-github-bot/received_events', 'type': 'User', 'site_admin': False}",closed,e782f200f7a525af4d10ff79d066613d46e23356,https://api.github.com/repos/pytorch/pytorch/commits/e782f200f7a525af4d10ff79d066613d46e23356,2019-03-14T23:57:07Z,14,13,1
17556,2294679274,"{'login': 'facebook-github-bot', 'id': 6422482, 'node_id': 'MDQ6VXNlcjY0MjI0ODI=', 'avatar_url': 'https://avatars3.githubusercontent.com/u/6422482?v=4', 'gravatar_id': '', 'url': 'https://api.github.com/users/facebook-github-bot', 'html_url': 'https://github.com/facebook-github-bot', 'followers_url': 'https://api.github.com/users/facebook-github-bot/followers', 'following_url': 'https://api.github.com/users/facebook-github-bot/following{/other_user}', 'gists_url': 'https://api.github.com/users/facebook-github-bot/gists{/gist_id}', 'starred_url': 'https://api.github.com/users/facebook-github-bot/starred{/owner}{/repo}', 'subscriptions_url': 'https://api.github.com/users/facebook-github-bot/subscriptions', 'organizations_url': 'https://api.github.com/users/facebook-github-bot/orgs', 'repos_url': 'https://api.github.com/users/facebook-github-bot/repos', 'events_url': 'https://api.github.com/users/facebook-github-bot/events{/privacy}', 'received_events_url': 'https://api.github.com/users/facebook-github-bot/received_events', 'type': 'User', 'site_admin': False}",referenced,f767c9ac767bf8b2d87119183dea4149bdbacdf1,https://api.github.com/repos/pytorch/pytorch/commits/f767c9ac767bf8b2d87119183dea4149bdbacdf1,2019-04-23T16:31:31Z,85,55,30
17531,2386054930,"{'login': 'facebook-github-bot', 'id': 6422482, 'node_id': 'MDQ6VXNlcjY0MjI0ODI=', 'avatar_url': 'https://avatars3.githubusercontent.com/u/6422482?v=4', 'gravatar_id': '', 'url': 'https://api.github.com/users/facebook-github-bot', 'html_url': 'https://github.com/facebook-github-bot', 'followers_url': 'https://api.github.com/users/facebook-github-bot/followers', 'following_url': 'https://api.github.com/users/facebook-github-bot/following{/other_user}', 'gists_url': 'https://api.github.com/users/facebook-github-bot/gists{/gist_id}', 'starred_url': 'https://api.github.com/users/facebook-github-bot/starred{/owner}{/repo}', 'subscriptions_url': 'https://api.github.com/users/facebook-github-bot/subscriptions', 'organizations_url': 'https://api.github.com/users/facebook-github-bot/orgs', 'repos_url': 'https://api.github.com/users/facebook-github-bot/repos', 'events_url': 'https://api.github.com/users/facebook-github-bot/events{/privacy}', 'received_events_url': 'https://api.github.com/users/facebook-github-bot/received_events', 'type': 'User', 'site_admin': False}",closed,9a41f447327e146a7b255de1d435992424e3ef6c,https://api.github.com/repos/pytorch/pytorch/commits/9a41f447327e146a7b255de1d435992424e3ef6c,2019-06-03T20:02:41Z,159,150,9
17520,2174545498,"{'login': 'facebook-github-bot', 'id': 6422482, 'node_id': 'MDQ6VXNlcjY0MjI0ODI=', 'avatar_url': 'https://avatars3.githubusercontent.com/u/6422482?v=4', 'gravatar_id': '', 'url': 'https://api.github.com/users/facebook-github-bot', 'html_url': 'https://github.com/facebook-github-bot', 'followers_url': 'https://api.github.com/users/facebook-github-bot/followers', 'following_url': 'https://api.github.com/users/facebook-github-bot/following{/other_user}', 'gists_url': 'https://api.github.com/users/facebook-github-bot/gists{/gist_id}', 'starred_url': 'https://api.github.com/users/facebook-github-bot/starred{/owner}{/repo}', 'subscriptions_url': 'https://api.github.com/users/facebook-github-bot/subscriptions', 'organizations_url': 'https://api.github.com/users/facebook-github-bot/orgs', 'repos_url': 'https://api.github.com/users/facebook-github-bot/repos', 'events_url': 'https://api.github.com/users/facebook-github-bot/events{/privacy}', 'received_events_url': 'https://api.github.com/users/facebook-github-bot/received_events', 'type': 'User', 'site_admin': False}",closed,a6170573c898a1367517d8daf8e777abaf96f752,https://api.github.com/repos/pytorch/pytorch/commits/a6170573c898a1367517d8daf8e777abaf96f752,2019-03-01T16:47:04Z,49,39,10
17492,2297891086,"{'login': 'facebook-github-bot', 'id': 6422482, 'node_id': 'MDQ6VXNlcjY0MjI0ODI=', 'avatar_url': 'https://avatars3.githubusercontent.com/u/6422482?v=4', 'gravatar_id': '', 'url': 'https://api.github.com/users/facebook-github-bot', 'html_url': 'https://github.com/facebook-github-bot', 'followers_url': 'https://api.github.com/users/facebook-github-bot/followers', 'following_url': 'https://api.github.com/users/facebook-github-bot/following{/other_user}', 'gists_url': 'https://api.github.com/users/facebook-github-bot/gists{/gist_id}', 'starred_url': 'https://api.github.com/users/facebook-github-bot/starred{/owner}{/repo}', 'subscriptions_url': 'https://api.github.com/users/facebook-github-bot/subscriptions', 'organizations_url': 'https://api.github.com/users/facebook-github-bot/orgs', 'repos_url': 'https://api.github.com/users/facebook-github-bot/repos', 'events_url': 'https://api.github.com/users/facebook-github-bot/events{/privacy}', 'received_events_url': 'https://api.github.com/users/facebook-github-bot/received_events', 'type': 'User', 'site_admin': False}",closed,41486306d9167050723d2c294bdf2f5cd8da8508,https://api.github.com/repos/pytorch/pytorch/commits/41486306d9167050723d2c294bdf2f5cd8da8508,2019-04-24T17:11:29Z,3068,1953,1115
17489,2166892285,"{'login': 'facebook-github-bot', 'id': 6422482, 'node_id': 'MDQ6VXNlcjY0MjI0ODI=', 'avatar_url': 'https://avatars3.githubusercontent.com/u/6422482?v=4', 'gravatar_id': '', 'url': 'https://api.github.com/users/facebook-github-bot', 'html_url': 'https://github.com/facebook-github-bot', 'followers_url': 'https://api.github.com/users/facebook-github-bot/followers', 'following_url': 'https://api.github.com/users/facebook-github-bot/following{/other_user}', 'gists_url': 'https://api.github.com/users/facebook-github-bot/gists{/gist_id}', 'starred_url': 'https://api.github.com/users/facebook-github-bot/starred{/owner}{/repo}', 'subscriptions_url': 'https://api.github.com/users/facebook-github-bot/subscriptions', 'organizations_url': 'https://api.github.com/users/facebook-github-bot/orgs', 'repos_url': 'https://api.github.com/users/facebook-github-bot/repos', 'events_url': 'https://api.github.com/users/facebook-github-bot/events{/privacy}', 'received_events_url': 'https://api.github.com/users/facebook-github-bot/received_events', 'type': 'User', 'site_admin': False}",closed,96faaa9d50fd4b5d96a9d400a544f8e229c52aa8,https://api.github.com/repos/pytorch/pytorch/commits/96faaa9d50fd4b5d96a9d400a544f8e229c52aa8,2019-02-27T04:38:15Z,4,2,2
17483,2170031258,"{'login': 'facebook-github-bot', 'id': 6422482, 'node_id': 'MDQ6VXNlcjY0MjI0ODI=', 'avatar_url': 'https://avatars3.githubusercontent.com/u/6422482?v=4', 'gravatar_id': '', 'url': 'https://api.github.com/users/facebook-github-bot', 'html_url': 'https://github.com/facebook-github-bot', 'followers_url': 'https://api.github.com/users/facebook-github-bot/followers', 'following_url': 'https://api.github.com/users/facebook-github-bot/following{/other_user}', 'gists_url': 'https://api.github.com/users/facebook-github-bot/gists{/gist_id}', 'starred_url': 'https://api.github.com/users/facebook-github-bot/starred{/owner}{/repo}', 'subscriptions_url': 'https://api.github.com/users/facebook-github-bot/subscriptions', 'organizations_url': 'https://api.github.com/users/facebook-github-bot/orgs', 'repos_url': 'https://api.github.com/users/facebook-github-bot/repos', 'events_url': 'https://api.github.com/users/facebook-github-bot/events{/privacy}', 'received_events_url': 'https://api.github.com/users/facebook-github-bot/received_events', 'type': 'User', 'site_admin': False}",closed,03132c1f56df2124866382f1b3376c09ede0c534,https://api.github.com/repos/pytorch/pytorch/commits/03132c1f56df2124866382f1b3376c09ede0c534,2019-02-28T05:43:38Z,153,112,41
17466,2192382367,"{'login': 'facebook-github-bot', 'id': 6422482, 'node_id': 'MDQ6VXNlcjY0MjI0ODI=', 'avatar_url': 'https://avatars3.githubusercontent.com/u/6422482?v=4', 'gravatar_id': '', 'url': 'https://api.github.com/users/facebook-github-bot', 'html_url': 'https://github.com/facebook-github-bot', 'followers_url': 'https://api.github.com/users/facebook-github-bot/followers', 'following_url': 'https://api.github.com/users/facebook-github-bot/following{/other_user}', 'gists_url': 'https://api.github.com/users/facebook-github-bot/gists{/gist_id}', 'starred_url': 'https://api.github.com/users/facebook-github-bot/starred{/owner}{/repo}', 'subscriptions_url': 'https://api.github.com/users/facebook-github-bot/subscriptions', 'organizations_url': 'https://api.github.com/users/facebook-github-bot/orgs', 'repos_url': 'https://api.github.com/users/facebook-github-bot/repos', 'events_url': 'https://api.github.com/users/facebook-github-bot/events{/privacy}', 'received_events_url': 'https://api.github.com/users/facebook-github-bot/received_events', 'type': 'User', 'site_admin': False}",closed,a6c4ea66dd78b28c9c0aecec64d4cf0b14ba55ff,https://api.github.com/repos/pytorch/pytorch/commits/a6c4ea66dd78b28c9c0aecec64d4cf0b14ba55ff,2019-03-10T16:26:00Z,25,24,1
17449,2179146826,"{'login': 'facebook-github-bot', 'id': 6422482, 'node_id': 'MDQ6VXNlcjY0MjI0ODI=', 'avatar_url': 'https://avatars3.githubusercontent.com/u/6422482?v=4', 'gravatar_id': '', 'url': 'https://api.github.com/users/facebook-github-bot', 'html_url': 'https://github.com/facebook-github-bot', 'followers_url': 'https://api.github.com/users/facebook-github-bot/followers', 'following_url': 'https://api.github.com/users/facebook-github-bot/following{/other_user}', 'gists_url': 'https://api.github.com/users/facebook-github-bot/gists{/gist_id}', 'starred_url': 'https://api.github.com/users/facebook-github-bot/starred{/owner}{/repo}', 'subscriptions_url': 'https://api.github.com/users/facebook-github-bot/subscriptions', 'organizations_url': 'https://api.github.com/users/facebook-github-bot/orgs', 'repos_url': 'https://api.github.com/users/facebook-github-bot/repos', 'events_url': 'https://api.github.com/users/facebook-github-bot/events{/privacy}', 'received_events_url': 'https://api.github.com/users/facebook-github-bot/received_events', 'type': 'User', 'site_admin': False}",closed,173561ff123ecee5df334aac4c104e120984ea55,https://api.github.com/repos/pytorch/pytorch/commits/173561ff123ecee5df334aac4c104e120984ea55,2019-03-04T21:20:21Z,95,70,25
17399,2159940283,"{'login': 'facebook-github-bot', 'id': 6422482, 'node_id': 'MDQ6VXNlcjY0MjI0ODI=', 'avatar_url': 'https://avatars3.githubusercontent.com/u/6422482?v=4', 'gravatar_id': '', 'url': 'https://api.github.com/users/facebook-github-bot', 'html_url': 'https://github.com/facebook-github-bot', 'followers_url': 'https://api.github.com/users/facebook-github-bot/followers', 'following_url': 'https://api.github.com/users/facebook-github-bot/following{/other_user}', 'gists_url': 'https://api.github.com/users/facebook-github-bot/gists{/gist_id}', 'starred_url': 'https://api.github.com/users/facebook-github-bot/starred{/owner}{/repo}', 'subscriptions_url': 'https://api.github.com/users/facebook-github-bot/subscriptions', 'organizations_url': 'https://api.github.com/users/facebook-github-bot/orgs', 'repos_url': 'https://api.github.com/users/facebook-github-bot/repos', 'events_url': 'https://api.github.com/users/facebook-github-bot/events{/privacy}', 'received_events_url': 'https://api.github.com/users/facebook-github-bot/received_events', 'type': 'User', 'site_admin': False}",closed,d76b9395a0588170bfe3f3d7117234e7f2de902d,https://api.github.com/repos/pytorch/pytorch/commits/d76b9395a0588170bfe3f3d7117234e7f2de902d,2019-02-24T05:01:46Z,373,0,373
17362,2158335368,"{'login': 'facebook-github-bot', 'id': 6422482, 'node_id': 'MDQ6VXNlcjY0MjI0ODI=', 'avatar_url': 'https://avatars3.githubusercontent.com/u/6422482?v=4', 'gravatar_id': '', 'url': 'https://api.github.com/users/facebook-github-bot', 'html_url': 'https://github.com/facebook-github-bot', 'followers_url': 'https://api.github.com/users/facebook-github-bot/followers', 'following_url': 'https://api.github.com/users/facebook-github-bot/following{/other_user}', 'gists_url': 'https://api.github.com/users/facebook-github-bot/gists{/gist_id}', 'starred_url': 'https://api.github.com/users/facebook-github-bot/starred{/owner}{/repo}', 'subscriptions_url': 'https://api.github.com/users/facebook-github-bot/subscriptions', 'organizations_url': 'https://api.github.com/users/facebook-github-bot/orgs', 'repos_url': 'https://api.github.com/users/facebook-github-bot/repos', 'events_url': 'https://api.github.com/users/facebook-github-bot/events{/privacy}', 'received_events_url': 'https://api.github.com/users/facebook-github-bot/received_events', 'type': 'User', 'site_admin': False}",closed,3d5968d3661fae5baa52b56af4535a648ca44b27,https://api.github.com/repos/pytorch/pytorch/commits/3d5968d3661fae5baa52b56af4535a648ca44b27,2019-02-22T16:33:02Z,110,80,30
17357,2501251374,"{'login': 'facebook-github-bot', 'id': 6422482, 'node_id': 'MDQ6VXNlcjY0MjI0ODI=', 'avatar_url': 'https://avatars3.githubusercontent.com/u/6422482?v=4', 'gravatar_id': '', 'url': 'https://api.github.com/users/facebook-github-bot', 'html_url': 'https://github.com/facebook-github-bot', 'followers_url': 'https://api.github.com/users/facebook-github-bot/followers', 'following_url': 'https://api.github.com/users/facebook-github-bot/following{/other_user}', 'gists_url': 'https://api.github.com/users/facebook-github-bot/gists{/gist_id}', 'starred_url': 'https://api.github.com/users/facebook-github-bot/starred{/owner}{/repo}', 'subscriptions_url': 'https://api.github.com/users/facebook-github-bot/subscriptions', 'organizations_url': 'https://api.github.com/users/facebook-github-bot/orgs', 'repos_url': 'https://api.github.com/users/facebook-github-bot/repos', 'events_url': 'https://api.github.com/users/facebook-github-bot/events{/privacy}', 'received_events_url': 'https://api.github.com/users/facebook-github-bot/received_events', 'type': 'User', 'site_admin': False}",closed,a6e45a69a8b1efc7ed4eb9d9d10899d0ee164895,https://api.github.com/repos/pytorch/pytorch/commits/a6e45a69a8b1efc7ed4eb9d9d10899d0ee164895,2019-07-22T22:07:31Z,63,60,3
17345,2244959060,"{'login': 'facebook-github-bot', 'id': 6422482, 'node_id': 'MDQ6VXNlcjY0MjI0ODI=', 'avatar_url': 'https://avatars3.githubusercontent.com/u/6422482?v=4', 'gravatar_id': '', 'url': 'https://api.github.com/users/facebook-github-bot', 'html_url': 'https://github.com/facebook-github-bot', 'followers_url': 'https://api.github.com/users/facebook-github-bot/followers', 'following_url': 'https://api.github.com/users/facebook-github-bot/following{/other_user}', 'gists_url': 'https://api.github.com/users/facebook-github-bot/gists{/gist_id}', 'starred_url': 'https://api.github.com/users/facebook-github-bot/starred{/owner}{/repo}', 'subscriptions_url': 'https://api.github.com/users/facebook-github-bot/subscriptions', 'organizations_url': 'https://api.github.com/users/facebook-github-bot/orgs', 'repos_url': 'https://api.github.com/users/facebook-github-bot/repos', 'events_url': 'https://api.github.com/users/facebook-github-bot/events{/privacy}', 'received_events_url': 'https://api.github.com/users/facebook-github-bot/received_events', 'type': 'User', 'site_admin': False}",closed,2e029db2f9a70959c0ba831d9d13e344ddab3c57,https://api.github.com/repos/pytorch/pytorch/commits/2e029db2f9a70959c0ba831d9d13e344ddab3c57,2019-04-02T00:17:51Z,22,20,2
17336,2228282019,"{'login': 'facebook-github-bot', 'id': 6422482, 'node_id': 'MDQ6VXNlcjY0MjI0ODI=', 'avatar_url': 'https://avatars3.githubusercontent.com/u/6422482?v=4', 'gravatar_id': '', 'url': 'https://api.github.com/users/facebook-github-bot', 'html_url': 'https://github.com/facebook-github-bot', 'followers_url': 'https://api.github.com/users/facebook-github-bot/followers', 'following_url': 'https://api.github.com/users/facebook-github-bot/following{/other_user}', 'gists_url': 'https://api.github.com/users/facebook-github-bot/gists{/gist_id}', 'starred_url': 'https://api.github.com/users/facebook-github-bot/starred{/owner}{/repo}', 'subscriptions_url': 'https://api.github.com/users/facebook-github-bot/subscriptions', 'organizations_url': 'https://api.github.com/users/facebook-github-bot/orgs', 'repos_url': 'https://api.github.com/users/facebook-github-bot/repos', 'events_url': 'https://api.github.com/users/facebook-github-bot/events{/privacy}', 'received_events_url': 'https://api.github.com/users/facebook-github-bot/received_events', 'type': 'User', 'site_admin': False}",closed,e1c272797b1078220b3333386450096062acd27f,https://api.github.com/repos/pytorch/pytorch/commits/e1c272797b1078220b3333386450096062acd27f,2019-03-26T01:07:12Z,512,252,260
17332,2172731915,"{'login': 'facebook-github-bot', 'id': 6422482, 'node_id': 'MDQ6VXNlcjY0MjI0ODI=', 'avatar_url': 'https://avatars3.githubusercontent.com/u/6422482?v=4', 'gravatar_id': '', 'url': 'https://api.github.com/users/facebook-github-bot', 'html_url': 'https://github.com/facebook-github-bot', 'followers_url': 'https://api.github.com/users/facebook-github-bot/followers', 'following_url': 'https://api.github.com/users/facebook-github-bot/following{/other_user}', 'gists_url': 'https://api.github.com/users/facebook-github-bot/gists{/gist_id}', 'starred_url': 'https://api.github.com/users/facebook-github-bot/starred{/owner}{/repo}', 'subscriptions_url': 'https://api.github.com/users/facebook-github-bot/subscriptions', 'organizations_url': 'https://api.github.com/users/facebook-github-bot/orgs', 'repos_url': 'https://api.github.com/users/facebook-github-bot/repos', 'events_url': 'https://api.github.com/users/facebook-github-bot/events{/privacy}', 'received_events_url': 'https://api.github.com/users/facebook-github-bot/received_events', 'type': 'User', 'site_admin': False}",closed,6b07612cef8fc2d7c1a0d540a92f066cf7ea82a7,https://api.github.com/repos/pytorch/pytorch/commits/6b07612cef8fc2d7c1a0d540a92f066cf7ea82a7,2019-03-01T00:40:10Z,6,5,1
17322,2158758766,"{'login': 'facebook-github-bot', 'id': 6422482, 'node_id': 'MDQ6VXNlcjY0MjI0ODI=', 'avatar_url': 'https://avatars3.githubusercontent.com/u/6422482?v=4', 'gravatar_id': '', 'url': 'https://api.github.com/users/facebook-github-bot', 'html_url': 'https://github.com/facebook-github-bot', 'followers_url': 'https://api.github.com/users/facebook-github-bot/followers', 'following_url': 'https://api.github.com/users/facebook-github-bot/following{/other_user}', 'gists_url': 'https://api.github.com/users/facebook-github-bot/gists{/gist_id}', 'starred_url': 'https://api.github.com/users/facebook-github-bot/starred{/owner}{/repo}', 'subscriptions_url': 'https://api.github.com/users/facebook-github-bot/subscriptions', 'organizations_url': 'https://api.github.com/users/facebook-github-bot/orgs', 'repos_url': 'https://api.github.com/users/facebook-github-bot/repos', 'events_url': 'https://api.github.com/users/facebook-github-bot/events{/privacy}', 'received_events_url': 'https://api.github.com/users/facebook-github-bot/received_events', 'type': 'User', 'site_admin': False}",closed,dd3acbc6d55e8df70fbbf643ec8510c8338c7398,https://api.github.com/repos/pytorch/pytorch/commits/dd3acbc6d55e8df70fbbf643ec8510c8338c7398,2019-02-22T19:32:13Z,1920,961,959
17274,2153260127,"{'login': 'facebook-github-bot', 'id': 6422482, 'node_id': 'MDQ6VXNlcjY0MjI0ODI=', 'avatar_url': 'https://avatars3.githubusercontent.com/u/6422482?v=4', 'gravatar_id': '', 'url': 'https://api.github.com/users/facebook-github-bot', 'html_url': 'https://github.com/facebook-github-bot', 'followers_url': 'https://api.github.com/users/facebook-github-bot/followers', 'following_url': 'https://api.github.com/users/facebook-github-bot/following{/other_user}', 'gists_url': 'https://api.github.com/users/facebook-github-bot/gists{/gist_id}', 'starred_url': 'https://api.github.com/users/facebook-github-bot/starred{/owner}{/repo}', 'subscriptions_url': 'https://api.github.com/users/facebook-github-bot/subscriptions', 'organizations_url': 'https://api.github.com/users/facebook-github-bot/orgs', 'repos_url': 'https://api.github.com/users/facebook-github-bot/repos', 'events_url': 'https://api.github.com/users/facebook-github-bot/events{/privacy}', 'received_events_url': 'https://api.github.com/users/facebook-github-bot/received_events', 'type': 'User', 'site_admin': False}",closed,36ddad3bfe57572d07945f2a523631b365d5c01b,https://api.github.com/repos/pytorch/pytorch/commits/36ddad3bfe57572d07945f2a523631b365d5c01b,2019-02-20T21:36:52Z,8,4,4
17271,2220950777,"{'login': 'ezyang', 'id': 13564, 'node_id': 'MDQ6VXNlcjEzNTY0', 'avatar_url': 'https://avatars0.githubusercontent.com/u/13564?v=4', 'gravatar_id': '', 'url': 'https://api.github.com/users/ezyang', 'html_url': 'https://github.com/ezyang', 'followers_url': 'https://api.github.com/users/ezyang/followers', 'following_url': 'https://api.github.com/users/ezyang/following{/other_user}', 'gists_url': 'https://api.github.com/users/ezyang/gists{/gist_id}', 'starred_url': 'https://api.github.com/users/ezyang/starred{/owner}{/repo}', 'subscriptions_url': 'https://api.github.com/users/ezyang/subscriptions', 'organizations_url': 'https://api.github.com/users/ezyang/orgs', 'repos_url': 'https://api.github.com/users/ezyang/repos', 'events_url': 'https://api.github.com/users/ezyang/events{/privacy}', 'received_events_url': 'https://api.github.com/users/ezyang/received_events', 'type': 'User', 'site_admin': False}",referenced,5abf16522cf031e79d81ffd88d9c83e354e33347,https://api.github.com/repos/pytorch/pytorch/commits/5abf16522cf031e79d81ffd88d9c83e354e33347,2019-03-21T20:27:49Z,9,9,0
17271,2220951097,"{'login': 'ezyang', 'id': 13564, 'node_id': 'MDQ6VXNlcjEzNTY0', 'avatar_url': 'https://avatars0.githubusercontent.com/u/13564?v=4', 'gravatar_id': '', 'url': 'https://api.github.com/users/ezyang', 'html_url': 'https://github.com/ezyang', 'followers_url': 'https://api.github.com/users/ezyang/followers', 'following_url': 'https://api.github.com/users/ezyang/following{/other_user}', 'gists_url': 'https://api.github.com/users/ezyang/gists{/gist_id}', 'starred_url': 'https://api.github.com/users/ezyang/starred{/owner}{/repo}', 'subscriptions_url': 'https://api.github.com/users/ezyang/subscriptions', 'organizations_url': 'https://api.github.com/users/ezyang/orgs', 'repos_url': 'https://api.github.com/users/ezyang/repos', 'events_url': 'https://api.github.com/users/ezyang/events{/privacy}', 'received_events_url': 'https://api.github.com/users/ezyang/received_events', 'type': 'User', 'site_admin': False}",referenced,5d232c151f9dd99ba12d0fc1e8f7f9a8f6782d91,https://api.github.com/repos/pytorch/pytorch/commits/5d232c151f9dd99ba12d0fc1e8f7f9a8f6782d91,2019-03-21T20:27:56Z,9,9,0
17271,2222745852,"{'login': 'ezyang', 'id': 13564, 'node_id': 'MDQ6VXNlcjEzNTY0', 'avatar_url': 'https://avatars0.githubusercontent.com/u/13564?v=4', 'gravatar_id': '', 'url': 'https://api.github.com/users/ezyang', 'html_url': 'https://github.com/ezyang', 'followers_url': 'https://api.github.com/users/ezyang/followers', 'following_url': 'https://api.github.com/users/ezyang/following{/other_user}', 'gists_url': 'https://api.github.com/users/ezyang/gists{/gist_id}', 'starred_url': 'https://api.github.com/users/ezyang/starred{/owner}{/repo}', 'subscriptions_url': 'https://api.github.com/users/ezyang/subscriptions', 'organizations_url': 'https://api.github.com/users/ezyang/orgs', 'repos_url': 'https://api.github.com/users/ezyang/repos', 'events_url': 'https://api.github.com/users/ezyang/events{/privacy}', 'received_events_url': 'https://api.github.com/users/ezyang/received_events', 'type': 'User', 'site_admin': False}",referenced,d6c0da1549aaaf5574f0f476fa45231f6476016d,https://api.github.com/repos/pytorch/pytorch/commits/d6c0da1549aaaf5574f0f476fa45231f6476016d,2019-03-22T14:11:37Z,1425,886,539
17271,2222746103,"{'login': 'ezyang', 'id': 13564, 'node_id': 'MDQ6VXNlcjEzNTY0', 'avatar_url': 'https://avatars0.githubusercontent.com/u/13564?v=4', 'gravatar_id': '', 'url': 'https://api.github.com/users/ezyang', 'html_url': 'https://github.com/ezyang', 'followers_url': 'https://api.github.com/users/ezyang/followers', 'following_url': 'https://api.github.com/users/ezyang/following{/other_user}', 'gists_url': 'https://api.github.com/users/ezyang/gists{/gist_id}', 'starred_url': 'https://api.github.com/users/ezyang/starred{/owner}{/repo}', 'subscriptions_url': 'https://api.github.com/users/ezyang/subscriptions', 'organizations_url': 'https://api.github.com/users/ezyang/orgs', 'repos_url': 'https://api.github.com/users/ezyang/repos', 'events_url': 'https://api.github.com/users/ezyang/events{/privacy}', 'received_events_url': 'https://api.github.com/users/ezyang/received_events', 'type': 'User', 'site_admin': False}",referenced,a3e96584db0eef7b6202a1211808f9f6e59dd529,https://api.github.com/repos/pytorch/pytorch/commits/a3e96584db0eef7b6202a1211808f9f6e59dd529,2019-03-22T14:11:42Z,9,9,0
17271,2222859039,"{'login': 'facebook-github-bot', 'id': 6422482, 'node_id': 'MDQ6VXNlcjY0MjI0ODI=', 'avatar_url': 'https://avatars3.githubusercontent.com/u/6422482?v=4', 'gravatar_id': '', 'url': 'https://api.github.com/users/facebook-github-bot', 'html_url': 'https://github.com/facebook-github-bot', 'followers_url': 'https://api.github.com/users/facebook-github-bot/followers', 'following_url': 'https://api.github.com/users/facebook-github-bot/following{/other_user}', 'gists_url': 'https://api.github.com/users/facebook-github-bot/gists{/gist_id}', 'starred_url': 'https://api.github.com/users/facebook-github-bot/starred{/owner}{/repo}', 'subscriptions_url': 'https://api.github.com/users/facebook-github-bot/subscriptions', 'organizations_url': 'https://api.github.com/users/facebook-github-bot/orgs', 'repos_url': 'https://api.github.com/users/facebook-github-bot/repos', 'events_url': 'https://api.github.com/users/facebook-github-bot/events{/privacy}', 'received_events_url': 'https://api.github.com/users/facebook-github-bot/received_events', 'type': 'User', 'site_admin': False}",referenced,2934153f3508ac1710f358677d83de72789bb275,https://api.github.com/repos/pytorch/pytorch/commits/2934153f3508ac1710f358677d83de72789bb275,2019-03-22T14:48:31Z,35,25,10
17271,2222871423,"{'login': 'facebook-github-bot', 'id': 6422482, 'node_id': 'MDQ6VXNlcjY0MjI0ODI=', 'avatar_url': 'https://avatars3.githubusercontent.com/u/6422482?v=4', 'gravatar_id': '', 'url': 'https://api.github.com/users/facebook-github-bot', 'html_url': 'https://github.com/facebook-github-bot', 'followers_url': 'https://api.github.com/users/facebook-github-bot/followers', 'following_url': 'https://api.github.com/users/facebook-github-bot/following{/other_user}', 'gists_url': 'https://api.github.com/users/facebook-github-bot/gists{/gist_id}', 'starred_url': 'https://api.github.com/users/facebook-github-bot/starred{/owner}{/repo}', 'subscriptions_url': 'https://api.github.com/users/facebook-github-bot/subscriptions', 'organizations_url': 'https://api.github.com/users/facebook-github-bot/orgs', 'repos_url': 'https://api.github.com/users/facebook-github-bot/repos', 'events_url': 'https://api.github.com/users/facebook-github-bot/events{/privacy}', 'received_events_url': 'https://api.github.com/users/facebook-github-bot/received_events', 'type': 'User', 'site_admin': False}",referenced,e3da16a99eb4b475a90fe424eaf9156c3f7370f4,https://api.github.com/repos/pytorch/pytorch/commits/e3da16a99eb4b475a90fe424eaf9156c3f7370f4,2019-03-22T14:52:21Z,9,9,0
17265,2155810991,"{'login': 'facebook-github-bot', 'id': 6422482, 'node_id': 'MDQ6VXNlcjY0MjI0ODI=', 'avatar_url': 'https://avatars3.githubusercontent.com/u/6422482?v=4', 'gravatar_id': '', 'url': 'https://api.github.com/users/facebook-github-bot', 'html_url': 'https://github.com/facebook-github-bot', 'followers_url': 'https://api.github.com/users/facebook-github-bot/followers', 'following_url': 'https://api.github.com/users/facebook-github-bot/following{/other_user}', 'gists_url': 'https://api.github.com/users/facebook-github-bot/gists{/gist_id}', 'starred_url': 'https://api.github.com/users/facebook-github-bot/starred{/owner}{/repo}', 'subscriptions_url': 'https://api.github.com/users/facebook-github-bot/subscriptions', 'organizations_url': 'https://api.github.com/users/facebook-github-bot/orgs', 'repos_url': 'https://api.github.com/users/facebook-github-bot/repos', 'events_url': 'https://api.github.com/users/facebook-github-bot/events{/privacy}', 'received_events_url': 'https://api.github.com/users/facebook-github-bot/received_events', 'type': 'User', 'site_admin': False}",closed,3069c45069efb12d4e8f88da695ae6374c3a1981,https://api.github.com/repos/pytorch/pytorch/commits/3069c45069efb12d4e8f88da695ae6374c3a1981,2019-02-21T18:27:08Z,22,11,11
17262,2192551630,"{'login': 'facebook-github-bot', 'id': 6422482, 'node_id': 'MDQ6VXNlcjY0MjI0ODI=', 'avatar_url': 'https://avatars3.githubusercontent.com/u/6422482?v=4', 'gravatar_id': '', 'url': 'https://api.github.com/users/facebook-github-bot', 'html_url': 'https://github.com/facebook-github-bot', 'followers_url': 'https://api.github.com/users/facebook-github-bot/followers', 'following_url': 'https://api.github.com/users/facebook-github-bot/following{/other_user}', 'gists_url': 'https://api.github.com/users/facebook-github-bot/gists{/gist_id}', 'starred_url': 'https://api.github.com/users/facebook-github-bot/starred{/owner}{/repo}', 'subscriptions_url': 'https://api.github.com/users/facebook-github-bot/subscriptions', 'organizations_url': 'https://api.github.com/users/facebook-github-bot/orgs', 'repos_url': 'https://api.github.com/users/facebook-github-bot/repos', 'events_url': 'https://api.github.com/users/facebook-github-bot/events{/privacy}', 'received_events_url': 'https://api.github.com/users/facebook-github-bot/received_events', 'type': 'User', 'site_admin': False}",closed,6bcff88d3ea6af9c1b9ed99157a40450ba04088c,https://api.github.com/repos/pytorch/pytorch/commits/6bcff88d3ea6af9c1b9ed99157a40450ba04088c,2019-03-10T22:28:16Z,21,17,4
17262,2471359863,"{'login': 'SsnL', 'id': 5674597, 'node_id': 'MDQ6VXNlcjU2NzQ1OTc=', 'avatar_url': 'https://avatars2.githubusercontent.com/u/5674597?v=4', 'gravatar_id': '', 'url': 'https://api.github.com/users/SsnL', 'html_url': 'https://github.com/SsnL', 'followers_url': 'https://api.github.com/users/SsnL/followers', 'following_url': 'https://api.github.com/users/SsnL/following{/other_user}', 'gists_url': 'https://api.github.com/users/SsnL/gists{/gist_id}', 'starred_url': 'https://api.github.com/users/SsnL/starred{/owner}{/repo}', 'subscriptions_url': 'https://api.github.com/users/SsnL/subscriptions', 'organizations_url': 'https://api.github.com/users/SsnL/orgs', 'repos_url': 'https://api.github.com/users/SsnL/repos', 'events_url': 'https://api.github.com/users/SsnL/events{/privacy}', 'received_events_url': 'https://api.github.com/users/SsnL/received_events', 'type': 'User', 'site_admin': False}",referenced,5a7f5978415fb7a785a87cd50415c4ffe387c364,https://api.github.com/repos/pytorch/pytorch/commits/5a7f5978415fb7a785a87cd50415c4ffe387c364,2019-07-10T05:16:32Z,3,1,2
17262,2473756297,"{'login': 'facebook-github-bot', 'id': 6422482, 'node_id': 'MDQ6VXNlcjY0MjI0ODI=', 'avatar_url': 'https://avatars3.githubusercontent.com/u/6422482?v=4', 'gravatar_id': '', 'url': 'https://api.github.com/users/facebook-github-bot', 'html_url': 'https://github.com/facebook-github-bot', 'followers_url': 'https://api.github.com/users/facebook-github-bot/followers', 'following_url': 'https://api.github.com/users/facebook-github-bot/following{/other_user}', 'gists_url': 'https://api.github.com/users/facebook-github-bot/gists{/gist_id}', 'starred_url': 'https://api.github.com/users/facebook-github-bot/starred{/owner}{/repo}', 'subscriptions_url': 'https://api.github.com/users/facebook-github-bot/subscriptions', 'organizations_url': 'https://api.github.com/users/facebook-github-bot/orgs', 'repos_url': 'https://api.github.com/users/facebook-github-bot/repos', 'events_url': 'https://api.github.com/users/facebook-github-bot/events{/privacy}', 'received_events_url': 'https://api.github.com/users/facebook-github-bot/received_events', 'type': 'User', 'site_admin': False}",referenced,368dbb9ab3228c69b054725f0544d20c6b008ef4,https://api.github.com/repos/pytorch/pytorch/commits/368dbb9ab3228c69b054725f0544d20c6b008ef4,2019-07-10T20:15:13Z,3,1,2
17261,2156440029,"{'login': 'facebook-github-bot', 'id': 6422482, 'node_id': 'MDQ6VXNlcjY0MjI0ODI=', 'avatar_url': 'https://avatars3.githubusercontent.com/u/6422482?v=4', 'gravatar_id': '', 'url': 'https://api.github.com/users/facebook-github-bot', 'html_url': 'https://github.com/facebook-github-bot', 'followers_url': 'https://api.github.com/users/facebook-github-bot/followers', 'following_url': 'https://api.github.com/users/facebook-github-bot/following{/other_user}', 'gists_url': 'https://api.github.com/users/facebook-github-bot/gists{/gist_id}', 'starred_url': 'https://api.github.com/users/facebook-github-bot/starred{/owner}{/repo}', 'subscriptions_url': 'https://api.github.com/users/facebook-github-bot/subscriptions', 'organizations_url': 'https://api.github.com/users/facebook-github-bot/orgs', 'repos_url': 'https://api.github.com/users/facebook-github-bot/repos', 'events_url': 'https://api.github.com/users/facebook-github-bot/events{/privacy}', 'received_events_url': 'https://api.github.com/users/facebook-github-bot/received_events', 'type': 'User', 'site_admin': False}",referenced,5fa78303edcfcc841c30ef27462f80904b3c79a2,https://api.github.com/repos/pytorch/pytorch/commits/5fa78303edcfcc841c30ef27462f80904b3c79a2,2019-02-21T23:00:06Z,15,7,8
17256,2150549860,"{'login': 'facebook-github-bot', 'id': 6422482, 'node_id': 'MDQ6VXNlcjY0MjI0ODI=', 'avatar_url': 'https://avatars3.githubusercontent.com/u/6422482?v=4', 'gravatar_id': '', 'url': 'https://api.github.com/users/facebook-github-bot', 'html_url': 'https://github.com/facebook-github-bot', 'followers_url': 'https://api.github.com/users/facebook-github-bot/followers', 'following_url': 'https://api.github.com/users/facebook-github-bot/following{/other_user}', 'gists_url': 'https://api.github.com/users/facebook-github-bot/gists{/gist_id}', 'starred_url': 'https://api.github.com/users/facebook-github-bot/starred{/owner}{/repo}', 'subscriptions_url': 'https://api.github.com/users/facebook-github-bot/subscriptions', 'organizations_url': 'https://api.github.com/users/facebook-github-bot/orgs', 'repos_url': 'https://api.github.com/users/facebook-github-bot/repos', 'events_url': 'https://api.github.com/users/facebook-github-bot/events{/privacy}', 'received_events_url': 'https://api.github.com/users/facebook-github-bot/received_events', 'type': 'User', 'site_admin': False}",closed,2b57bdb7abd18d1bf89c9b86e8f128146705211a,https://api.github.com/repos/pytorch/pytorch/commits/2b57bdb7abd18d1bf89c9b86e8f128146705211a,2019-02-20T00:43:28Z,29,28,1
17247,2203411858,"{'login': 'facebook-github-bot', 'id': 6422482, 'node_id': 'MDQ6VXNlcjY0MjI0ODI=', 'avatar_url': 'https://avatars3.githubusercontent.com/u/6422482?v=4', 'gravatar_id': '', 'url': 'https://api.github.com/users/facebook-github-bot', 'html_url': 'https://github.com/facebook-github-bot', 'followers_url': 'https://api.github.com/users/facebook-github-bot/followers', 'following_url': 'https://api.github.com/users/facebook-github-bot/following{/other_user}', 'gists_url': 'https://api.github.com/users/facebook-github-bot/gists{/gist_id}', 'starred_url': 'https://api.github.com/users/facebook-github-bot/starred{/owner}{/repo}', 'subscriptions_url': 'https://api.github.com/users/facebook-github-bot/subscriptions', 'organizations_url': 'https://api.github.com/users/facebook-github-bot/orgs', 'repos_url': 'https://api.github.com/users/facebook-github-bot/repos', 'events_url': 'https://api.github.com/users/facebook-github-bot/events{/privacy}', 'received_events_url': 'https://api.github.com/users/facebook-github-bot/received_events', 'type': 'User', 'site_admin': False}",closed,16e50c78e7e06276e972ed8aa38fa5fb561637ec,https://api.github.com/repos/pytorch/pytorch/commits/16e50c78e7e06276e972ed8aa38fa5fb561637ec,2019-03-14T13:37:35Z,97,81,16
17239,2153891047,"{'login': 'facebook-github-bot', 'id': 6422482, 'node_id': 'MDQ6VXNlcjY0MjI0ODI=', 'avatar_url': 'https://avatars3.githubusercontent.com/u/6422482?v=4', 'gravatar_id': '', 'url': 'https://api.github.com/users/facebook-github-bot', 'html_url': 'https://github.com/facebook-github-bot', 'followers_url': 'https://api.github.com/users/facebook-github-bot/followers', 'following_url': 'https://api.github.com/users/facebook-github-bot/following{/other_user}', 'gists_url': 'https://api.github.com/users/facebook-github-bot/gists{/gist_id}', 'starred_url': 'https://api.github.com/users/facebook-github-bot/starred{/owner}{/repo}', 'subscriptions_url': 'https://api.github.com/users/facebook-github-bot/subscriptions', 'organizations_url': 'https://api.github.com/users/facebook-github-bot/orgs', 'repos_url': 'https://api.github.com/users/facebook-github-bot/repos', 'events_url': 'https://api.github.com/users/facebook-github-bot/events{/privacy}', 'received_events_url': 'https://api.github.com/users/facebook-github-bot/received_events', 'type': 'User', 'site_admin': False}",closed,b3b692a80a5bdafc5d305048f1512ccd91f42bc3,https://api.github.com/repos/pytorch/pytorch/commits/b3b692a80a5bdafc5d305048f1512ccd91f42bc3,2019-02-21T04:33:20Z,27,13,14
17229,2247815725,"{'login': 'facebook-github-bot', 'id': 6422482, 'node_id': 'MDQ6VXNlcjY0MjI0ODI=', 'avatar_url': 'https://avatars3.githubusercontent.com/u/6422482?v=4', 'gravatar_id': '', 'url': 'https://api.github.com/users/facebook-github-bot', 'html_url': 'https://github.com/facebook-github-bot', 'followers_url': 'https://api.github.com/users/facebook-github-bot/followers', 'following_url': 'https://api.github.com/users/facebook-github-bot/following{/other_user}', 'gists_url': 'https://api.github.com/users/facebook-github-bot/gists{/gist_id}', 'starred_url': 'https://api.github.com/users/facebook-github-bot/starred{/owner}{/repo}', 'subscriptions_url': 'https://api.github.com/users/facebook-github-bot/subscriptions', 'organizations_url': 'https://api.github.com/users/facebook-github-bot/orgs', 'repos_url': 'https://api.github.com/users/facebook-github-bot/repos', 'events_url': 'https://api.github.com/users/facebook-github-bot/events{/privacy}', 'received_events_url': 'https://api.github.com/users/facebook-github-bot/received_events', 'type': 'User', 'site_admin': False}",closed,2e97c82470966df6942f364102690460ea58403e,https://api.github.com/repos/pytorch/pytorch/commits/2e97c82470966df6942f364102690460ea58403e,2019-04-02T20:29:29Z,288,203,85
17223,2149713535,"{'login': 'facebook-github-bot', 'id': 6422482, 'node_id': 'MDQ6VXNlcjY0MjI0ODI=', 'avatar_url': 'https://avatars3.githubusercontent.com/u/6422482?v=4', 'gravatar_id': '', 'url': 'https://api.github.com/users/facebook-github-bot', 'html_url': 'https://github.com/facebook-github-bot', 'followers_url': 'https://api.github.com/users/facebook-github-bot/followers', 'following_url': 'https://api.github.com/users/facebook-github-bot/following{/other_user}', 'gists_url': 'https://api.github.com/users/facebook-github-bot/gists{/gist_id}', 'starred_url': 'https://api.github.com/users/facebook-github-bot/starred{/owner}{/repo}', 'subscriptions_url': 'https://api.github.com/users/facebook-github-bot/subscriptions', 'organizations_url': 'https://api.github.com/users/facebook-github-bot/orgs', 'repos_url': 'https://api.github.com/users/facebook-github-bot/repos', 'events_url': 'https://api.github.com/users/facebook-github-bot/events{/privacy}', 'received_events_url': 'https://api.github.com/users/facebook-github-bot/received_events', 'type': 'User', 'site_admin': False}",closed,43d5cd4d340c41970244c653aa2d1a5f81246c28,https://api.github.com/repos/pytorch/pytorch/commits/43d5cd4d340c41970244c653aa2d1a5f81246c28,2019-02-19T18:16:15Z,4,2,2
17218,2156355988,"{'login': 'facebook-github-bot', 'id': 6422482, 'node_id': 'MDQ6VXNlcjY0MjI0ODI=', 'avatar_url': 'https://avatars3.githubusercontent.com/u/6422482?v=4', 'gravatar_id': '', 'url': 'https://api.github.com/users/facebook-github-bot', 'html_url': 'https://github.com/facebook-github-bot', 'followers_url': 'https://api.github.com/users/facebook-github-bot/followers', 'following_url': 'https://api.github.com/users/facebook-github-bot/following{/other_user}', 'gists_url': 'https://api.github.com/users/facebook-github-bot/gists{/gist_id}', 'starred_url': 'https://api.github.com/users/facebook-github-bot/starred{/owner}{/repo}', 'subscriptions_url': 'https://api.github.com/users/facebook-github-bot/subscriptions', 'organizations_url': 'https://api.github.com/users/facebook-github-bot/orgs', 'repos_url': 'https://api.github.com/users/facebook-github-bot/repos', 'events_url': 'https://api.github.com/users/facebook-github-bot/events{/privacy}', 'received_events_url': 'https://api.github.com/users/facebook-github-bot/received_events', 'type': 'User', 'site_admin': False}",closed,6feded880ee830841172b301df19896a47c0fc3a,https://api.github.com/repos/pytorch/pytorch/commits/6feded880ee830841172b301df19896a47c0fc3a,2019-02-21T22:18:59Z,2,1,1
17218,2294745575,"{'login': 'facebook-github-bot', 'id': 6422482, 'node_id': 'MDQ6VXNlcjY0MjI0ODI=', 'avatar_url': 'https://avatars3.githubusercontent.com/u/6422482?v=4', 'gravatar_id': '', 'url': 'https://api.github.com/users/facebook-github-bot', 'html_url': 'https://github.com/facebook-github-bot', 'followers_url': 'https://api.github.com/users/facebook-github-bot/followers', 'following_url': 'https://api.github.com/users/facebook-github-bot/following{/other_user}', 'gists_url': 'https://api.github.com/users/facebook-github-bot/gists{/gist_id}', 'starred_url': 'https://api.github.com/users/facebook-github-bot/starred{/owner}{/repo}', 'subscriptions_url': 'https://api.github.com/users/facebook-github-bot/subscriptions', 'organizations_url': 'https://api.github.com/users/facebook-github-bot/orgs', 'repos_url': 'https://api.github.com/users/facebook-github-bot/repos', 'events_url': 'https://api.github.com/users/facebook-github-bot/events{/privacy}', 'received_events_url': 'https://api.github.com/users/facebook-github-bot/received_events', 'type': 'User', 'site_admin': False}",referenced,7a4189696f0cf7b4bda643d1b565736e3a6df324,https://api.github.com/repos/pytorch/pytorch/commits/7a4189696f0cf7b4bda643d1b565736e3a6df324,2019-04-23T16:56:42Z,25,19,6
17210,2148733574,"{'login': 'facebook-github-bot', 'id': 6422482, 'node_id': 'MDQ6VXNlcjY0MjI0ODI=', 'avatar_url': 'https://avatars3.githubusercontent.com/u/6422482?v=4', 'gravatar_id': '', 'url': 'https://api.github.com/users/facebook-github-bot', 'html_url': 'https://github.com/facebook-github-bot', 'followers_url': 'https://api.github.com/users/facebook-github-bot/followers', 'following_url': 'https://api.github.com/users/facebook-github-bot/following{/other_user}', 'gists_url': 'https://api.github.com/users/facebook-github-bot/gists{/gist_id}', 'starred_url': 'https://api.github.com/users/facebook-github-bot/starred{/owner}{/repo}', 'subscriptions_url': 'https://api.github.com/users/facebook-github-bot/subscriptions', 'organizations_url': 'https://api.github.com/users/facebook-github-bot/orgs', 'repos_url': 'https://api.github.com/users/facebook-github-bot/repos', 'events_url': 'https://api.github.com/users/facebook-github-bot/events{/privacy}', 'received_events_url': 'https://api.github.com/users/facebook-github-bot/received_events', 'type': 'User', 'site_admin': False}",closed,fad9eda7fbbeea08c810d2d048a41fd9b23f38fe,https://api.github.com/repos/pytorch/pytorch/commits/fad9eda7fbbeea08c810d2d048a41fd9b23f38fe,2019-02-19T12:40:58Z,26,24,2
17206,2155424467,"{'login': 'facebook-github-bot', 'id': 6422482, 'node_id': 'MDQ6VXNlcjY0MjI0ODI=', 'avatar_url': 'https://avatars3.githubusercontent.com/u/6422482?v=4', 'gravatar_id': '', 'url': 'https://api.github.com/users/facebook-github-bot', 'html_url': 'https://github.com/facebook-github-bot', 'followers_url': 'https://api.github.com/users/facebook-github-bot/followers', 'following_url': 'https://api.github.com/users/facebook-github-bot/following{/other_user}', 'gists_url': 'https://api.github.com/users/facebook-github-bot/gists{/gist_id}', 'starred_url': 'https://api.github.com/users/facebook-github-bot/starred{/owner}{/repo}', 'subscriptions_url': 'https://api.github.com/users/facebook-github-bot/subscriptions', 'organizations_url': 'https://api.github.com/users/facebook-github-bot/orgs', 'repos_url': 'https://api.github.com/users/facebook-github-bot/repos', 'events_url': 'https://api.github.com/users/facebook-github-bot/events{/privacy}', 'received_events_url': 'https://api.github.com/users/facebook-github-bot/received_events', 'type': 'User', 'site_admin': False}",referenced,de81a2741f400bbce23c87bedcdc606aa56012c0,https://api.github.com/repos/pytorch/pytorch/commits/de81a2741f400bbce23c87bedcdc606aa56012c0,2019-02-21T16:06:01Z,33,31,2
17179,2723102100,"{'login': 'eellison', 'id': 11477974, 'node_id': 'MDQ6VXNlcjExNDc3OTc0', 'avatar_url': 'https://avatars2.githubusercontent.com/u/11477974?v=4', 'gravatar_id': '', 'url': 'https://api.github.com/users/eellison', 'html_url': 'https://github.com/eellison', 'followers_url': 'https://api.github.com/users/eellison/followers', 'following_url': 'https://api.github.com/users/eellison/following{/other_user}', 'gists_url': 'https://api.github.com/users/eellison/gists{/gist_id}', 'starred_url': 'https://api.github.com/users/eellison/starred{/owner}{/repo}', 'subscriptions_url': 'https://api.github.com/users/eellison/subscriptions', 'organizations_url': 'https://api.github.com/users/eellison/orgs', 'repos_url': 'https://api.github.com/users/eellison/repos', 'events_url': 'https://api.github.com/users/eellison/events{/privacy}', 'received_events_url': 'https://api.github.com/users/eellison/received_events', 'type': 'User', 'site_admin': False}",referenced,c9d7be8096b2ac45a54572cf9f10db9763e398f3,https://api.github.com/repos/pytorch/pytorch/commits/c9d7be8096b2ac45a54572cf9f10db9763e398f3,2019-10-17T23:55:00Z,58,30,28
17179,2723105074,"{'login': 'eellison', 'id': 11477974, 'node_id': 'MDQ6VXNlcjExNDc3OTc0', 'avatar_url': 'https://avatars2.githubusercontent.com/u/11477974?v=4', 'gravatar_id': '', 'url': 'https://api.github.com/users/eellison', 'html_url': 'https://github.com/eellison', 'followers_url': 'https://api.github.com/users/eellison/followers', 'following_url': 'https://api.github.com/users/eellison/following{/other_user}', 'gists_url': 'https://api.github.com/users/eellison/gists{/gist_id}', 'starred_url': 'https://api.github.com/users/eellison/starred{/owner}{/repo}', 'subscriptions_url': 'https://api.github.com/users/eellison/subscriptions', 'organizations_url': 'https://api.github.com/users/eellison/orgs', 'repos_url': 'https://api.github.com/users/eellison/repos', 'events_url': 'https://api.github.com/users/eellison/events{/privacy}', 'received_events_url': 'https://api.github.com/users/eellison/received_events', 'type': 'User', 'site_admin': False}",referenced,161058c47212f9500c8b335b709f8cdc5e635498,https://api.github.com/repos/pytorch/pytorch/commits/161058c47212f9500c8b335b709f8cdc5e635498,2019-10-17T23:57:08Z,31,13,18
17179,2732008794,"{'login': 'eellison', 'id': 11477974, 'node_id': 'MDQ6VXNlcjExNDc3OTc0', 'avatar_url': 'https://avatars2.githubusercontent.com/u/11477974?v=4', 'gravatar_id': '', 'url': 'https://api.github.com/users/eellison', 'html_url': 'https://github.com/eellison', 'followers_url': 'https://api.github.com/users/eellison/followers', 'following_url': 'https://api.github.com/users/eellison/following{/other_user}', 'gists_url': 'https://api.github.com/users/eellison/gists{/gist_id}', 'starred_url': 'https://api.github.com/users/eellison/starred{/owner}{/repo}', 'subscriptions_url': 'https://api.github.com/users/eellison/subscriptions', 'organizations_url': 'https://api.github.com/users/eellison/orgs', 'repos_url': 'https://api.github.com/users/eellison/repos', 'events_url': 'https://api.github.com/users/eellison/events{/privacy}', 'received_events_url': 'https://api.github.com/users/eellison/received_events', 'type': 'User', 'site_admin': False}",referenced,9a0717a5b286ef4e40e99bf5f6de97ba685a73d0,https://api.github.com/repos/pytorch/pytorch/commits/9a0717a5b286ef4e40e99bf5f6de97ba685a73d0,2019-10-22T05:30:18Z,10,5,5
17179,2732069714,"{'login': 'eellison', 'id': 11477974, 'node_id': 'MDQ6VXNlcjExNDc3OTc0', 'avatar_url': 'https://avatars2.githubusercontent.com/u/11477974?v=4', 'gravatar_id': '', 'url': 'https://api.github.com/users/eellison', 'html_url': 'https://github.com/eellison', 'followers_url': 'https://api.github.com/users/eellison/followers', 'following_url': 'https://api.github.com/users/eellison/following{/other_user}', 'gists_url': 'https://api.github.com/users/eellison/gists{/gist_id}', 'starred_url': 'https://api.github.com/users/eellison/starred{/owner}{/repo}', 'subscriptions_url': 'https://api.github.com/users/eellison/subscriptions', 'organizations_url': 'https://api.github.com/users/eellison/orgs', 'repos_url': 'https://api.github.com/users/eellison/repos', 'events_url': 'https://api.github.com/users/eellison/events{/privacy}', 'received_events_url': 'https://api.github.com/users/eellison/received_events', 'type': 'User', 'site_admin': False}",referenced,55b5d1246271fcccc5b5f9d3a28ad1d6d57a0aa9,https://api.github.com/repos/pytorch/pytorch/commits/55b5d1246271fcccc5b5f9d3a28ad1d6d57a0aa9,2019-10-22T06:11:51Z,26369,17296,9073
17179,2753951363,"{'login': 'eellison', 'id': 11477974, 'node_id': 'MDQ6VXNlcjExNDc3OTc0', 'avatar_url': 'https://avatars2.githubusercontent.com/u/11477974?v=4', 'gravatar_id': '', 'url': 'https://api.github.com/users/eellison', 'html_url': 'https://github.com/eellison', 'followers_url': 'https://api.github.com/users/eellison/followers', 'following_url': 'https://api.github.com/users/eellison/following{/other_user}', 'gists_url': 'https://api.github.com/users/eellison/gists{/gist_id}', 'starred_url': 'https://api.github.com/users/eellison/starred{/owner}{/repo}', 'subscriptions_url': 'https://api.github.com/users/eellison/subscriptions', 'organizations_url': 'https://api.github.com/users/eellison/orgs', 'repos_url': 'https://api.github.com/users/eellison/repos', 'events_url': 'https://api.github.com/users/eellison/events{/privacy}', 'received_events_url': 'https://api.github.com/users/eellison/received_events', 'type': 'User', 'site_admin': False}",referenced,529485fd81efa7218ad2c35994a83977c86004c6,https://api.github.com/repos/pytorch/pytorch/commits/529485fd81efa7218ad2c35994a83977c86004c6,2019-10-29T21:56:39Z,329,181,148
17179,2754178583,"{'login': 'eellison', 'id': 11477974, 'node_id': 'MDQ6VXNlcjExNDc3OTc0', 'avatar_url': 'https://avatars2.githubusercontent.com/u/11477974?v=4', 'gravatar_id': '', 'url': 'https://api.github.com/users/eellison', 'html_url': 'https://github.com/eellison', 'followers_url': 'https://api.github.com/users/eellison/followers', 'following_url': 'https://api.github.com/users/eellison/following{/other_user}', 'gists_url': 'https://api.github.com/users/eellison/gists{/gist_id}', 'starred_url': 'https://api.github.com/users/eellison/starred{/owner}{/repo}', 'subscriptions_url': 'https://api.github.com/users/eellison/subscriptions', 'organizations_url': 'https://api.github.com/users/eellison/orgs', 'repos_url': 'https://api.github.com/users/eellison/repos', 'events_url': 'https://api.github.com/users/eellison/events{/privacy}', 'received_events_url': 'https://api.github.com/users/eellison/received_events', 'type': 'User', 'site_admin': False}",referenced,28999ca98a72040c70ff88617a8fea0f25ba696e,https://api.github.com/repos/pytorch/pytorch/commits/28999ca98a72040c70ff88617a8fea0f25ba696e,2019-10-29T23:46:04Z,18075,12158,5917
17179,2757107669,"{'login': 'eellison', 'id': 11477974, 'node_id': 'MDQ6VXNlcjExNDc3OTc0', 'avatar_url': 'https://avatars2.githubusercontent.com/u/11477974?v=4', 'gravatar_id': '', 'url': 'https://api.github.com/users/eellison', 'html_url': 'https://github.com/eellison', 'followers_url': 'https://api.github.com/users/eellison/followers', 'following_url': 'https://api.github.com/users/eellison/following{/other_user}', 'gists_url': 'https://api.github.com/users/eellison/gists{/gist_id}', 'starred_url': 'https://api.github.com/users/eellison/starred{/owner}{/repo}', 'subscriptions_url': 'https://api.github.com/users/eellison/subscriptions', 'organizations_url': 'https://api.github.com/users/eellison/orgs', 'repos_url': 'https://api.github.com/users/eellison/repos', 'events_url': 'https://api.github.com/users/eellison/events{/privacy}', 'received_events_url': 'https://api.github.com/users/eellison/received_events', 'type': 'User', 'site_admin': False}",referenced,7b7694988ab9fb9e4cbaac25a62d012cda7ea5f7,https://api.github.com/repos/pytorch/pytorch/commits/7b7694988ab9fb9e4cbaac25a62d012cda7ea5f7,2019-10-30T18:08:40Z,5,3,2
17179,2757369545,"{'login': 'eellison', 'id': 11477974, 'node_id': 'MDQ6VXNlcjExNDc3OTc0', 'avatar_url': 'https://avatars2.githubusercontent.com/u/11477974?v=4', 'gravatar_id': '', 'url': 'https://api.github.com/users/eellison', 'html_url': 'https://github.com/eellison', 'followers_url': 'https://api.github.com/users/eellison/followers', 'following_url': 'https://api.github.com/users/eellison/following{/other_user}', 'gists_url': 'https://api.github.com/users/eellison/gists{/gist_id}', 'starred_url': 'https://api.github.com/users/eellison/starred{/owner}{/repo}', 'subscriptions_url': 'https://api.github.com/users/eellison/subscriptions', 'organizations_url': 'https://api.github.com/users/eellison/orgs', 'repos_url': 'https://api.github.com/users/eellison/repos', 'events_url': 'https://api.github.com/users/eellison/events{/privacy}', 'received_events_url': 'https://api.github.com/users/eellison/received_events', 'type': 'User', 'site_admin': False}",referenced,ba400d612bf82d349e57eb466fbd5fe6dcec356c,https://api.github.com/repos/pytorch/pytorch/commits/ba400d612bf82d349e57eb466fbd5fe6dcec356c,2019-10-30T19:31:28Z,13,7,6
17179,2764247608,"{'login': 'eellison', 'id': 11477974, 'node_id': 'MDQ6VXNlcjExNDc3OTc0', 'avatar_url': 'https://avatars2.githubusercontent.com/u/11477974?v=4', 'gravatar_id': '', 'url': 'https://api.github.com/users/eellison', 'html_url': 'https://github.com/eellison', 'followers_url': 'https://api.github.com/users/eellison/followers', 'following_url': 'https://api.github.com/users/eellison/following{/other_user}', 'gists_url': 'https://api.github.com/users/eellison/gists{/gist_id}', 'starred_url': 'https://api.github.com/users/eellison/starred{/owner}{/repo}', 'subscriptions_url': 'https://api.github.com/users/eellison/subscriptions', 'organizations_url': 'https://api.github.com/users/eellison/orgs', 'repos_url': 'https://api.github.com/users/eellison/repos', 'events_url': 'https://api.github.com/users/eellison/events{/privacy}', 'received_events_url': 'https://api.github.com/users/eellison/received_events', 'type': 'User', 'site_admin': False}",referenced,e896c200b37beaf42d3579862669802a3e1fda76,https://api.github.com/repos/pytorch/pytorch/commits/e896c200b37beaf42d3579862669802a3e1fda76,2019-11-01T19:25:41Z,168,76,92
17179,2764370543,"{'login': 'eellison', 'id': 11477974, 'node_id': 'MDQ6VXNlcjExNDc3OTc0', 'avatar_url': 'https://avatars2.githubusercontent.com/u/11477974?v=4', 'gravatar_id': '', 'url': 'https://api.github.com/users/eellison', 'html_url': 'https://github.com/eellison', 'followers_url': 'https://api.github.com/users/eellison/followers', 'following_url': 'https://api.github.com/users/eellison/following{/other_user}', 'gists_url': 'https://api.github.com/users/eellison/gists{/gist_id}', 'starred_url': 'https://api.github.com/users/eellison/starred{/owner}{/repo}', 'subscriptions_url': 'https://api.github.com/users/eellison/subscriptions', 'organizations_url': 'https://api.github.com/users/eellison/orgs', 'repos_url': 'https://api.github.com/users/eellison/repos', 'events_url': 'https://api.github.com/users/eellison/events{/privacy}', 'received_events_url': 'https://api.github.com/users/eellison/received_events', 'type': 'User', 'site_admin': False}",referenced,f44f42cb565e07e333132b63c708243f0a03c93b,https://api.github.com/repos/pytorch/pytorch/commits/f44f42cb565e07e333132b63c708243f0a03c93b,2019-11-01T20:17:17Z,13,5,8
17179,2768541601,"{'login': 'facebook-github-bot', 'id': 6422482, 'node_id': 'MDQ6VXNlcjY0MjI0ODI=', 'avatar_url': 'https://avatars3.githubusercontent.com/u/6422482?v=4', 'gravatar_id': '', 'url': 'https://api.github.com/users/facebook-github-bot', 'html_url': 'https://github.com/facebook-github-bot', 'followers_url': 'https://api.github.com/users/facebook-github-bot/followers', 'following_url': 'https://api.github.com/users/facebook-github-bot/following{/other_user}', 'gists_url': 'https://api.github.com/users/facebook-github-bot/gists{/gist_id}', 'starred_url': 'https://api.github.com/users/facebook-github-bot/starred{/owner}{/repo}', 'subscriptions_url': 'https://api.github.com/users/facebook-github-bot/subscriptions', 'organizations_url': 'https://api.github.com/users/facebook-github-bot/orgs', 'repos_url': 'https://api.github.com/users/facebook-github-bot/repos', 'events_url': 'https://api.github.com/users/facebook-github-bot/events{/privacy}', 'received_events_url': 'https://api.github.com/users/facebook-github-bot/received_events', 'type': 'User', 'site_admin': False}",referenced,fdeef45852578a068a62abba253a87aab857dc5f,https://api.github.com/repos/pytorch/pytorch/commits/fdeef45852578a068a62abba253a87aab857dc5f,2019-11-04T17:19:52Z,779,555,224
17161,2185020065,"{'login': 'facebook-github-bot', 'id': 6422482, 'node_id': 'MDQ6VXNlcjY0MjI0ODI=', 'avatar_url': 'https://avatars3.githubusercontent.com/u/6422482?v=4', 'gravatar_id': '', 'url': 'https://api.github.com/users/facebook-github-bot', 'html_url': 'https://github.com/facebook-github-bot', 'followers_url': 'https://api.github.com/users/facebook-github-bot/followers', 'following_url': 'https://api.github.com/users/facebook-github-bot/following{/other_user}', 'gists_url': 'https://api.github.com/users/facebook-github-bot/gists{/gist_id}', 'starred_url': 'https://api.github.com/users/facebook-github-bot/starred{/owner}{/repo}', 'subscriptions_url': 'https://api.github.com/users/facebook-github-bot/subscriptions', 'organizations_url': 'https://api.github.com/users/facebook-github-bot/orgs', 'repos_url': 'https://api.github.com/users/facebook-github-bot/repos', 'events_url': 'https://api.github.com/users/facebook-github-bot/events{/privacy}', 'received_events_url': 'https://api.github.com/users/facebook-github-bot/received_events', 'type': 'User', 'site_admin': False}",closed,886e482776ffe5c30b7cf606d1ba20f042b4a1b6,https://api.github.com/repos/pytorch/pytorch/commits/886e482776ffe5c30b7cf606d1ba20f042b4a1b6,2019-03-06T18:35:03Z,46,28,18
17152,2169044479,"{'login': 'facebook-github-bot', 'id': 6422482, 'node_id': 'MDQ6VXNlcjY0MjI0ODI=', 'avatar_url': 'https://avatars3.githubusercontent.com/u/6422482?v=4', 'gravatar_id': '', 'url': 'https://api.github.com/users/facebook-github-bot', 'html_url': 'https://github.com/facebook-github-bot', 'followers_url': 'https://api.github.com/users/facebook-github-bot/followers', 'following_url': 'https://api.github.com/users/facebook-github-bot/following{/other_user}', 'gists_url': 'https://api.github.com/users/facebook-github-bot/gists{/gist_id}', 'starred_url': 'https://api.github.com/users/facebook-github-bot/starred{/owner}{/repo}', 'subscriptions_url': 'https://api.github.com/users/facebook-github-bot/subscriptions', 'organizations_url': 'https://api.github.com/users/facebook-github-bot/orgs', 'repos_url': 'https://api.github.com/users/facebook-github-bot/repos', 'events_url': 'https://api.github.com/users/facebook-github-bot/events{/privacy}', 'received_events_url': 'https://api.github.com/users/facebook-github-bot/received_events', 'type': 'User', 'site_admin': False}",referenced,b4572668b48b746802580263dafa12762d202379,https://api.github.com/repos/pytorch/pytorch/commits/b4572668b48b746802580263dafa12762d202379,2019-02-27T19:44:18Z,95,81,14
17144,2151597299,"{'login': 'facebook-github-bot', 'id': 6422482, 'node_id': 'MDQ6VXNlcjY0MjI0ODI=', 'avatar_url': 'https://avatars3.githubusercontent.com/u/6422482?v=4', 'gravatar_id': '', 'url': 'https://api.github.com/users/facebook-github-bot', 'html_url': 'https://github.com/facebook-github-bot', 'followers_url': 'https://api.github.com/users/facebook-github-bot/followers', 'following_url': 'https://api.github.com/users/facebook-github-bot/following{/other_user}', 'gists_url': 'https://api.github.com/users/facebook-github-bot/gists{/gist_id}', 'starred_url': 'https://api.github.com/users/facebook-github-bot/starred{/owner}{/repo}', 'subscriptions_url': 'https://api.github.com/users/facebook-github-bot/subscriptions', 'organizations_url': 'https://api.github.com/users/facebook-github-bot/orgs', 'repos_url': 'https://api.github.com/users/facebook-github-bot/repos', 'events_url': 'https://api.github.com/users/facebook-github-bot/events{/privacy}', 'received_events_url': 'https://api.github.com/users/facebook-github-bot/received_events', 'type': 'User', 'site_admin': False}",closed,237e5438f532418ecb465ca7209e3e2241e32501,https://api.github.com/repos/pytorch/pytorch/commits/237e5438f532418ecb465ca7209e3e2241e32501,2019-02-20T11:12:31Z,18,17,1
17140,2154212285,"{'login': 'facebook-github-bot', 'id': 6422482, 'node_id': 'MDQ6VXNlcjY0MjI0ODI=', 'avatar_url': 'https://avatars3.githubusercontent.com/u/6422482?v=4', 'gravatar_id': '', 'url': 'https://api.github.com/users/facebook-github-bot', 'html_url': 'https://github.com/facebook-github-bot', 'followers_url': 'https://api.github.com/users/facebook-github-bot/followers', 'following_url': 'https://api.github.com/users/facebook-github-bot/following{/other_user}', 'gists_url': 'https://api.github.com/users/facebook-github-bot/gists{/gist_id}', 'starred_url': 'https://api.github.com/users/facebook-github-bot/starred{/owner}{/repo}', 'subscriptions_url': 'https://api.github.com/users/facebook-github-bot/subscriptions', 'organizations_url': 'https://api.github.com/users/facebook-github-bot/orgs', 'repos_url': 'https://api.github.com/users/facebook-github-bot/repos', 'events_url': 'https://api.github.com/users/facebook-github-bot/events{/privacy}', 'received_events_url': 'https://api.github.com/users/facebook-github-bot/received_events', 'type': 'User', 'site_admin': False}",closed,2c302b6ea68eb9024f5f1b9cdc41e3bf39556fa2,https://api.github.com/repos/pytorch/pytorch/commits/2c302b6ea68eb9024f5f1b9cdc41e3bf39556fa2,2019-02-21T08:20:25Z,22,22,0
17130,2143348555,"{'login': 'facebook-github-bot', 'id': 6422482, 'node_id': 'MDQ6VXNlcjY0MjI0ODI=', 'avatar_url': 'https://avatars3.githubusercontent.com/u/6422482?v=4', 'gravatar_id': '', 'url': 'https://api.github.com/users/facebook-github-bot', 'html_url': 'https://github.com/facebook-github-bot', 'followers_url': 'https://api.github.com/users/facebook-github-bot/followers', 'following_url': 'https://api.github.com/users/facebook-github-bot/following{/other_user}', 'gists_url': 'https://api.github.com/users/facebook-github-bot/gists{/gist_id}', 'starred_url': 'https://api.github.com/users/facebook-github-bot/starred{/owner}{/repo}', 'subscriptions_url': 'https://api.github.com/users/facebook-github-bot/subscriptions', 'organizations_url': 'https://api.github.com/users/facebook-github-bot/orgs', 'repos_url': 'https://api.github.com/users/facebook-github-bot/repos', 'events_url': 'https://api.github.com/users/facebook-github-bot/events{/privacy}', 'received_events_url': 'https://api.github.com/users/facebook-github-bot/received_events', 'type': 'User', 'site_admin': False}",closed,326c891d32e3a786b350c2f08bc296106d73739c,https://api.github.com/repos/pytorch/pytorch/commits/326c891d32e3a786b350c2f08bc296106d73739c,2019-02-15T19:25:58Z,2,1,1
17112,2172317261,"{'login': 'facebook-github-bot', 'id': 6422482, 'node_id': 'MDQ6VXNlcjY0MjI0ODI=', 'avatar_url': 'https://avatars3.githubusercontent.com/u/6422482?v=4', 'gravatar_id': '', 'url': 'https://api.github.com/users/facebook-github-bot', 'html_url': 'https://github.com/facebook-github-bot', 'followers_url': 'https://api.github.com/users/facebook-github-bot/followers', 'following_url': 'https://api.github.com/users/facebook-github-bot/following{/other_user}', 'gists_url': 'https://api.github.com/users/facebook-github-bot/gists{/gist_id}', 'starred_url': 'https://api.github.com/users/facebook-github-bot/starred{/owner}{/repo}', 'subscriptions_url': 'https://api.github.com/users/facebook-github-bot/subscriptions', 'organizations_url': 'https://api.github.com/users/facebook-github-bot/orgs', 'repos_url': 'https://api.github.com/users/facebook-github-bot/repos', 'events_url': 'https://api.github.com/users/facebook-github-bot/events{/privacy}', 'received_events_url': 'https://api.github.com/users/facebook-github-bot/received_events', 'type': 'User', 'site_admin': False}",closed,2e5a8cee82b21b917d3d5cf6b77577f798b596a5,https://api.github.com/repos/pytorch/pytorch/commits/2e5a8cee82b21b917d3d5cf6b77577f798b596a5,2019-02-28T21:09:06Z,154,154,0
17106,2191420720,"{'login': 'facebook-github-bot', 'id': 6422482, 'node_id': 'MDQ6VXNlcjY0MjI0ODI=', 'avatar_url': 'https://avatars3.githubusercontent.com/u/6422482?v=4', 'gravatar_id': '', 'url': 'https://api.github.com/users/facebook-github-bot', 'html_url': 'https://github.com/facebook-github-bot', 'followers_url': 'https://api.github.com/users/facebook-github-bot/followers', 'following_url': 'https://api.github.com/users/facebook-github-bot/following{/other_user}', 'gists_url': 'https://api.github.com/users/facebook-github-bot/gists{/gist_id}', 'starred_url': 'https://api.github.com/users/facebook-github-bot/starred{/owner}{/repo}', 'subscriptions_url': 'https://api.github.com/users/facebook-github-bot/subscriptions', 'organizations_url': 'https://api.github.com/users/facebook-github-bot/orgs', 'repos_url': 'https://api.github.com/users/facebook-github-bot/repos', 'events_url': 'https://api.github.com/users/facebook-github-bot/events{/privacy}', 'received_events_url': 'https://api.github.com/users/facebook-github-bot/received_events', 'type': 'User', 'site_admin': False}",closed,0955592243b8ed122a14ab6c1cd8e02ed49ec6d9,https://api.github.com/repos/pytorch/pytorch/commits/0955592243b8ed122a14ab6c1cd8e02ed49ec6d9,2019-03-08T23:31:48Z,2,1,1
17101,2197148554,"{'login': 'facebook-github-bot', 'id': 6422482, 'node_id': 'MDQ6VXNlcjY0MjI0ODI=', 'avatar_url': 'https://avatars3.githubusercontent.com/u/6422482?v=4', 'gravatar_id': '', 'url': 'https://api.github.com/users/facebook-github-bot', 'html_url': 'https://github.com/facebook-github-bot', 'followers_url': 'https://api.github.com/users/facebook-github-bot/followers', 'following_url': 'https://api.github.com/users/facebook-github-bot/following{/other_user}', 'gists_url': 'https://api.github.com/users/facebook-github-bot/gists{/gist_id}', 'starred_url': 'https://api.github.com/users/facebook-github-bot/starred{/owner}{/repo}', 'subscriptions_url': 'https://api.github.com/users/facebook-github-bot/subscriptions', 'organizations_url': 'https://api.github.com/users/facebook-github-bot/orgs', 'repos_url': 'https://api.github.com/users/facebook-github-bot/repos', 'events_url': 'https://api.github.com/users/facebook-github-bot/events{/privacy}', 'received_events_url': 'https://api.github.com/users/facebook-github-bot/received_events', 'type': 'User', 'site_admin': False}",closed,12d6725c15207e05c6d01e3d5b062db2f16fb5e9,https://api.github.com/repos/pytorch/pytorch/commits/12d6725c15207e05c6d01e3d5b062db2f16fb5e9,2019-03-12T13:37:12Z,6,3,3
17065,2143326179,"{'login': 'facebook-github-bot', 'id': 6422482, 'node_id': 'MDQ6VXNlcjY0MjI0ODI=', 'avatar_url': 'https://avatars3.githubusercontent.com/u/6422482?v=4', 'gravatar_id': '', 'url': 'https://api.github.com/users/facebook-github-bot', 'html_url': 'https://github.com/facebook-github-bot', 'followers_url': 'https://api.github.com/users/facebook-github-bot/followers', 'following_url': 'https://api.github.com/users/facebook-github-bot/following{/other_user}', 'gists_url': 'https://api.github.com/users/facebook-github-bot/gists{/gist_id}', 'starred_url': 'https://api.github.com/users/facebook-github-bot/starred{/owner}{/repo}', 'subscriptions_url': 'https://api.github.com/users/facebook-github-bot/subscriptions', 'organizations_url': 'https://api.github.com/users/facebook-github-bot/orgs', 'repos_url': 'https://api.github.com/users/facebook-github-bot/repos', 'events_url': 'https://api.github.com/users/facebook-github-bot/events{/privacy}', 'received_events_url': 'https://api.github.com/users/facebook-github-bot/received_events', 'type': 'User', 'site_admin': False}",closed,472cfc0f2cc617d70ef28bdf3a623e1ff2e759d5,https://api.github.com/repos/pytorch/pytorch/commits/472cfc0f2cc617d70ef28bdf3a623e1ff2e759d5,2019-02-15T19:16:21Z,45,44,1
17051,2150599010,"{'login': 'facebook-github-bot', 'id': 6422482, 'node_id': 'MDQ6VXNlcjY0MjI0ODI=', 'avatar_url': 'https://avatars3.githubusercontent.com/u/6422482?v=4', 'gravatar_id': '', 'url': 'https://api.github.com/users/facebook-github-bot', 'html_url': 'https://github.com/facebook-github-bot', 'followers_url': 'https://api.github.com/users/facebook-github-bot/followers', 'following_url': 'https://api.github.com/users/facebook-github-bot/following{/other_user}', 'gists_url': 'https://api.github.com/users/facebook-github-bot/gists{/gist_id}', 'starred_url': 'https://api.github.com/users/facebook-github-bot/starred{/owner}{/repo}', 'subscriptions_url': 'https://api.github.com/users/facebook-github-bot/subscriptions', 'organizations_url': 'https://api.github.com/users/facebook-github-bot/orgs', 'repos_url': 'https://api.github.com/users/facebook-github-bot/repos', 'events_url': 'https://api.github.com/users/facebook-github-bot/events{/privacy}', 'received_events_url': 'https://api.github.com/users/facebook-github-bot/received_events', 'type': 'User', 'site_admin': False}",closed,428b666814cea4b15860bf3485a613fadd5bfdee,https://api.github.com/repos/pytorch/pytorch/commits/428b666814cea4b15860bf3485a613fadd5bfdee,2019-02-20T01:18:19Z,28,23,5
17051,2174809497,"{'login': 'facebook-github-bot', 'id': 6422482, 'node_id': 'MDQ6VXNlcjY0MjI0ODI=', 'avatar_url': 'https://avatars3.githubusercontent.com/u/6422482?v=4', 'gravatar_id': '', 'url': 'https://api.github.com/users/facebook-github-bot', 'html_url': 'https://github.com/facebook-github-bot', 'followers_url': 'https://api.github.com/users/facebook-github-bot/followers', 'following_url': 'https://api.github.com/users/facebook-github-bot/following{/other_user}', 'gists_url': 'https://api.github.com/users/facebook-github-bot/gists{/gist_id}', 'starred_url': 'https://api.github.com/users/facebook-github-bot/starred{/owner}{/repo}', 'subscriptions_url': 'https://api.github.com/users/facebook-github-bot/subscriptions', 'organizations_url': 'https://api.github.com/users/facebook-github-bot/orgs', 'repos_url': 'https://api.github.com/users/facebook-github-bot/repos', 'events_url': 'https://api.github.com/users/facebook-github-bot/events{/privacy}', 'received_events_url': 'https://api.github.com/users/facebook-github-bot/received_events', 'type': 'User', 'site_admin': False}",referenced,698f9474636d46a4c8dd29ef3762e1cef3a476bb,https://api.github.com/repos/pytorch/pytorch/commits/698f9474636d46a4c8dd29ef3762e1cef3a476bb,2019-03-01T18:39:45Z,44,4,40
17038,2143466500,"{'login': 'facebook-github-bot', 'id': 6422482, 'node_id': 'MDQ6VXNlcjY0MjI0ODI=', 'avatar_url': 'https://avatars3.githubusercontent.com/u/6422482?v=4', 'gravatar_id': '', 'url': 'https://api.github.com/users/facebook-github-bot', 'html_url': 'https://github.com/facebook-github-bot', 'followers_url': 'https://api.github.com/users/facebook-github-bot/followers', 'following_url': 'https://api.github.com/users/facebook-github-bot/following{/other_user}', 'gists_url': 'https://api.github.com/users/facebook-github-bot/gists{/gist_id}', 'starred_url': 'https://api.github.com/users/facebook-github-bot/starred{/owner}{/repo}', 'subscriptions_url': 'https://api.github.com/users/facebook-github-bot/subscriptions', 'organizations_url': 'https://api.github.com/users/facebook-github-bot/orgs', 'repos_url': 'https://api.github.com/users/facebook-github-bot/repos', 'events_url': 'https://api.github.com/users/facebook-github-bot/events{/privacy}', 'received_events_url': 'https://api.github.com/users/facebook-github-bot/received_events', 'type': 'User', 'site_admin': False}",closed,01686db21b035d9cbeb1656beabe1e9b0be5c7a4,https://api.github.com/repos/pytorch/pytorch/commits/01686db21b035d9cbeb1656beabe1e9b0be5c7a4,2019-02-15T20:23:05Z,3666,3659,7
17017,2159155566,"{'login': 'facebook-github-bot', 'id': 6422482, 'node_id': 'MDQ6VXNlcjY0MjI0ODI=', 'avatar_url': 'https://avatars3.githubusercontent.com/u/6422482?v=4', 'gravatar_id': '', 'url': 'https://api.github.com/users/facebook-github-bot', 'html_url': 'https://github.com/facebook-github-bot', 'followers_url': 'https://api.github.com/users/facebook-github-bot/followers', 'following_url': 'https://api.github.com/users/facebook-github-bot/following{/other_user}', 'gists_url': 'https://api.github.com/users/facebook-github-bot/gists{/gist_id}', 'starred_url': 'https://api.github.com/users/facebook-github-bot/starred{/owner}{/repo}', 'subscriptions_url': 'https://api.github.com/users/facebook-github-bot/subscriptions', 'organizations_url': 'https://api.github.com/users/facebook-github-bot/orgs', 'repos_url': 'https://api.github.com/users/facebook-github-bot/repos', 'events_url': 'https://api.github.com/users/facebook-github-bot/events{/privacy}', 'received_events_url': 'https://api.github.com/users/facebook-github-bot/received_events', 'type': 'User', 'site_admin': False}",closed,dbd66c17bcae6015844f2603bb5db28af84ac7d7,https://api.github.com/repos/pytorch/pytorch/commits/dbd66c17bcae6015844f2603bb5db28af84ac7d7,2019-02-22T22:51:17Z,81,79,2
17017,2172573316,"{'login': 'facebook-github-bot', 'id': 6422482, 'node_id': 'MDQ6VXNlcjY0MjI0ODI=', 'avatar_url': 'https://avatars3.githubusercontent.com/u/6422482?v=4', 'gravatar_id': '', 'url': 'https://api.github.com/users/facebook-github-bot', 'html_url': 'https://github.com/facebook-github-bot', 'followers_url': 'https://api.github.com/users/facebook-github-bot/followers', 'following_url': 'https://api.github.com/users/facebook-github-bot/following{/other_user}', 'gists_url': 'https://api.github.com/users/facebook-github-bot/gists{/gist_id}', 'starred_url': 'https://api.github.com/users/facebook-github-bot/starred{/owner}{/repo}', 'subscriptions_url': 'https://api.github.com/users/facebook-github-bot/subscriptions', 'organizations_url': 'https://api.github.com/users/facebook-github-bot/orgs', 'repos_url': 'https://api.github.com/users/facebook-github-bot/repos', 'events_url': 'https://api.github.com/users/facebook-github-bot/events{/privacy}', 'received_events_url': 'https://api.github.com/users/facebook-github-bot/received_events', 'type': 'User', 'site_admin': False}",referenced,b36d9351b1568daa75f707d13791992571b4986e,https://api.github.com/repos/pytorch/pytorch/commits/b36d9351b1568daa75f707d13791992571b4986e,2019-02-28T23:01:53Z,93,91,2
17007,2135133313,"{'login': 'ezyang', 'id': 13564, 'node_id': 'MDQ6VXNlcjEzNTY0', 'avatar_url': 'https://avatars0.githubusercontent.com/u/13564?v=4', 'gravatar_id': '', 'url': 'https://api.github.com/users/ezyang', 'html_url': 'https://github.com/ezyang', 'followers_url': 'https://api.github.com/users/ezyang/followers', 'following_url': 'https://api.github.com/users/ezyang/following{/other_user}', 'gists_url': 'https://api.github.com/users/ezyang/gists{/gist_id}', 'starred_url': 'https://api.github.com/users/ezyang/starred{/owner}{/repo}', 'subscriptions_url': 'https://api.github.com/users/ezyang/subscriptions', 'organizations_url': 'https://api.github.com/users/ezyang/orgs', 'repos_url': 'https://api.github.com/users/ezyang/repos', 'events_url': 'https://api.github.com/users/ezyang/events{/privacy}', 'received_events_url': 'https://api.github.com/users/ezyang/received_events', 'type': 'User', 'site_admin': False}",referenced,246d9767119e52f6eb7d5adf77d690a38be6f61c,https://api.github.com/repos/pytorch/pytorch/commits/246d9767119e52f6eb7d5adf77d690a38be6f61c,2019-02-12T22:26:37Z,4,4,0
17000,2194423877,"{'login': 'facebook-github-bot', 'id': 6422482, 'node_id': 'MDQ6VXNlcjY0MjI0ODI=', 'avatar_url': 'https://avatars3.githubusercontent.com/u/6422482?v=4', 'gravatar_id': '', 'url': 'https://api.github.com/users/facebook-github-bot', 'html_url': 'https://github.com/facebook-github-bot', 'followers_url': 'https://api.github.com/users/facebook-github-bot/followers', 'following_url': 'https://api.github.com/users/facebook-github-bot/following{/other_user}', 'gists_url': 'https://api.github.com/users/facebook-github-bot/gists{/gist_id}', 'starred_url': 'https://api.github.com/users/facebook-github-bot/starred{/owner}{/repo}', 'subscriptions_url': 'https://api.github.com/users/facebook-github-bot/subscriptions', 'organizations_url': 'https://api.github.com/users/facebook-github-bot/orgs', 'repos_url': 'https://api.github.com/users/facebook-github-bot/repos', 'events_url': 'https://api.github.com/users/facebook-github-bot/events{/privacy}', 'received_events_url': 'https://api.github.com/users/facebook-github-bot/received_events', 'type': 'User', 'site_admin': False}",closed,b57fe3cc66cfc348d56a7f41fa74b784119fa89a,https://api.github.com/repos/pytorch/pytorch/commits/b57fe3cc66cfc348d56a7f41fa74b784119fa89a,2019-03-11T16:03:03Z,23,23,0
16998,2150549847,"{'login': 'facebook-github-bot', 'id': 6422482, 'node_id': 'MDQ6VXNlcjY0MjI0ODI=', 'avatar_url': 'https://avatars3.githubusercontent.com/u/6422482?v=4', 'gravatar_id': '', 'url': 'https://api.github.com/users/facebook-github-bot', 'html_url': 'https://github.com/facebook-github-bot', 'followers_url': 'https://api.github.com/users/facebook-github-bot/followers', 'following_url': 'https://api.github.com/users/facebook-github-bot/following{/other_user}', 'gists_url': 'https://api.github.com/users/facebook-github-bot/gists{/gist_id}', 'starred_url': 'https://api.github.com/users/facebook-github-bot/starred{/owner}{/repo}', 'subscriptions_url': 'https://api.github.com/users/facebook-github-bot/subscriptions', 'organizations_url': 'https://api.github.com/users/facebook-github-bot/orgs', 'repos_url': 'https://api.github.com/users/facebook-github-bot/repos', 'events_url': 'https://api.github.com/users/facebook-github-bot/events{/privacy}', 'received_events_url': 'https://api.github.com/users/facebook-github-bot/received_events', 'type': 'User', 'site_admin': False}",closed,594a4d7b5599f2ea58c7e8697d896f15c7b256fa,https://api.github.com/repos/pytorch/pytorch/commits/594a4d7b5599f2ea58c7e8697d896f15c7b256fa,2019-02-20T00:43:27Z,8,8,0
16996,2244860153,"{'login': 'facebook-github-bot', 'id': 6422482, 'node_id': 'MDQ6VXNlcjY0MjI0ODI=', 'avatar_url': 'https://avatars3.githubusercontent.com/u/6422482?v=4', 'gravatar_id': '', 'url': 'https://api.github.com/users/facebook-github-bot', 'html_url': 'https://github.com/facebook-github-bot', 'followers_url': 'https://api.github.com/users/facebook-github-bot/followers', 'following_url': 'https://api.github.com/users/facebook-github-bot/following{/other_user}', 'gists_url': 'https://api.github.com/users/facebook-github-bot/gists{/gist_id}', 'starred_url': 'https://api.github.com/users/facebook-github-bot/starred{/owner}{/repo}', 'subscriptions_url': 'https://api.github.com/users/facebook-github-bot/subscriptions', 'organizations_url': 'https://api.github.com/users/facebook-github-bot/orgs', 'repos_url': 'https://api.github.com/users/facebook-github-bot/repos', 'events_url': 'https://api.github.com/users/facebook-github-bot/events{/privacy}', 'received_events_url': 'https://api.github.com/users/facebook-github-bot/received_events', 'type': 'User', 'site_admin': False}",closed,1b25fdbcd0cd838096dbb8aa3943255e96556dc4,https://api.github.com/repos/pytorch/pytorch/commits/1b25fdbcd0cd838096dbb8aa3943255e96556dc4,2019-04-01T23:06:07Z,185,179,6
16983,2134669678,"{'login': 'facebook-github-bot', 'id': 6422482, 'node_id': 'MDQ6VXNlcjY0MjI0ODI=', 'avatar_url': 'https://avatars3.githubusercontent.com/u/6422482?v=4', 'gravatar_id': '', 'url': 'https://api.github.com/users/facebook-github-bot', 'html_url': 'https://github.com/facebook-github-bot', 'followers_url': 'https://api.github.com/users/facebook-github-bot/followers', 'following_url': 'https://api.github.com/users/facebook-github-bot/following{/other_user}', 'gists_url': 'https://api.github.com/users/facebook-github-bot/gists{/gist_id}', 'starred_url': 'https://api.github.com/users/facebook-github-bot/starred{/owner}{/repo}', 'subscriptions_url': 'https://api.github.com/users/facebook-github-bot/subscriptions', 'organizations_url': 'https://api.github.com/users/facebook-github-bot/orgs', 'repos_url': 'https://api.github.com/users/facebook-github-bot/repos', 'events_url': 'https://api.github.com/users/facebook-github-bot/events{/privacy}', 'received_events_url': 'https://api.github.com/users/facebook-github-bot/received_events', 'type': 'User', 'site_admin': False}",closed,a2c322e7357a897402e6bdf700f086eaaed48cfd,https://api.github.com/repos/pytorch/pytorch/commits/a2c322e7357a897402e6bdf700f086eaaed48cfd,2019-02-12T19:08:00Z,4,2,2
16962,2322242973,"{'login': 'facebook-github-bot', 'id': 6422482, 'node_id': 'MDQ6VXNlcjY0MjI0ODI=', 'avatar_url': 'https://avatars3.githubusercontent.com/u/6422482?v=4', 'gravatar_id': '', 'url': 'https://api.github.com/users/facebook-github-bot', 'html_url': 'https://github.com/facebook-github-bot', 'followers_url': 'https://api.github.com/users/facebook-github-bot/followers', 'following_url': 'https://api.github.com/users/facebook-github-bot/following{/other_user}', 'gists_url': 'https://api.github.com/users/facebook-github-bot/gists{/gist_id}', 'starred_url': 'https://api.github.com/users/facebook-github-bot/starred{/owner}{/repo}', 'subscriptions_url': 'https://api.github.com/users/facebook-github-bot/subscriptions', 'organizations_url': 'https://api.github.com/users/facebook-github-bot/orgs', 'repos_url': 'https://api.github.com/users/facebook-github-bot/repos', 'events_url': 'https://api.github.com/users/facebook-github-bot/events{/privacy}', 'received_events_url': 'https://api.github.com/users/facebook-github-bot/received_events', 'type': 'User', 'site_admin': False}",referenced,26f5275644da200f83458dffd6b3216933200c36,https://api.github.com/repos/pytorch/pytorch/commits/26f5275644da200f83458dffd6b3216933200c36,2019-05-06T21:25:03Z,223,142,81
16952,2172386482,"{'login': 'facebook-github-bot', 'id': 6422482, 'node_id': 'MDQ6VXNlcjY0MjI0ODI=', 'avatar_url': 'https://avatars3.githubusercontent.com/u/6422482?v=4', 'gravatar_id': '', 'url': 'https://api.github.com/users/facebook-github-bot', 'html_url': 'https://github.com/facebook-github-bot', 'followers_url': 'https://api.github.com/users/facebook-github-bot/followers', 'following_url': 'https://api.github.com/users/facebook-github-bot/following{/other_user}', 'gists_url': 'https://api.github.com/users/facebook-github-bot/gists{/gist_id}', 'starred_url': 'https://api.github.com/users/facebook-github-bot/starred{/owner}{/repo}', 'subscriptions_url': 'https://api.github.com/users/facebook-github-bot/subscriptions', 'organizations_url': 'https://api.github.com/users/facebook-github-bot/orgs', 'repos_url': 'https://api.github.com/users/facebook-github-bot/repos', 'events_url': 'https://api.github.com/users/facebook-github-bot/events{/privacy}', 'received_events_url': 'https://api.github.com/users/facebook-github-bot/received_events', 'type': 'User', 'site_admin': False}",referenced,c596683309d9f50406d395f2b93b7c12b0e68fee,https://api.github.com/repos/pytorch/pytorch/commits/c596683309d9f50406d395f2b93b7c12b0e68fee,2019-02-28T21:37:50Z,2,1,1
16921,2156490143,"{'login': 'facebook-github-bot', 'id': 6422482, 'node_id': 'MDQ6VXNlcjY0MjI0ODI=', 'avatar_url': 'https://avatars3.githubusercontent.com/u/6422482?v=4', 'gravatar_id': '', 'url': 'https://api.github.com/users/facebook-github-bot', 'html_url': 'https://github.com/facebook-github-bot', 'followers_url': 'https://api.github.com/users/facebook-github-bot/followers', 'following_url': 'https://api.github.com/users/facebook-github-bot/following{/other_user}', 'gists_url': 'https://api.github.com/users/facebook-github-bot/gists{/gist_id}', 'starred_url': 'https://api.github.com/users/facebook-github-bot/starred{/owner}{/repo}', 'subscriptions_url': 'https://api.github.com/users/facebook-github-bot/subscriptions', 'organizations_url': 'https://api.github.com/users/facebook-github-bot/orgs', 'repos_url': 'https://api.github.com/users/facebook-github-bot/repos', 'events_url': 'https://api.github.com/users/facebook-github-bot/events{/privacy}', 'received_events_url': 'https://api.github.com/users/facebook-github-bot/received_events', 'type': 'User', 'site_admin': False}",closed,4c6da649e537882c40223c7e1f66403d321a04bc,https://api.github.com/repos/pytorch/pytorch/commits/4c6da649e537882c40223c7e1f66403d321a04bc,2019-02-21T23:28:31Z,119,85,34
16860,2159052921,"{'login': 'facebook-github-bot', 'id': 6422482, 'node_id': 'MDQ6VXNlcjY0MjI0ODI=', 'avatar_url': 'https://avatars3.githubusercontent.com/u/6422482?v=4', 'gravatar_id': '', 'url': 'https://api.github.com/users/facebook-github-bot', 'html_url': 'https://github.com/facebook-github-bot', 'followers_url': 'https://api.github.com/users/facebook-github-bot/followers', 'following_url': 'https://api.github.com/users/facebook-github-bot/following{/other_user}', 'gists_url': 'https://api.github.com/users/facebook-github-bot/gists{/gist_id}', 'starred_url': 'https://api.github.com/users/facebook-github-bot/starred{/owner}{/repo}', 'subscriptions_url': 'https://api.github.com/users/facebook-github-bot/subscriptions', 'organizations_url': 'https://api.github.com/users/facebook-github-bot/orgs', 'repos_url': 'https://api.github.com/users/facebook-github-bot/repos', 'events_url': 'https://api.github.com/users/facebook-github-bot/events{/privacy}', 'received_events_url': 'https://api.github.com/users/facebook-github-bot/received_events', 'type': 'User', 'site_admin': False}",closed,356a94b64e69aa2e87b33e7bbd0b302feca327a4,https://api.github.com/repos/pytorch/pytorch/commits/356a94b64e69aa2e87b33e7bbd0b302feca327a4,2019-02-22T21:53:21Z,293,161,132
16856,2126102666,"{'login': 'facebook-github-bot', 'id': 6422482, 'node_id': 'MDQ6VXNlcjY0MjI0ODI=', 'avatar_url': 'https://avatars3.githubusercontent.com/u/6422482?v=4', 'gravatar_id': '', 'url': 'https://api.github.com/users/facebook-github-bot', 'html_url': 'https://github.com/facebook-github-bot', 'followers_url': 'https://api.github.com/users/facebook-github-bot/followers', 'following_url': 'https://api.github.com/users/facebook-github-bot/following{/other_user}', 'gists_url': 'https://api.github.com/users/facebook-github-bot/gists{/gist_id}', 'starred_url': 'https://api.github.com/users/facebook-github-bot/starred{/owner}{/repo}', 'subscriptions_url': 'https://api.github.com/users/facebook-github-bot/subscriptions', 'organizations_url': 'https://api.github.com/users/facebook-github-bot/orgs', 'repos_url': 'https://api.github.com/users/facebook-github-bot/repos', 'events_url': 'https://api.github.com/users/facebook-github-bot/events{/privacy}', 'received_events_url': 'https://api.github.com/users/facebook-github-bot/received_events', 'type': 'User', 'site_admin': False}",closed,ee0e71bee7383c89148063102770491317614ab2,https://api.github.com/repos/pytorch/pytorch/commits/ee0e71bee7383c89148063102770491317614ab2,2019-02-08T02:46:20Z,40,34,6
16849,2197995279,"{'login': 'facebook-github-bot', 'id': 6422482, 'node_id': 'MDQ6VXNlcjY0MjI0ODI=', 'avatar_url': 'https://avatars3.githubusercontent.com/u/6422482?v=4', 'gravatar_id': '', 'url': 'https://api.github.com/users/facebook-github-bot', 'html_url': 'https://github.com/facebook-github-bot', 'followers_url': 'https://api.github.com/users/facebook-github-bot/followers', 'following_url': 'https://api.github.com/users/facebook-github-bot/following{/other_user}', 'gists_url': 'https://api.github.com/users/facebook-github-bot/gists{/gist_id}', 'starred_url': 'https://api.github.com/users/facebook-github-bot/starred{/owner}{/repo}', 'subscriptions_url': 'https://api.github.com/users/facebook-github-bot/subscriptions', 'organizations_url': 'https://api.github.com/users/facebook-github-bot/orgs', 'repos_url': 'https://api.github.com/users/facebook-github-bot/repos', 'events_url': 'https://api.github.com/users/facebook-github-bot/events{/privacy}', 'received_events_url': 'https://api.github.com/users/facebook-github-bot/received_events', 'type': 'User', 'site_admin': False}",referenced,abab9c1d78d6eb0eb9af2bad5212a9707272f305,https://api.github.com/repos/pytorch/pytorch/commits/abab9c1d78d6eb0eb9af2bad5212a9707272f305,2019-03-12T17:54:48Z,144,106,38
16845,2128088177,"{'login': 'facebook-github-bot', 'id': 6422482, 'node_id': 'MDQ6VXNlcjY0MjI0ODI=', 'avatar_url': 'https://avatars3.githubusercontent.com/u/6422482?v=4', 'gravatar_id': '', 'url': 'https://api.github.com/users/facebook-github-bot', 'html_url': 'https://github.com/facebook-github-bot', 'followers_url': 'https://api.github.com/users/facebook-github-bot/followers', 'following_url': 'https://api.github.com/users/facebook-github-bot/following{/other_user}', 'gists_url': 'https://api.github.com/users/facebook-github-bot/gists{/gist_id}', 'starred_url': 'https://api.github.com/users/facebook-github-bot/starred{/owner}{/repo}', 'subscriptions_url': 'https://api.github.com/users/facebook-github-bot/subscriptions', 'organizations_url': 'https://api.github.com/users/facebook-github-bot/orgs', 'repos_url': 'https://api.github.com/users/facebook-github-bot/repos', 'events_url': 'https://api.github.com/users/facebook-github-bot/events{/privacy}', 'received_events_url': 'https://api.github.com/users/facebook-github-bot/received_events', 'type': 'User', 'site_admin': False}",referenced,cd2dca3cafb49fbf64a4714571717f2390625e72,https://api.github.com/repos/pytorch/pytorch/commits/cd2dca3cafb49fbf64a4714571717f2390625e72,2019-02-08T20:33:40Z,76,72,4
16813,2194883482,"{'login': 'facebook-github-bot', 'id': 6422482, 'node_id': 'MDQ6VXNlcjY0MjI0ODI=', 'avatar_url': 'https://avatars3.githubusercontent.com/u/6422482?v=4', 'gravatar_id': '', 'url': 'https://api.github.com/users/facebook-github-bot', 'html_url': 'https://github.com/facebook-github-bot', 'followers_url': 'https://api.github.com/users/facebook-github-bot/followers', 'following_url': 'https://api.github.com/users/facebook-github-bot/following{/other_user}', 'gists_url': 'https://api.github.com/users/facebook-github-bot/gists{/gist_id}', 'starred_url': 'https://api.github.com/users/facebook-github-bot/starred{/owner}{/repo}', 'subscriptions_url': 'https://api.github.com/users/facebook-github-bot/subscriptions', 'organizations_url': 'https://api.github.com/users/facebook-github-bot/orgs', 'repos_url': 'https://api.github.com/users/facebook-github-bot/repos', 'events_url': 'https://api.github.com/users/facebook-github-bot/events{/privacy}', 'received_events_url': 'https://api.github.com/users/facebook-github-bot/received_events', 'type': 'User', 'site_admin': False}",closed,11c89dde55c11b8571f130d72d8e8cf2a3b6d767,https://api.github.com/repos/pytorch/pytorch/commits/11c89dde55c11b8571f130d72d8e8cf2a3b6d767,2019-03-11T18:35:43Z,69,42,27
16756,2123524118,"{'login': 'facebook-github-bot', 'id': 6422482, 'node_id': 'MDQ6VXNlcjY0MjI0ODI=', 'avatar_url': 'https://avatars3.githubusercontent.com/u/6422482?v=4', 'gravatar_id': '', 'url': 'https://api.github.com/users/facebook-github-bot', 'html_url': 'https://github.com/facebook-github-bot', 'followers_url': 'https://api.github.com/users/facebook-github-bot/followers', 'following_url': 'https://api.github.com/users/facebook-github-bot/following{/other_user}', 'gists_url': 'https://api.github.com/users/facebook-github-bot/gists{/gist_id}', 'starred_url': 'https://api.github.com/users/facebook-github-bot/starred{/owner}{/repo}', 'subscriptions_url': 'https://api.github.com/users/facebook-github-bot/subscriptions', 'organizations_url': 'https://api.github.com/users/facebook-github-bot/orgs', 'repos_url': 'https://api.github.com/users/facebook-github-bot/repos', 'events_url': 'https://api.github.com/users/facebook-github-bot/events{/privacy}', 'received_events_url': 'https://api.github.com/users/facebook-github-bot/received_events', 'type': 'User', 'site_admin': False}",referenced,0d366e1bde42265d764a6a9aad27a38753156fb0,https://api.github.com/repos/pytorch/pytorch/commits/0d366e1bde42265d764a6a9aad27a38753156fb0,2019-02-07T09:39:23Z,3,3,0
16712,2116196030,"{'login': 'soumith', 'id': 1310570, 'node_id': 'MDQ6VXNlcjEzMTA1NzA=', 'avatar_url': 'https://avatars0.githubusercontent.com/u/1310570?v=4', 'gravatar_id': '', 'url': 'https://api.github.com/users/soumith', 'html_url': 'https://github.com/soumith', 'followers_url': 'https://api.github.com/users/soumith/followers', 'following_url': 'https://api.github.com/users/soumith/following{/other_user}', 'gists_url': 'https://api.github.com/users/soumith/gists{/gist_id}', 'starred_url': 'https://api.github.com/users/soumith/starred{/owner}{/repo}', 'subscriptions_url': 'https://api.github.com/users/soumith/subscriptions', 'organizations_url': 'https://api.github.com/users/soumith/orgs', 'repos_url': 'https://api.github.com/users/soumith/repos', 'events_url': 'https://api.github.com/users/soumith/events{/privacy}', 'received_events_url': 'https://api.github.com/users/soumith/received_events', 'type': 'User', 'site_admin': False}",referenced,c19b079327768f4b8aacf26c05894d5cd9ca59ee,https://api.github.com/repos/pytorch/pytorch/commits/c19b079327768f4b8aacf26c05894d5cd9ca59ee,2019-02-04T16:37:22Z,1,1,0
16712,2122768968,"{'login': 'facebook-github-bot', 'id': 6422482, 'node_id': 'MDQ6VXNlcjY0MjI0ODI=', 'avatar_url': 'https://avatars3.githubusercontent.com/u/6422482?v=4', 'gravatar_id': '', 'url': 'https://api.github.com/users/facebook-github-bot', 'html_url': 'https://github.com/facebook-github-bot', 'followers_url': 'https://api.github.com/users/facebook-github-bot/followers', 'following_url': 'https://api.github.com/users/facebook-github-bot/following{/other_user}', 'gists_url': 'https://api.github.com/users/facebook-github-bot/gists{/gist_id}', 'starred_url': 'https://api.github.com/users/facebook-github-bot/starred{/owner}{/repo}', 'subscriptions_url': 'https://api.github.com/users/facebook-github-bot/subscriptions', 'organizations_url': 'https://api.github.com/users/facebook-github-bot/orgs', 'repos_url': 'https://api.github.com/users/facebook-github-bot/repos', 'events_url': 'https://api.github.com/users/facebook-github-bot/events{/privacy}', 'received_events_url': 'https://api.github.com/users/facebook-github-bot/received_events', 'type': 'User', 'site_admin': False}",closed,717ae09184a5329f53d99bc56d0ab0118c3522e6,https://api.github.com/repos/pytorch/pytorch/commits/717ae09184a5329f53d99bc56d0ab0118c3522e6,2019-02-06T23:53:26Z,1,1,0
16707,2132940866,"{'login': 'facebook-github-bot', 'id': 6422482, 'node_id': 'MDQ6VXNlcjY0MjI0ODI=', 'avatar_url': 'https://avatars3.githubusercontent.com/u/6422482?v=4', 'gravatar_id': '', 'url': 'https://api.github.com/users/facebook-github-bot', 'html_url': 'https://github.com/facebook-github-bot', 'followers_url': 'https://api.github.com/users/facebook-github-bot/followers', 'following_url': 'https://api.github.com/users/facebook-github-bot/following{/other_user}', 'gists_url': 'https://api.github.com/users/facebook-github-bot/gists{/gist_id}', 'starred_url': 'https://api.github.com/users/facebook-github-bot/starred{/owner}{/repo}', 'subscriptions_url': 'https://api.github.com/users/facebook-github-bot/subscriptions', 'organizations_url': 'https://api.github.com/users/facebook-github-bot/orgs', 'repos_url': 'https://api.github.com/users/facebook-github-bot/repos', 'events_url': 'https://api.github.com/users/facebook-github-bot/events{/privacy}', 'received_events_url': 'https://api.github.com/users/facebook-github-bot/received_events', 'type': 'User', 'site_admin': False}",closed,bad4442a7cefebd1fae825f86b6b9667aa321896,https://api.github.com/repos/pytorch/pytorch/commits/bad4442a7cefebd1fae825f86b6b9667aa321896,2019-02-12T08:17:13Z,38,30,8
16667,2687750992,"{'login': 'facebook-github-bot', 'id': 6422482, 'node_id': 'MDQ6VXNlcjY0MjI0ODI=', 'avatar_url': 'https://avatars3.githubusercontent.com/u/6422482?v=4', 'gravatar_id': '', 'url': 'https://api.github.com/users/facebook-github-bot', 'html_url': 'https://github.com/facebook-github-bot', 'followers_url': 'https://api.github.com/users/facebook-github-bot/followers', 'following_url': 'https://api.github.com/users/facebook-github-bot/following{/other_user}', 'gists_url': 'https://api.github.com/users/facebook-github-bot/gists{/gist_id}', 'starred_url': 'https://api.github.com/users/facebook-github-bot/starred{/owner}{/repo}', 'subscriptions_url': 'https://api.github.com/users/facebook-github-bot/subscriptions', 'organizations_url': 'https://api.github.com/users/facebook-github-bot/orgs', 'repos_url': 'https://api.github.com/users/facebook-github-bot/repos', 'events_url': 'https://api.github.com/users/facebook-github-bot/events{/privacy}', 'received_events_url': 'https://api.github.com/users/facebook-github-bot/received_events', 'type': 'User', 'site_admin': False}",referenced,b7fb2b8862f7f2cf20120f684a3e422b86e9c2af,https://api.github.com/repos/pytorch/pytorch/commits/b7fb2b8862f7f2cf20120f684a3e422b86e9c2af,2019-10-04T15:09:44Z,71,71,0
16662,2143266104,"{'login': 'facebook-github-bot', 'id': 6422482, 'node_id': 'MDQ6VXNlcjY0MjI0ODI=', 'avatar_url': 'https://avatars3.githubusercontent.com/u/6422482?v=4', 'gravatar_id': '', 'url': 'https://api.github.com/users/facebook-github-bot', 'html_url': 'https://github.com/facebook-github-bot', 'followers_url': 'https://api.github.com/users/facebook-github-bot/followers', 'following_url': 'https://api.github.com/users/facebook-github-bot/following{/other_user}', 'gists_url': 'https://api.github.com/users/facebook-github-bot/gists{/gist_id}', 'starred_url': 'https://api.github.com/users/facebook-github-bot/starred{/owner}{/repo}', 'subscriptions_url': 'https://api.github.com/users/facebook-github-bot/subscriptions', 'organizations_url': 'https://api.github.com/users/facebook-github-bot/orgs', 'repos_url': 'https://api.github.com/users/facebook-github-bot/repos', 'events_url': 'https://api.github.com/users/facebook-github-bot/events{/privacy}', 'received_events_url': 'https://api.github.com/users/facebook-github-bot/received_events', 'type': 'User', 'site_admin': False}",referenced,38139bc356b5dd59be7938be386f68138ef33ff3,https://api.github.com/repos/pytorch/pytorch/commits/38139bc356b5dd59be7938be386f68138ef33ff3,2019-02-15T18:49:53Z,131,127,4
16662,2207358105,"{'login': 'facebook-github-bot', 'id': 6422482, 'node_id': 'MDQ6VXNlcjY0MjI0ODI=', 'avatar_url': 'https://avatars3.githubusercontent.com/u/6422482?v=4', 'gravatar_id': '', 'url': 'https://api.github.com/users/facebook-github-bot', 'html_url': 'https://github.com/facebook-github-bot', 'followers_url': 'https://api.github.com/users/facebook-github-bot/followers', 'following_url': 'https://api.github.com/users/facebook-github-bot/following{/other_user}', 'gists_url': 'https://api.github.com/users/facebook-github-bot/gists{/gist_id}', 'starred_url': 'https://api.github.com/users/facebook-github-bot/starred{/owner}{/repo}', 'subscriptions_url': 'https://api.github.com/users/facebook-github-bot/subscriptions', 'organizations_url': 'https://api.github.com/users/facebook-github-bot/orgs', 'repos_url': 'https://api.github.com/users/facebook-github-bot/repos', 'events_url': 'https://api.github.com/users/facebook-github-bot/events{/privacy}', 'received_events_url': 'https://api.github.com/users/facebook-github-bot/received_events', 'type': 'User', 'site_admin': False}",referenced,cd26200d1b01cd66c2c5d641feba836a8f2341d3,https://api.github.com/repos/pytorch/pytorch/commits/cd26200d1b01cd66c2c5d641feba836a8f2341d3,2019-03-15T18:56:23Z,43,42,1
16662,2207460103,"{'login': 'facebook-github-bot', 'id': 6422482, 'node_id': 'MDQ6VXNlcjY0MjI0ODI=', 'avatar_url': 'https://avatars3.githubusercontent.com/u/6422482?v=4', 'gravatar_id': '', 'url': 'https://api.github.com/users/facebook-github-bot', 'html_url': 'https://github.com/facebook-github-bot', 'followers_url': 'https://api.github.com/users/facebook-github-bot/followers', 'following_url': 'https://api.github.com/users/facebook-github-bot/following{/other_user}', 'gists_url': 'https://api.github.com/users/facebook-github-bot/gists{/gist_id}', 'starred_url': 'https://api.github.com/users/facebook-github-bot/starred{/owner}{/repo}', 'subscriptions_url': 'https://api.github.com/users/facebook-github-bot/subscriptions', 'organizations_url': 'https://api.github.com/users/facebook-github-bot/orgs', 'repos_url': 'https://api.github.com/users/facebook-github-bot/repos', 'events_url': 'https://api.github.com/users/facebook-github-bot/events{/privacy}', 'received_events_url': 'https://api.github.com/users/facebook-github-bot/received_events', 'type': 'User', 'site_admin': False}",referenced,9a8a26867212e3f3c01caabc1d244345c7015694,https://api.github.com/repos/pytorch/pytorch/commits/9a8a26867212e3f3c01caabc1d244345c7015694,2019-03-15T19:47:53Z,159,157,2
16650,2155338270,"{'login': 'facebook-github-bot', 'id': 6422482, 'node_id': 'MDQ6VXNlcjY0MjI0ODI=', 'avatar_url': 'https://avatars3.githubusercontent.com/u/6422482?v=4', 'gravatar_id': '', 'url': 'https://api.github.com/users/facebook-github-bot', 'html_url': 'https://github.com/facebook-github-bot', 'followers_url': 'https://api.github.com/users/facebook-github-bot/followers', 'following_url': 'https://api.github.com/users/facebook-github-bot/following{/other_user}', 'gists_url': 'https://api.github.com/users/facebook-github-bot/gists{/gist_id}', 'starred_url': 'https://api.github.com/users/facebook-github-bot/starred{/owner}{/repo}', 'subscriptions_url': 'https://api.github.com/users/facebook-github-bot/subscriptions', 'organizations_url': 'https://api.github.com/users/facebook-github-bot/orgs', 'repos_url': 'https://api.github.com/users/facebook-github-bot/repos', 'events_url': 'https://api.github.com/users/facebook-github-bot/events{/privacy}', 'received_events_url': 'https://api.github.com/users/facebook-github-bot/received_events', 'type': 'User', 'site_admin': False}",closed,37890610b02fae2bd4b4eff3fd3747a3dc0ffaad,https://api.github.com/repos/pytorch/pytorch/commits/37890610b02fae2bd4b4eff3fd3747a3dc0ffaad,2019-02-21T15:38:42Z,1,1,0
16647,2239341584,"{'login': 'facebook-github-bot', 'id': 6422482, 'node_id': 'MDQ6VXNlcjY0MjI0ODI=', 'avatar_url': 'https://avatars3.githubusercontent.com/u/6422482?v=4', 'gravatar_id': '', 'url': 'https://api.github.com/users/facebook-github-bot', 'html_url': 'https://github.com/facebook-github-bot', 'followers_url': 'https://api.github.com/users/facebook-github-bot/followers', 'following_url': 'https://api.github.com/users/facebook-github-bot/following{/other_user}', 'gists_url': 'https://api.github.com/users/facebook-github-bot/gists{/gist_id}', 'starred_url': 'https://api.github.com/users/facebook-github-bot/starred{/owner}{/repo}', 'subscriptions_url': 'https://api.github.com/users/facebook-github-bot/subscriptions', 'organizations_url': 'https://api.github.com/users/facebook-github-bot/orgs', 'repos_url': 'https://api.github.com/users/facebook-github-bot/repos', 'events_url': 'https://api.github.com/users/facebook-github-bot/events{/privacy}', 'received_events_url': 'https://api.github.com/users/facebook-github-bot/received_events', 'type': 'User', 'site_admin': False}",referenced,c0a2452ffe1bf4202763bbfcafa5867461158de3,https://api.github.com/repos/pytorch/pytorch/commits/c0a2452ffe1bf4202763bbfcafa5867461158de3,2019-03-29T14:06:37Z,7,6,1
16642,2129626209,"{'login': 'facebook-github-bot', 'id': 6422482, 'node_id': 'MDQ6VXNlcjY0MjI0ODI=', 'avatar_url': 'https://avatars3.githubusercontent.com/u/6422482?v=4', 'gravatar_id': '', 'url': 'https://api.github.com/users/facebook-github-bot', 'html_url': 'https://github.com/facebook-github-bot', 'followers_url': 'https://api.github.com/users/facebook-github-bot/followers', 'following_url': 'https://api.github.com/users/facebook-github-bot/following{/other_user}', 'gists_url': 'https://api.github.com/users/facebook-github-bot/gists{/gist_id}', 'starred_url': 'https://api.github.com/users/facebook-github-bot/starred{/owner}{/repo}', 'subscriptions_url': 'https://api.github.com/users/facebook-github-bot/subscriptions', 'organizations_url': 'https://api.github.com/users/facebook-github-bot/orgs', 'repos_url': 'https://api.github.com/users/facebook-github-bot/repos', 'events_url': 'https://api.github.com/users/facebook-github-bot/events{/privacy}', 'received_events_url': 'https://api.github.com/users/facebook-github-bot/received_events', 'type': 'User', 'site_admin': False}",closed,8f6ee88a1d14d2f783c65e487b5cbda3f7211980,https://api.github.com/repos/pytorch/pytorch/commits/8f6ee88a1d14d2f783c65e487b5cbda3f7211980,2019-02-11T03:39:27Z,79,47,32
16627,2138660350,"{'login': 'facebook-github-bot', 'id': 6422482, 'node_id': 'MDQ6VXNlcjY0MjI0ODI=', 'avatar_url': 'https://avatars3.githubusercontent.com/u/6422482?v=4', 'gravatar_id': '', 'url': 'https://api.github.com/users/facebook-github-bot', 'html_url': 'https://github.com/facebook-github-bot', 'followers_url': 'https://api.github.com/users/facebook-github-bot/followers', 'following_url': 'https://api.github.com/users/facebook-github-bot/following{/other_user}', 'gists_url': 'https://api.github.com/users/facebook-github-bot/gists{/gist_id}', 'starred_url': 'https://api.github.com/users/facebook-github-bot/starred{/owner}{/repo}', 'subscriptions_url': 'https://api.github.com/users/facebook-github-bot/subscriptions', 'organizations_url': 'https://api.github.com/users/facebook-github-bot/orgs', 'repos_url': 'https://api.github.com/users/facebook-github-bot/repos', 'events_url': 'https://api.github.com/users/facebook-github-bot/events{/privacy}', 'received_events_url': 'https://api.github.com/users/facebook-github-bot/received_events', 'type': 'User', 'site_admin': False}",closed,8abfd28f588ccea9fcc11787acff2260b5ea9e55,https://api.github.com/repos/pytorch/pytorch/commits/8abfd28f588ccea9fcc11787acff2260b5ea9e55,2019-02-14T04:55:59Z,2,1,1
16607,2238177322,"{'login': 'facebook-github-bot', 'id': 6422482, 'node_id': 'MDQ6VXNlcjY0MjI0ODI=', 'avatar_url': 'https://avatars3.githubusercontent.com/u/6422482?v=4', 'gravatar_id': '', 'url': 'https://api.github.com/users/facebook-github-bot', 'html_url': 'https://github.com/facebook-github-bot', 'followers_url': 'https://api.github.com/users/facebook-github-bot/followers', 'following_url': 'https://api.github.com/users/facebook-github-bot/following{/other_user}', 'gists_url': 'https://api.github.com/users/facebook-github-bot/gists{/gist_id}', 'starred_url': 'https://api.github.com/users/facebook-github-bot/starred{/owner}{/repo}', 'subscriptions_url': 'https://api.github.com/users/facebook-github-bot/subscriptions', 'organizations_url': 'https://api.github.com/users/facebook-github-bot/orgs', 'repos_url': 'https://api.github.com/users/facebook-github-bot/repos', 'events_url': 'https://api.github.com/users/facebook-github-bot/events{/privacy}', 'received_events_url': 'https://api.github.com/users/facebook-github-bot/received_events', 'type': 'User', 'site_admin': False}",closed,37529161326a001e8398bc5b4e75791db94c04b0,https://api.github.com/repos/pytorch/pytorch/commits/37529161326a001e8398bc5b4e75791db94c04b0,2019-03-29T04:03:04Z,6,4,2
16591,2119627841,"{'login': 'facebook-github-bot', 'id': 6422482, 'node_id': 'MDQ6VXNlcjY0MjI0ODI=', 'avatar_url': 'https://avatars3.githubusercontent.com/u/6422482?v=4', 'gravatar_id': '', 'url': 'https://api.github.com/users/facebook-github-bot', 'html_url': 'https://github.com/facebook-github-bot', 'followers_url': 'https://api.github.com/users/facebook-github-bot/followers', 'following_url': 'https://api.github.com/users/facebook-github-bot/following{/other_user}', 'gists_url': 'https://api.github.com/users/facebook-github-bot/gists{/gist_id}', 'starred_url': 'https://api.github.com/users/facebook-github-bot/starred{/owner}{/repo}', 'subscriptions_url': 'https://api.github.com/users/facebook-github-bot/subscriptions', 'organizations_url': 'https://api.github.com/users/facebook-github-bot/orgs', 'repos_url': 'https://api.github.com/users/facebook-github-bot/repos', 'events_url': 'https://api.github.com/users/facebook-github-bot/events{/privacy}', 'received_events_url': 'https://api.github.com/users/facebook-github-bot/received_events', 'type': 'User', 'site_admin': False}",closed,6efa40e07b8e0b3ec27e4d2818172e4ed4239a90,https://api.github.com/repos/pytorch/pytorch/commits/6efa40e07b8e0b3ec27e4d2818172e4ed4239a90,2019-02-05T20:52:52Z,131,65,66
16577,2131875390,"{'login': 'facebook-github-bot', 'id': 6422482, 'node_id': 'MDQ6VXNlcjY0MjI0ODI=', 'avatar_url': 'https://avatars3.githubusercontent.com/u/6422482?v=4', 'gravatar_id': '', 'url': 'https://api.github.com/users/facebook-github-bot', 'html_url': 'https://github.com/facebook-github-bot', 'followers_url': 'https://api.github.com/users/facebook-github-bot/followers', 'following_url': 'https://api.github.com/users/facebook-github-bot/following{/other_user}', 'gists_url': 'https://api.github.com/users/facebook-github-bot/gists{/gist_id}', 'starred_url': 'https://api.github.com/users/facebook-github-bot/starred{/owner}{/repo}', 'subscriptions_url': 'https://api.github.com/users/facebook-github-bot/subscriptions', 'organizations_url': 'https://api.github.com/users/facebook-github-bot/orgs', 'repos_url': 'https://api.github.com/users/facebook-github-bot/repos', 'events_url': 'https://api.github.com/users/facebook-github-bot/events{/privacy}', 'received_events_url': 'https://api.github.com/users/facebook-github-bot/received_events', 'type': 'User', 'site_admin': False}",closed,7743ed850231781097fe4388fbe6d299cbb4a2c6,https://api.github.com/repos/pytorch/pytorch/commits/7743ed850231781097fe4388fbe6d299cbb4a2c6,2019-02-11T21:43:40Z,104,97,7
16562,2254520907,"{'login': 'facebook-github-bot', 'id': 6422482, 'node_id': 'MDQ6VXNlcjY0MjI0ODI=', 'avatar_url': 'https://avatars3.githubusercontent.com/u/6422482?v=4', 'gravatar_id': '', 'url': 'https://api.github.com/users/facebook-github-bot', 'html_url': 'https://github.com/facebook-github-bot', 'followers_url': 'https://api.github.com/users/facebook-github-bot/followers', 'following_url': 'https://api.github.com/users/facebook-github-bot/following{/other_user}', 'gists_url': 'https://api.github.com/users/facebook-github-bot/gists{/gist_id}', 'starred_url': 'https://api.github.com/users/facebook-github-bot/starred{/owner}{/repo}', 'subscriptions_url': 'https://api.github.com/users/facebook-github-bot/subscriptions', 'organizations_url': 'https://api.github.com/users/facebook-github-bot/orgs', 'repos_url': 'https://api.github.com/users/facebook-github-bot/repos', 'events_url': 'https://api.github.com/users/facebook-github-bot/events{/privacy}', 'received_events_url': 'https://api.github.com/users/facebook-github-bot/received_events', 'type': 'User', 'site_admin': False}",referenced,d35c39e73b04d7ab95812be8cbda21023e1b5cc4,https://api.github.com/repos/pytorch/pytorch/commits/d35c39e73b04d7ab95812be8cbda21023e1b5cc4,2019-04-05T00:27:01Z,22,19,3
16560,2108154111,"{'login': 'facebook-github-bot', 'id': 6422482, 'node_id': 'MDQ6VXNlcjY0MjI0ODI=', 'avatar_url': 'https://avatars3.githubusercontent.com/u/6422482?v=4', 'gravatar_id': '', 'url': 'https://api.github.com/users/facebook-github-bot', 'html_url': 'https://github.com/facebook-github-bot', 'followers_url': 'https://api.github.com/users/facebook-github-bot/followers', 'following_url': 'https://api.github.com/users/facebook-github-bot/following{/other_user}', 'gists_url': 'https://api.github.com/users/facebook-github-bot/gists{/gist_id}', 'starred_url': 'https://api.github.com/users/facebook-github-bot/starred{/owner}{/repo}', 'subscriptions_url': 'https://api.github.com/users/facebook-github-bot/subscriptions', 'organizations_url': 'https://api.github.com/users/facebook-github-bot/orgs', 'repos_url': 'https://api.github.com/users/facebook-github-bot/repos', 'events_url': 'https://api.github.com/users/facebook-github-bot/events{/privacy}', 'received_events_url': 'https://api.github.com/users/facebook-github-bot/received_events', 'type': 'User', 'site_admin': False}",referenced,16e2e4f29f8c9bd076011992755c3d2962fc5eb5,https://api.github.com/repos/pytorch/pytorch/commits/16e2e4f29f8c9bd076011992755c3d2962fc5eb5,2019-01-31T00:54:55Z,12,12,0
16543,2108084826,"{'login': 'facebook-github-bot', 'id': 6422482, 'node_id': 'MDQ6VXNlcjY0MjI0ODI=', 'avatar_url': 'https://avatars3.githubusercontent.com/u/6422482?v=4', 'gravatar_id': '', 'url': 'https://api.github.com/users/facebook-github-bot', 'html_url': 'https://github.com/facebook-github-bot', 'followers_url': 'https://api.github.com/users/facebook-github-bot/followers', 'following_url': 'https://api.github.com/users/facebook-github-bot/following{/other_user}', 'gists_url': 'https://api.github.com/users/facebook-github-bot/gists{/gist_id}', 'starred_url': 'https://api.github.com/users/facebook-github-bot/starred{/owner}{/repo}', 'subscriptions_url': 'https://api.github.com/users/facebook-github-bot/subscriptions', 'organizations_url': 'https://api.github.com/users/facebook-github-bot/orgs', 'repos_url': 'https://api.github.com/users/facebook-github-bot/repos', 'events_url': 'https://api.github.com/users/facebook-github-bot/events{/privacy}', 'received_events_url': 'https://api.github.com/users/facebook-github-bot/received_events', 'type': 'User', 'site_admin': False}",closed,851437dd4b5a44b4f9795925f07329d0aab1aa3c,https://api.github.com/repos/pytorch/pytorch/commits/851437dd4b5a44b4f9795925f07329d0aab1aa3c,2019-01-31T00:10:07Z,16,11,5
16532,2490503516,"{'login': 'ezyang', 'id': 13564, 'node_id': 'MDQ6VXNlcjEzNTY0', 'avatar_url': 'https://avatars0.githubusercontent.com/u/13564?v=4', 'gravatar_id': '', 'url': 'https://api.github.com/users/ezyang', 'html_url': 'https://github.com/ezyang', 'followers_url': 'https://api.github.com/users/ezyang/followers', 'following_url': 'https://api.github.com/users/ezyang/following{/other_user}', 'gists_url': 'https://api.github.com/users/ezyang/gists{/gist_id}', 'starred_url': 'https://api.github.com/users/ezyang/starred{/owner}{/repo}', 'subscriptions_url': 'https://api.github.com/users/ezyang/subscriptions', 'organizations_url': 'https://api.github.com/users/ezyang/orgs', 'repos_url': 'https://api.github.com/users/ezyang/repos', 'events_url': 'https://api.github.com/users/ezyang/events{/privacy}', 'received_events_url': 'https://api.github.com/users/ezyang/received_events', 'type': 'User', 'site_admin': False}",referenced,b119feb3b626bf2fba262b8e111b94270ca52440,https://api.github.com/repos/pytorch/pytorch/commits/b119feb3b626bf2fba262b8e111b94270ca52440,2019-07-17T18:42:17Z,135,98,37
16532,2490503870,"{'login': 'ezyang', 'id': 13564, 'node_id': 'MDQ6VXNlcjEzNTY0', 'avatar_url': 'https://avatars0.githubusercontent.com/u/13564?v=4', 'gravatar_id': '', 'url': 'https://api.github.com/users/ezyang', 'html_url': 'https://github.com/ezyang', 'followers_url': 'https://api.github.com/users/ezyang/followers', 'following_url': 'https://api.github.com/users/ezyang/following{/other_user}', 'gists_url': 'https://api.github.com/users/ezyang/gists{/gist_id}', 'starred_url': 'https://api.github.com/users/ezyang/starred{/owner}{/repo}', 'subscriptions_url': 'https://api.github.com/users/ezyang/subscriptions', 'organizations_url': 'https://api.github.com/users/ezyang/orgs', 'repos_url': 'https://api.github.com/users/ezyang/repos', 'events_url': 'https://api.github.com/users/ezyang/events{/privacy}', 'received_events_url': 'https://api.github.com/users/ezyang/received_events', 'type': 'User', 'site_admin': False}",referenced,0497e97dd9ab2f0b4b3a13f9bd8166e29c291233,https://api.github.com/repos/pytorch/pytorch/commits/0497e97dd9ab2f0b4b3a13f9bd8166e29c291233,2019-07-17T18:42:24Z,135,98,37
16532,2490914888,"{'login': 'ezyang', 'id': 13564, 'node_id': 'MDQ6VXNlcjEzNTY0', 'avatar_url': 'https://avatars0.githubusercontent.com/u/13564?v=4', 'gravatar_id': '', 'url': 'https://api.github.com/users/ezyang', 'html_url': 'https://github.com/ezyang', 'followers_url': 'https://api.github.com/users/ezyang/followers', 'following_url': 'https://api.github.com/users/ezyang/following{/other_user}', 'gists_url': 'https://api.github.com/users/ezyang/gists{/gist_id}', 'starred_url': 'https://api.github.com/users/ezyang/starred{/owner}{/repo}', 'subscriptions_url': 'https://api.github.com/users/ezyang/subscriptions', 'organizations_url': 'https://api.github.com/users/ezyang/orgs', 'repos_url': 'https://api.github.com/users/ezyang/repos', 'events_url': 'https://api.github.com/users/ezyang/events{/privacy}', 'received_events_url': 'https://api.github.com/users/ezyang/received_events', 'type': 'User', 'site_admin': False}",referenced,4b412ab8d3ffe74f3ac5c786fab0ac54ca6fc23d,https://api.github.com/repos/pytorch/pytorch/commits/4b412ab8d3ffe74f3ac5c786fab0ac54ca6fc23d,2019-07-17T21:26:32Z,72,61,11
16532,2490915075,"{'login': 'ezyang', 'id': 13564, 'node_id': 'MDQ6VXNlcjEzNTY0', 'avatar_url': 'https://avatars0.githubusercontent.com/u/13564?v=4', 'gravatar_id': '', 'url': 'https://api.github.com/users/ezyang', 'html_url': 'https://github.com/ezyang', 'followers_url': 'https://api.github.com/users/ezyang/followers', 'following_url': 'https://api.github.com/users/ezyang/following{/other_user}', 'gists_url': 'https://api.github.com/users/ezyang/gists{/gist_id}', 'starred_url': 'https://api.github.com/users/ezyang/starred{/owner}{/repo}', 'subscriptions_url': 'https://api.github.com/users/ezyang/subscriptions', 'organizations_url': 'https://api.github.com/users/ezyang/orgs', 'repos_url': 'https://api.github.com/users/ezyang/repos', 'events_url': 'https://api.github.com/users/ezyang/events{/privacy}', 'received_events_url': 'https://api.github.com/users/ezyang/received_events', 'type': 'User', 'site_admin': False}",referenced,9f9641558259def52c4722efa26124bfc91d06d0,https://api.github.com/repos/pytorch/pytorch/commits/9f9641558259def52c4722efa26124bfc91d06d0,2019-07-17T21:26:37Z,195,153,42
16532,2496371565,"{'login': 'ezyang', 'id': 13564, 'node_id': 'MDQ6VXNlcjEzNTY0', 'avatar_url': 'https://avatars0.githubusercontent.com/u/13564?v=4', 'gravatar_id': '', 'url': 'https://api.github.com/users/ezyang', 'html_url': 'https://github.com/ezyang', 'followers_url': 'https://api.github.com/users/ezyang/followers', 'following_url': 'https://api.github.com/users/ezyang/following{/other_user}', 'gists_url': 'https://api.github.com/users/ezyang/gists{/gist_id}', 'starred_url': 'https://api.github.com/users/ezyang/starred{/owner}{/repo}', 'subscriptions_url': 'https://api.github.com/users/ezyang/subscriptions', 'organizations_url': 'https://api.github.com/users/ezyang/orgs', 'repos_url': 'https://api.github.com/users/ezyang/repos', 'events_url': 'https://api.github.com/users/ezyang/events{/privacy}', 'received_events_url': 'https://api.github.com/users/ezyang/received_events', 'type': 'User', 'site_admin': False}",referenced,7c44ca5b5151a34a4b0ddbb4389832402f7e4004,https://api.github.com/repos/pytorch/pytorch/commits/7c44ca5b5151a34a4b0ddbb4389832402f7e4004,2019-07-19T16:31:33Z,184,85,99
16532,2496371713,"{'login': 'ezyang', 'id': 13564, 'node_id': 'MDQ6VXNlcjEzNTY0', 'avatar_url': 'https://avatars0.githubusercontent.com/u/13564?v=4', 'gravatar_id': '', 'url': 'https://api.github.com/users/ezyang', 'html_url': 'https://github.com/ezyang', 'followers_url': 'https://api.github.com/users/ezyang/followers', 'following_url': 'https://api.github.com/users/ezyang/following{/other_user}', 'gists_url': 'https://api.github.com/users/ezyang/gists{/gist_id}', 'starred_url': 'https://api.github.com/users/ezyang/starred{/owner}{/repo}', 'subscriptions_url': 'https://api.github.com/users/ezyang/subscriptions', 'organizations_url': 'https://api.github.com/users/ezyang/orgs', 'repos_url': 'https://api.github.com/users/ezyang/repos', 'events_url': 'https://api.github.com/users/ezyang/events{/privacy}', 'received_events_url': 'https://api.github.com/users/ezyang/received_events', 'type': 'User', 'site_admin': False}",referenced,6bda38d37e7568d065fd373740789215109f6a9f,https://api.github.com/repos/pytorch/pytorch/commits/6bda38d37e7568d065fd373740789215109f6a9f,2019-07-19T16:31:38Z,343,220,123
16532,2496589298,"{'login': 'ezyang', 'id': 13564, 'node_id': 'MDQ6VXNlcjEzNTY0', 'avatar_url': 'https://avatars0.githubusercontent.com/u/13564?v=4', 'gravatar_id': '', 'url': 'https://api.github.com/users/ezyang', 'html_url': 'https://github.com/ezyang', 'followers_url': 'https://api.github.com/users/ezyang/followers', 'following_url': 'https://api.github.com/users/ezyang/following{/other_user}', 'gists_url': 'https://api.github.com/users/ezyang/gists{/gist_id}', 'starred_url': 'https://api.github.com/users/ezyang/starred{/owner}{/repo}', 'subscriptions_url': 'https://api.github.com/users/ezyang/subscriptions', 'organizations_url': 'https://api.github.com/users/ezyang/orgs', 'repos_url': 'https://api.github.com/users/ezyang/repos', 'events_url': 'https://api.github.com/users/ezyang/events{/privacy}', 'received_events_url': 'https://api.github.com/users/ezyang/received_events', 'type': 'User', 'site_admin': False}",referenced,79b5216a0a6f38bba71f2b3ebe5e92b3093381f3,https://api.github.com/repos/pytorch/pytorch/commits/79b5216a0a6f38bba71f2b3ebe5e92b3093381f3,2019-07-19T18:04:21Z,3880,2678,1202
16532,2496589412,"{'login': 'ezyang', 'id': 13564, 'node_id': 'MDQ6VXNlcjEzNTY0', 'avatar_url': 'https://avatars0.githubusercontent.com/u/13564?v=4', 'gravatar_id': '', 'url': 'https://api.github.com/users/ezyang', 'html_url': 'https://github.com/ezyang', 'followers_url': 'https://api.github.com/users/ezyang/followers', 'following_url': 'https://api.github.com/users/ezyang/following{/other_user}', 'gists_url': 'https://api.github.com/users/ezyang/gists{/gist_id}', 'starred_url': 'https://api.github.com/users/ezyang/starred{/owner}{/repo}', 'subscriptions_url': 'https://api.github.com/users/ezyang/subscriptions', 'organizations_url': 'https://api.github.com/users/ezyang/orgs', 'repos_url': 'https://api.github.com/users/ezyang/repos', 'events_url': 'https://api.github.com/users/ezyang/events{/privacy}', 'received_events_url': 'https://api.github.com/users/ezyang/received_events', 'type': 'User', 'site_admin': False}",referenced,c1447a7980367e9be8b4328dbf37b520807a2857,https://api.github.com/repos/pytorch/pytorch/commits/c1447a7980367e9be8b4328dbf37b520807a2857,2019-07-19T18:04:23Z,425,302,123
16532,2496633228,"{'login': 'ezyang', 'id': 13564, 'node_id': 'MDQ6VXNlcjEzNTY0', 'avatar_url': 'https://avatars0.githubusercontent.com/u/13564?v=4', 'gravatar_id': '', 'url': 'https://api.github.com/users/ezyang', 'html_url': 'https://github.com/ezyang', 'followers_url': 'https://api.github.com/users/ezyang/followers', 'following_url': 'https://api.github.com/users/ezyang/following{/other_user}', 'gists_url': 'https://api.github.com/users/ezyang/gists{/gist_id}', 'starred_url': 'https://api.github.com/users/ezyang/starred{/owner}{/repo}', 'subscriptions_url': 'https://api.github.com/users/ezyang/subscriptions', 'organizations_url': 'https://api.github.com/users/ezyang/orgs', 'repos_url': 'https://api.github.com/users/ezyang/repos', 'events_url': 'https://api.github.com/users/ezyang/events{/privacy}', 'received_events_url': 'https://api.github.com/users/ezyang/received_events', 'type': 'User', 'site_admin': False}",referenced,7a1d67a553edc96ee7b1d0f4a92200dd70739275,https://api.github.com/repos/pytorch/pytorch/commits/7a1d67a553edc96ee7b1d0f4a92200dd70739275,2019-07-19T18:22:49Z,3,2,1
16532,2496633365,"{'login': 'ezyang', 'id': 13564, 'node_id': 'MDQ6VXNlcjEzNTY0', 'avatar_url': 'https://avatars0.githubusercontent.com/u/13564?v=4', 'gravatar_id': '', 'url': 'https://api.github.com/users/ezyang', 'html_url': 'https://github.com/ezyang', 'followers_url': 'https://api.github.com/users/ezyang/followers', 'following_url': 'https://api.github.com/users/ezyang/following{/other_user}', 'gists_url': 'https://api.github.com/users/ezyang/gists{/gist_id}', 'starred_url': 'https://api.github.com/users/ezyang/starred{/owner}{/repo}', 'subscriptions_url': 'https://api.github.com/users/ezyang/subscriptions', 'organizations_url': 'https://api.github.com/users/ezyang/orgs', 'repos_url': 'https://api.github.com/users/ezyang/repos', 'events_url': 'https://api.github.com/users/ezyang/events{/privacy}', 'received_events_url': 'https://api.github.com/users/ezyang/received_events', 'type': 'User', 'site_admin': False}",referenced,9397cd75d9ec183c78af779b528bdbfa9f09338f,https://api.github.com/repos/pytorch/pytorch/commits/9397cd75d9ec183c78af779b528bdbfa9f09338f,2019-07-19T18:22:52Z,426,303,123
16520,2263990186,"{'login': 'facebook-github-bot', 'id': 6422482, 'node_id': 'MDQ6VXNlcjY0MjI0ODI=', 'avatar_url': 'https://avatars3.githubusercontent.com/u/6422482?v=4', 'gravatar_id': '', 'url': 'https://api.github.com/users/facebook-github-bot', 'html_url': 'https://github.com/facebook-github-bot', 'followers_url': 'https://api.github.com/users/facebook-github-bot/followers', 'following_url': 'https://api.github.com/users/facebook-github-bot/following{/other_user}', 'gists_url': 'https://api.github.com/users/facebook-github-bot/gists{/gist_id}', 'starred_url': 'https://api.github.com/users/facebook-github-bot/starred{/owner}{/repo}', 'subscriptions_url': 'https://api.github.com/users/facebook-github-bot/subscriptions', 'organizations_url': 'https://api.github.com/users/facebook-github-bot/orgs', 'repos_url': 'https://api.github.com/users/facebook-github-bot/repos', 'events_url': 'https://api.github.com/users/facebook-github-bot/events{/privacy}', 'received_events_url': 'https://api.github.com/users/facebook-github-bot/received_events', 'type': 'User', 'site_admin': False}",closed,8f9b11cf334bf15c35909094edd868892bddbc6f,https://api.github.com/repos/pytorch/pytorch/commits/8f9b11cf334bf15c35909094edd868892bddbc6f,2019-04-09T19:38:26Z,63,63,0
16501,2105209806,"{'login': 'facebook-github-bot', 'id': 6422482, 'node_id': 'MDQ6VXNlcjY0MjI0ODI=', 'avatar_url': 'https://avatars3.githubusercontent.com/u/6422482?v=4', 'gravatar_id': '', 'url': 'https://api.github.com/users/facebook-github-bot', 'html_url': 'https://github.com/facebook-github-bot', 'followers_url': 'https://api.github.com/users/facebook-github-bot/followers', 'following_url': 'https://api.github.com/users/facebook-github-bot/following{/other_user}', 'gists_url': 'https://api.github.com/users/facebook-github-bot/gists{/gist_id}', 'starred_url': 'https://api.github.com/users/facebook-github-bot/starred{/owner}{/repo}', 'subscriptions_url': 'https://api.github.com/users/facebook-github-bot/subscriptions', 'organizations_url': 'https://api.github.com/users/facebook-github-bot/orgs', 'repos_url': 'https://api.github.com/users/facebook-github-bot/repos', 'events_url': 'https://api.github.com/users/facebook-github-bot/events{/privacy}', 'received_events_url': 'https://api.github.com/users/facebook-github-bot/received_events', 'type': 'User', 'site_admin': False}",closed,ffed8bff6a1df334e371957009dd77af0c5140dd,https://api.github.com/repos/pytorch/pytorch/commits/ffed8bff6a1df334e371957009dd77af0c5140dd,2019-01-30T00:20:50Z,12,10,2
16498,2186047839,"{'login': 'facebook-github-bot', 'id': 6422482, 'node_id': 'MDQ6VXNlcjY0MjI0ODI=', 'avatar_url': 'https://avatars3.githubusercontent.com/u/6422482?v=4', 'gravatar_id': '', 'url': 'https://api.github.com/users/facebook-github-bot', 'html_url': 'https://github.com/facebook-github-bot', 'followers_url': 'https://api.github.com/users/facebook-github-bot/followers', 'following_url': 'https://api.github.com/users/facebook-github-bot/following{/other_user}', 'gists_url': 'https://api.github.com/users/facebook-github-bot/gists{/gist_id}', 'starred_url': 'https://api.github.com/users/facebook-github-bot/starred{/owner}{/repo}', 'subscriptions_url': 'https://api.github.com/users/facebook-github-bot/subscriptions', 'organizations_url': 'https://api.github.com/users/facebook-github-bot/orgs', 'repos_url': 'https://api.github.com/users/facebook-github-bot/repos', 'events_url': 'https://api.github.com/users/facebook-github-bot/events{/privacy}', 'received_events_url': 'https://api.github.com/users/facebook-github-bot/received_events', 'type': 'User', 'site_admin': False}",referenced,8ec7357312590d8ccb305d58690238536b009159,https://api.github.com/repos/pytorch/pytorch/commits/8ec7357312590d8ccb305d58690238536b009159,2019-03-07T03:42:14Z,27,21,6
16471,2148722555,"{'login': 'facebook-github-bot', 'id': 6422482, 'node_id': 'MDQ6VXNlcjY0MjI0ODI=', 'avatar_url': 'https://avatars3.githubusercontent.com/u/6422482?v=4', 'gravatar_id': '', 'url': 'https://api.github.com/users/facebook-github-bot', 'html_url': 'https://github.com/facebook-github-bot', 'followers_url': 'https://api.github.com/users/facebook-github-bot/followers', 'following_url': 'https://api.github.com/users/facebook-github-bot/following{/other_user}', 'gists_url': 'https://api.github.com/users/facebook-github-bot/gists{/gist_id}', 'starred_url': 'https://api.github.com/users/facebook-github-bot/starred{/owner}{/repo}', 'subscriptions_url': 'https://api.github.com/users/facebook-github-bot/subscriptions', 'organizations_url': 'https://api.github.com/users/facebook-github-bot/orgs', 'repos_url': 'https://api.github.com/users/facebook-github-bot/repos', 'events_url': 'https://api.github.com/users/facebook-github-bot/events{/privacy}', 'received_events_url': 'https://api.github.com/users/facebook-github-bot/received_events', 'type': 'User', 'site_admin': False}",referenced,7e5442f90099e27d285e585b8d4e3ee05eb4ac4e,https://api.github.com/repos/pytorch/pytorch/commits/7e5442f90099e27d285e585b8d4e3ee05eb4ac4e,2019-02-19T12:35:58Z,23,21,2
16448,2134140111,"{'login': 'facebook-github-bot', 'id': 6422482, 'node_id': 'MDQ6VXNlcjY0MjI0ODI=', 'avatar_url': 'https://avatars3.githubusercontent.com/u/6422482?v=4', 'gravatar_id': '', 'url': 'https://api.github.com/users/facebook-github-bot', 'html_url': 'https://github.com/facebook-github-bot', 'followers_url': 'https://api.github.com/users/facebook-github-bot/followers', 'following_url': 'https://api.github.com/users/facebook-github-bot/following{/other_user}', 'gists_url': 'https://api.github.com/users/facebook-github-bot/gists{/gist_id}', 'starred_url': 'https://api.github.com/users/facebook-github-bot/starred{/owner}{/repo}', 'subscriptions_url': 'https://api.github.com/users/facebook-github-bot/subscriptions', 'organizations_url': 'https://api.github.com/users/facebook-github-bot/orgs', 'repos_url': 'https://api.github.com/users/facebook-github-bot/repos', 'events_url': 'https://api.github.com/users/facebook-github-bot/events{/privacy}', 'received_events_url': 'https://api.github.com/users/facebook-github-bot/received_events', 'type': 'User', 'site_admin': False}",referenced,f61f9e17578dc9c47e77500cd86f6a002e2062cf,https://api.github.com/repos/pytorch/pytorch/commits/f61f9e17578dc9c47e77500cd86f6a002e2062cf,2019-02-12T15:58:12Z,3,2,1
16448,2230224973,"{'login': 'SsnL', 'id': 5674597, 'node_id': 'MDQ6VXNlcjU2NzQ1OTc=', 'avatar_url': 'https://avatars2.githubusercontent.com/u/5674597?v=4', 'gravatar_id': '', 'url': 'https://api.github.com/users/SsnL', 'html_url': 'https://github.com/SsnL', 'followers_url': 'https://api.github.com/users/SsnL/followers', 'following_url': 'https://api.github.com/users/SsnL/following{/other_user}', 'gists_url': 'https://api.github.com/users/SsnL/gists{/gist_id}', 'starred_url': 'https://api.github.com/users/SsnL/starred{/owner}{/repo}', 'subscriptions_url': 'https://api.github.com/users/SsnL/subscriptions', 'organizations_url': 'https://api.github.com/users/SsnL/orgs', 'repos_url': 'https://api.github.com/users/SsnL/repos', 'events_url': 'https://api.github.com/users/SsnL/events{/privacy}', 'received_events_url': 'https://api.github.com/users/SsnL/received_events', 'type': 'User', 'site_admin': False}",referenced,2d655098aa3c644aa74e4bf22a5ae6e055af301d,https://api.github.com/repos/pytorch/pytorch/commits/2d655098aa3c644aa74e4bf22a5ae6e055af301d,2019-03-26T15:40:09Z,7,1,6
16448,2231841969,"{'login': 'facebook-github-bot', 'id': 6422482, 'node_id': 'MDQ6VXNlcjY0MjI0ODI=', 'avatar_url': 'https://avatars3.githubusercontent.com/u/6422482?v=4', 'gravatar_id': '', 'url': 'https://api.github.com/users/facebook-github-bot', 'html_url': 'https://github.com/facebook-github-bot', 'followers_url': 'https://api.github.com/users/facebook-github-bot/followers', 'following_url': 'https://api.github.com/users/facebook-github-bot/following{/other_user}', 'gists_url': 'https://api.github.com/users/facebook-github-bot/gists{/gist_id}', 'starred_url': 'https://api.github.com/users/facebook-github-bot/starred{/owner}{/repo}', 'subscriptions_url': 'https://api.github.com/users/facebook-github-bot/subscriptions', 'organizations_url': 'https://api.github.com/users/facebook-github-bot/orgs', 'repos_url': 'https://api.github.com/users/facebook-github-bot/repos', 'events_url': 'https://api.github.com/users/facebook-github-bot/events{/privacy}', 'received_events_url': 'https://api.github.com/users/facebook-github-bot/received_events', 'type': 'User', 'site_admin': False}",closed,60538c8366587d9b8b08226c953c98a0013b833f,https://api.github.com/repos/pytorch/pytorch/commits/60538c8366587d9b8b08226c953c98a0013b833f,2019-03-27T04:00:04Z,7,1,6
16446,2104869319,"{'login': 'facebook-github-bot', 'id': 6422482, 'node_id': 'MDQ6VXNlcjY0MjI0ODI=', 'avatar_url': 'https://avatars3.githubusercontent.com/u/6422482?v=4', 'gravatar_id': '', 'url': 'https://api.github.com/users/facebook-github-bot', 'html_url': 'https://github.com/facebook-github-bot', 'followers_url': 'https://api.github.com/users/facebook-github-bot/followers', 'following_url': 'https://api.github.com/users/facebook-github-bot/following{/other_user}', 'gists_url': 'https://api.github.com/users/facebook-github-bot/gists{/gist_id}', 'starred_url': 'https://api.github.com/users/facebook-github-bot/starred{/owner}{/repo}', 'subscriptions_url': 'https://api.github.com/users/facebook-github-bot/subscriptions', 'organizations_url': 'https://api.github.com/users/facebook-github-bot/orgs', 'repos_url': 'https://api.github.com/users/facebook-github-bot/repos', 'events_url': 'https://api.github.com/users/facebook-github-bot/events{/privacy}', 'received_events_url': 'https://api.github.com/users/facebook-github-bot/received_events', 'type': 'User', 'site_admin': False}",closed,3ab620926f83a406de4da8250d3111796d74ed5d,https://api.github.com/repos/pytorch/pytorch/commits/3ab620926f83a406de4da8250d3111796d74ed5d,2019-01-29T21:17:02Z,10,6,4
16428,2213720485,"{'login': 'facebook-github-bot', 'id': 6422482, 'node_id': 'MDQ6VXNlcjY0MjI0ODI=', 'avatar_url': 'https://avatars3.githubusercontent.com/u/6422482?v=4', 'gravatar_id': '', 'url': 'https://api.github.com/users/facebook-github-bot', 'html_url': 'https://github.com/facebook-github-bot', 'followers_url': 'https://api.github.com/users/facebook-github-bot/followers', 'following_url': 'https://api.github.com/users/facebook-github-bot/following{/other_user}', 'gists_url': 'https://api.github.com/users/facebook-github-bot/gists{/gist_id}', 'starred_url': 'https://api.github.com/users/facebook-github-bot/starred{/owner}{/repo}', 'subscriptions_url': 'https://api.github.com/users/facebook-github-bot/subscriptions', 'organizations_url': 'https://api.github.com/users/facebook-github-bot/orgs', 'repos_url': 'https://api.github.com/users/facebook-github-bot/repos', 'events_url': 'https://api.github.com/users/facebook-github-bot/events{/privacy}', 'received_events_url': 'https://api.github.com/users/facebook-github-bot/received_events', 'type': 'User', 'site_admin': False}",closed,8ed2b88bf1ce39ba166e21e262d4f6b97bd96acd,https://api.github.com/repos/pytorch/pytorch/commits/8ed2b88bf1ce39ba166e21e262d4f6b97bd96acd,2019-03-19T14:11:32Z,2,1,1
16367,2212159450,"{'login': 'facebook-github-bot', 'id': 6422482, 'node_id': 'MDQ6VXNlcjY0MjI0ODI=', 'avatar_url': 'https://avatars3.githubusercontent.com/u/6422482?v=4', 'gravatar_id': '', 'url': 'https://api.github.com/users/facebook-github-bot', 'html_url': 'https://github.com/facebook-github-bot', 'followers_url': 'https://api.github.com/users/facebook-github-bot/followers', 'following_url': 'https://api.github.com/users/facebook-github-bot/following{/other_user}', 'gists_url': 'https://api.github.com/users/facebook-github-bot/gists{/gist_id}', 'starred_url': 'https://api.github.com/users/facebook-github-bot/starred{/owner}{/repo}', 'subscriptions_url': 'https://api.github.com/users/facebook-github-bot/subscriptions', 'organizations_url': 'https://api.github.com/users/facebook-github-bot/orgs', 'repos_url': 'https://api.github.com/users/facebook-github-bot/repos', 'events_url': 'https://api.github.com/users/facebook-github-bot/events{/privacy}', 'received_events_url': 'https://api.github.com/users/facebook-github-bot/received_events', 'type': 'User', 'site_admin': False}",closed,3d44305e9d3f0ecb9eb126dbf0125a0cdc513b2d,https://api.github.com/repos/pytorch/pytorch/commits/3d44305e9d3f0ecb9eb126dbf0125a0cdc513b2d,2019-03-19T01:20:13Z,872,864,8
16365,2098983769,"{'login': 'facebook-github-bot', 'id': 6422482, 'node_id': 'MDQ6VXNlcjY0MjI0ODI=', 'avatar_url': 'https://avatars3.githubusercontent.com/u/6422482?v=4', 'gravatar_id': '', 'url': 'https://api.github.com/users/facebook-github-bot', 'html_url': 'https://github.com/facebook-github-bot', 'followers_url': 'https://api.github.com/users/facebook-github-bot/followers', 'following_url': 'https://api.github.com/users/facebook-github-bot/following{/other_user}', 'gists_url': 'https://api.github.com/users/facebook-github-bot/gists{/gist_id}', 'starred_url': 'https://api.github.com/users/facebook-github-bot/starred{/owner}{/repo}', 'subscriptions_url': 'https://api.github.com/users/facebook-github-bot/subscriptions', 'organizations_url': 'https://api.github.com/users/facebook-github-bot/orgs', 'repos_url': 'https://api.github.com/users/facebook-github-bot/repos', 'events_url': 'https://api.github.com/users/facebook-github-bot/events{/privacy}', 'received_events_url': 'https://api.github.com/users/facebook-github-bot/received_events', 'type': 'User', 'site_admin': False}",closed,8c81a72e87ac4114fbddfadb9285d89a9ead79a1,https://api.github.com/repos/pytorch/pytorch/commits/8c81a72e87ac4114fbddfadb9285d89a9ead79a1,2019-01-26T19:20:25Z,2,1,1
16365,2114601909,"{'login': 'soumith', 'id': 1310570, 'node_id': 'MDQ6VXNlcjEzMTA1NzA=', 'avatar_url': 'https://avatars0.githubusercontent.com/u/1310570?v=4', 'gravatar_id': '', 'url': 'https://api.github.com/users/soumith', 'html_url': 'https://github.com/soumith', 'followers_url': 'https://api.github.com/users/soumith/followers', 'following_url': 'https://api.github.com/users/soumith/following{/other_user}', 'gists_url': 'https://api.github.com/users/soumith/gists{/gist_id}', 'starred_url': 'https://api.github.com/users/soumith/starred{/owner}{/repo}', 'subscriptions_url': 'https://api.github.com/users/soumith/subscriptions', 'organizations_url': 'https://api.github.com/users/soumith/orgs', 'repos_url': 'https://api.github.com/users/soumith/repos', 'events_url': 'https://api.github.com/users/soumith/events{/privacy}', 'received_events_url': 'https://api.github.com/users/soumith/received_events', 'type': 'User', 'site_admin': False}",referenced,37c8a33b54882c9efb1404dae4079cb29a3ef494,https://api.github.com/repos/pytorch/pytorch/commits/37c8a33b54882c9efb1404dae4079cb29a3ef494,2019-02-04T00:51:11Z,2,1,1
16364,2239318544,"{'login': 'facebook-github-bot', 'id': 6422482, 'node_id': 'MDQ6VXNlcjY0MjI0ODI=', 'avatar_url': 'https://avatars3.githubusercontent.com/u/6422482?v=4', 'gravatar_id': '', 'url': 'https://api.github.com/users/facebook-github-bot', 'html_url': 'https://github.com/facebook-github-bot', 'followers_url': 'https://api.github.com/users/facebook-github-bot/followers', 'following_url': 'https://api.github.com/users/facebook-github-bot/following{/other_user}', 'gists_url': 'https://api.github.com/users/facebook-github-bot/gists{/gist_id}', 'starred_url': 'https://api.github.com/users/facebook-github-bot/starred{/owner}{/repo}', 'subscriptions_url': 'https://api.github.com/users/facebook-github-bot/subscriptions', 'organizations_url': 'https://api.github.com/users/facebook-github-bot/orgs', 'repos_url': 'https://api.github.com/users/facebook-github-bot/repos', 'events_url': 'https://api.github.com/users/facebook-github-bot/events{/privacy}', 'received_events_url': 'https://api.github.com/users/facebook-github-bot/received_events', 'type': 'User', 'site_admin': False}",closed,95d3825e48ad8eb6caab2374d831b4e76824dc25,https://api.github.com/repos/pytorch/pytorch/commits/95d3825e48ad8eb6caab2374d831b4e76824dc25,2019-03-29T13:59:11Z,3,2,1
16326,2107900252,"{'login': 'facebook-github-bot', 'id': 6422482, 'node_id': 'MDQ6VXNlcjY0MjI0ODI=', 'avatar_url': 'https://avatars3.githubusercontent.com/u/6422482?v=4', 'gravatar_id': '', 'url': 'https://api.github.com/users/facebook-github-bot', 'html_url': 'https://github.com/facebook-github-bot', 'followers_url': 'https://api.github.com/users/facebook-github-bot/followers', 'following_url': 'https://api.github.com/users/facebook-github-bot/following{/other_user}', 'gists_url': 'https://api.github.com/users/facebook-github-bot/gists{/gist_id}', 'starred_url': 'https://api.github.com/users/facebook-github-bot/starred{/owner}{/repo}', 'subscriptions_url': 'https://api.github.com/users/facebook-github-bot/subscriptions', 'organizations_url': 'https://api.github.com/users/facebook-github-bot/orgs', 'repos_url': 'https://api.github.com/users/facebook-github-bot/repos', 'events_url': 'https://api.github.com/users/facebook-github-bot/events{/privacy}', 'received_events_url': 'https://api.github.com/users/facebook-github-bot/received_events', 'type': 'User', 'site_admin': False}",closed,18659e13367dd1ff37af9d79b954a035f7230582,https://api.github.com/repos/pytorch/pytorch/commits/18659e13367dd1ff37af9d79b954a035f7230582,2019-01-30T22:22:21Z,101,94,7
16292,2099502966,"{'login': 'facebook-github-bot', 'id': 6422482, 'node_id': 'MDQ6VXNlcjY0MjI0ODI=', 'avatar_url': 'https://avatars3.githubusercontent.com/u/6422482?v=4', 'gravatar_id': '', 'url': 'https://api.github.com/users/facebook-github-bot', 'html_url': 'https://github.com/facebook-github-bot', 'followers_url': 'https://api.github.com/users/facebook-github-bot/followers', 'following_url': 'https://api.github.com/users/facebook-github-bot/following{/other_user}', 'gists_url': 'https://api.github.com/users/facebook-github-bot/gists{/gist_id}', 'starred_url': 'https://api.github.com/users/facebook-github-bot/starred{/owner}{/repo}', 'subscriptions_url': 'https://api.github.com/users/facebook-github-bot/subscriptions', 'organizations_url': 'https://api.github.com/users/facebook-github-bot/orgs', 'repos_url': 'https://api.github.com/users/facebook-github-bot/repos', 'events_url': 'https://api.github.com/users/facebook-github-bot/events{/privacy}', 'received_events_url': 'https://api.github.com/users/facebook-github-bot/received_events', 'type': 'User', 'site_admin': False}",referenced,ee1844813801e3c0cca51a7272383f0a04393cfb,https://api.github.com/repos/pytorch/pytorch/commits/ee1844813801e3c0cca51a7272383f0a04393cfb,2019-01-27T20:31:26Z,2,1,1
16288,2095653949,"{'login': 'facebook-github-bot', 'id': 6422482, 'node_id': 'MDQ6VXNlcjY0MjI0ODI=', 'avatar_url': 'https://avatars3.githubusercontent.com/u/6422482?v=4', 'gravatar_id': '', 'url': 'https://api.github.com/users/facebook-github-bot', 'html_url': 'https://github.com/facebook-github-bot', 'followers_url': 'https://api.github.com/users/facebook-github-bot/followers', 'following_url': 'https://api.github.com/users/facebook-github-bot/following{/other_user}', 'gists_url': 'https://api.github.com/users/facebook-github-bot/gists{/gist_id}', 'starred_url': 'https://api.github.com/users/facebook-github-bot/starred{/owner}{/repo}', 'subscriptions_url': 'https://api.github.com/users/facebook-github-bot/subscriptions', 'organizations_url': 'https://api.github.com/users/facebook-github-bot/orgs', 'repos_url': 'https://api.github.com/users/facebook-github-bot/repos', 'events_url': 'https://api.github.com/users/facebook-github-bot/events{/privacy}', 'received_events_url': 'https://api.github.com/users/facebook-github-bot/received_events', 'type': 'User', 'site_admin': False}",referenced,fdda533eb1d494da5e3dee8f321e0001db76adf9,https://api.github.com/repos/pytorch/pytorch/commits/fdda533eb1d494da5e3dee8f321e0001db76adf9,2019-01-24T21:12:24Z,35,34,1
16285,2110533794,"{'login': 'facebook-github-bot', 'id': 6422482, 'node_id': 'MDQ6VXNlcjY0MjI0ODI=', 'avatar_url': 'https://avatars3.githubusercontent.com/u/6422482?v=4', 'gravatar_id': '', 'url': 'https://api.github.com/users/facebook-github-bot', 'html_url': 'https://github.com/facebook-github-bot', 'followers_url': 'https://api.github.com/users/facebook-github-bot/followers', 'following_url': 'https://api.github.com/users/facebook-github-bot/following{/other_user}', 'gists_url': 'https://api.github.com/users/facebook-github-bot/gists{/gist_id}', 'starred_url': 'https://api.github.com/users/facebook-github-bot/starred{/owner}{/repo}', 'subscriptions_url': 'https://api.github.com/users/facebook-github-bot/subscriptions', 'organizations_url': 'https://api.github.com/users/facebook-github-bot/orgs', 'repos_url': 'https://api.github.com/users/facebook-github-bot/repos', 'events_url': 'https://api.github.com/users/facebook-github-bot/events{/privacy}', 'received_events_url': 'https://api.github.com/users/facebook-github-bot/received_events', 'type': 'User', 'site_admin': False}",closed,26565046acaaffab037ae24a331eec89f2be935b,https://api.github.com/repos/pytorch/pytorch/commits/26565046acaaffab037ae24a331eec89f2be935b,2019-01-31T20:30:38Z,4,3,1
16284,2125185232,"{'login': 'facebook-github-bot', 'id': 6422482, 'node_id': 'MDQ6VXNlcjY0MjI0ODI=', 'avatar_url': 'https://avatars3.githubusercontent.com/u/6422482?v=4', 'gravatar_id': '', 'url': 'https://api.github.com/users/facebook-github-bot', 'html_url': 'https://github.com/facebook-github-bot', 'followers_url': 'https://api.github.com/users/facebook-github-bot/followers', 'following_url': 'https://api.github.com/users/facebook-github-bot/following{/other_user}', 'gists_url': 'https://api.github.com/users/facebook-github-bot/gists{/gist_id}', 'starred_url': 'https://api.github.com/users/facebook-github-bot/starred{/owner}{/repo}', 'subscriptions_url': 'https://api.github.com/users/facebook-github-bot/subscriptions', 'organizations_url': 'https://api.github.com/users/facebook-github-bot/orgs', 'repos_url': 'https://api.github.com/users/facebook-github-bot/repos', 'events_url': 'https://api.github.com/users/facebook-github-bot/events{/privacy}', 'received_events_url': 'https://api.github.com/users/facebook-github-bot/received_events', 'type': 'User', 'site_admin': False}",closed,44d98c30a3ab4921b4b9354859c3571e21ae7722,https://api.github.com/repos/pytorch/pytorch/commits/44d98c30a3ab4921b4b9354859c3571e21ae7722,2019-02-07T20:29:58Z,33,25,8
16271,2096067357,"{'login': 'facebook-github-bot', 'id': 6422482, 'node_id': 'MDQ6VXNlcjY0MjI0ODI=', 'avatar_url': 'https://avatars3.githubusercontent.com/u/6422482?v=4', 'gravatar_id': '', 'url': 'https://api.github.com/users/facebook-github-bot', 'html_url': 'https://github.com/facebook-github-bot', 'followers_url': 'https://api.github.com/users/facebook-github-bot/followers', 'following_url': 'https://api.github.com/users/facebook-github-bot/following{/other_user}', 'gists_url': 'https://api.github.com/users/facebook-github-bot/gists{/gist_id}', 'starred_url': 'https://api.github.com/users/facebook-github-bot/starred{/owner}{/repo}', 'subscriptions_url': 'https://api.github.com/users/facebook-github-bot/subscriptions', 'organizations_url': 'https://api.github.com/users/facebook-github-bot/orgs', 'repos_url': 'https://api.github.com/users/facebook-github-bot/repos', 'events_url': 'https://api.github.com/users/facebook-github-bot/events{/privacy}', 'received_events_url': 'https://api.github.com/users/facebook-github-bot/received_events', 'type': 'User', 'site_admin': False}",referenced,7ce634ebc2943ff11d2ec727b7db83ab9758a6e0,https://api.github.com/repos/pytorch/pytorch/commits/7ce634ebc2943ff11d2ec727b7db83ab9758a6e0,2019-01-25T01:17:42Z,102,73,29
16267,2093185967,"{'login': 'facebook-github-bot', 'id': 6422482, 'node_id': 'MDQ6VXNlcjY0MjI0ODI=', 'avatar_url': 'https://avatars3.githubusercontent.com/u/6422482?v=4', 'gravatar_id': '', 'url': 'https://api.github.com/users/facebook-github-bot', 'html_url': 'https://github.com/facebook-github-bot', 'followers_url': 'https://api.github.com/users/facebook-github-bot/followers', 'following_url': 'https://api.github.com/users/facebook-github-bot/following{/other_user}', 'gists_url': 'https://api.github.com/users/facebook-github-bot/gists{/gist_id}', 'starred_url': 'https://api.github.com/users/facebook-github-bot/starred{/owner}{/repo}', 'subscriptions_url': 'https://api.github.com/users/facebook-github-bot/subscriptions', 'organizations_url': 'https://api.github.com/users/facebook-github-bot/orgs', 'repos_url': 'https://api.github.com/users/facebook-github-bot/repos', 'events_url': 'https://api.github.com/users/facebook-github-bot/events{/privacy}', 'received_events_url': 'https://api.github.com/users/facebook-github-bot/received_events', 'type': 'User', 'site_admin': False}",referenced,4b06c063a5259f50ec4c3cdde621857ea125fa97,https://api.github.com/repos/pytorch/pytorch/commits/4b06c063a5259f50ec4c3cdde621857ea125fa97,2019-01-24T00:17:41Z,4,3,1
16267,3003472114,"{'login': 'facebook-github-bot', 'id': 6422482, 'node_id': 'MDQ6VXNlcjY0MjI0ODI=', 'avatar_url': 'https://avatars3.githubusercontent.com/u/6422482?v=4', 'gravatar_id': '', 'url': 'https://api.github.com/users/facebook-github-bot', 'html_url': 'https://github.com/facebook-github-bot', 'followers_url': 'https://api.github.com/users/facebook-github-bot/followers', 'following_url': 'https://api.github.com/users/facebook-github-bot/following{/other_user}', 'gists_url': 'https://api.github.com/users/facebook-github-bot/gists{/gist_id}', 'starred_url': 'https://api.github.com/users/facebook-github-bot/starred{/owner}{/repo}', 'subscriptions_url': 'https://api.github.com/users/facebook-github-bot/subscriptions', 'organizations_url': 'https://api.github.com/users/facebook-github-bot/orgs', 'repos_url': 'https://api.github.com/users/facebook-github-bot/repos', 'events_url': 'https://api.github.com/users/facebook-github-bot/events{/privacy}', 'received_events_url': 'https://api.github.com/users/facebook-github-bot/received_events', 'type': 'User', 'site_admin': False}",referenced,37953d92d198b6d8941d8120218d86d6e3813eee,https://api.github.com/repos/pytorch/pytorch/commits/37953d92d198b6d8941d8120218d86d6e3813eee,2020-02-03T19:22:50Z,2,2,0
16250,2096067355,"{'login': 'facebook-github-bot', 'id': 6422482, 'node_id': 'MDQ6VXNlcjY0MjI0ODI=', 'avatar_url': 'https://avatars3.githubusercontent.com/u/6422482?v=4', 'gravatar_id': '', 'url': 'https://api.github.com/users/facebook-github-bot', 'html_url': 'https://github.com/facebook-github-bot', 'followers_url': 'https://api.github.com/users/facebook-github-bot/followers', 'following_url': 'https://api.github.com/users/facebook-github-bot/following{/other_user}', 'gists_url': 'https://api.github.com/users/facebook-github-bot/gists{/gist_id}', 'starred_url': 'https://api.github.com/users/facebook-github-bot/starred{/owner}{/repo}', 'subscriptions_url': 'https://api.github.com/users/facebook-github-bot/subscriptions', 'organizations_url': 'https://api.github.com/users/facebook-github-bot/orgs', 'repos_url': 'https://api.github.com/users/facebook-github-bot/repos', 'events_url': 'https://api.github.com/users/facebook-github-bot/events{/privacy}', 'received_events_url': 'https://api.github.com/users/facebook-github-bot/received_events', 'type': 'User', 'site_admin': False}",closed,7ce634ebc2943ff11d2ec727b7db83ab9758a6e0,https://api.github.com/repos/pytorch/pytorch/commits/7ce634ebc2943ff11d2ec727b7db83ab9758a6e0,2019-01-25T01:17:42Z,102,73,29
16233,2129574402,"{'login': 'facebook-github-bot', 'id': 6422482, 'node_id': 'MDQ6VXNlcjY0MjI0ODI=', 'avatar_url': 'https://avatars3.githubusercontent.com/u/6422482?v=4', 'gravatar_id': '', 'url': 'https://api.github.com/users/facebook-github-bot', 'html_url': 'https://github.com/facebook-github-bot', 'followers_url': 'https://api.github.com/users/facebook-github-bot/followers', 'following_url': 'https://api.github.com/users/facebook-github-bot/following{/other_user}', 'gists_url': 'https://api.github.com/users/facebook-github-bot/gists{/gist_id}', 'starred_url': 'https://api.github.com/users/facebook-github-bot/starred{/owner}{/repo}', 'subscriptions_url': 'https://api.github.com/users/facebook-github-bot/subscriptions', 'organizations_url': 'https://api.github.com/users/facebook-github-bot/orgs', 'repos_url': 'https://api.github.com/users/facebook-github-bot/repos', 'events_url': 'https://api.github.com/users/facebook-github-bot/events{/privacy}', 'received_events_url': 'https://api.github.com/users/facebook-github-bot/received_events', 'type': 'User', 'site_admin': False}",closed,eae139e18fb575a8f6a0d2e43ff2f93ffe1acfde,https://api.github.com/repos/pytorch/pytorch/commits/eae139e18fb575a8f6a0d2e43ff2f93ffe1acfde,2019-02-11T02:17:24Z,110,90,20
16183,2112444345,"{'login': 'facebook-github-bot', 'id': 6422482, 'node_id': 'MDQ6VXNlcjY0MjI0ODI=', 'avatar_url': 'https://avatars3.githubusercontent.com/u/6422482?v=4', 'gravatar_id': '', 'url': 'https://api.github.com/users/facebook-github-bot', 'html_url': 'https://github.com/facebook-github-bot', 'followers_url': 'https://api.github.com/users/facebook-github-bot/followers', 'following_url': 'https://api.github.com/users/facebook-github-bot/following{/other_user}', 'gists_url': 'https://api.github.com/users/facebook-github-bot/gists{/gist_id}', 'starred_url': 'https://api.github.com/users/facebook-github-bot/starred{/owner}{/repo}', 'subscriptions_url': 'https://api.github.com/users/facebook-github-bot/subscriptions', 'organizations_url': 'https://api.github.com/users/facebook-github-bot/orgs', 'repos_url': 'https://api.github.com/users/facebook-github-bot/repos', 'events_url': 'https://api.github.com/users/facebook-github-bot/events{/privacy}', 'received_events_url': 'https://api.github.com/users/facebook-github-bot/received_events', 'type': 'User', 'site_admin': False}",referenced,87ae1558a6c8c7c0693bfa995458d16239c484d7,https://api.github.com/repos/pytorch/pytorch/commits/87ae1558a6c8c7c0693bfa995458d16239c484d7,2019-02-01T15:18:25Z,2,1,1
16158,2341132083,"{'login': 'facebook-github-bot', 'id': 6422482, 'node_id': 'MDQ6VXNlcjY0MjI0ODI=', 'avatar_url': 'https://avatars3.githubusercontent.com/u/6422482?v=4', 'gravatar_id': '', 'url': 'https://api.github.com/users/facebook-github-bot', 'html_url': 'https://github.com/facebook-github-bot', 'followers_url': 'https://api.github.com/users/facebook-github-bot/followers', 'following_url': 'https://api.github.com/users/facebook-github-bot/following{/other_user}', 'gists_url': 'https://api.github.com/users/facebook-github-bot/gists{/gist_id}', 'starred_url': 'https://api.github.com/users/facebook-github-bot/starred{/owner}{/repo}', 'subscriptions_url': 'https://api.github.com/users/facebook-github-bot/subscriptions', 'organizations_url': 'https://api.github.com/users/facebook-github-bot/orgs', 'repos_url': 'https://api.github.com/users/facebook-github-bot/repos', 'events_url': 'https://api.github.com/users/facebook-github-bot/events{/privacy}', 'received_events_url': 'https://api.github.com/users/facebook-github-bot/received_events', 'type': 'User', 'site_admin': False}",referenced,3479777519c4d8b61a3b26b1285dc7fce126dfd3,https://api.github.com/repos/pytorch/pytorch/commits/3479777519c4d8b61a3b26b1285dc7fce126dfd3,2019-05-14T19:01:01Z,4660,2268,2392
16156,2090158732,"{'login': 'facebook-github-bot', 'id': 6422482, 'node_id': 'MDQ6VXNlcjY0MjI0ODI=', 'avatar_url': 'https://avatars3.githubusercontent.com/u/6422482?v=4', 'gravatar_id': '', 'url': 'https://api.github.com/users/facebook-github-bot', 'html_url': 'https://github.com/facebook-github-bot', 'followers_url': 'https://api.github.com/users/facebook-github-bot/followers', 'following_url': 'https://api.github.com/users/facebook-github-bot/following{/other_user}', 'gists_url': 'https://api.github.com/users/facebook-github-bot/gists{/gist_id}', 'starred_url': 'https://api.github.com/users/facebook-github-bot/starred{/owner}{/repo}', 'subscriptions_url': 'https://api.github.com/users/facebook-github-bot/subscriptions', 'organizations_url': 'https://api.github.com/users/facebook-github-bot/orgs', 'repos_url': 'https://api.github.com/users/facebook-github-bot/repos', 'events_url': 'https://api.github.com/users/facebook-github-bot/events{/privacy}', 'received_events_url': 'https://api.github.com/users/facebook-github-bot/received_events', 'type': 'User', 'site_admin': False}",closed,2235fb256e9e58050585a1bd0342de599570fcce,https://api.github.com/repos/pytorch/pytorch/commits/2235fb256e9e58050585a1bd0342de599570fcce,2019-01-22T22:36:37Z,114,107,7
16154,2898338634,"{'login': 'gchanan', 'id': 3768583, 'node_id': 'MDQ6VXNlcjM3Njg1ODM=', 'avatar_url': 'https://avatars2.githubusercontent.com/u/3768583?v=4', 'gravatar_id': '', 'url': 'https://api.github.com/users/gchanan', 'html_url': 'https://github.com/gchanan', 'followers_url': 'https://api.github.com/users/gchanan/followers', 'following_url': 'https://api.github.com/users/gchanan/following{/other_user}', 'gists_url': 'https://api.github.com/users/gchanan/gists{/gist_id}', 'starred_url': 'https://api.github.com/users/gchanan/starred{/owner}{/repo}', 'subscriptions_url': 'https://api.github.com/users/gchanan/subscriptions', 'organizations_url': 'https://api.github.com/users/gchanan/orgs', 'repos_url': 'https://api.github.com/users/gchanan/repos', 'events_url': 'https://api.github.com/users/gchanan/events{/privacy}', 'received_events_url': 'https://api.github.com/users/gchanan/received_events', 'type': 'User', 'site_admin': False}",referenced,8dfa3b3fe40f29e64d86574dae06e3d992b497b8,https://api.github.com/repos/pytorch/pytorch/commits/8dfa3b3fe40f29e64d86574dae06e3d992b497b8,2019-12-19T19:11:14Z,28,26,2
16154,2898339086,"{'login': 'gchanan', 'id': 3768583, 'node_id': 'MDQ6VXNlcjM3Njg1ODM=', 'avatar_url': 'https://avatars2.githubusercontent.com/u/3768583?v=4', 'gravatar_id': '', 'url': 'https://api.github.com/users/gchanan', 'html_url': 'https://github.com/gchanan', 'followers_url': 'https://api.github.com/users/gchanan/followers', 'following_url': 'https://api.github.com/users/gchanan/following{/other_user}', 'gists_url': 'https://api.github.com/users/gchanan/gists{/gist_id}', 'starred_url': 'https://api.github.com/users/gchanan/starred{/owner}{/repo}', 'subscriptions_url': 'https://api.github.com/users/gchanan/subscriptions', 'organizations_url': 'https://api.github.com/users/gchanan/orgs', 'repos_url': 'https://api.github.com/users/gchanan/repos', 'events_url': 'https://api.github.com/users/gchanan/events{/privacy}', 'received_events_url': 'https://api.github.com/users/gchanan/received_events', 'type': 'User', 'site_admin': False}",referenced,58c240e6a7c4d7fe4afa31774361d37eb5a82256,https://api.github.com/repos/pytorch/pytorch/commits/58c240e6a7c4d7fe4afa31774361d37eb5a82256,2019-12-19T19:11:23Z,28,26,2
16154,2901150898,"{'login': 'gchanan', 'id': 3768583, 'node_id': 'MDQ6VXNlcjM3Njg1ODM=', 'avatar_url': 'https://avatars2.githubusercontent.com/u/3768583?v=4', 'gravatar_id': '', 'url': 'https://api.github.com/users/gchanan', 'html_url': 'https://github.com/gchanan', 'followers_url': 'https://api.github.com/users/gchanan/followers', 'following_url': 'https://api.github.com/users/gchanan/following{/other_user}', 'gists_url': 'https://api.github.com/users/gchanan/gists{/gist_id}', 'starred_url': 'https://api.github.com/users/gchanan/starred{/owner}{/repo}', 'subscriptions_url': 'https://api.github.com/users/gchanan/subscriptions', 'organizations_url': 'https://api.github.com/users/gchanan/orgs', 'repos_url': 'https://api.github.com/users/gchanan/repos', 'events_url': 'https://api.github.com/users/gchanan/events{/privacy}', 'received_events_url': 'https://api.github.com/users/gchanan/received_events', 'type': 'User', 'site_admin': False}",referenced,e6e32cfac74f835c2134835d67b846bf7e181b24,https://api.github.com/repos/pytorch/pytorch/commits/e6e32cfac74f835c2134835d67b846bf7e181b24,2019-12-20T15:48:37Z,827,490,337
16154,2901151284,"{'login': 'gchanan', 'id': 3768583, 'node_id': 'MDQ6VXNlcjM3Njg1ODM=', 'avatar_url': 'https://avatars2.githubusercontent.com/u/3768583?v=4', 'gravatar_id': '', 'url': 'https://api.github.com/users/gchanan', 'html_url': 'https://github.com/gchanan', 'followers_url': 'https://api.github.com/users/gchanan/followers', 'following_url': 'https://api.github.com/users/gchanan/following{/other_user}', 'gists_url': 'https://api.github.com/users/gchanan/gists{/gist_id}', 'starred_url': 'https://api.github.com/users/gchanan/starred{/owner}{/repo}', 'subscriptions_url': 'https://api.github.com/users/gchanan/subscriptions', 'organizations_url': 'https://api.github.com/users/gchanan/orgs', 'repos_url': 'https://api.github.com/users/gchanan/repos', 'events_url': 'https://api.github.com/users/gchanan/events{/privacy}', 'received_events_url': 'https://api.github.com/users/gchanan/received_events', 'type': 'User', 'site_admin': False}",referenced,179fb0048e6ebcbfd37eee27a534ebda483ed125,https://api.github.com/repos/pytorch/pytorch/commits/179fb0048e6ebcbfd37eee27a534ebda483ed125,2019-12-20T15:48:44Z,28,26,2
16154,2901179504,"{'login': 'gchanan', 'id': 3768583, 'node_id': 'MDQ6VXNlcjM3Njg1ODM=', 'avatar_url': 'https://avatars2.githubusercontent.com/u/3768583?v=4', 'gravatar_id': '', 'url': 'https://api.github.com/users/gchanan', 'html_url': 'https://github.com/gchanan', 'followers_url': 'https://api.github.com/users/gchanan/followers', 'following_url': 'https://api.github.com/users/gchanan/following{/other_user}', 'gists_url': 'https://api.github.com/users/gchanan/gists{/gist_id}', 'starred_url': 'https://api.github.com/users/gchanan/starred{/owner}{/repo}', 'subscriptions_url': 'https://api.github.com/users/gchanan/subscriptions', 'organizations_url': 'https://api.github.com/users/gchanan/orgs', 'repos_url': 'https://api.github.com/users/gchanan/repos', 'events_url': 'https://api.github.com/users/gchanan/events{/privacy}', 'received_events_url': 'https://api.github.com/users/gchanan/received_events', 'type': 'User', 'site_admin': False}",referenced,fb5091ce9a3c9c1749a46827ef74fad5a8484b8c,https://api.github.com/repos/pytorch/pytorch/commits/fb5091ce9a3c9c1749a46827ef74fad5a8484b8c,2019-12-20T15:58:06Z,8,4,4
16154,2901179862,"{'login': 'gchanan', 'id': 3768583, 'node_id': 'MDQ6VXNlcjM3Njg1ODM=', 'avatar_url': 'https://avatars2.githubusercontent.com/u/3768583?v=4', 'gravatar_id': '', 'url': 'https://api.github.com/users/gchanan', 'html_url': 'https://github.com/gchanan', 'followers_url': 'https://api.github.com/users/gchanan/followers', 'following_url': 'https://api.github.com/users/gchanan/following{/other_user}', 'gists_url': 'https://api.github.com/users/gchanan/gists{/gist_id}', 'starred_url': 'https://api.github.com/users/gchanan/starred{/owner}{/repo}', 'subscriptions_url': 'https://api.github.com/users/gchanan/subscriptions', 'organizations_url': 'https://api.github.com/users/gchanan/orgs', 'repos_url': 'https://api.github.com/users/gchanan/repos', 'events_url': 'https://api.github.com/users/gchanan/events{/privacy}', 'received_events_url': 'https://api.github.com/users/gchanan/received_events', 'type': 'User', 'site_admin': False}",referenced,b5dbec36bf7155834060a62ad1120ba203af77af,https://api.github.com/repos/pytorch/pytorch/commits/b5dbec36bf7155834060a62ad1120ba203af77af,2019-12-20T15:58:13Z,28,26,2
16154,2905537455,"{'login': 'gchanan', 'id': 3768583, 'node_id': 'MDQ6VXNlcjM3Njg1ODM=', 'avatar_url': 'https://avatars2.githubusercontent.com/u/3768583?v=4', 'gravatar_id': '', 'url': 'https://api.github.com/users/gchanan', 'html_url': 'https://github.com/gchanan', 'followers_url': 'https://api.github.com/users/gchanan/followers', 'following_url': 'https://api.github.com/users/gchanan/following{/other_user}', 'gists_url': 'https://api.github.com/users/gchanan/gists{/gist_id}', 'starred_url': 'https://api.github.com/users/gchanan/starred{/owner}{/repo}', 'subscriptions_url': 'https://api.github.com/users/gchanan/subscriptions', 'organizations_url': 'https://api.github.com/users/gchanan/orgs', 'repos_url': 'https://api.github.com/users/gchanan/repos', 'events_url': 'https://api.github.com/users/gchanan/events{/privacy}', 'received_events_url': 'https://api.github.com/users/gchanan/received_events', 'type': 'User', 'site_admin': False}",referenced,4f161afb6c6f8fd2477cea7bc078ee0a96b1f6df,https://api.github.com/repos/pytorch/pytorch/commits/4f161afb6c6f8fd2477cea7bc078ee0a96b1f6df,2019-12-23T19:56:00Z,6,4,2
16154,2905537668,"{'login': 'gchanan', 'id': 3768583, 'node_id': 'MDQ6VXNlcjM3Njg1ODM=', 'avatar_url': 'https://avatars2.githubusercontent.com/u/3768583?v=4', 'gravatar_id': '', 'url': 'https://api.github.com/users/gchanan', 'html_url': 'https://github.com/gchanan', 'followers_url': 'https://api.github.com/users/gchanan/followers', 'following_url': 'https://api.github.com/users/gchanan/following{/other_user}', 'gists_url': 'https://api.github.com/users/gchanan/gists{/gist_id}', 'starred_url': 'https://api.github.com/users/gchanan/starred{/owner}{/repo}', 'subscriptions_url': 'https://api.github.com/users/gchanan/subscriptions', 'organizations_url': 'https://api.github.com/users/gchanan/orgs', 'repos_url': 'https://api.github.com/users/gchanan/repos', 'events_url': 'https://api.github.com/users/gchanan/events{/privacy}', 'received_events_url': 'https://api.github.com/users/gchanan/received_events', 'type': 'User', 'site_admin': False}",referenced,bed3f8c8b1403ab536ec2a859e54706e5c633bd7,https://api.github.com/repos/pytorch/pytorch/commits/bed3f8c8b1403ab536ec2a859e54706e5c633bd7,2019-12-23T19:56:06Z,28,26,2
16154,2909255512,"{'login': 'gchanan', 'id': 3768583, 'node_id': 'MDQ6VXNlcjM3Njg1ODM=', 'avatar_url': 'https://avatars2.githubusercontent.com/u/3768583?v=4', 'gravatar_id': '', 'url': 'https://api.github.com/users/gchanan', 'html_url': 'https://github.com/gchanan', 'followers_url': 'https://api.github.com/users/gchanan/followers', 'following_url': 'https://api.github.com/users/gchanan/following{/other_user}', 'gists_url': 'https://api.github.com/users/gchanan/gists{/gist_id}', 'starred_url': 'https://api.github.com/users/gchanan/starred{/owner}{/repo}', 'subscriptions_url': 'https://api.github.com/users/gchanan/subscriptions', 'organizations_url': 'https://api.github.com/users/gchanan/orgs', 'repos_url': 'https://api.github.com/users/gchanan/repos', 'events_url': 'https://api.github.com/users/gchanan/events{/privacy}', 'received_events_url': 'https://api.github.com/users/gchanan/received_events', 'type': 'User', 'site_admin': False}",referenced,3773f47416596f981163c11b25048cf6bc3f4812,https://api.github.com/repos/pytorch/pytorch/commits/3773f47416596f981163c11b25048cf6bc3f4812,2019-12-26T15:31:11Z,4594,3071,1523
16154,2909255605,"{'login': 'gchanan', 'id': 3768583, 'node_id': 'MDQ6VXNlcjM3Njg1ODM=', 'avatar_url': 'https://avatars2.githubusercontent.com/u/3768583?v=4', 'gravatar_id': '', 'url': 'https://api.github.com/users/gchanan', 'html_url': 'https://github.com/gchanan', 'followers_url': 'https://api.github.com/users/gchanan/followers', 'following_url': 'https://api.github.com/users/gchanan/following{/other_user}', 'gists_url': 'https://api.github.com/users/gchanan/gists{/gist_id}', 'starred_url': 'https://api.github.com/users/gchanan/starred{/owner}{/repo}', 'subscriptions_url': 'https://api.github.com/users/gchanan/subscriptions', 'organizations_url': 'https://api.github.com/users/gchanan/orgs', 'repos_url': 'https://api.github.com/users/gchanan/repos', 'events_url': 'https://api.github.com/users/gchanan/events{/privacy}', 'received_events_url': 'https://api.github.com/users/gchanan/received_events', 'type': 'User', 'site_admin': False}",referenced,4430dfedb20c5b39432b401661b3047352ed3133,https://api.github.com/repos/pytorch/pytorch/commits/4430dfedb20c5b39432b401661b3047352ed3133,2019-12-26T15:31:15Z,28,26,2
16154,2909526752,"{'login': 'facebook-github-bot', 'id': 6422482, 'node_id': 'MDQ6VXNlcjY0MjI0ODI=', 'avatar_url': 'https://avatars3.githubusercontent.com/u/6422482?v=4', 'gravatar_id': '', 'url': 'https://api.github.com/users/facebook-github-bot', 'html_url': 'https://github.com/facebook-github-bot', 'followers_url': 'https://api.github.com/users/facebook-github-bot/followers', 'following_url': 'https://api.github.com/users/facebook-github-bot/following{/other_user}', 'gists_url': 'https://api.github.com/users/facebook-github-bot/gists{/gist_id}', 'starred_url': 'https://api.github.com/users/facebook-github-bot/starred{/owner}{/repo}', 'subscriptions_url': 'https://api.github.com/users/facebook-github-bot/subscriptions', 'organizations_url': 'https://api.github.com/users/facebook-github-bot/orgs', 'repos_url': 'https://api.github.com/users/facebook-github-bot/repos', 'events_url': 'https://api.github.com/users/facebook-github-bot/events{/privacy}', 'received_events_url': 'https://api.github.com/users/facebook-github-bot/received_events', 'type': 'User', 'site_admin': False}",closed,866c1b1fcc2475da1bcd777a2f8e37f123f399be,https://api.github.com/repos/pytorch/pytorch/commits/866c1b1fcc2475da1bcd777a2f8e37f123f399be,2019-12-26T18:46:31Z,28,26,2
16152,2103082471,"{'login': 'facebook-github-bot', 'id': 6422482, 'node_id': 'MDQ6VXNlcjY0MjI0ODI=', 'avatar_url': 'https://avatars3.githubusercontent.com/u/6422482?v=4', 'gravatar_id': '', 'url': 'https://api.github.com/users/facebook-github-bot', 'html_url': 'https://github.com/facebook-github-bot', 'followers_url': 'https://api.github.com/users/facebook-github-bot/followers', 'following_url': 'https://api.github.com/users/facebook-github-bot/following{/other_user}', 'gists_url': 'https://api.github.com/users/facebook-github-bot/gists{/gist_id}', 'starred_url': 'https://api.github.com/users/facebook-github-bot/starred{/owner}{/repo}', 'subscriptions_url': 'https://api.github.com/users/facebook-github-bot/subscriptions', 'organizations_url': 'https://api.github.com/users/facebook-github-bot/orgs', 'repos_url': 'https://api.github.com/users/facebook-github-bot/repos', 'events_url': 'https://api.github.com/users/facebook-github-bot/events{/privacy}', 'received_events_url': 'https://api.github.com/users/facebook-github-bot/received_events', 'type': 'User', 'site_admin': False}",closed,bd19dd4b90aa94359b84986b0f9a298538ac7889,https://api.github.com/repos/pytorch/pytorch/commits/bd19dd4b90aa94359b84986b0f9a298538ac7889,2019-01-29T09:30:17Z,15,11,4
16144,2114469139,"{'login': 'facebook-github-bot', 'id': 6422482, 'node_id': 'MDQ6VXNlcjY0MjI0ODI=', 'avatar_url': 'https://avatars3.githubusercontent.com/u/6422482?v=4', 'gravatar_id': '', 'url': 'https://api.github.com/users/facebook-github-bot', 'html_url': 'https://github.com/facebook-github-bot', 'followers_url': 'https://api.github.com/users/facebook-github-bot/followers', 'following_url': 'https://api.github.com/users/facebook-github-bot/following{/other_user}', 'gists_url': 'https://api.github.com/users/facebook-github-bot/gists{/gist_id}', 'starred_url': 'https://api.github.com/users/facebook-github-bot/starred{/owner}{/repo}', 'subscriptions_url': 'https://api.github.com/users/facebook-github-bot/subscriptions', 'organizations_url': 'https://api.github.com/users/facebook-github-bot/orgs', 'repos_url': 'https://api.github.com/users/facebook-github-bot/repos', 'events_url': 'https://api.github.com/users/facebook-github-bot/events{/privacy}', 'received_events_url': 'https://api.github.com/users/facebook-github-bot/received_events', 'type': 'User', 'site_admin': False}",closed,a53d28dd87aa3f5e8fa0f8cbd3199b6a4661c0a9,https://api.github.com/repos/pytorch/pytorch/commits/a53d28dd87aa3f5e8fa0f8cbd3199b6a4661c0a9,2019-02-03T19:54:09Z,2,1,1
16099,2648773155,"{'login': 'facebook-github-bot', 'id': 6422482, 'node_id': 'MDQ6VXNlcjY0MjI0ODI=', 'avatar_url': 'https://avatars3.githubusercontent.com/u/6422482?v=4', 'gravatar_id': '', 'url': 'https://api.github.com/users/facebook-github-bot', 'html_url': 'https://github.com/facebook-github-bot', 'followers_url': 'https://api.github.com/users/facebook-github-bot/followers', 'following_url': 'https://api.github.com/users/facebook-github-bot/following{/other_user}', 'gists_url': 'https://api.github.com/users/facebook-github-bot/gists{/gist_id}', 'starred_url': 'https://api.github.com/users/facebook-github-bot/starred{/owner}{/repo}', 'subscriptions_url': 'https://api.github.com/users/facebook-github-bot/subscriptions', 'organizations_url': 'https://api.github.com/users/facebook-github-bot/orgs', 'repos_url': 'https://api.github.com/users/facebook-github-bot/repos', 'events_url': 'https://api.github.com/users/facebook-github-bot/events{/privacy}', 'received_events_url': 'https://api.github.com/users/facebook-github-bot/received_events', 'type': 'User', 'site_admin': False}",closed,aad0263a6b91c45d65404a621fdb220fccce0947,https://api.github.com/repos/pytorch/pytorch/commits/aad0263a6b91c45d65404a621fdb220fccce0947,2019-09-20T00:38:09Z,213,213,0
16045,2225277704,"{'login': 'facebook-github-bot', 'id': 6422482, 'node_id': 'MDQ6VXNlcjY0MjI0ODI=', 'avatar_url': 'https://avatars3.githubusercontent.com/u/6422482?v=4', 'gravatar_id': '', 'url': 'https://api.github.com/users/facebook-github-bot', 'html_url': 'https://github.com/facebook-github-bot', 'followers_url': 'https://api.github.com/users/facebook-github-bot/followers', 'following_url': 'https://api.github.com/users/facebook-github-bot/following{/other_user}', 'gists_url': 'https://api.github.com/users/facebook-github-bot/gists{/gist_id}', 'starred_url': 'https://api.github.com/users/facebook-github-bot/starred{/owner}{/repo}', 'subscriptions_url': 'https://api.github.com/users/facebook-github-bot/subscriptions', 'organizations_url': 'https://api.github.com/users/facebook-github-bot/orgs', 'repos_url': 'https://api.github.com/users/facebook-github-bot/repos', 'events_url': 'https://api.github.com/users/facebook-github-bot/events{/privacy}', 'received_events_url': 'https://api.github.com/users/facebook-github-bot/received_events', 'type': 'User', 'site_admin': False}",referenced,8bc5b867093f1b44f5168f3e41b1bdf0ba3e05a7,https://api.github.com/repos/pytorch/pytorch/commits/8bc5b867093f1b44f5168f3e41b1bdf0ba3e05a7,2019-03-25T02:24:13Z,22,20,2
16043,2078355691,"{'login': 'facebook-github-bot', 'id': 6422482, 'node_id': 'MDQ6VXNlcjY0MjI0ODI=', 'avatar_url': 'https://avatars3.githubusercontent.com/u/6422482?v=4', 'gravatar_id': '', 'url': 'https://api.github.com/users/facebook-github-bot', 'html_url': 'https://github.com/facebook-github-bot', 'followers_url': 'https://api.github.com/users/facebook-github-bot/followers', 'following_url': 'https://api.github.com/users/facebook-github-bot/following{/other_user}', 'gists_url': 'https://api.github.com/users/facebook-github-bot/gists{/gist_id}', 'starred_url': 'https://api.github.com/users/facebook-github-bot/starred{/owner}{/repo}', 'subscriptions_url': 'https://api.github.com/users/facebook-github-bot/subscriptions', 'organizations_url': 'https://api.github.com/users/facebook-github-bot/orgs', 'repos_url': 'https://api.github.com/users/facebook-github-bot/repos', 'events_url': 'https://api.github.com/users/facebook-github-bot/events{/privacy}', 'received_events_url': 'https://api.github.com/users/facebook-github-bot/received_events', 'type': 'User', 'site_admin': False}",closed,503f412f795d6e91d3b16aafc1d522fbdc41b440,https://api.github.com/repos/pytorch/pytorch/commits/503f412f795d6e91d3b16aafc1d522fbdc41b440,2019-01-16T19:35:41Z,20,10,10
16043,2083874024,"{'login': 'soumith', 'id': 1310570, 'node_id': 'MDQ6VXNlcjEzMTA1NzA=', 'avatar_url': 'https://avatars0.githubusercontent.com/u/1310570?v=4', 'gravatar_id': '', 'url': 'https://api.github.com/users/soumith', 'html_url': 'https://github.com/soumith', 'followers_url': 'https://api.github.com/users/soumith/followers', 'following_url': 'https://api.github.com/users/soumith/following{/other_user}', 'gists_url': 'https://api.github.com/users/soumith/gists{/gist_id}', 'starred_url': 'https://api.github.com/users/soumith/starred{/owner}{/repo}', 'subscriptions_url': 'https://api.github.com/users/soumith/subscriptions', 'organizations_url': 'https://api.github.com/users/soumith/orgs', 'repos_url': 'https://api.github.com/users/soumith/repos', 'events_url': 'https://api.github.com/users/soumith/events{/privacy}', 'received_events_url': 'https://api.github.com/users/soumith/received_events', 'type': 'User', 'site_admin': False}",referenced,8c7a1856bbad713bd27a6426c88895ec4d045f6d,https://api.github.com/repos/pytorch/pytorch/commits/8c7a1856bbad713bd27a6426c88895ec4d045f6d,2019-01-18T20:32:00Z,20,10,10
16043,2102600456,"{'login': 'soumith', 'id': 1310570, 'node_id': 'MDQ6VXNlcjEzMTA1NzA=', 'avatar_url': 'https://avatars0.githubusercontent.com/u/1310570?v=4', 'gravatar_id': '', 'url': 'https://api.github.com/users/soumith', 'html_url': 'https://github.com/soumith', 'followers_url': 'https://api.github.com/users/soumith/followers', 'following_url': 'https://api.github.com/users/soumith/following{/other_user}', 'gists_url': 'https://api.github.com/users/soumith/gists{/gist_id}', 'starred_url': 'https://api.github.com/users/soumith/starred{/owner}{/repo}', 'subscriptions_url': 'https://api.github.com/users/soumith/subscriptions', 'organizations_url': 'https://api.github.com/users/soumith/orgs', 'repos_url': 'https://api.github.com/users/soumith/repos', 'events_url': 'https://api.github.com/users/soumith/events{/privacy}', 'received_events_url': 'https://api.github.com/users/soumith/received_events', 'type': 'User', 'site_admin': False}",referenced,1e61241227dfd795fb013791dc3c72e50ce5b843,https://api.github.com/repos/pytorch/pytorch/commits/1e61241227dfd795fb013791dc3c72e50ce5b843,2019-01-29T04:12:51Z,20,10,10
16019,2083890654,"{'login': 'facebook-github-bot', 'id': 6422482, 'node_id': 'MDQ6VXNlcjY0MjI0ODI=', 'avatar_url': 'https://avatars3.githubusercontent.com/u/6422482?v=4', 'gravatar_id': '', 'url': 'https://api.github.com/users/facebook-github-bot', 'html_url': 'https://github.com/facebook-github-bot', 'followers_url': 'https://api.github.com/users/facebook-github-bot/followers', 'following_url': 'https://api.github.com/users/facebook-github-bot/following{/other_user}', 'gists_url': 'https://api.github.com/users/facebook-github-bot/gists{/gist_id}', 'starred_url': 'https://api.github.com/users/facebook-github-bot/starred{/owner}{/repo}', 'subscriptions_url': 'https://api.github.com/users/facebook-github-bot/subscriptions', 'organizations_url': 'https://api.github.com/users/facebook-github-bot/orgs', 'repos_url': 'https://api.github.com/users/facebook-github-bot/repos', 'events_url': 'https://api.github.com/users/facebook-github-bot/events{/privacy}', 'received_events_url': 'https://api.github.com/users/facebook-github-bot/received_events', 'type': 'User', 'site_admin': False}",closed,292edfb0879cb2ae9377637eadd282dfb6daea33,https://api.github.com/repos/pytorch/pytorch/commits/292edfb0879cb2ae9377637eadd282dfb6daea33,2019-01-18T20:41:26Z,40,36,4
16018,2093462594,"{'login': 'soumith', 'id': 1310570, 'node_id': 'MDQ6VXNlcjEzMTA1NzA=', 'avatar_url': 'https://avatars0.githubusercontent.com/u/1310570?v=4', 'gravatar_id': '', 'url': 'https://api.github.com/users/soumith', 'html_url': 'https://github.com/soumith', 'followers_url': 'https://api.github.com/users/soumith/followers', 'following_url': 'https://api.github.com/users/soumith/following{/other_user}', 'gists_url': 'https://api.github.com/users/soumith/gists{/gist_id}', 'starred_url': 'https://api.github.com/users/soumith/starred{/owner}{/repo}', 'subscriptions_url': 'https://api.github.com/users/soumith/subscriptions', 'organizations_url': 'https://api.github.com/users/soumith/orgs', 'repos_url': 'https://api.github.com/users/soumith/repos', 'events_url': 'https://api.github.com/users/soumith/events{/privacy}', 'received_events_url': 'https://api.github.com/users/soumith/received_events', 'type': 'User', 'site_admin': False}",referenced,d82fd3431ae623bc9f48ae06f1621a862fccb2d5,https://api.github.com/repos/pytorch/pytorch/commits/d82fd3431ae623bc9f48ae06f1621a862fccb2d5,2019-01-24T04:14:55Z,37,35,2
16018,2094828157,"{'login': 'facebook-github-bot', 'id': 6422482, 'node_id': 'MDQ6VXNlcjY0MjI0ODI=', 'avatar_url': 'https://avatars3.githubusercontent.com/u/6422482?v=4', 'gravatar_id': '', 'url': 'https://api.github.com/users/facebook-github-bot', 'html_url': 'https://github.com/facebook-github-bot', 'followers_url': 'https://api.github.com/users/facebook-github-bot/followers', 'following_url': 'https://api.github.com/users/facebook-github-bot/following{/other_user}', 'gists_url': 'https://api.github.com/users/facebook-github-bot/gists{/gist_id}', 'starred_url': 'https://api.github.com/users/facebook-github-bot/starred{/owner}{/repo}', 'subscriptions_url': 'https://api.github.com/users/facebook-github-bot/subscriptions', 'organizations_url': 'https://api.github.com/users/facebook-github-bot/orgs', 'repos_url': 'https://api.github.com/users/facebook-github-bot/repos', 'events_url': 'https://api.github.com/users/facebook-github-bot/events{/privacy}', 'received_events_url': 'https://api.github.com/users/facebook-github-bot/received_events', 'type': 'User', 'site_admin': False}",closed,0cb24098c74f8ebed81ec08b83bf6cb5ab3903f5,https://api.github.com/repos/pytorch/pytorch/commits/0cb24098c74f8ebed81ec08b83bf6cb5ab3903f5,2019-01-24T15:41:08Z,37,35,2
16018,2102600514,"{'login': 'soumith', 'id': 1310570, 'node_id': 'MDQ6VXNlcjEzMTA1NzA=', 'avatar_url': 'https://avatars0.githubusercontent.com/u/1310570?v=4', 'gravatar_id': '', 'url': 'https://api.github.com/users/soumith', 'html_url': 'https://github.com/soumith', 'followers_url': 'https://api.github.com/users/soumith/followers', 'following_url': 'https://api.github.com/users/soumith/following{/other_user}', 'gists_url': 'https://api.github.com/users/soumith/gists{/gist_id}', 'starred_url': 'https://api.github.com/users/soumith/starred{/owner}{/repo}', 'subscriptions_url': 'https://api.github.com/users/soumith/subscriptions', 'organizations_url': 'https://api.github.com/users/soumith/orgs', 'repos_url': 'https://api.github.com/users/soumith/repos', 'events_url': 'https://api.github.com/users/soumith/events{/privacy}', 'received_events_url': 'https://api.github.com/users/soumith/received_events', 'type': 'User', 'site_admin': False}",referenced,af03dbb93b7ffdf9c64f41c07c7d9c7eaf9f5924,https://api.github.com/repos/pytorch/pytorch/commits/af03dbb93b7ffdf9c64f41c07c7d9c7eaf9f5924,2019-01-29T04:12:52Z,37,35,2
15992,2078020904,"{'login': 'facebook-github-bot', 'id': 6422482, 'node_id': 'MDQ6VXNlcjY0MjI0ODI=', 'avatar_url': 'https://avatars3.githubusercontent.com/u/6422482?v=4', 'gravatar_id': '', 'url': 'https://api.github.com/users/facebook-github-bot', 'html_url': 'https://github.com/facebook-github-bot', 'followers_url': 'https://api.github.com/users/facebook-github-bot/followers', 'following_url': 'https://api.github.com/users/facebook-github-bot/following{/other_user}', 'gists_url': 'https://api.github.com/users/facebook-github-bot/gists{/gist_id}', 'starred_url': 'https://api.github.com/users/facebook-github-bot/starred{/owner}{/repo}', 'subscriptions_url': 'https://api.github.com/users/facebook-github-bot/subscriptions', 'organizations_url': 'https://api.github.com/users/facebook-github-bot/orgs', 'repos_url': 'https://api.github.com/users/facebook-github-bot/repos', 'events_url': 'https://api.github.com/users/facebook-github-bot/events{/privacy}', 'received_events_url': 'https://api.github.com/users/facebook-github-bot/received_events', 'type': 'User', 'site_admin': False}",closed,3cf76e78bd115b7b1340bdc2e8c677dc219704f3,https://api.github.com/repos/pytorch/pytorch/commits/3cf76e78bd115b7b1340bdc2e8c677dc219704f3,2019-01-16T17:12:16Z,18,18,0
15982,2982623786,"{'login': 'facebook-github-bot', 'id': 6422482, 'node_id': 'MDQ6VXNlcjY0MjI0ODI=', 'avatar_url': 'https://avatars3.githubusercontent.com/u/6422482?v=4', 'gravatar_id': '', 'url': 'https://api.github.com/users/facebook-github-bot', 'html_url': 'https://github.com/facebook-github-bot', 'followers_url': 'https://api.github.com/users/facebook-github-bot/followers', 'following_url': 'https://api.github.com/users/facebook-github-bot/following{/other_user}', 'gists_url': 'https://api.github.com/users/facebook-github-bot/gists{/gist_id}', 'starred_url': 'https://api.github.com/users/facebook-github-bot/starred{/owner}{/repo}', 'subscriptions_url': 'https://api.github.com/users/facebook-github-bot/subscriptions', 'organizations_url': 'https://api.github.com/users/facebook-github-bot/orgs', 'repos_url': 'https://api.github.com/users/facebook-github-bot/repos', 'events_url': 'https://api.github.com/users/facebook-github-bot/events{/privacy}', 'received_events_url': 'https://api.github.com/users/facebook-github-bot/received_events', 'type': 'User', 'site_admin': False}",closed,19bb496a0d8f37b8f9da77c98875bc16959f4c7f,https://api.github.com/repos/pytorch/pytorch/commits/19bb496a0d8f37b8f9da77c98875bc16959f4c7f,2020-01-27T17:03:17Z,16,5,11
15968,2072090911,"{'login': 'facebook-github-bot', 'id': 6422482, 'node_id': 'MDQ6VXNlcjY0MjI0ODI=', 'avatar_url': 'https://avatars3.githubusercontent.com/u/6422482?v=4', 'gravatar_id': '', 'url': 'https://api.github.com/users/facebook-github-bot', 'html_url': 'https://github.com/facebook-github-bot', 'followers_url': 'https://api.github.com/users/facebook-github-bot/followers', 'following_url': 'https://api.github.com/users/facebook-github-bot/following{/other_user}', 'gists_url': 'https://api.github.com/users/facebook-github-bot/gists{/gist_id}', 'starred_url': 'https://api.github.com/users/facebook-github-bot/starred{/owner}{/repo}', 'subscriptions_url': 'https://api.github.com/users/facebook-github-bot/subscriptions', 'organizations_url': 'https://api.github.com/users/facebook-github-bot/orgs', 'repos_url': 'https://api.github.com/users/facebook-github-bot/repos', 'events_url': 'https://api.github.com/users/facebook-github-bot/events{/privacy}', 'received_events_url': 'https://api.github.com/users/facebook-github-bot/received_events', 'type': 'User', 'site_admin': False}",referenced,300dcc3b96b2b8672570c4c9e6038cb5cff75afd,https://api.github.com/repos/pytorch/pytorch/commits/300dcc3b96b2b8672570c4c9e6038cb5cff75afd,2019-01-14T15:33:24Z,133,121,12
15946,2112570449,"{'login': 'facebook-github-bot', 'id': 6422482, 'node_id': 'MDQ6VXNlcjY0MjI0ODI=', 'avatar_url': 'https://avatars3.githubusercontent.com/u/6422482?v=4', 'gravatar_id': '', 'url': 'https://api.github.com/users/facebook-github-bot', 'html_url': 'https://github.com/facebook-github-bot', 'followers_url': 'https://api.github.com/users/facebook-github-bot/followers', 'following_url': 'https://api.github.com/users/facebook-github-bot/following{/other_user}', 'gists_url': 'https://api.github.com/users/facebook-github-bot/gists{/gist_id}', 'starred_url': 'https://api.github.com/users/facebook-github-bot/starred{/owner}{/repo}', 'subscriptions_url': 'https://api.github.com/users/facebook-github-bot/subscriptions', 'organizations_url': 'https://api.github.com/users/facebook-github-bot/orgs', 'repos_url': 'https://api.github.com/users/facebook-github-bot/repos', 'events_url': 'https://api.github.com/users/facebook-github-bot/events{/privacy}', 'received_events_url': 'https://api.github.com/users/facebook-github-bot/received_events', 'type': 'User', 'site_admin': False}",referenced,7078b2baf57bb6664309c680d4cc35bae23d6c9d,https://api.github.com/repos/pytorch/pytorch/commits/7078b2baf57bb6664309c680d4cc35bae23d6c9d,2019-02-01T16:04:15Z,48,40,8
15923,2084731460,"{'login': 'facebook-github-bot', 'id': 6422482, 'node_id': 'MDQ6VXNlcjY0MjI0ODI=', 'avatar_url': 'https://avatars3.githubusercontent.com/u/6422482?v=4', 'gravatar_id': '', 'url': 'https://api.github.com/users/facebook-github-bot', 'html_url': 'https://github.com/facebook-github-bot', 'followers_url': 'https://api.github.com/users/facebook-github-bot/followers', 'following_url': 'https://api.github.com/users/facebook-github-bot/following{/other_user}', 'gists_url': 'https://api.github.com/users/facebook-github-bot/gists{/gist_id}', 'starred_url': 'https://api.github.com/users/facebook-github-bot/starred{/owner}{/repo}', 'subscriptions_url': 'https://api.github.com/users/facebook-github-bot/subscriptions', 'organizations_url': 'https://api.github.com/users/facebook-github-bot/orgs', 'repos_url': 'https://api.github.com/users/facebook-github-bot/repos', 'events_url': 'https://api.github.com/users/facebook-github-bot/events{/privacy}', 'received_events_url': 'https://api.github.com/users/facebook-github-bot/received_events', 'type': 'User', 'site_admin': False}",closed,33d1ec396bad4ff8d53b154e64166b56c9054a75,https://api.github.com/repos/pytorch/pytorch/commits/33d1ec396bad4ff8d53b154e64166b56c9054a75,2019-01-19T23:02:40Z,2,2,0
15923,2093465108,"{'login': 'soumith', 'id': 1310570, 'node_id': 'MDQ6VXNlcjEzMTA1NzA=', 'avatar_url': 'https://avatars0.githubusercontent.com/u/1310570?v=4', 'gravatar_id': '', 'url': 'https://api.github.com/users/soumith', 'html_url': 'https://github.com/soumith', 'followers_url': 'https://api.github.com/users/soumith/followers', 'following_url': 'https://api.github.com/users/soumith/following{/other_user}', 'gists_url': 'https://api.github.com/users/soumith/gists{/gist_id}', 'starred_url': 'https://api.github.com/users/soumith/starred{/owner}{/repo}', 'subscriptions_url': 'https://api.github.com/users/soumith/subscriptions', 'organizations_url': 'https://api.github.com/users/soumith/orgs', 'repos_url': 'https://api.github.com/users/soumith/repos', 'events_url': 'https://api.github.com/users/soumith/events{/privacy}', 'received_events_url': 'https://api.github.com/users/soumith/received_events', 'type': 'User', 'site_admin': False}",referenced,7eaa9cf5513f0731bf642b9c909bbeb79f8ba542,https://api.github.com/repos/pytorch/pytorch/commits/7eaa9cf5513f0731bf642b9c909bbeb79f8ba542,2019-01-24T04:17:27Z,2,2,0
15923,2102600521,"{'login': 'soumith', 'id': 1310570, 'node_id': 'MDQ6VXNlcjEzMTA1NzA=', 'avatar_url': 'https://avatars0.githubusercontent.com/u/1310570?v=4', 'gravatar_id': '', 'url': 'https://api.github.com/users/soumith', 'html_url': 'https://github.com/soumith', 'followers_url': 'https://api.github.com/users/soumith/followers', 'following_url': 'https://api.github.com/users/soumith/following{/other_user}', 'gists_url': 'https://api.github.com/users/soumith/gists{/gist_id}', 'starred_url': 'https://api.github.com/users/soumith/starred{/owner}{/repo}', 'subscriptions_url': 'https://api.github.com/users/soumith/subscriptions', 'organizations_url': 'https://api.github.com/users/soumith/orgs', 'repos_url': 'https://api.github.com/users/soumith/repos', 'events_url': 'https://api.github.com/users/soumith/events{/privacy}', 'received_events_url': 'https://api.github.com/users/soumith/received_events', 'type': 'User', 'site_admin': False}",referenced,e274158c722656b86cce12b4b798e8169659266f,https://api.github.com/repos/pytorch/pytorch/commits/e274158c722656b86cce12b4b798e8169659266f,2019-01-29T04:12:52Z,2,2,0
15919,2080783884,"{'login': 'facebook-github-bot', 'id': 6422482, 'node_id': 'MDQ6VXNlcjY0MjI0ODI=', 'avatar_url': 'https://avatars3.githubusercontent.com/u/6422482?v=4', 'gravatar_id': '', 'url': 'https://api.github.com/users/facebook-github-bot', 'html_url': 'https://github.com/facebook-github-bot', 'followers_url': 'https://api.github.com/users/facebook-github-bot/followers', 'following_url': 'https://api.github.com/users/facebook-github-bot/following{/other_user}', 'gists_url': 'https://api.github.com/users/facebook-github-bot/gists{/gist_id}', 'starred_url': 'https://api.github.com/users/facebook-github-bot/starred{/owner}{/repo}', 'subscriptions_url': 'https://api.github.com/users/facebook-github-bot/subscriptions', 'organizations_url': 'https://api.github.com/users/facebook-github-bot/orgs', 'repos_url': 'https://api.github.com/users/facebook-github-bot/repos', 'events_url': 'https://api.github.com/users/facebook-github-bot/events{/privacy}', 'received_events_url': 'https://api.github.com/users/facebook-github-bot/received_events', 'type': 'User', 'site_admin': False}",referenced,334258e39e5f821f55a6dce805e81f1eb31f73ef,https://api.github.com/repos/pytorch/pytorch/commits/334258e39e5f821f55a6dce805e81f1eb31f73ef,2019-01-17T16:45:32Z,4,1,3
15919,2081981270,"{'login': 'soumith', 'id': 1310570, 'node_id': 'MDQ6VXNlcjEzMTA1NzA=', 'avatar_url': 'https://avatars0.githubusercontent.com/u/1310570?v=4', 'gravatar_id': '', 'url': 'https://api.github.com/users/soumith', 'html_url': 'https://github.com/soumith', 'followers_url': 'https://api.github.com/users/soumith/followers', 'following_url': 'https://api.github.com/users/soumith/following{/other_user}', 'gists_url': 'https://api.github.com/users/soumith/gists{/gist_id}', 'starred_url': 'https://api.github.com/users/soumith/starred{/owner}{/repo}', 'subscriptions_url': 'https://api.github.com/users/soumith/subscriptions', 'organizations_url': 'https://api.github.com/users/soumith/orgs', 'repos_url': 'https://api.github.com/users/soumith/repos', 'events_url': 'https://api.github.com/users/soumith/events{/privacy}', 'received_events_url': 'https://api.github.com/users/soumith/received_events', 'type': 'User', 'site_admin': False}",referenced,b879d006f1a26ee5a9d3d4911ca6dbe89c827978,https://api.github.com/repos/pytorch/pytorch/commits/b879d006f1a26ee5a9d3d4911ca6dbe89c827978,2019-01-18T04:02:13Z,6,1,5
15911,2070383730,"{'login': 'facebook-github-bot', 'id': 6422482, 'node_id': 'MDQ6VXNlcjY0MjI0ODI=', 'avatar_url': 'https://avatars3.githubusercontent.com/u/6422482?v=4', 'gravatar_id': '', 'url': 'https://api.github.com/users/facebook-github-bot', 'html_url': 'https://github.com/facebook-github-bot', 'followers_url': 'https://api.github.com/users/facebook-github-bot/followers', 'following_url': 'https://api.github.com/users/facebook-github-bot/following{/other_user}', 'gists_url': 'https://api.github.com/users/facebook-github-bot/gists{/gist_id}', 'starred_url': 'https://api.github.com/users/facebook-github-bot/starred{/owner}{/repo}', 'subscriptions_url': 'https://api.github.com/users/facebook-github-bot/subscriptions', 'organizations_url': 'https://api.github.com/users/facebook-github-bot/orgs', 'repos_url': 'https://api.github.com/users/facebook-github-bot/repos', 'events_url': 'https://api.github.com/users/facebook-github-bot/events{/privacy}', 'received_events_url': 'https://api.github.com/users/facebook-github-bot/received_events', 'type': 'User', 'site_admin': False}",referenced,04b8a2f1baa87efc0434a532e036a0bb29de22a9,https://api.github.com/repos/pytorch/pytorch/commits/04b8a2f1baa87efc0434a532e036a0bb29de22a9,2019-01-13T05:04:40Z,8,4,4
15911,2071082248,"{'login': 'facebook-github-bot', 'id': 6422482, 'node_id': 'MDQ6VXNlcjY0MjI0ODI=', 'avatar_url': 'https://avatars3.githubusercontent.com/u/6422482?v=4', 'gravatar_id': '', 'url': 'https://api.github.com/users/facebook-github-bot', 'html_url': 'https://github.com/facebook-github-bot', 'followers_url': 'https://api.github.com/users/facebook-github-bot/followers', 'following_url': 'https://api.github.com/users/facebook-github-bot/following{/other_user}', 'gists_url': 'https://api.github.com/users/facebook-github-bot/gists{/gist_id}', 'starred_url': 'https://api.github.com/users/facebook-github-bot/starred{/owner}{/repo}', 'subscriptions_url': 'https://api.github.com/users/facebook-github-bot/subscriptions', 'organizations_url': 'https://api.github.com/users/facebook-github-bot/orgs', 'repos_url': 'https://api.github.com/users/facebook-github-bot/repos', 'events_url': 'https://api.github.com/users/facebook-github-bot/events{/privacy}', 'received_events_url': 'https://api.github.com/users/facebook-github-bot/received_events', 'type': 'User', 'site_admin': False}",closed,ca18fb85672159bf52b9a3d56738d057129b292f,https://api.github.com/repos/pytorch/pytorch/commits/ca18fb85672159bf52b9a3d56738d057129b292f,2019-01-14T07:34:09Z,446,212,234
15863,2111362402,"{'login': 'facebook-github-bot', 'id': 6422482, 'node_id': 'MDQ6VXNlcjY0MjI0ODI=', 'avatar_url': 'https://avatars3.githubusercontent.com/u/6422482?v=4', 'gravatar_id': '', 'url': 'https://api.github.com/users/facebook-github-bot', 'html_url': 'https://github.com/facebook-github-bot', 'followers_url': 'https://api.github.com/users/facebook-github-bot/followers', 'following_url': 'https://api.github.com/users/facebook-github-bot/following{/other_user}', 'gists_url': 'https://api.github.com/users/facebook-github-bot/gists{/gist_id}', 'starred_url': 'https://api.github.com/users/facebook-github-bot/starred{/owner}{/repo}', 'subscriptions_url': 'https://api.github.com/users/facebook-github-bot/subscriptions', 'organizations_url': 'https://api.github.com/users/facebook-github-bot/orgs', 'repos_url': 'https://api.github.com/users/facebook-github-bot/repos', 'events_url': 'https://api.github.com/users/facebook-github-bot/events{/privacy}', 'received_events_url': 'https://api.github.com/users/facebook-github-bot/received_events', 'type': 'User', 'site_admin': False}",closed,b0e692c8a66ed9cb174df12aa1ff747e8b7c8495,https://api.github.com/repos/pytorch/pytorch/commits/b0e692c8a66ed9cb174df12aa1ff747e8b7c8495,2019-02-01T06:08:38Z,4,2,2
15858,2066059137,"{'login': 'facebook-github-bot', 'id': 6422482, 'node_id': 'MDQ6VXNlcjY0MjI0ODI=', 'avatar_url': 'https://avatars3.githubusercontent.com/u/6422482?v=4', 'gravatar_id': '', 'url': 'https://api.github.com/users/facebook-github-bot', 'html_url': 'https://github.com/facebook-github-bot', 'followers_url': 'https://api.github.com/users/facebook-github-bot/followers', 'following_url': 'https://api.github.com/users/facebook-github-bot/following{/other_user}', 'gists_url': 'https://api.github.com/users/facebook-github-bot/gists{/gist_id}', 'starred_url': 'https://api.github.com/users/facebook-github-bot/starred{/owner}{/repo}', 'subscriptions_url': 'https://api.github.com/users/facebook-github-bot/subscriptions', 'organizations_url': 'https://api.github.com/users/facebook-github-bot/orgs', 'repos_url': 'https://api.github.com/users/facebook-github-bot/repos', 'events_url': 'https://api.github.com/users/facebook-github-bot/events{/privacy}', 'received_events_url': 'https://api.github.com/users/facebook-github-bot/received_events', 'type': 'User', 'site_admin': False}",closed,0ed3f766e9eb803e8f37f728af9494d756aec9a7,https://api.github.com/repos/pytorch/pytorch/commits/0ed3f766e9eb803e8f37f728af9494d756aec9a7,2019-01-10T14:48:50Z,300,156,144
15858,2077817081,"{'login': 'zou3519', 'id': 5652049, 'node_id': 'MDQ6VXNlcjU2NTIwNDk=', 'avatar_url': 'https://avatars3.githubusercontent.com/u/5652049?v=4', 'gravatar_id': '', 'url': 'https://api.github.com/users/zou3519', 'html_url': 'https://github.com/zou3519', 'followers_url': 'https://api.github.com/users/zou3519/followers', 'following_url': 'https://api.github.com/users/zou3519/following{/other_user}', 'gists_url': 'https://api.github.com/users/zou3519/gists{/gist_id}', 'starred_url': 'https://api.github.com/users/zou3519/starred{/owner}{/repo}', 'subscriptions_url': 'https://api.github.com/users/zou3519/subscriptions', 'organizations_url': 'https://api.github.com/users/zou3519/orgs', 'repos_url': 'https://api.github.com/users/zou3519/repos', 'events_url': 'https://api.github.com/users/zou3519/events{/privacy}', 'received_events_url': 'https://api.github.com/users/zou3519/received_events', 'type': 'User', 'site_admin': False}",referenced,a3b75019a50b590d1c16dcc147f99140cb790a2d,https://api.github.com/repos/pytorch/pytorch/commits/a3b75019a50b590d1c16dcc147f99140cb790a2d,2019-01-16T16:01:00Z,309,168,141
15837,2076385755,"{'login': 'facebook-github-bot', 'id': 6422482, 'node_id': 'MDQ6VXNlcjY0MjI0ODI=', 'avatar_url': 'https://avatars3.githubusercontent.com/u/6422482?v=4', 'gravatar_id': '', 'url': 'https://api.github.com/users/facebook-github-bot', 'html_url': 'https://github.com/facebook-github-bot', 'followers_url': 'https://api.github.com/users/facebook-github-bot/followers', 'following_url': 'https://api.github.com/users/facebook-github-bot/following{/other_user}', 'gists_url': 'https://api.github.com/users/facebook-github-bot/gists{/gist_id}', 'starred_url': 'https://api.github.com/users/facebook-github-bot/starred{/owner}{/repo}', 'subscriptions_url': 'https://api.github.com/users/facebook-github-bot/subscriptions', 'organizations_url': 'https://api.github.com/users/facebook-github-bot/orgs', 'repos_url': 'https://api.github.com/users/facebook-github-bot/repos', 'events_url': 'https://api.github.com/users/facebook-github-bot/events{/privacy}', 'received_events_url': 'https://api.github.com/users/facebook-github-bot/received_events', 'type': 'User', 'site_admin': False}",referenced,fb68d813be3ccbab3cbf74008a11071b9a646c75,https://api.github.com/repos/pytorch/pytorch/commits/fb68d813be3ccbab3cbf74008a11071b9a646c75,2019-01-16T03:59:20Z,46,42,4
15828,2718282485,"{'login': 'facebook-github-bot', 'id': 6422482, 'node_id': 'MDQ6VXNlcjY0MjI0ODI=', 'avatar_url': 'https://avatars3.githubusercontent.com/u/6422482?v=4', 'gravatar_id': '', 'url': 'https://api.github.com/users/facebook-github-bot', 'html_url': 'https://github.com/facebook-github-bot', 'followers_url': 'https://api.github.com/users/facebook-github-bot/followers', 'following_url': 'https://api.github.com/users/facebook-github-bot/following{/other_user}', 'gists_url': 'https://api.github.com/users/facebook-github-bot/gists{/gist_id}', 'starred_url': 'https://api.github.com/users/facebook-github-bot/starred{/owner}{/repo}', 'subscriptions_url': 'https://api.github.com/users/facebook-github-bot/subscriptions', 'organizations_url': 'https://api.github.com/users/facebook-github-bot/orgs', 'repos_url': 'https://api.github.com/users/facebook-github-bot/repos', 'events_url': 'https://api.github.com/users/facebook-github-bot/events{/privacy}', 'received_events_url': 'https://api.github.com/users/facebook-github-bot/received_events', 'type': 'User', 'site_admin': False}",referenced,3d3bff5ff1bc277306d15a3caa96c2a6fdb924bb,https://api.github.com/repos/pytorch/pytorch/commits/3d3bff5ff1bc277306d15a3caa96c2a6fdb924bb,2019-10-16T16:22:02Z,48,22,26
15826,2069368451,"{'login': 'facebook-github-bot', 'id': 6422482, 'node_id': 'MDQ6VXNlcjY0MjI0ODI=', 'avatar_url': 'https://avatars3.githubusercontent.com/u/6422482?v=4', 'gravatar_id': '', 'url': 'https://api.github.com/users/facebook-github-bot', 'html_url': 'https://github.com/facebook-github-bot', 'followers_url': 'https://api.github.com/users/facebook-github-bot/followers', 'following_url': 'https://api.github.com/users/facebook-github-bot/following{/other_user}', 'gists_url': 'https://api.github.com/users/facebook-github-bot/gists{/gist_id}', 'starred_url': 'https://api.github.com/users/facebook-github-bot/starred{/owner}{/repo}', 'subscriptions_url': 'https://api.github.com/users/facebook-github-bot/subscriptions', 'organizations_url': 'https://api.github.com/users/facebook-github-bot/orgs', 'repos_url': 'https://api.github.com/users/facebook-github-bot/repos', 'events_url': 'https://api.github.com/users/facebook-github-bot/events{/privacy}', 'received_events_url': 'https://api.github.com/users/facebook-github-bot/received_events', 'type': 'User', 'site_admin': False}",closed,e07cca13123446d61576a2f54b9c5a680ff9f364,https://api.github.com/repos/pytorch/pytorch/commits/e07cca13123446d61576a2f54b9c5a680ff9f364,2019-01-11T19:30:06Z,12,11,1
15826,2083874016,"{'login': 'soumith', 'id': 1310570, 'node_id': 'MDQ6VXNlcjEzMTA1NzA=', 'avatar_url': 'https://avatars0.githubusercontent.com/u/1310570?v=4', 'gravatar_id': '', 'url': 'https://api.github.com/users/soumith', 'html_url': 'https://github.com/soumith', 'followers_url': 'https://api.github.com/users/soumith/followers', 'following_url': 'https://api.github.com/users/soumith/following{/other_user}', 'gists_url': 'https://api.github.com/users/soumith/gists{/gist_id}', 'starred_url': 'https://api.github.com/users/soumith/starred{/owner}{/repo}', 'subscriptions_url': 'https://api.github.com/users/soumith/subscriptions', 'organizations_url': 'https://api.github.com/users/soumith/orgs', 'repos_url': 'https://api.github.com/users/soumith/repos', 'events_url': 'https://api.github.com/users/soumith/events{/privacy}', 'received_events_url': 'https://api.github.com/users/soumith/received_events', 'type': 'User', 'site_admin': False}",referenced,829aa398c24c7ec55ae2f64454834345b31f880e,https://api.github.com/repos/pytorch/pytorch/commits/829aa398c24c7ec55ae2f64454834345b31f880e,2019-01-18T20:32:00Z,12,11,1
15826,2102600453,"{'login': 'soumith', 'id': 1310570, 'node_id': 'MDQ6VXNlcjEzMTA1NzA=', 'avatar_url': 'https://avatars0.githubusercontent.com/u/1310570?v=4', 'gravatar_id': '', 'url': 'https://api.github.com/users/soumith', 'html_url': 'https://github.com/soumith', 'followers_url': 'https://api.github.com/users/soumith/followers', 'following_url': 'https://api.github.com/users/soumith/following{/other_user}', 'gists_url': 'https://api.github.com/users/soumith/gists{/gist_id}', 'starred_url': 'https://api.github.com/users/soumith/starred{/owner}{/repo}', 'subscriptions_url': 'https://api.github.com/users/soumith/subscriptions', 'organizations_url': 'https://api.github.com/users/soumith/orgs', 'repos_url': 'https://api.github.com/users/soumith/repos', 'events_url': 'https://api.github.com/users/soumith/events{/privacy}', 'received_events_url': 'https://api.github.com/users/soumith/received_events', 'type': 'User', 'site_admin': False}",referenced,9a9eae14d0eeb216c4a442b7c080263b99b934dc,https://api.github.com/repos/pytorch/pytorch/commits/9a9eae14d0eeb216c4a442b7c080263b99b934dc,2019-01-29T04:12:50Z,12,11,1
15815,2113566449,"{'login': 'facebook-github-bot', 'id': 6422482, 'node_id': 'MDQ6VXNlcjY0MjI0ODI=', 'avatar_url': 'https://avatars3.githubusercontent.com/u/6422482?v=4', 'gravatar_id': '', 'url': 'https://api.github.com/users/facebook-github-bot', 'html_url': 'https://github.com/facebook-github-bot', 'followers_url': 'https://api.github.com/users/facebook-github-bot/followers', 'following_url': 'https://api.github.com/users/facebook-github-bot/following{/other_user}', 'gists_url': 'https://api.github.com/users/facebook-github-bot/gists{/gist_id}', 'starred_url': 'https://api.github.com/users/facebook-github-bot/starred{/owner}{/repo}', 'subscriptions_url': 'https://api.github.com/users/facebook-github-bot/subscriptions', 'organizations_url': 'https://api.github.com/users/facebook-github-bot/orgs', 'repos_url': 'https://api.github.com/users/facebook-github-bot/repos', 'events_url': 'https://api.github.com/users/facebook-github-bot/events{/privacy}', 'received_events_url': 'https://api.github.com/users/facebook-github-bot/received_events', 'type': 'User', 'site_admin': False}",closed,c865d46736db4afff51690a712e35ed8e3899490,https://api.github.com/repos/pytorch/pytorch/commits/c865d46736db4afff51690a712e35ed8e3899490,2019-02-02T00:47:34Z,130,124,6
15792,2067088000,"{'login': 'facebook-github-bot', 'id': 6422482, 'node_id': 'MDQ6VXNlcjY0MjI0ODI=', 'avatar_url': 'https://avatars3.githubusercontent.com/u/6422482?v=4', 'gravatar_id': '', 'url': 'https://api.github.com/users/facebook-github-bot', 'html_url': 'https://github.com/facebook-github-bot', 'followers_url': 'https://api.github.com/users/facebook-github-bot/followers', 'following_url': 'https://api.github.com/users/facebook-github-bot/following{/other_user}', 'gists_url': 'https://api.github.com/users/facebook-github-bot/gists{/gist_id}', 'starred_url': 'https://api.github.com/users/facebook-github-bot/starred{/owner}{/repo}', 'subscriptions_url': 'https://api.github.com/users/facebook-github-bot/subscriptions', 'organizations_url': 'https://api.github.com/users/facebook-github-bot/orgs', 'repos_url': 'https://api.github.com/users/facebook-github-bot/repos', 'events_url': 'https://api.github.com/users/facebook-github-bot/events{/privacy}', 'received_events_url': 'https://api.github.com/users/facebook-github-bot/received_events', 'type': 'User', 'site_admin': False}",referenced,b1fa19961e266f900fa5283a913b57c054509b5d,https://api.github.com/repos/pytorch/pytorch/commits/b1fa19961e266f900fa5283a913b57c054509b5d,2019-01-10T21:57:12Z,40,20,20
15792,2082135421,"{'login': 'soumith', 'id': 1310570, 'node_id': 'MDQ6VXNlcjEzMTA1NzA=', 'avatar_url': 'https://avatars0.githubusercontent.com/u/1310570?v=4', 'gravatar_id': '', 'url': 'https://api.github.com/users/soumith', 'html_url': 'https://github.com/soumith', 'followers_url': 'https://api.github.com/users/soumith/followers', 'following_url': 'https://api.github.com/users/soumith/following{/other_user}', 'gists_url': 'https://api.github.com/users/soumith/gists{/gist_id}', 'starred_url': 'https://api.github.com/users/soumith/starred{/owner}{/repo}', 'subscriptions_url': 'https://api.github.com/users/soumith/subscriptions', 'organizations_url': 'https://api.github.com/users/soumith/orgs', 'repos_url': 'https://api.github.com/users/soumith/repos', 'events_url': 'https://api.github.com/users/soumith/events{/privacy}', 'received_events_url': 'https://api.github.com/users/soumith/received_events', 'type': 'User', 'site_admin': False}",referenced,c3acababf2d67171314166dd7605686c5fba6364,https://api.github.com/repos/pytorch/pytorch/commits/c3acababf2d67171314166dd7605686c5fba6364,2019-01-18T06:37:44Z,40,20,20
15792,2102600428,"{'login': 'soumith', 'id': 1310570, 'node_id': 'MDQ6VXNlcjEzMTA1NzA=', 'avatar_url': 'https://avatars0.githubusercontent.com/u/1310570?v=4', 'gravatar_id': '', 'url': 'https://api.github.com/users/soumith', 'html_url': 'https://github.com/soumith', 'followers_url': 'https://api.github.com/users/soumith/followers', 'following_url': 'https://api.github.com/users/soumith/following{/other_user}', 'gists_url': 'https://api.github.com/users/soumith/gists{/gist_id}', 'starred_url': 'https://api.github.com/users/soumith/starred{/owner}{/repo}', 'subscriptions_url': 'https://api.github.com/users/soumith/subscriptions', 'organizations_url': 'https://api.github.com/users/soumith/orgs', 'repos_url': 'https://api.github.com/users/soumith/repos', 'events_url': 'https://api.github.com/users/soumith/events{/privacy}', 'received_events_url': 'https://api.github.com/users/soumith/received_events', 'type': 'User', 'site_admin': False}",referenced,9a7737146cb5660ebf4305c9ffc75267954a9a81,https://api.github.com/repos/pytorch/pytorch/commits/9a7737146cb5660ebf4305c9ffc75267954a9a81,2019-01-29T04:12:50Z,40,20,20
15773,2391256489,"{'login': 'facebook-github-bot', 'id': 6422482, 'node_id': 'MDQ6VXNlcjY0MjI0ODI=', 'avatar_url': 'https://avatars3.githubusercontent.com/u/6422482?v=4', 'gravatar_id': '', 'url': 'https://api.github.com/users/facebook-github-bot', 'html_url': 'https://github.com/facebook-github-bot', 'followers_url': 'https://api.github.com/users/facebook-github-bot/followers', 'following_url': 'https://api.github.com/users/facebook-github-bot/following{/other_user}', 'gists_url': 'https://api.github.com/users/facebook-github-bot/gists{/gist_id}', 'starred_url': 'https://api.github.com/users/facebook-github-bot/starred{/owner}{/repo}', 'subscriptions_url': 'https://api.github.com/users/facebook-github-bot/subscriptions', 'organizations_url': 'https://api.github.com/users/facebook-github-bot/orgs', 'repos_url': 'https://api.github.com/users/facebook-github-bot/repos', 'events_url': 'https://api.github.com/users/facebook-github-bot/events{/privacy}', 'received_events_url': 'https://api.github.com/users/facebook-github-bot/received_events', 'type': 'User', 'site_admin': False}",closed,6251c563eb1b02ea0ad76271e0f8a0e378348f00,https://api.github.com/repos/pytorch/pytorch/commits/6251c563eb1b02ea0ad76271e0f8a0e378348f00,2019-06-05T13:38:16Z,370,181,189
15768,2061411115,"{'login': 'facebook-github-bot', 'id': 6422482, 'node_id': 'MDQ6VXNlcjY0MjI0ODI=', 'avatar_url': 'https://avatars3.githubusercontent.com/u/6422482?v=4', 'gravatar_id': '', 'url': 'https://api.github.com/users/facebook-github-bot', 'html_url': 'https://github.com/facebook-github-bot', 'followers_url': 'https://api.github.com/users/facebook-github-bot/followers', 'following_url': 'https://api.github.com/users/facebook-github-bot/following{/other_user}', 'gists_url': 'https://api.github.com/users/facebook-github-bot/gists{/gist_id}', 'starred_url': 'https://api.github.com/users/facebook-github-bot/starred{/owner}{/repo}', 'subscriptions_url': 'https://api.github.com/users/facebook-github-bot/subscriptions', 'organizations_url': 'https://api.github.com/users/facebook-github-bot/orgs', 'repos_url': 'https://api.github.com/users/facebook-github-bot/repos', 'events_url': 'https://api.github.com/users/facebook-github-bot/events{/privacy}', 'received_events_url': 'https://api.github.com/users/facebook-github-bot/received_events', 'type': 'User', 'site_admin': False}",closed,acc83ad54ef85eacd3c7ebfe20ee8225164e5bd1,https://api.github.com/repos/pytorch/pytorch/commits/acc83ad54ef85eacd3c7ebfe20ee8225164e5bd1,2019-01-08T21:45:46Z,32,28,4
15764,2068949187,"{'login': 'facebook-github-bot', 'id': 6422482, 'node_id': 'MDQ6VXNlcjY0MjI0ODI=', 'avatar_url': 'https://avatars3.githubusercontent.com/u/6422482?v=4', 'gravatar_id': '', 'url': 'https://api.github.com/users/facebook-github-bot', 'html_url': 'https://github.com/facebook-github-bot', 'followers_url': 'https://api.github.com/users/facebook-github-bot/followers', 'following_url': 'https://api.github.com/users/facebook-github-bot/following{/other_user}', 'gists_url': 'https://api.github.com/users/facebook-github-bot/gists{/gist_id}', 'starred_url': 'https://api.github.com/users/facebook-github-bot/starred{/owner}{/repo}', 'subscriptions_url': 'https://api.github.com/users/facebook-github-bot/subscriptions', 'organizations_url': 'https://api.github.com/users/facebook-github-bot/orgs', 'repos_url': 'https://api.github.com/users/facebook-github-bot/repos', 'events_url': 'https://api.github.com/users/facebook-github-bot/events{/privacy}', 'received_events_url': 'https://api.github.com/users/facebook-github-bot/received_events', 'type': 'User', 'site_admin': False}",closed,70dd44f6a8a20a52b8d800e08a8aa7ef98ee6352,https://api.github.com/repos/pytorch/pytorch/commits/70dd44f6a8a20a52b8d800e08a8aa7ef98ee6352,2019-01-11T16:15:37Z,80,50,30
15764,2081563661,"{'login': 'soumith', 'id': 1310570, 'node_id': 'MDQ6VXNlcjEzMTA1NzA=', 'avatar_url': 'https://avatars0.githubusercontent.com/u/1310570?v=4', 'gravatar_id': '', 'url': 'https://api.github.com/users/soumith', 'html_url': 'https://github.com/soumith', 'followers_url': 'https://api.github.com/users/soumith/followers', 'following_url': 'https://api.github.com/users/soumith/following{/other_user}', 'gists_url': 'https://api.github.com/users/soumith/gists{/gist_id}', 'starred_url': 'https://api.github.com/users/soumith/starred{/owner}{/repo}', 'subscriptions_url': 'https://api.github.com/users/soumith/subscriptions', 'organizations_url': 'https://api.github.com/users/soumith/orgs', 'repos_url': 'https://api.github.com/users/soumith/repos', 'events_url': 'https://api.github.com/users/soumith/events{/privacy}', 'received_events_url': 'https://api.github.com/users/soumith/received_events', 'type': 'User', 'site_admin': False}",referenced,49eef6e85030790b402a04665bd862fb22fb6776,https://api.github.com/repos/pytorch/pytorch/commits/49eef6e85030790b402a04665bd862fb22fb6776,2019-01-17T22:31:56Z,80,50,30
15764,2081981263,"{'login': 'soumith', 'id': 1310570, 'node_id': 'MDQ6VXNlcjEzMTA1NzA=', 'avatar_url': 'https://avatars0.githubusercontent.com/u/1310570?v=4', 'gravatar_id': '', 'url': 'https://api.github.com/users/soumith', 'html_url': 'https://github.com/soumith', 'followers_url': 'https://api.github.com/users/soumith/followers', 'following_url': 'https://api.github.com/users/soumith/following{/other_user}', 'gists_url': 'https://api.github.com/users/soumith/gists{/gist_id}', 'starred_url': 'https://api.github.com/users/soumith/starred{/owner}{/repo}', 'subscriptions_url': 'https://api.github.com/users/soumith/subscriptions', 'organizations_url': 'https://api.github.com/users/soumith/orgs', 'repos_url': 'https://api.github.com/users/soumith/repos', 'events_url': 'https://api.github.com/users/soumith/events{/privacy}', 'received_events_url': 'https://api.github.com/users/soumith/received_events', 'type': 'User', 'site_admin': False}",referenced,dfdf2376bb9bf4e99a2f7a61e956954646929709,https://api.github.com/repos/pytorch/pytorch/commits/dfdf2376bb9bf4e99a2f7a61e956954646929709,2019-01-18T04:02:12Z,80,50,30
15749,2060888030,"{'login': 'facebook-github-bot', 'id': 6422482, 'node_id': 'MDQ6VXNlcjY0MjI0ODI=', 'avatar_url': 'https://avatars3.githubusercontent.com/u/6422482?v=4', 'gravatar_id': '', 'url': 'https://api.github.com/users/facebook-github-bot', 'html_url': 'https://github.com/facebook-github-bot', 'followers_url': 'https://api.github.com/users/facebook-github-bot/followers', 'following_url': 'https://api.github.com/users/facebook-github-bot/following{/other_user}', 'gists_url': 'https://api.github.com/users/facebook-github-bot/gists{/gist_id}', 'starred_url': 'https://api.github.com/users/facebook-github-bot/starred{/owner}{/repo}', 'subscriptions_url': 'https://api.github.com/users/facebook-github-bot/subscriptions', 'organizations_url': 'https://api.github.com/users/facebook-github-bot/orgs', 'repos_url': 'https://api.github.com/users/facebook-github-bot/repos', 'events_url': 'https://api.github.com/users/facebook-github-bot/events{/privacy}', 'received_events_url': 'https://api.github.com/users/facebook-github-bot/received_events', 'type': 'User', 'site_admin': False}",closed,461dc9a28b132f032e1ae81bfdab27e9d3770fe9,https://api.github.com/repos/pytorch/pytorch/commits/461dc9a28b132f032e1ae81bfdab27e9d3770fe9,2019-01-08T17:50:02Z,25,24,1
15749,2081563666,"{'login': 'soumith', 'id': 1310570, 'node_id': 'MDQ6VXNlcjEzMTA1NzA=', 'avatar_url': 'https://avatars0.githubusercontent.com/u/1310570?v=4', 'gravatar_id': '', 'url': 'https://api.github.com/users/soumith', 'html_url': 'https://github.com/soumith', 'followers_url': 'https://api.github.com/users/soumith/followers', 'following_url': 'https://api.github.com/users/soumith/following{/other_user}', 'gists_url': 'https://api.github.com/users/soumith/gists{/gist_id}', 'starred_url': 'https://api.github.com/users/soumith/starred{/owner}{/repo}', 'subscriptions_url': 'https://api.github.com/users/soumith/subscriptions', 'organizations_url': 'https://api.github.com/users/soumith/orgs', 'repos_url': 'https://api.github.com/users/soumith/repos', 'events_url': 'https://api.github.com/users/soumith/events{/privacy}', 'received_events_url': 'https://api.github.com/users/soumith/received_events', 'type': 'User', 'site_admin': False}",referenced,563e227c11add2a6188a85ef4d906c9039b6cabd,https://api.github.com/repos/pytorch/pytorch/commits/563e227c11add2a6188a85ef4d906c9039b6cabd,2019-01-17T22:31:56Z,25,24,1
15749,2081981267,"{'login': 'soumith', 'id': 1310570, 'node_id': 'MDQ6VXNlcjEzMTA1NzA=', 'avatar_url': 'https://avatars0.githubusercontent.com/u/1310570?v=4', 'gravatar_id': '', 'url': 'https://api.github.com/users/soumith', 'html_url': 'https://github.com/soumith', 'followers_url': 'https://api.github.com/users/soumith/followers', 'following_url': 'https://api.github.com/users/soumith/following{/other_user}', 'gists_url': 'https://api.github.com/users/soumith/gists{/gist_id}', 'starred_url': 'https://api.github.com/users/soumith/starred{/owner}{/repo}', 'subscriptions_url': 'https://api.github.com/users/soumith/subscriptions', 'organizations_url': 'https://api.github.com/users/soumith/orgs', 'repos_url': 'https://api.github.com/users/soumith/repos', 'events_url': 'https://api.github.com/users/soumith/events{/privacy}', 'received_events_url': 'https://api.github.com/users/soumith/received_events', 'type': 'User', 'site_admin': False}",referenced,167f8e8314a51545f82ff2accf8574fb3bb1c202,https://api.github.com/repos/pytorch/pytorch/commits/167f8e8314a51545f82ff2accf8574fb3bb1c202,2019-01-18T04:02:13Z,25,24,1
15735,2063400645,"{'login': 'facebook-github-bot', 'id': 6422482, 'node_id': 'MDQ6VXNlcjY0MjI0ODI=', 'avatar_url': 'https://avatars3.githubusercontent.com/u/6422482?v=4', 'gravatar_id': '', 'url': 'https://api.github.com/users/facebook-github-bot', 'html_url': 'https://github.com/facebook-github-bot', 'followers_url': 'https://api.github.com/users/facebook-github-bot/followers', 'following_url': 'https://api.github.com/users/facebook-github-bot/following{/other_user}', 'gists_url': 'https://api.github.com/users/facebook-github-bot/gists{/gist_id}', 'starred_url': 'https://api.github.com/users/facebook-github-bot/starred{/owner}{/repo}', 'subscriptions_url': 'https://api.github.com/users/facebook-github-bot/subscriptions', 'organizations_url': 'https://api.github.com/users/facebook-github-bot/orgs', 'repos_url': 'https://api.github.com/users/facebook-github-bot/repos', 'events_url': 'https://api.github.com/users/facebook-github-bot/events{/privacy}', 'received_events_url': 'https://api.github.com/users/facebook-github-bot/received_events', 'type': 'User', 'site_admin': False}",referenced,f0c2a9a7b68f77841ba112088deedcd01ddc978a,https://api.github.com/repos/pytorch/pytorch/commits/f0c2a9a7b68f77841ba112088deedcd01ddc978a,2019-01-09T15:32:57Z,8,8,0
15735,2081424989,"{'login': 'soumith', 'id': 1310570, 'node_id': 'MDQ6VXNlcjEzMTA1NzA=', 'avatar_url': 'https://avatars0.githubusercontent.com/u/1310570?v=4', 'gravatar_id': '', 'url': 'https://api.github.com/users/soumith', 'html_url': 'https://github.com/soumith', 'followers_url': 'https://api.github.com/users/soumith/followers', 'following_url': 'https://api.github.com/users/soumith/following{/other_user}', 'gists_url': 'https://api.github.com/users/soumith/gists{/gist_id}', 'starred_url': 'https://api.github.com/users/soumith/starred{/owner}{/repo}', 'subscriptions_url': 'https://api.github.com/users/soumith/subscriptions', 'organizations_url': 'https://api.github.com/users/soumith/orgs', 'repos_url': 'https://api.github.com/users/soumith/repos', 'events_url': 'https://api.github.com/users/soumith/events{/privacy}', 'received_events_url': 'https://api.github.com/users/soumith/received_events', 'type': 'User', 'site_admin': False}",referenced,fa7b7a180125ce83242a9e96adfd0958d80f1065,https://api.github.com/repos/pytorch/pytorch/commits/fa7b7a180125ce83242a9e96adfd0958d80f1065,2019-01-17T21:23:35Z,21,21,0
15735,2082115970,"{'login': 'soumith', 'id': 1310570, 'node_id': 'MDQ6VXNlcjEzMTA1NzA=', 'avatar_url': 'https://avatars0.githubusercontent.com/u/1310570?v=4', 'gravatar_id': '', 'url': 'https://api.github.com/users/soumith', 'html_url': 'https://github.com/soumith', 'followers_url': 'https://api.github.com/users/soumith/followers', 'following_url': 'https://api.github.com/users/soumith/following{/other_user}', 'gists_url': 'https://api.github.com/users/soumith/gists{/gist_id}', 'starred_url': 'https://api.github.com/users/soumith/starred{/owner}{/repo}', 'subscriptions_url': 'https://api.github.com/users/soumith/subscriptions', 'organizations_url': 'https://api.github.com/users/soumith/orgs', 'repos_url': 'https://api.github.com/users/soumith/repos', 'events_url': 'https://api.github.com/users/soumith/events{/privacy}', 'received_events_url': 'https://api.github.com/users/soumith/received_events', 'type': 'User', 'site_admin': False}",referenced,0418b45553067aaf9e9dc67a6818c86073a48105,https://api.github.com/repos/pytorch/pytorch/commits/0418b45553067aaf9e9dc67a6818c86073a48105,2019-01-18T06:20:46Z,8,8,0
15735,2102600411,"{'login': 'soumith', 'id': 1310570, 'node_id': 'MDQ6VXNlcjEzMTA1NzA=', 'avatar_url': 'https://avatars0.githubusercontent.com/u/1310570?v=4', 'gravatar_id': '', 'url': 'https://api.github.com/users/soumith', 'html_url': 'https://github.com/soumith', 'followers_url': 'https://api.github.com/users/soumith/followers', 'following_url': 'https://api.github.com/users/soumith/following{/other_user}', 'gists_url': 'https://api.github.com/users/soumith/gists{/gist_id}', 'starred_url': 'https://api.github.com/users/soumith/starred{/owner}{/repo}', 'subscriptions_url': 'https://api.github.com/users/soumith/subscriptions', 'organizations_url': 'https://api.github.com/users/soumith/orgs', 'repos_url': 'https://api.github.com/users/soumith/repos', 'events_url': 'https://api.github.com/users/soumith/events{/privacy}', 'received_events_url': 'https://api.github.com/users/soumith/received_events', 'type': 'User', 'site_admin': False}",referenced,ba4d1e8ca63b34563b523b4788dfe7e2bba73654,https://api.github.com/repos/pytorch/pytorch/commits/ba4d1e8ca63b34563b523b4788dfe7e2bba73654,2019-01-29T04:12:49Z,8,8,0
15730,2062268956,"{'login': 'facebook-github-bot', 'id': 6422482, 'node_id': 'MDQ6VXNlcjY0MjI0ODI=', 'avatar_url': 'https://avatars3.githubusercontent.com/u/6422482?v=4', 'gravatar_id': '', 'url': 'https://api.github.com/users/facebook-github-bot', 'html_url': 'https://github.com/facebook-github-bot', 'followers_url': 'https://api.github.com/users/facebook-github-bot/followers', 'following_url': 'https://api.github.com/users/facebook-github-bot/following{/other_user}', 'gists_url': 'https://api.github.com/users/facebook-github-bot/gists{/gist_id}', 'starred_url': 'https://api.github.com/users/facebook-github-bot/starred{/owner}{/repo}', 'subscriptions_url': 'https://api.github.com/users/facebook-github-bot/subscriptions', 'organizations_url': 'https://api.github.com/users/facebook-github-bot/orgs', 'repos_url': 'https://api.github.com/users/facebook-github-bot/repos', 'events_url': 'https://api.github.com/users/facebook-github-bot/events{/privacy}', 'received_events_url': 'https://api.github.com/users/facebook-github-bot/received_events', 'type': 'User', 'site_admin': False}",closed,ac206a95f5eefee0c7010c33d45371be0bee19ee,https://api.github.com/repos/pytorch/pytorch/commits/ac206a95f5eefee0c7010c33d45371be0bee19ee,2019-01-09T06:57:14Z,7,7,0
15702,2152090219,"{'login': 'facebook-github-bot', 'id': 6422482, 'node_id': 'MDQ6VXNlcjY0MjI0ODI=', 'avatar_url': 'https://avatars3.githubusercontent.com/u/6422482?v=4', 'gravatar_id': '', 'url': 'https://api.github.com/users/facebook-github-bot', 'html_url': 'https://github.com/facebook-github-bot', 'followers_url': 'https://api.github.com/users/facebook-github-bot/followers', 'following_url': 'https://api.github.com/users/facebook-github-bot/following{/other_user}', 'gists_url': 'https://api.github.com/users/facebook-github-bot/gists{/gist_id}', 'starred_url': 'https://api.github.com/users/facebook-github-bot/starred{/owner}{/repo}', 'subscriptions_url': 'https://api.github.com/users/facebook-github-bot/subscriptions', 'organizations_url': 'https://api.github.com/users/facebook-github-bot/orgs', 'repos_url': 'https://api.github.com/users/facebook-github-bot/repos', 'events_url': 'https://api.github.com/users/facebook-github-bot/events{/privacy}', 'received_events_url': 'https://api.github.com/users/facebook-github-bot/received_events', 'type': 'User', 'site_admin': False}",closed,1b3315ec17f3acd851f007c235b164fc1cbacd51,https://api.github.com/repos/pytorch/pytorch/commits/1b3315ec17f3acd851f007c235b164fc1cbacd51,2019-02-20T14:32:13Z,2,2,0
15700,2058348295,"{'login': 'facebook-github-bot', 'id': 6422482, 'node_id': 'MDQ6VXNlcjY0MjI0ODI=', 'avatar_url': 'https://avatars3.githubusercontent.com/u/6422482?v=4', 'gravatar_id': '', 'url': 'https://api.github.com/users/facebook-github-bot', 'html_url': 'https://github.com/facebook-github-bot', 'followers_url': 'https://api.github.com/users/facebook-github-bot/followers', 'following_url': 'https://api.github.com/users/facebook-github-bot/following{/other_user}', 'gists_url': 'https://api.github.com/users/facebook-github-bot/gists{/gist_id}', 'starred_url': 'https://api.github.com/users/facebook-github-bot/starred{/owner}{/repo}', 'subscriptions_url': 'https://api.github.com/users/facebook-github-bot/subscriptions', 'organizations_url': 'https://api.github.com/users/facebook-github-bot/orgs', 'repos_url': 'https://api.github.com/users/facebook-github-bot/repos', 'events_url': 'https://api.github.com/users/facebook-github-bot/events{/privacy}', 'received_events_url': 'https://api.github.com/users/facebook-github-bot/received_events', 'type': 'User', 'site_admin': False}",closed,95febdfacc112158565561e374819396dfd88861,https://api.github.com/repos/pytorch/pytorch/commits/95febdfacc112158565561e374819396dfd88861,2019-01-07T18:44:47Z,24,23,1
15683,2130476343,"{'login': 'facebook-github-bot', 'id': 6422482, 'node_id': 'MDQ6VXNlcjY0MjI0ODI=', 'avatar_url': 'https://avatars3.githubusercontent.com/u/6422482?v=4', 'gravatar_id': '', 'url': 'https://api.github.com/users/facebook-github-bot', 'html_url': 'https://github.com/facebook-github-bot', 'followers_url': 'https://api.github.com/users/facebook-github-bot/followers', 'following_url': 'https://api.github.com/users/facebook-github-bot/following{/other_user}', 'gists_url': 'https://api.github.com/users/facebook-github-bot/gists{/gist_id}', 'starred_url': 'https://api.github.com/users/facebook-github-bot/starred{/owner}{/repo}', 'subscriptions_url': 'https://api.github.com/users/facebook-github-bot/subscriptions', 'organizations_url': 'https://api.github.com/users/facebook-github-bot/orgs', 'repos_url': 'https://api.github.com/users/facebook-github-bot/repos', 'events_url': 'https://api.github.com/users/facebook-github-bot/events{/privacy}', 'received_events_url': 'https://api.github.com/users/facebook-github-bot/received_events', 'type': 'User', 'site_admin': False}",closed,8b4dea3f56a2c5791c4f4b332c6c6a2311984365,https://api.github.com/repos/pytorch/pytorch/commits/8b4dea3f56a2c5791c4f4b332c6c6a2311984365,2019-02-11T12:56:53Z,18,18,0
15682,2053532301,"{'login': 'facebook-github-bot', 'id': 6422482, 'node_id': 'MDQ6VXNlcjY0MjI0ODI=', 'avatar_url': 'https://avatars3.githubusercontent.com/u/6422482?v=4', 'gravatar_id': '', 'url': 'https://api.github.com/users/facebook-github-bot', 'html_url': 'https://github.com/facebook-github-bot', 'followers_url': 'https://api.github.com/users/facebook-github-bot/followers', 'following_url': 'https://api.github.com/users/facebook-github-bot/following{/other_user}', 'gists_url': 'https://api.github.com/users/facebook-github-bot/gists{/gist_id}', 'starred_url': 'https://api.github.com/users/facebook-github-bot/starred{/owner}{/repo}', 'subscriptions_url': 'https://api.github.com/users/facebook-github-bot/subscriptions', 'organizations_url': 'https://api.github.com/users/facebook-github-bot/orgs', 'repos_url': 'https://api.github.com/users/facebook-github-bot/repos', 'events_url': 'https://api.github.com/users/facebook-github-bot/events{/privacy}', 'received_events_url': 'https://api.github.com/users/facebook-github-bot/received_events', 'type': 'User', 'site_admin': False}",referenced,1e9a6d71921fc673d90699cd5230cf957f5f61cf,https://api.github.com/repos/pytorch/pytorch/commits/1e9a6d71921fc673d90699cd5230cf957f5f61cf,2019-01-03T23:18:34Z,50,45,5
15682,2059262941,"{'login': 'facebook-github-bot', 'id': 6422482, 'node_id': 'MDQ6VXNlcjY0MjI0ODI=', 'avatar_url': 'https://avatars3.githubusercontent.com/u/6422482?v=4', 'gravatar_id': '', 'url': 'https://api.github.com/users/facebook-github-bot', 'html_url': 'https://github.com/facebook-github-bot', 'followers_url': 'https://api.github.com/users/facebook-github-bot/followers', 'following_url': 'https://api.github.com/users/facebook-github-bot/following{/other_user}', 'gists_url': 'https://api.github.com/users/facebook-github-bot/gists{/gist_id}', 'starred_url': 'https://api.github.com/users/facebook-github-bot/starred{/owner}{/repo}', 'subscriptions_url': 'https://api.github.com/users/facebook-github-bot/subscriptions', 'organizations_url': 'https://api.github.com/users/facebook-github-bot/orgs', 'repos_url': 'https://api.github.com/users/facebook-github-bot/repos', 'events_url': 'https://api.github.com/users/facebook-github-bot/events{/privacy}', 'received_events_url': 'https://api.github.com/users/facebook-github-bot/received_events', 'type': 'User', 'site_admin': False}",referenced,99d274386353e99d1568448d6e798d216e176d21,https://api.github.com/repos/pytorch/pytorch/commits/99d274386353e99d1568448d6e798d216e176d21,2019-01-08T04:59:21Z,35,26,9
15681,2064888255,"{'login': 'facebook-github-bot', 'id': 6422482, 'node_id': 'MDQ6VXNlcjY0MjI0ODI=', 'avatar_url': 'https://avatars3.githubusercontent.com/u/6422482?v=4', 'gravatar_id': '', 'url': 'https://api.github.com/users/facebook-github-bot', 'html_url': 'https://github.com/facebook-github-bot', 'followers_url': 'https://api.github.com/users/facebook-github-bot/followers', 'following_url': 'https://api.github.com/users/facebook-github-bot/following{/other_user}', 'gists_url': 'https://api.github.com/users/facebook-github-bot/gists{/gist_id}', 'starred_url': 'https://api.github.com/users/facebook-github-bot/starred{/owner}{/repo}', 'subscriptions_url': 'https://api.github.com/users/facebook-github-bot/subscriptions', 'organizations_url': 'https://api.github.com/users/facebook-github-bot/orgs', 'repos_url': 'https://api.github.com/users/facebook-github-bot/repos', 'events_url': 'https://api.github.com/users/facebook-github-bot/events{/privacy}', 'received_events_url': 'https://api.github.com/users/facebook-github-bot/received_events', 'type': 'User', 'site_admin': False}",closed,5f1dd9e7436366d2ea4580ebbaaba1a70b22b4c9,https://api.github.com/repos/pytorch/pytorch/commits/5f1dd9e7436366d2ea4580ebbaaba1a70b22b4c9,2019-01-10T04:11:04Z,7,7,0
15681,2083235771,"{'login': 'soumith', 'id': 1310570, 'node_id': 'MDQ6VXNlcjEzMTA1NzA=', 'avatar_url': 'https://avatars0.githubusercontent.com/u/1310570?v=4', 'gravatar_id': '', 'url': 'https://api.github.com/users/soumith', 'html_url': 'https://github.com/soumith', 'followers_url': 'https://api.github.com/users/soumith/followers', 'following_url': 'https://api.github.com/users/soumith/following{/other_user}', 'gists_url': 'https://api.github.com/users/soumith/gists{/gist_id}', 'starred_url': 'https://api.github.com/users/soumith/starred{/owner}{/repo}', 'subscriptions_url': 'https://api.github.com/users/soumith/subscriptions', 'organizations_url': 'https://api.github.com/users/soumith/orgs', 'repos_url': 'https://api.github.com/users/soumith/repos', 'events_url': 'https://api.github.com/users/soumith/events{/privacy}', 'received_events_url': 'https://api.github.com/users/soumith/received_events', 'type': 'User', 'site_admin': False}",referenced,98fbabc9ee7df4dbb5f3e5b86b4f24799e92f976,https://api.github.com/repos/pytorch/pytorch/commits/98fbabc9ee7df4dbb5f3e5b86b4f24799e92f976,2019-01-18T15:41:10Z,7,7,0
15681,2102600439,"{'login': 'soumith', 'id': 1310570, 'node_id': 'MDQ6VXNlcjEzMTA1NzA=', 'avatar_url': 'https://avatars0.githubusercontent.com/u/1310570?v=4', 'gravatar_id': '', 'url': 'https://api.github.com/users/soumith', 'html_url': 'https://github.com/soumith', 'followers_url': 'https://api.github.com/users/soumith/followers', 'following_url': 'https://api.github.com/users/soumith/following{/other_user}', 'gists_url': 'https://api.github.com/users/soumith/gists{/gist_id}', 'starred_url': 'https://api.github.com/users/soumith/starred{/owner}{/repo}', 'subscriptions_url': 'https://api.github.com/users/soumith/subscriptions', 'organizations_url': 'https://api.github.com/users/soumith/orgs', 'repos_url': 'https://api.github.com/users/soumith/repos', 'events_url': 'https://api.github.com/users/soumith/events{/privacy}', 'received_events_url': 'https://api.github.com/users/soumith/received_events', 'type': 'User', 'site_admin': False}",referenced,ca1f9349dd60c8367a058a206b516d92984021d3,https://api.github.com/repos/pytorch/pytorch/commits/ca1f9349dd60c8367a058a206b516d92984021d3,2019-01-29T04:12:50Z,7,7,0
15669,2051372591,"{'login': 'facebook-github-bot', 'id': 6422482, 'node_id': 'MDQ6VXNlcjY0MjI0ODI=', 'avatar_url': 'https://avatars3.githubusercontent.com/u/6422482?v=4', 'gravatar_id': '', 'url': 'https://api.github.com/users/facebook-github-bot', 'html_url': 'https://github.com/facebook-github-bot', 'followers_url': 'https://api.github.com/users/facebook-github-bot/followers', 'following_url': 'https://api.github.com/users/facebook-github-bot/following{/other_user}', 'gists_url': 'https://api.github.com/users/facebook-github-bot/gists{/gist_id}', 'starred_url': 'https://api.github.com/users/facebook-github-bot/starred{/owner}{/repo}', 'subscriptions_url': 'https://api.github.com/users/facebook-github-bot/subscriptions', 'organizations_url': 'https://api.github.com/users/facebook-github-bot/orgs', 'repos_url': 'https://api.github.com/users/facebook-github-bot/repos', 'events_url': 'https://api.github.com/users/facebook-github-bot/events{/privacy}', 'received_events_url': 'https://api.github.com/users/facebook-github-bot/received_events', 'type': 'User', 'site_admin': False}",closed,d86cc3e7de1c3e18adb8d5d4794e62d14bb2b543,https://api.github.com/repos/pytorch/pytorch/commits/d86cc3e7de1c3e18adb8d5d4794e62d14bb2b543,2019-01-02T22:36:53Z,16,13,3
15669,2084121321,"{'login': 'suo', 'id': 1617424, 'node_id': 'MDQ6VXNlcjE2MTc0MjQ=', 'avatar_url': 'https://avatars2.githubusercontent.com/u/1617424?v=4', 'gravatar_id': '', 'url': 'https://api.github.com/users/suo', 'html_url': 'https://github.com/suo', 'followers_url': 'https://api.github.com/users/suo/followers', 'following_url': 'https://api.github.com/users/suo/following{/other_user}', 'gists_url': 'https://api.github.com/users/suo/gists{/gist_id}', 'starred_url': 'https://api.github.com/users/suo/starred{/owner}{/repo}', 'subscriptions_url': 'https://api.github.com/users/suo/subscriptions', 'organizations_url': 'https://api.github.com/users/suo/orgs', 'repos_url': 'https://api.github.com/users/suo/repos', 'events_url': 'https://api.github.com/users/suo/events{/privacy}', 'received_events_url': 'https://api.github.com/users/suo/received_events', 'type': 'User', 'site_admin': False}",referenced,5e7283af7a644ff25e494efd00a56820747fc569,https://api.github.com/repos/pytorch/pytorch/commits/5e7283af7a644ff25e494efd00a56820747fc569,2019-01-18T22:50:32Z,26,19,7
15669,2084701971,"{'login': 'soumith', 'id': 1310570, 'node_id': 'MDQ6VXNlcjEzMTA1NzA=', 'avatar_url': 'https://avatars0.githubusercontent.com/u/1310570?v=4', 'gravatar_id': '', 'url': 'https://api.github.com/users/soumith', 'html_url': 'https://github.com/soumith', 'followers_url': 'https://api.github.com/users/soumith/followers', 'following_url': 'https://api.github.com/users/soumith/following{/other_user}', 'gists_url': 'https://api.github.com/users/soumith/gists{/gist_id}', 'starred_url': 'https://api.github.com/users/soumith/starred{/owner}{/repo}', 'subscriptions_url': 'https://api.github.com/users/soumith/subscriptions', 'organizations_url': 'https://api.github.com/users/soumith/orgs', 'repos_url': 'https://api.github.com/users/soumith/repos', 'events_url': 'https://api.github.com/users/soumith/events{/privacy}', 'received_events_url': 'https://api.github.com/users/soumith/received_events', 'type': 'User', 'site_admin': False}",referenced,42b24eb52768148a219a27e4b88aab15d18a33b7,https://api.github.com/repos/pytorch/pytorch/commits/42b24eb52768148a219a27e4b88aab15d18a33b7,2019-01-19T21:28:35Z,26,19,7
15669,2102600496,"{'login': 'soumith', 'id': 1310570, 'node_id': 'MDQ6VXNlcjEzMTA1NzA=', 'avatar_url': 'https://avatars0.githubusercontent.com/u/1310570?v=4', 'gravatar_id': '', 'url': 'https://api.github.com/users/soumith', 'html_url': 'https://github.com/soumith', 'followers_url': 'https://api.github.com/users/soumith/followers', 'following_url': 'https://api.github.com/users/soumith/following{/other_user}', 'gists_url': 'https://api.github.com/users/soumith/gists{/gist_id}', 'starred_url': 'https://api.github.com/users/soumith/starred{/owner}{/repo}', 'subscriptions_url': 'https://api.github.com/users/soumith/subscriptions', 'organizations_url': 'https://api.github.com/users/soumith/orgs', 'repos_url': 'https://api.github.com/users/soumith/repos', 'events_url': 'https://api.github.com/users/soumith/events{/privacy}', 'received_events_url': 'https://api.github.com/users/soumith/received_events', 'type': 'User', 'site_admin': False}",referenced,c926cb4408da5d2f75499a7791f26feb6e26c743,https://api.github.com/repos/pytorch/pytorch/commits/c926cb4408da5d2f75499a7791f26feb6e26c743,2019-01-29T04:12:51Z,26,19,7
15661,2058735219,"{'login': 'facebook-github-bot', 'id': 6422482, 'node_id': 'MDQ6VXNlcjY0MjI0ODI=', 'avatar_url': 'https://avatars3.githubusercontent.com/u/6422482?v=4', 'gravatar_id': '', 'url': 'https://api.github.com/users/facebook-github-bot', 'html_url': 'https://github.com/facebook-github-bot', 'followers_url': 'https://api.github.com/users/facebook-github-bot/followers', 'following_url': 'https://api.github.com/users/facebook-github-bot/following{/other_user}', 'gists_url': 'https://api.github.com/users/facebook-github-bot/gists{/gist_id}', 'starred_url': 'https://api.github.com/users/facebook-github-bot/starred{/owner}{/repo}', 'subscriptions_url': 'https://api.github.com/users/facebook-github-bot/subscriptions', 'organizations_url': 'https://api.github.com/users/facebook-github-bot/orgs', 'repos_url': 'https://api.github.com/users/facebook-github-bot/repos', 'events_url': 'https://api.github.com/users/facebook-github-bot/events{/privacy}', 'received_events_url': 'https://api.github.com/users/facebook-github-bot/received_events', 'type': 'User', 'site_admin': False}",closed,76feb8c40fcfa49c6555ff7d89a0380406577c7a,https://api.github.com/repos/pytorch/pytorch/commits/76feb8c40fcfa49c6555ff7d89a0380406577c7a,2019-01-07T21:53:19Z,36,30,6
15647,2051640971,"{'login': 'facebook-github-bot', 'id': 6422482, 'node_id': 'MDQ6VXNlcjY0MjI0ODI=', 'avatar_url': 'https://avatars3.githubusercontent.com/u/6422482?v=4', 'gravatar_id': '', 'url': 'https://api.github.com/users/facebook-github-bot', 'html_url': 'https://github.com/facebook-github-bot', 'followers_url': 'https://api.github.com/users/facebook-github-bot/followers', 'following_url': 'https://api.github.com/users/facebook-github-bot/following{/other_user}', 'gists_url': 'https://api.github.com/users/facebook-github-bot/gists{/gist_id}', 'starred_url': 'https://api.github.com/users/facebook-github-bot/starred{/owner}{/repo}', 'subscriptions_url': 'https://api.github.com/users/facebook-github-bot/subscriptions', 'organizations_url': 'https://api.github.com/users/facebook-github-bot/orgs', 'repos_url': 'https://api.github.com/users/facebook-github-bot/repos', 'events_url': 'https://api.github.com/users/facebook-github-bot/events{/privacy}', 'received_events_url': 'https://api.github.com/users/facebook-github-bot/received_events', 'type': 'User', 'site_admin': False}",closed,e2549cbc0101fc4f376f3226b0002625a397da14,https://api.github.com/repos/pytorch/pytorch/commits/e2549cbc0101fc4f376f3226b0002625a397da14,2019-01-03T03:54:15Z,7,6,1
15642,2154212293,"{'login': 'facebook-github-bot', 'id': 6422482, 'node_id': 'MDQ6VXNlcjY0MjI0ODI=', 'avatar_url': 'https://avatars3.githubusercontent.com/u/6422482?v=4', 'gravatar_id': '', 'url': 'https://api.github.com/users/facebook-github-bot', 'html_url': 'https://github.com/facebook-github-bot', 'followers_url': 'https://api.github.com/users/facebook-github-bot/followers', 'following_url': 'https://api.github.com/users/facebook-github-bot/following{/other_user}', 'gists_url': 'https://api.github.com/users/facebook-github-bot/gists{/gist_id}', 'starred_url': 'https://api.github.com/users/facebook-github-bot/starred{/owner}{/repo}', 'subscriptions_url': 'https://api.github.com/users/facebook-github-bot/subscriptions', 'organizations_url': 'https://api.github.com/users/facebook-github-bot/orgs', 'repos_url': 'https://api.github.com/users/facebook-github-bot/repos', 'events_url': 'https://api.github.com/users/facebook-github-bot/events{/privacy}', 'received_events_url': 'https://api.github.com/users/facebook-github-bot/received_events', 'type': 'User', 'site_admin': False}",referenced,2c302b6ea68eb9024f5f1b9cdc41e3bf39556fa2,https://api.github.com/repos/pytorch/pytorch/commits/2c302b6ea68eb9024f5f1b9cdc41e3bf39556fa2,2019-02-21T08:20:25Z,22,22,0
15638,2082559417,"{'login': 'facebook-github-bot', 'id': 6422482, 'node_id': 'MDQ6VXNlcjY0MjI0ODI=', 'avatar_url': 'https://avatars3.githubusercontent.com/u/6422482?v=4', 'gravatar_id': '', 'url': 'https://api.github.com/users/facebook-github-bot', 'html_url': 'https://github.com/facebook-github-bot', 'followers_url': 'https://api.github.com/users/facebook-github-bot/followers', 'following_url': 'https://api.github.com/users/facebook-github-bot/following{/other_user}', 'gists_url': 'https://api.github.com/users/facebook-github-bot/gists{/gist_id}', 'starred_url': 'https://api.github.com/users/facebook-github-bot/starred{/owner}{/repo}', 'subscriptions_url': 'https://api.github.com/users/facebook-github-bot/subscriptions', 'organizations_url': 'https://api.github.com/users/facebook-github-bot/orgs', 'repos_url': 'https://api.github.com/users/facebook-github-bot/repos', 'events_url': 'https://api.github.com/users/facebook-github-bot/events{/privacy}', 'received_events_url': 'https://api.github.com/users/facebook-github-bot/received_events', 'type': 'User', 'site_admin': False}",closed,b4bc55beefda3a0724b0fb83c04b6bbd8dd46c77,https://api.github.com/repos/pytorch/pytorch/commits/b4bc55beefda3a0724b0fb83c04b6bbd8dd46c77,2019-01-18T10:31:03Z,151,101,50
15638,2084121324,"{'login': 'suo', 'id': 1617424, 'node_id': 'MDQ6VXNlcjE2MTc0MjQ=', 'avatar_url': 'https://avatars2.githubusercontent.com/u/1617424?v=4', 'gravatar_id': '', 'url': 'https://api.github.com/users/suo', 'html_url': 'https://github.com/suo', 'followers_url': 'https://api.github.com/users/suo/followers', 'following_url': 'https://api.github.com/users/suo/following{/other_user}', 'gists_url': 'https://api.github.com/users/suo/gists{/gist_id}', 'starred_url': 'https://api.github.com/users/suo/starred{/owner}{/repo}', 'subscriptions_url': 'https://api.github.com/users/suo/subscriptions', 'organizations_url': 'https://api.github.com/users/suo/orgs', 'repos_url': 'https://api.github.com/users/suo/repos', 'events_url': 'https://api.github.com/users/suo/events{/privacy}', 'received_events_url': 'https://api.github.com/users/suo/received_events', 'type': 'User', 'site_admin': False}",referenced,30c33f97d8e82bf7f54788e6d730d4f45283f724,https://api.github.com/repos/pytorch/pytorch/commits/30c33f97d8e82bf7f54788e6d730d4f45283f724,2019-01-18T22:50:33Z,151,101,50
15638,2084701973,"{'login': 'soumith', 'id': 1310570, 'node_id': 'MDQ6VXNlcjEzMTA1NzA=', 'avatar_url': 'https://avatars0.githubusercontent.com/u/1310570?v=4', 'gravatar_id': '', 'url': 'https://api.github.com/users/soumith', 'html_url': 'https://github.com/soumith', 'followers_url': 'https://api.github.com/users/soumith/followers', 'following_url': 'https://api.github.com/users/soumith/following{/other_user}', 'gists_url': 'https://api.github.com/users/soumith/gists{/gist_id}', 'starred_url': 'https://api.github.com/users/soumith/starred{/owner}{/repo}', 'subscriptions_url': 'https://api.github.com/users/soumith/subscriptions', 'organizations_url': 'https://api.github.com/users/soumith/orgs', 'repos_url': 'https://api.github.com/users/soumith/repos', 'events_url': 'https://api.github.com/users/soumith/events{/privacy}', 'received_events_url': 'https://api.github.com/users/soumith/received_events', 'type': 'User', 'site_admin': False}",referenced,44b4f6914042d101f87842d95708e6e1688604e4,https://api.github.com/repos/pytorch/pytorch/commits/44b4f6914042d101f87842d95708e6e1688604e4,2019-01-19T21:28:35Z,151,101,50
15638,2102600500,"{'login': 'soumith', 'id': 1310570, 'node_id': 'MDQ6VXNlcjEzMTA1NzA=', 'avatar_url': 'https://avatars0.githubusercontent.com/u/1310570?v=4', 'gravatar_id': '', 'url': 'https://api.github.com/users/soumith', 'html_url': 'https://github.com/soumith', 'followers_url': 'https://api.github.com/users/soumith/followers', 'following_url': 'https://api.github.com/users/soumith/following{/other_user}', 'gists_url': 'https://api.github.com/users/soumith/gists{/gist_id}', 'starred_url': 'https://api.github.com/users/soumith/starred{/owner}{/repo}', 'subscriptions_url': 'https://api.github.com/users/soumith/subscriptions', 'organizations_url': 'https://api.github.com/users/soumith/orgs', 'repos_url': 'https://api.github.com/users/soumith/repos', 'events_url': 'https://api.github.com/users/soumith/events{/privacy}', 'received_events_url': 'https://api.github.com/users/soumith/received_events', 'type': 'User', 'site_admin': False}",referenced,b65b55a652834b17bf2d33b20a7cb4027e8faeef,https://api.github.com/repos/pytorch/pytorch/commits/b65b55a652834b17bf2d33b20a7cb4027e8faeef,2019-01-29T04:12:51Z,151,101,50
15636,2053844022,"{'login': 'facebook-github-bot', 'id': 6422482, 'node_id': 'MDQ6VXNlcjY0MjI0ODI=', 'avatar_url': 'https://avatars3.githubusercontent.com/u/6422482?v=4', 'gravatar_id': '', 'url': 'https://api.github.com/users/facebook-github-bot', 'html_url': 'https://github.com/facebook-github-bot', 'followers_url': 'https://api.github.com/users/facebook-github-bot/followers', 'following_url': 'https://api.github.com/users/facebook-github-bot/following{/other_user}', 'gists_url': 'https://api.github.com/users/facebook-github-bot/gists{/gist_id}', 'starred_url': 'https://api.github.com/users/facebook-github-bot/starred{/owner}{/repo}', 'subscriptions_url': 'https://api.github.com/users/facebook-github-bot/subscriptions', 'organizations_url': 'https://api.github.com/users/facebook-github-bot/orgs', 'repos_url': 'https://api.github.com/users/facebook-github-bot/repos', 'events_url': 'https://api.github.com/users/facebook-github-bot/events{/privacy}', 'received_events_url': 'https://api.github.com/users/facebook-github-bot/received_events', 'type': 'User', 'site_admin': False}",referenced,2d8f14cd120a74d80de199f057a2d40e17b0dd96,https://api.github.com/repos/pytorch/pytorch/commits/2d8f14cd120a74d80de199f057a2d40e17b0dd96,2019-01-04T05:40:56Z,4,2,2
15618,2555302394,"{'login': 'facebook-github-bot', 'id': 6422482, 'node_id': 'MDQ6VXNlcjY0MjI0ODI=', 'avatar_url': 'https://avatars3.githubusercontent.com/u/6422482?v=4', 'gravatar_id': '', 'url': 'https://api.github.com/users/facebook-github-bot', 'html_url': 'https://github.com/facebook-github-bot', 'followers_url': 'https://api.github.com/users/facebook-github-bot/followers', 'following_url': 'https://api.github.com/users/facebook-github-bot/following{/other_user}', 'gists_url': 'https://api.github.com/users/facebook-github-bot/gists{/gist_id}', 'starred_url': 'https://api.github.com/users/facebook-github-bot/starred{/owner}{/repo}', 'subscriptions_url': 'https://api.github.com/users/facebook-github-bot/subscriptions', 'organizations_url': 'https://api.github.com/users/facebook-github-bot/orgs', 'repos_url': 'https://api.github.com/users/facebook-github-bot/repos', 'events_url': 'https://api.github.com/users/facebook-github-bot/events{/privacy}', 'received_events_url': 'https://api.github.com/users/facebook-github-bot/received_events', 'type': 'User', 'site_admin': False}",referenced,c771d50ca26048647e7bfeb70f597c33769030bc,https://api.github.com/repos/pytorch/pytorch/commits/c771d50ca26048647e7bfeb70f597c33769030bc,2019-08-14T03:36:06Z,3,1,2
15614,2048258581,"{'login': 'facebook-github-bot', 'id': 6422482, 'node_id': 'MDQ6VXNlcjY0MjI0ODI=', 'avatar_url': 'https://avatars3.githubusercontent.com/u/6422482?v=4', 'gravatar_id': '', 'url': 'https://api.github.com/users/facebook-github-bot', 'html_url': 'https://github.com/facebook-github-bot', 'followers_url': 'https://api.github.com/users/facebook-github-bot/followers', 'following_url': 'https://api.github.com/users/facebook-github-bot/following{/other_user}', 'gists_url': 'https://api.github.com/users/facebook-github-bot/gists{/gist_id}', 'starred_url': 'https://api.github.com/users/facebook-github-bot/starred{/owner}{/repo}', 'subscriptions_url': 'https://api.github.com/users/facebook-github-bot/subscriptions', 'organizations_url': 'https://api.github.com/users/facebook-github-bot/orgs', 'repos_url': 'https://api.github.com/users/facebook-github-bot/repos', 'events_url': 'https://api.github.com/users/facebook-github-bot/events{/privacy}', 'received_events_url': 'https://api.github.com/users/facebook-github-bot/received_events', 'type': 'User', 'site_admin': False}",closed,4047cdc6906c6e5c5e1fb837f7f479e0af149fa7,https://api.github.com/repos/pytorch/pytorch/commits/4047cdc6906c6e5c5e1fb837f7f479e0af149fa7,2018-12-30T00:13:17Z,10,10,0
15614,2082135413,"{'login': 'soumith', 'id': 1310570, 'node_id': 'MDQ6VXNlcjEzMTA1NzA=', 'avatar_url': 'https://avatars0.githubusercontent.com/u/1310570?v=4', 'gravatar_id': '', 'url': 'https://api.github.com/users/soumith', 'html_url': 'https://github.com/soumith', 'followers_url': 'https://api.github.com/users/soumith/followers', 'following_url': 'https://api.github.com/users/soumith/following{/other_user}', 'gists_url': 'https://api.github.com/users/soumith/gists{/gist_id}', 'starred_url': 'https://api.github.com/users/soumith/starred{/owner}{/repo}', 'subscriptions_url': 'https://api.github.com/users/soumith/subscriptions', 'organizations_url': 'https://api.github.com/users/soumith/orgs', 'repos_url': 'https://api.github.com/users/soumith/repos', 'events_url': 'https://api.github.com/users/soumith/events{/privacy}', 'received_events_url': 'https://api.github.com/users/soumith/received_events', 'type': 'User', 'site_admin': False}",referenced,f9af1daf123413460ebad76b5c91c1e85d1a7b5b,https://api.github.com/repos/pytorch/pytorch/commits/f9af1daf123413460ebad76b5c91c1e85d1a7b5b,2019-01-18T06:37:44Z,10,10,0
15614,2102600423,"{'login': 'soumith', 'id': 1310570, 'node_id': 'MDQ6VXNlcjEzMTA1NzA=', 'avatar_url': 'https://avatars0.githubusercontent.com/u/1310570?v=4', 'gravatar_id': '', 'url': 'https://api.github.com/users/soumith', 'html_url': 'https://github.com/soumith', 'followers_url': 'https://api.github.com/users/soumith/followers', 'following_url': 'https://api.github.com/users/soumith/following{/other_user}', 'gists_url': 'https://api.github.com/users/soumith/gists{/gist_id}', 'starred_url': 'https://api.github.com/users/soumith/starred{/owner}{/repo}', 'subscriptions_url': 'https://api.github.com/users/soumith/subscriptions', 'organizations_url': 'https://api.github.com/users/soumith/orgs', 'repos_url': 'https://api.github.com/users/soumith/repos', 'events_url': 'https://api.github.com/users/soumith/events{/privacy}', 'received_events_url': 'https://api.github.com/users/soumith/received_events', 'type': 'User', 'site_admin': False}",referenced,f80dba92aede4f8f424431de6d42947b93edcd47,https://api.github.com/repos/pytorch/pytorch/commits/f80dba92aede4f8f424431de6d42947b93edcd47,2019-01-29T04:12:50Z,10,10,0
15605,2099495033,"{'login': 'facebook-github-bot', 'id': 6422482, 'node_id': 'MDQ6VXNlcjY0MjI0ODI=', 'avatar_url': 'https://avatars3.githubusercontent.com/u/6422482?v=4', 'gravatar_id': '', 'url': 'https://api.github.com/users/facebook-github-bot', 'html_url': 'https://github.com/facebook-github-bot', 'followers_url': 'https://api.github.com/users/facebook-github-bot/followers', 'following_url': 'https://api.github.com/users/facebook-github-bot/following{/other_user}', 'gists_url': 'https://api.github.com/users/facebook-github-bot/gists{/gist_id}', 'starred_url': 'https://api.github.com/users/facebook-github-bot/starred{/owner}{/repo}', 'subscriptions_url': 'https://api.github.com/users/facebook-github-bot/subscriptions', 'organizations_url': 'https://api.github.com/users/facebook-github-bot/orgs', 'repos_url': 'https://api.github.com/users/facebook-github-bot/repos', 'events_url': 'https://api.github.com/users/facebook-github-bot/events{/privacy}', 'received_events_url': 'https://api.github.com/users/facebook-github-bot/received_events', 'type': 'User', 'site_admin': False}",referenced,c863a759a0caa13f10f639b66de43e0b3b0f9dd4,https://api.github.com/repos/pytorch/pytorch/commits/c863a759a0caa13f10f639b66de43e0b3b0f9dd4,2019-01-27T20:12:57Z,30,25,5
15604,2066959375,"{'login': 'facebook-github-bot', 'id': 6422482, 'node_id': 'MDQ6VXNlcjY0MjI0ODI=', 'avatar_url': 'https://avatars3.githubusercontent.com/u/6422482?v=4', 'gravatar_id': '', 'url': 'https://api.github.com/users/facebook-github-bot', 'html_url': 'https://github.com/facebook-github-bot', 'followers_url': 'https://api.github.com/users/facebook-github-bot/followers', 'following_url': 'https://api.github.com/users/facebook-github-bot/following{/other_user}', 'gists_url': 'https://api.github.com/users/facebook-github-bot/gists{/gist_id}', 'starred_url': 'https://api.github.com/users/facebook-github-bot/starred{/owner}{/repo}', 'subscriptions_url': 'https://api.github.com/users/facebook-github-bot/subscriptions', 'organizations_url': 'https://api.github.com/users/facebook-github-bot/orgs', 'repos_url': 'https://api.github.com/users/facebook-github-bot/repos', 'events_url': 'https://api.github.com/users/facebook-github-bot/events{/privacy}', 'received_events_url': 'https://api.github.com/users/facebook-github-bot/received_events', 'type': 'User', 'site_admin': False}",referenced,9173cd5a4d31abd8cf42fcae0341db8287a69074,https://api.github.com/repos/pytorch/pytorch/commits/9173cd5a4d31abd8cf42fcae0341db8287a69074,2019-01-10T20:54:27Z,24,19,5
15604,2084121329,"{'login': 'suo', 'id': 1617424, 'node_id': 'MDQ6VXNlcjE2MTc0MjQ=', 'avatar_url': 'https://avatars2.githubusercontent.com/u/1617424?v=4', 'gravatar_id': '', 'url': 'https://api.github.com/users/suo', 'html_url': 'https://github.com/suo', 'followers_url': 'https://api.github.com/users/suo/followers', 'following_url': 'https://api.github.com/users/suo/following{/other_user}', 'gists_url': 'https://api.github.com/users/suo/gists{/gist_id}', 'starred_url': 'https://api.github.com/users/suo/starred{/owner}{/repo}', 'subscriptions_url': 'https://api.github.com/users/suo/subscriptions', 'organizations_url': 'https://api.github.com/users/suo/orgs', 'repos_url': 'https://api.github.com/users/suo/repos', 'events_url': 'https://api.github.com/users/suo/events{/privacy}', 'received_events_url': 'https://api.github.com/users/suo/received_events', 'type': 'User', 'site_admin': False}",referenced,9d793e468b672b7feda355ab96be1ffcd1acf711,https://api.github.com/repos/pytorch/pytorch/commits/9d793e468b672b7feda355ab96be1ffcd1acf711,2019-01-18T22:50:33Z,41,28,13
15604,2084701975,"{'login': 'soumith', 'id': 1310570, 'node_id': 'MDQ6VXNlcjEzMTA1NzA=', 'avatar_url': 'https://avatars0.githubusercontent.com/u/1310570?v=4', 'gravatar_id': '', 'url': 'https://api.github.com/users/soumith', 'html_url': 'https://github.com/soumith', 'followers_url': 'https://api.github.com/users/soumith/followers', 'following_url': 'https://api.github.com/users/soumith/following{/other_user}', 'gists_url': 'https://api.github.com/users/soumith/gists{/gist_id}', 'starred_url': 'https://api.github.com/users/soumith/starred{/owner}{/repo}', 'subscriptions_url': 'https://api.github.com/users/soumith/subscriptions', 'organizations_url': 'https://api.github.com/users/soumith/orgs', 'repos_url': 'https://api.github.com/users/soumith/repos', 'events_url': 'https://api.github.com/users/soumith/events{/privacy}', 'received_events_url': 'https://api.github.com/users/soumith/received_events', 'type': 'User', 'site_admin': False}",referenced,91266c6fcb7badbf07bbcdef63bc63da02994699,https://api.github.com/repos/pytorch/pytorch/commits/91266c6fcb7badbf07bbcdef63bc63da02994699,2019-01-19T21:28:35Z,41,28,13
15604,2102600504,"{'login': 'soumith', 'id': 1310570, 'node_id': 'MDQ6VXNlcjEzMTA1NzA=', 'avatar_url': 'https://avatars0.githubusercontent.com/u/1310570?v=4', 'gravatar_id': '', 'url': 'https://api.github.com/users/soumith', 'html_url': 'https://github.com/soumith', 'followers_url': 'https://api.github.com/users/soumith/followers', 'following_url': 'https://api.github.com/users/soumith/following{/other_user}', 'gists_url': 'https://api.github.com/users/soumith/gists{/gist_id}', 'starred_url': 'https://api.github.com/users/soumith/starred{/owner}{/repo}', 'subscriptions_url': 'https://api.github.com/users/soumith/subscriptions', 'organizations_url': 'https://api.github.com/users/soumith/orgs', 'repos_url': 'https://api.github.com/users/soumith/repos', 'events_url': 'https://api.github.com/users/soumith/events{/privacy}', 'received_events_url': 'https://api.github.com/users/soumith/received_events', 'type': 'User', 'site_admin': False}",referenced,231f1a499191e4961885aad2ddf2f9915968584e,https://api.github.com/repos/pytorch/pytorch/commits/231f1a499191e4961885aad2ddf2f9915968584e,2019-01-29T04:12:52Z,41,28,13
15602,2069598119,"{'login': 'facebook-github-bot', 'id': 6422482, 'node_id': 'MDQ6VXNlcjY0MjI0ODI=', 'avatar_url': 'https://avatars3.githubusercontent.com/u/6422482?v=4', 'gravatar_id': '', 'url': 'https://api.github.com/users/facebook-github-bot', 'html_url': 'https://github.com/facebook-github-bot', 'followers_url': 'https://api.github.com/users/facebook-github-bot/followers', 'following_url': 'https://api.github.com/users/facebook-github-bot/following{/other_user}', 'gists_url': 'https://api.github.com/users/facebook-github-bot/gists{/gist_id}', 'starred_url': 'https://api.github.com/users/facebook-github-bot/starred{/owner}{/repo}', 'subscriptions_url': 'https://api.github.com/users/facebook-github-bot/subscriptions', 'organizations_url': 'https://api.github.com/users/facebook-github-bot/orgs', 'repos_url': 'https://api.github.com/users/facebook-github-bot/repos', 'events_url': 'https://api.github.com/users/facebook-github-bot/events{/privacy}', 'received_events_url': 'https://api.github.com/users/facebook-github-bot/received_events', 'type': 'User', 'site_admin': False}",referenced,d33159a4261fed36e147cc2351aff0741f0fa715,https://api.github.com/repos/pytorch/pytorch/commits/d33159a4261fed36e147cc2351aff0741f0fa715,2019-01-11T21:33:56Z,234,40,194
15602,2081563648,"{'login': 'soumith', 'id': 1310570, 'node_id': 'MDQ6VXNlcjEzMTA1NzA=', 'avatar_url': 'https://avatars0.githubusercontent.com/u/1310570?v=4', 'gravatar_id': '', 'url': 'https://api.github.com/users/soumith', 'html_url': 'https://github.com/soumith', 'followers_url': 'https://api.github.com/users/soumith/followers', 'following_url': 'https://api.github.com/users/soumith/following{/other_user}', 'gists_url': 'https://api.github.com/users/soumith/gists{/gist_id}', 'starred_url': 'https://api.github.com/users/soumith/starred{/owner}{/repo}', 'subscriptions_url': 'https://api.github.com/users/soumith/subscriptions', 'organizations_url': 'https://api.github.com/users/soumith/orgs', 'repos_url': 'https://api.github.com/users/soumith/repos', 'events_url': 'https://api.github.com/users/soumith/events{/privacy}', 'received_events_url': 'https://api.github.com/users/soumith/received_events', 'type': 'User', 'site_admin': False}",referenced,bd51538b147fb5da98f7c6a72ecfa5468acadad7,https://api.github.com/repos/pytorch/pytorch/commits/bd51538b147fb5da98f7c6a72ecfa5468acadad7,2019-01-17T22:31:55Z,234,40,194
15602,2081981258,"{'login': 'soumith', 'id': 1310570, 'node_id': 'MDQ6VXNlcjEzMTA1NzA=', 'avatar_url': 'https://avatars0.githubusercontent.com/u/1310570?v=4', 'gravatar_id': '', 'url': 'https://api.github.com/users/soumith', 'html_url': 'https://github.com/soumith', 'followers_url': 'https://api.github.com/users/soumith/followers', 'following_url': 'https://api.github.com/users/soumith/following{/other_user}', 'gists_url': 'https://api.github.com/users/soumith/gists{/gist_id}', 'starred_url': 'https://api.github.com/users/soumith/starred{/owner}{/repo}', 'subscriptions_url': 'https://api.github.com/users/soumith/subscriptions', 'organizations_url': 'https://api.github.com/users/soumith/orgs', 'repos_url': 'https://api.github.com/users/soumith/repos', 'events_url': 'https://api.github.com/users/soumith/events{/privacy}', 'received_events_url': 'https://api.github.com/users/soumith/received_events', 'type': 'User', 'site_admin': False}",referenced,4e5b994ca7050ab3a4d644a2fd2e1ffa2b57f6af,https://api.github.com/repos/pytorch/pytorch/commits/4e5b994ca7050ab3a4d644a2fd2e1ffa2b57f6af,2019-01-18T04:02:12Z,234,40,194
15597,2071088934,"{'login': 'facebook-github-bot', 'id': 6422482, 'node_id': 'MDQ6VXNlcjY0MjI0ODI=', 'avatar_url': 'https://avatars3.githubusercontent.com/u/6422482?v=4', 'gravatar_id': '', 'url': 'https://api.github.com/users/facebook-github-bot', 'html_url': 'https://github.com/facebook-github-bot', 'followers_url': 'https://api.github.com/users/facebook-github-bot/followers', 'following_url': 'https://api.github.com/users/facebook-github-bot/following{/other_user}', 'gists_url': 'https://api.github.com/users/facebook-github-bot/gists{/gist_id}', 'starred_url': 'https://api.github.com/users/facebook-github-bot/starred{/owner}{/repo}', 'subscriptions_url': 'https://api.github.com/users/facebook-github-bot/subscriptions', 'organizations_url': 'https://api.github.com/users/facebook-github-bot/orgs', 'repos_url': 'https://api.github.com/users/facebook-github-bot/repos', 'events_url': 'https://api.github.com/users/facebook-github-bot/events{/privacy}', 'received_events_url': 'https://api.github.com/users/facebook-github-bot/received_events', 'type': 'User', 'site_admin': False}",closed,492b7d410b03fef9b0438f64fb5d4383402b973e,https://api.github.com/repos/pytorch/pytorch/commits/492b7d410b03fef9b0438f64fb5d4383402b973e,2019-01-14T07:40:00Z,10,5,5
15570,2047755215,"{'login': 'facebook-github-bot', 'id': 6422482, 'node_id': 'MDQ6VXNlcjY0MjI0ODI=', 'avatar_url': 'https://avatars3.githubusercontent.com/u/6422482?v=4', 'gravatar_id': '', 'url': 'https://api.github.com/users/facebook-github-bot', 'html_url': 'https://github.com/facebook-github-bot', 'followers_url': 'https://api.github.com/users/facebook-github-bot/followers', 'following_url': 'https://api.github.com/users/facebook-github-bot/following{/other_user}', 'gists_url': 'https://api.github.com/users/facebook-github-bot/gists{/gist_id}', 'starred_url': 'https://api.github.com/users/facebook-github-bot/starred{/owner}{/repo}', 'subscriptions_url': 'https://api.github.com/users/facebook-github-bot/subscriptions', 'organizations_url': 'https://api.github.com/users/facebook-github-bot/orgs', 'repos_url': 'https://api.github.com/users/facebook-github-bot/repos', 'events_url': 'https://api.github.com/users/facebook-github-bot/events{/privacy}', 'received_events_url': 'https://api.github.com/users/facebook-github-bot/received_events', 'type': 'User', 'site_admin': False}",closed,692898fe379c9092f5e380797c32305145cd06e1,https://api.github.com/repos/pytorch/pytorch/commits/692898fe379c9092f5e380797c32305145cd06e1,2018-12-28T21:55:53Z,20,20,0
15570,2084121318,"{'login': 'suo', 'id': 1617424, 'node_id': 'MDQ6VXNlcjE2MTc0MjQ=', 'avatar_url': 'https://avatars2.githubusercontent.com/u/1617424?v=4', 'gravatar_id': '', 'url': 'https://api.github.com/users/suo', 'html_url': 'https://github.com/suo', 'followers_url': 'https://api.github.com/users/suo/followers', 'following_url': 'https://api.github.com/users/suo/following{/other_user}', 'gists_url': 'https://api.github.com/users/suo/gists{/gist_id}', 'starred_url': 'https://api.github.com/users/suo/starred{/owner}{/repo}', 'subscriptions_url': 'https://api.github.com/users/suo/subscriptions', 'organizations_url': 'https://api.github.com/users/suo/orgs', 'repos_url': 'https://api.github.com/users/suo/repos', 'events_url': 'https://api.github.com/users/suo/events{/privacy}', 'received_events_url': 'https://api.github.com/users/suo/received_events', 'type': 'User', 'site_admin': False}",referenced,df96bf490e662ed9b2fd4df73bd90eee81ce4a37,https://api.github.com/repos/pytorch/pytorch/commits/df96bf490e662ed9b2fd4df73bd90eee81ce4a37,2019-01-18T22:50:32Z,20,20,0
15570,2084701969,"{'login': 'soumith', 'id': 1310570, 'node_id': 'MDQ6VXNlcjEzMTA1NzA=', 'avatar_url': 'https://avatars0.githubusercontent.com/u/1310570?v=4', 'gravatar_id': '', 'url': 'https://api.github.com/users/soumith', 'html_url': 'https://github.com/soumith', 'followers_url': 'https://api.github.com/users/soumith/followers', 'following_url': 'https://api.github.com/users/soumith/following{/other_user}', 'gists_url': 'https://api.github.com/users/soumith/gists{/gist_id}', 'starred_url': 'https://api.github.com/users/soumith/starred{/owner}{/repo}', 'subscriptions_url': 'https://api.github.com/users/soumith/subscriptions', 'organizations_url': 'https://api.github.com/users/soumith/orgs', 'repos_url': 'https://api.github.com/users/soumith/repos', 'events_url': 'https://api.github.com/users/soumith/events{/privacy}', 'received_events_url': 'https://api.github.com/users/soumith/received_events', 'type': 'User', 'site_admin': False}",referenced,c536841487627a772df34d8844d0e20000983903,https://api.github.com/repos/pytorch/pytorch/commits/c536841487627a772df34d8844d0e20000983903,2019-01-19T21:28:35Z,20,20,0
15570,2102600490,"{'login': 'soumith', 'id': 1310570, 'node_id': 'MDQ6VXNlcjEzMTA1NzA=', 'avatar_url': 'https://avatars0.githubusercontent.com/u/1310570?v=4', 'gravatar_id': '', 'url': 'https://api.github.com/users/soumith', 'html_url': 'https://github.com/soumith', 'followers_url': 'https://api.github.com/users/soumith/followers', 'following_url': 'https://api.github.com/users/soumith/following{/other_user}', 'gists_url': 'https://api.github.com/users/soumith/gists{/gist_id}', 'starred_url': 'https://api.github.com/users/soumith/starred{/owner}{/repo}', 'subscriptions_url': 'https://api.github.com/users/soumith/subscriptions', 'organizations_url': 'https://api.github.com/users/soumith/orgs', 'repos_url': 'https://api.github.com/users/soumith/repos', 'events_url': 'https://api.github.com/users/soumith/events{/privacy}', 'received_events_url': 'https://api.github.com/users/soumith/received_events', 'type': 'User', 'site_admin': False}",referenced,a6f4538f31d2a74f4ea51e849f449703eefb0397,https://api.github.com/repos/pytorch/pytorch/commits/a6f4538f31d2a74f4ea51e849f449703eefb0397,2019-01-29T04:12:51Z,20,20,0
15567,2083289145,"{'login': 'facebook-github-bot', 'id': 6422482, 'node_id': 'MDQ6VXNlcjY0MjI0ODI=', 'avatar_url': 'https://avatars3.githubusercontent.com/u/6422482?v=4', 'gravatar_id': '', 'url': 'https://api.github.com/users/facebook-github-bot', 'html_url': 'https://github.com/facebook-github-bot', 'followers_url': 'https://api.github.com/users/facebook-github-bot/followers', 'following_url': 'https://api.github.com/users/facebook-github-bot/following{/other_user}', 'gists_url': 'https://api.github.com/users/facebook-github-bot/gists{/gist_id}', 'starred_url': 'https://api.github.com/users/facebook-github-bot/starred{/owner}{/repo}', 'subscriptions_url': 'https://api.github.com/users/facebook-github-bot/subscriptions', 'organizations_url': 'https://api.github.com/users/facebook-github-bot/orgs', 'repos_url': 'https://api.github.com/users/facebook-github-bot/repos', 'events_url': 'https://api.github.com/users/facebook-github-bot/events{/privacy}', 'received_events_url': 'https://api.github.com/users/facebook-github-bot/received_events', 'type': 'User', 'site_admin': False}",closed,ed0a761c824d5e325e39afe954f92cc14c3c88c1,https://api.github.com/repos/pytorch/pytorch/commits/ed0a761c824d5e325e39afe954f92cc14c3c88c1,2019-01-18T16:00:52Z,17,15,2
15565,2073380596,"{'login': 'facebook-github-bot', 'id': 6422482, 'node_id': 'MDQ6VXNlcjY0MjI0ODI=', 'avatar_url': 'https://avatars3.githubusercontent.com/u/6422482?v=4', 'gravatar_id': '', 'url': 'https://api.github.com/users/facebook-github-bot', 'html_url': 'https://github.com/facebook-github-bot', 'followers_url': 'https://api.github.com/users/facebook-github-bot/followers', 'following_url': 'https://api.github.com/users/facebook-github-bot/following{/other_user}', 'gists_url': 'https://api.github.com/users/facebook-github-bot/gists{/gist_id}', 'starred_url': 'https://api.github.com/users/facebook-github-bot/starred{/owner}{/repo}', 'subscriptions_url': 'https://api.github.com/users/facebook-github-bot/subscriptions', 'organizations_url': 'https://api.github.com/users/facebook-github-bot/orgs', 'repos_url': 'https://api.github.com/users/facebook-github-bot/repos', 'events_url': 'https://api.github.com/users/facebook-github-bot/events{/privacy}', 'received_events_url': 'https://api.github.com/users/facebook-github-bot/received_events', 'type': 'User', 'site_admin': False}",closed,ddece5a7936d04282eea3a3fb4b42d29ce899dd2,https://api.github.com/repos/pytorch/pytorch/commits/ddece5a7936d04282eea3a3fb4b42d29ce899dd2,2019-01-15T01:09:39Z,2,1,1
15537,2071057987,"{'login': 'facebook-github-bot', 'id': 6422482, 'node_id': 'MDQ6VXNlcjY0MjI0ODI=', 'avatar_url': 'https://avatars3.githubusercontent.com/u/6422482?v=4', 'gravatar_id': '', 'url': 'https://api.github.com/users/facebook-github-bot', 'html_url': 'https://github.com/facebook-github-bot', 'followers_url': 'https://api.github.com/users/facebook-github-bot/followers', 'following_url': 'https://api.github.com/users/facebook-github-bot/following{/other_user}', 'gists_url': 'https://api.github.com/users/facebook-github-bot/gists{/gist_id}', 'starred_url': 'https://api.github.com/users/facebook-github-bot/starred{/owner}{/repo}', 'subscriptions_url': 'https://api.github.com/users/facebook-github-bot/subscriptions', 'organizations_url': 'https://api.github.com/users/facebook-github-bot/orgs', 'repos_url': 'https://api.github.com/users/facebook-github-bot/repos', 'events_url': 'https://api.github.com/users/facebook-github-bot/events{/privacy}', 'received_events_url': 'https://api.github.com/users/facebook-github-bot/received_events', 'type': 'User', 'site_admin': False}",referenced,a7415787ace8090c5f480a4fb6233437a3f4327e,https://api.github.com/repos/pytorch/pytorch/commits/a7415787ace8090c5f480a4fb6233437a3f4327e,2019-01-14T07:11:20Z,43,37,6
15530,2065021560,"{'login': 'facebook-github-bot', 'id': 6422482, 'node_id': 'MDQ6VXNlcjY0MjI0ODI=', 'avatar_url': 'https://avatars3.githubusercontent.com/u/6422482?v=4', 'gravatar_id': '', 'url': 'https://api.github.com/users/facebook-github-bot', 'html_url': 'https://github.com/facebook-github-bot', 'followers_url': 'https://api.github.com/users/facebook-github-bot/followers', 'following_url': 'https://api.github.com/users/facebook-github-bot/following{/other_user}', 'gists_url': 'https://api.github.com/users/facebook-github-bot/gists{/gist_id}', 'starred_url': 'https://api.github.com/users/facebook-github-bot/starred{/owner}{/repo}', 'subscriptions_url': 'https://api.github.com/users/facebook-github-bot/subscriptions', 'organizations_url': 'https://api.github.com/users/facebook-github-bot/orgs', 'repos_url': 'https://api.github.com/users/facebook-github-bot/repos', 'events_url': 'https://api.github.com/users/facebook-github-bot/events{/privacy}', 'received_events_url': 'https://api.github.com/users/facebook-github-bot/received_events', 'type': 'User', 'site_admin': False}",closed,cdaeb0db545d50ee98d5dd1186ae258cbc744a86,https://api.github.com/repos/pytorch/pytorch/commits/cdaeb0db545d50ee98d5dd1186ae258cbc744a86,2019-01-10T06:23:02Z,6,3,3
15519,2045291398,"{'login': 'facebook-github-bot', 'id': 6422482, 'node_id': 'MDQ6VXNlcjY0MjI0ODI=', 'avatar_url': 'https://avatars3.githubusercontent.com/u/6422482?v=4', 'gravatar_id': '', 'url': 'https://api.github.com/users/facebook-github-bot', 'html_url': 'https://github.com/facebook-github-bot', 'followers_url': 'https://api.github.com/users/facebook-github-bot/followers', 'following_url': 'https://api.github.com/users/facebook-github-bot/following{/other_user}', 'gists_url': 'https://api.github.com/users/facebook-github-bot/gists{/gist_id}', 'starred_url': 'https://api.github.com/users/facebook-github-bot/starred{/owner}{/repo}', 'subscriptions_url': 'https://api.github.com/users/facebook-github-bot/subscriptions', 'organizations_url': 'https://api.github.com/users/facebook-github-bot/orgs', 'repos_url': 'https://api.github.com/users/facebook-github-bot/repos', 'events_url': 'https://api.github.com/users/facebook-github-bot/events{/privacy}', 'received_events_url': 'https://api.github.com/users/facebook-github-bot/received_events', 'type': 'User', 'site_admin': False}",closed,4d029bba7fdef1d7935c3eaf88eda819f9191470,https://api.github.com/repos/pytorch/pytorch/commits/4d029bba7fdef1d7935c3eaf88eda819f9191470,2018-12-27T03:49:58Z,14,9,5
15519,2081539302,"{'login': 'soumith', 'id': 1310570, 'node_id': 'MDQ6VXNlcjEzMTA1NzA=', 'avatar_url': 'https://avatars0.githubusercontent.com/u/1310570?v=4', 'gravatar_id': '', 'url': 'https://api.github.com/users/soumith', 'html_url': 'https://github.com/soumith', 'followers_url': 'https://api.github.com/users/soumith/followers', 'following_url': 'https://api.github.com/users/soumith/following{/other_user}', 'gists_url': 'https://api.github.com/users/soumith/gists{/gist_id}', 'starred_url': 'https://api.github.com/users/soumith/starred{/owner}{/repo}', 'subscriptions_url': 'https://api.github.com/users/soumith/subscriptions', 'organizations_url': 'https://api.github.com/users/soumith/orgs', 'repos_url': 'https://api.github.com/users/soumith/repos', 'events_url': 'https://api.github.com/users/soumith/events{/privacy}', 'received_events_url': 'https://api.github.com/users/soumith/received_events', 'type': 'User', 'site_admin': False}",referenced,198e5ae637691505a52e240905fd4222df91c6e5,https://api.github.com/repos/pytorch/pytorch/commits/198e5ae637691505a52e240905fd4222df91c6e5,2019-01-17T22:19:17Z,14,9,5
15519,2081981232,"{'login': 'soumith', 'id': 1310570, 'node_id': 'MDQ6VXNlcjEzMTA1NzA=', 'avatar_url': 'https://avatars0.githubusercontent.com/u/1310570?v=4', 'gravatar_id': '', 'url': 'https://api.github.com/users/soumith', 'html_url': 'https://github.com/soumith', 'followers_url': 'https://api.github.com/users/soumith/followers', 'following_url': 'https://api.github.com/users/soumith/following{/other_user}', 'gists_url': 'https://api.github.com/users/soumith/gists{/gist_id}', 'starred_url': 'https://api.github.com/users/soumith/starred{/owner}{/repo}', 'subscriptions_url': 'https://api.github.com/users/soumith/subscriptions', 'organizations_url': 'https://api.github.com/users/soumith/orgs', 'repos_url': 'https://api.github.com/users/soumith/repos', 'events_url': 'https://api.github.com/users/soumith/events{/privacy}', 'received_events_url': 'https://api.github.com/users/soumith/received_events', 'type': 'User', 'site_admin': False}",referenced,a4e2d27ddbe7bd90c0e0d4d2608067076afc4de2,https://api.github.com/repos/pytorch/pytorch/commits/a4e2d27ddbe7bd90c0e0d4d2608067076afc4de2,2019-01-18T04:02:12Z,14,9,5
15511,2081075454,"{'login': 'facebook-github-bot', 'id': 6422482, 'node_id': 'MDQ6VXNlcjY0MjI0ODI=', 'avatar_url': 'https://avatars3.githubusercontent.com/u/6422482?v=4', 'gravatar_id': '', 'url': 'https://api.github.com/users/facebook-github-bot', 'html_url': 'https://github.com/facebook-github-bot', 'followers_url': 'https://api.github.com/users/facebook-github-bot/followers', 'following_url': 'https://api.github.com/users/facebook-github-bot/following{/other_user}', 'gists_url': 'https://api.github.com/users/facebook-github-bot/gists{/gist_id}', 'starred_url': 'https://api.github.com/users/facebook-github-bot/starred{/owner}{/repo}', 'subscriptions_url': 'https://api.github.com/users/facebook-github-bot/subscriptions', 'organizations_url': 'https://api.github.com/users/facebook-github-bot/orgs', 'repos_url': 'https://api.github.com/users/facebook-github-bot/repos', 'events_url': 'https://api.github.com/users/facebook-github-bot/events{/privacy}', 'received_events_url': 'https://api.github.com/users/facebook-github-bot/received_events', 'type': 'User', 'site_admin': False}",referenced,595f767880244979da6dcf22f6f032865ecb1718,https://api.github.com/repos/pytorch/pytorch/commits/595f767880244979da6dcf22f6f032865ecb1718,2019-01-17T18:46:13Z,323,153,170
15508,2182510396,"{'login': 'facebook-github-bot', 'id': 6422482, 'node_id': 'MDQ6VXNlcjY0MjI0ODI=', 'avatar_url': 'https://avatars3.githubusercontent.com/u/6422482?v=4', 'gravatar_id': '', 'url': 'https://api.github.com/users/facebook-github-bot', 'html_url': 'https://github.com/facebook-github-bot', 'followers_url': 'https://api.github.com/users/facebook-github-bot/followers', 'following_url': 'https://api.github.com/users/facebook-github-bot/following{/other_user}', 'gists_url': 'https://api.github.com/users/facebook-github-bot/gists{/gist_id}', 'starred_url': 'https://api.github.com/users/facebook-github-bot/starred{/owner}{/repo}', 'subscriptions_url': 'https://api.github.com/users/facebook-github-bot/subscriptions', 'organizations_url': 'https://api.github.com/users/facebook-github-bot/orgs', 'repos_url': 'https://api.github.com/users/facebook-github-bot/repos', 'events_url': 'https://api.github.com/users/facebook-github-bot/events{/privacy}', 'received_events_url': 'https://api.github.com/users/facebook-github-bot/received_events', 'type': 'User', 'site_admin': False}",closed,a478d416203b0e3934e2b1aaa6e05d838be748e7,https://api.github.com/repos/pytorch/pytorch/commits/a478d416203b0e3934e2b1aaa6e05d838be748e7,2019-03-05T22:37:20Z,16,11,5
15505,2046563138,"{'login': 'facebook-github-bot', 'id': 6422482, 'node_id': 'MDQ6VXNlcjY0MjI0ODI=', 'avatar_url': 'https://avatars3.githubusercontent.com/u/6422482?v=4', 'gravatar_id': '', 'url': 'https://api.github.com/users/facebook-github-bot', 'html_url': 'https://github.com/facebook-github-bot', 'followers_url': 'https://api.github.com/users/facebook-github-bot/followers', 'following_url': 'https://api.github.com/users/facebook-github-bot/following{/other_user}', 'gists_url': 'https://api.github.com/users/facebook-github-bot/gists{/gist_id}', 'starred_url': 'https://api.github.com/users/facebook-github-bot/starred{/owner}{/repo}', 'subscriptions_url': 'https://api.github.com/users/facebook-github-bot/subscriptions', 'organizations_url': 'https://api.github.com/users/facebook-github-bot/orgs', 'repos_url': 'https://api.github.com/users/facebook-github-bot/repos', 'events_url': 'https://api.github.com/users/facebook-github-bot/events{/privacy}', 'received_events_url': 'https://api.github.com/users/facebook-github-bot/received_events', 'type': 'User', 'site_admin': False}",closed,0fff5b361215168ddc1335bb9e6be580f0922279,https://api.github.com/repos/pytorch/pytorch/commits/0fff5b361215168ddc1335bb9e6be580f0922279,2018-12-27T23:47:20Z,47,47,0
15497,2044182740,"{'login': 'facebook-github-bot', 'id': 6422482, 'node_id': 'MDQ6VXNlcjY0MjI0ODI=', 'avatar_url': 'https://avatars3.githubusercontent.com/u/6422482?v=4', 'gravatar_id': '', 'url': 'https://api.github.com/users/facebook-github-bot', 'html_url': 'https://github.com/facebook-github-bot', 'followers_url': 'https://api.github.com/users/facebook-github-bot/followers', 'following_url': 'https://api.github.com/users/facebook-github-bot/following{/other_user}', 'gists_url': 'https://api.github.com/users/facebook-github-bot/gists{/gist_id}', 'starred_url': 'https://api.github.com/users/facebook-github-bot/starred{/owner}{/repo}', 'subscriptions_url': 'https://api.github.com/users/facebook-github-bot/subscriptions', 'organizations_url': 'https://api.github.com/users/facebook-github-bot/orgs', 'repos_url': 'https://api.github.com/users/facebook-github-bot/repos', 'events_url': 'https://api.github.com/users/facebook-github-bot/events{/privacy}', 'received_events_url': 'https://api.github.com/users/facebook-github-bot/received_events', 'type': 'User', 'site_admin': False}",closed,2ed95c58713b45a6a9dac4336135523555bc58a9,https://api.github.com/repos/pytorch/pytorch/commits/2ed95c58713b45a6a9dac4336135523555bc58a9,2018-12-26T05:51:34Z,11,11,0
15478,2073267885,"{'login': 'facebook-github-bot', 'id': 6422482, 'node_id': 'MDQ6VXNlcjY0MjI0ODI=', 'avatar_url': 'https://avatars3.githubusercontent.com/u/6422482?v=4', 'gravatar_id': '', 'url': 'https://api.github.com/users/facebook-github-bot', 'html_url': 'https://github.com/facebook-github-bot', 'followers_url': 'https://api.github.com/users/facebook-github-bot/followers', 'following_url': 'https://api.github.com/users/facebook-github-bot/following{/other_user}', 'gists_url': 'https://api.github.com/users/facebook-github-bot/gists{/gist_id}', 'starred_url': 'https://api.github.com/users/facebook-github-bot/starred{/owner}{/repo}', 'subscriptions_url': 'https://api.github.com/users/facebook-github-bot/subscriptions', 'organizations_url': 'https://api.github.com/users/facebook-github-bot/orgs', 'repos_url': 'https://api.github.com/users/facebook-github-bot/repos', 'events_url': 'https://api.github.com/users/facebook-github-bot/events{/privacy}', 'received_events_url': 'https://api.github.com/users/facebook-github-bot/received_events', 'type': 'User', 'site_admin': False}",referenced,4fb39318963fd6ac64d4fc312d850004858641da,https://api.github.com/repos/pytorch/pytorch/commits/4fb39318963fd6ac64d4fc312d850004858641da,2019-01-14T23:50:52Z,128,128,0
15476,2718282451,"{'login': 'facebook-github-bot', 'id': 6422482, 'node_id': 'MDQ6VXNlcjY0MjI0ODI=', 'avatar_url': 'https://avatars3.githubusercontent.com/u/6422482?v=4', 'gravatar_id': '', 'url': 'https://api.github.com/users/facebook-github-bot', 'html_url': 'https://github.com/facebook-github-bot', 'followers_url': 'https://api.github.com/users/facebook-github-bot/followers', 'following_url': 'https://api.github.com/users/facebook-github-bot/following{/other_user}', 'gists_url': 'https://api.github.com/users/facebook-github-bot/gists{/gist_id}', 'starred_url': 'https://api.github.com/users/facebook-github-bot/starred{/owner}{/repo}', 'subscriptions_url': 'https://api.github.com/users/facebook-github-bot/subscriptions', 'organizations_url': 'https://api.github.com/users/facebook-github-bot/orgs', 'repos_url': 'https://api.github.com/users/facebook-github-bot/repos', 'events_url': 'https://api.github.com/users/facebook-github-bot/events{/privacy}', 'received_events_url': 'https://api.github.com/users/facebook-github-bot/received_events', 'type': 'User', 'site_admin': False}",closed,3d3bff5ff1bc277306d15a3caa96c2a6fdb924bb,https://api.github.com/repos/pytorch/pytorch/commits/3d3bff5ff1bc277306d15a3caa96c2a6fdb924bb,2019-10-16T16:22:02Z,48,22,26
15464,2041525256,"{'login': 'facebook-github-bot', 'id': 6422482, 'node_id': 'MDQ6VXNlcjY0MjI0ODI=', 'avatar_url': 'https://avatars3.githubusercontent.com/u/6422482?v=4', 'gravatar_id': '', 'url': 'https://api.github.com/users/facebook-github-bot', 'html_url': 'https://github.com/facebook-github-bot', 'followers_url': 'https://api.github.com/users/facebook-github-bot/followers', 'following_url': 'https://api.github.com/users/facebook-github-bot/following{/other_user}', 'gists_url': 'https://api.github.com/users/facebook-github-bot/gists{/gist_id}', 'starred_url': 'https://api.github.com/users/facebook-github-bot/starred{/owner}{/repo}', 'subscriptions_url': 'https://api.github.com/users/facebook-github-bot/subscriptions', 'organizations_url': 'https://api.github.com/users/facebook-github-bot/orgs', 'repos_url': 'https://api.github.com/users/facebook-github-bot/repos', 'events_url': 'https://api.github.com/users/facebook-github-bot/events{/privacy}', 'received_events_url': 'https://api.github.com/users/facebook-github-bot/received_events', 'type': 'User', 'site_admin': False}",closed,7e2ec2488677776d58a45c4fcdc37d89ffe46462,https://api.github.com/repos/pytorch/pytorch/commits/7e2ec2488677776d58a45c4fcdc37d89ffe46462,2018-12-21T19:44:20Z,2,1,1
15464,2081539320,"{'login': 'soumith', 'id': 1310570, 'node_id': 'MDQ6VXNlcjEzMTA1NzA=', 'avatar_url': 'https://avatars0.githubusercontent.com/u/1310570?v=4', 'gravatar_id': '', 'url': 'https://api.github.com/users/soumith', 'html_url': 'https://github.com/soumith', 'followers_url': 'https://api.github.com/users/soumith/followers', 'following_url': 'https://api.github.com/users/soumith/following{/other_user}', 'gists_url': 'https://api.github.com/users/soumith/gists{/gist_id}', 'starred_url': 'https://api.github.com/users/soumith/starred{/owner}{/repo}', 'subscriptions_url': 'https://api.github.com/users/soumith/subscriptions', 'organizations_url': 'https://api.github.com/users/soumith/orgs', 'repos_url': 'https://api.github.com/users/soumith/repos', 'events_url': 'https://api.github.com/users/soumith/events{/privacy}', 'received_events_url': 'https://api.github.com/users/soumith/received_events', 'type': 'User', 'site_admin': False}",referenced,52891837fa07ce7fce54a82e0e66efa09daa8742,https://api.github.com/repos/pytorch/pytorch/commits/52891837fa07ce7fce54a82e0e66efa09daa8742,2019-01-17T22:19:18Z,2,1,1
15464,2081981246,"{'login': 'soumith', 'id': 1310570, 'node_id': 'MDQ6VXNlcjEzMTA1NzA=', 'avatar_url': 'https://avatars0.githubusercontent.com/u/1310570?v=4', 'gravatar_id': '', 'url': 'https://api.github.com/users/soumith', 'html_url': 'https://github.com/soumith', 'followers_url': 'https://api.github.com/users/soumith/followers', 'following_url': 'https://api.github.com/users/soumith/following{/other_user}', 'gists_url': 'https://api.github.com/users/soumith/gists{/gist_id}', 'starred_url': 'https://api.github.com/users/soumith/starred{/owner}{/repo}', 'subscriptions_url': 'https://api.github.com/users/soumith/subscriptions', 'organizations_url': 'https://api.github.com/users/soumith/orgs', 'repos_url': 'https://api.github.com/users/soumith/repos', 'events_url': 'https://api.github.com/users/soumith/events{/privacy}', 'received_events_url': 'https://api.github.com/users/soumith/received_events', 'type': 'User', 'site_admin': False}",referenced,4c964dac7f733a530156b0242de362cb555fcb57,https://api.github.com/repos/pytorch/pytorch/commits/4c964dac7f733a530156b0242de362cb555fcb57,2019-01-18T04:02:12Z,2,1,1
15462,2212353116,"{'login': 'facebook-github-bot', 'id': 6422482, 'node_id': 'MDQ6VXNlcjY0MjI0ODI=', 'avatar_url': 'https://avatars3.githubusercontent.com/u/6422482?v=4', 'gravatar_id': '', 'url': 'https://api.github.com/users/facebook-github-bot', 'html_url': 'https://github.com/facebook-github-bot', 'followers_url': 'https://api.github.com/users/facebook-github-bot/followers', 'following_url': 'https://api.github.com/users/facebook-github-bot/following{/other_user}', 'gists_url': 'https://api.github.com/users/facebook-github-bot/gists{/gist_id}', 'starred_url': 'https://api.github.com/users/facebook-github-bot/starred{/owner}{/repo}', 'subscriptions_url': 'https://api.github.com/users/facebook-github-bot/subscriptions', 'organizations_url': 'https://api.github.com/users/facebook-github-bot/orgs', 'repos_url': 'https://api.github.com/users/facebook-github-bot/repos', 'events_url': 'https://api.github.com/users/facebook-github-bot/events{/privacy}', 'received_events_url': 'https://api.github.com/users/facebook-github-bot/received_events', 'type': 'User', 'site_admin': False}",referenced,195cba500f2c98c10f3d4b8fc3cca6493099b6df,https://api.github.com/repos/pytorch/pytorch/commits/195cba500f2c98c10f3d4b8fc3cca6493099b6df,2019-03-19T04:02:26Z,51,24,27
15353,2053063019,"{'login': 'facebook-github-bot', 'id': 6422482, 'node_id': 'MDQ6VXNlcjY0MjI0ODI=', 'avatar_url': 'https://avatars3.githubusercontent.com/u/6422482?v=4', 'gravatar_id': '', 'url': 'https://api.github.com/users/facebook-github-bot', 'html_url': 'https://github.com/facebook-github-bot', 'followers_url': 'https://api.github.com/users/facebook-github-bot/followers', 'following_url': 'https://api.github.com/users/facebook-github-bot/following{/other_user}', 'gists_url': 'https://api.github.com/users/facebook-github-bot/gists{/gist_id}', 'starred_url': 'https://api.github.com/users/facebook-github-bot/starred{/owner}{/repo}', 'subscriptions_url': 'https://api.github.com/users/facebook-github-bot/subscriptions', 'organizations_url': 'https://api.github.com/users/facebook-github-bot/orgs', 'repos_url': 'https://api.github.com/users/facebook-github-bot/repos', 'events_url': 'https://api.github.com/users/facebook-github-bot/events{/privacy}', 'received_events_url': 'https://api.github.com/users/facebook-github-bot/received_events', 'type': 'User', 'site_admin': False}",closed,78442f04fc60fd3f6fa5be70d3507811d6b11fd9,https://api.github.com/repos/pytorch/pytorch/commits/78442f04fc60fd3f6fa5be70d3507811d6b11fd9,2019-01-03T18:51:34Z,39,25,14
15353,2081539314,"{'login': 'soumith', 'id': 1310570, 'node_id': 'MDQ6VXNlcjEzMTA1NzA=', 'avatar_url': 'https://avatars0.githubusercontent.com/u/1310570?v=4', 'gravatar_id': '', 'url': 'https://api.github.com/users/soumith', 'html_url': 'https://github.com/soumith', 'followers_url': 'https://api.github.com/users/soumith/followers', 'following_url': 'https://api.github.com/users/soumith/following{/other_user}', 'gists_url': 'https://api.github.com/users/soumith/gists{/gist_id}', 'starred_url': 'https://api.github.com/users/soumith/starred{/owner}{/repo}', 'subscriptions_url': 'https://api.github.com/users/soumith/subscriptions', 'organizations_url': 'https://api.github.com/users/soumith/orgs', 'repos_url': 'https://api.github.com/users/soumith/repos', 'events_url': 'https://api.github.com/users/soumith/events{/privacy}', 'received_events_url': 'https://api.github.com/users/soumith/received_events', 'type': 'User', 'site_admin': False}",referenced,a634536a1c9fb788a2696fb3326a4bf9fe64811a,https://api.github.com/repos/pytorch/pytorch/commits/a634536a1c9fb788a2696fb3326a4bf9fe64811a,2019-01-17T22:19:18Z,39,25,14
15353,2081981242,"{'login': 'soumith', 'id': 1310570, 'node_id': 'MDQ6VXNlcjEzMTA1NzA=', 'avatar_url': 'https://avatars0.githubusercontent.com/u/1310570?v=4', 'gravatar_id': '', 'url': 'https://api.github.com/users/soumith', 'html_url': 'https://github.com/soumith', 'followers_url': 'https://api.github.com/users/soumith/followers', 'following_url': 'https://api.github.com/users/soumith/following{/other_user}', 'gists_url': 'https://api.github.com/users/soumith/gists{/gist_id}', 'starred_url': 'https://api.github.com/users/soumith/starred{/owner}{/repo}', 'subscriptions_url': 'https://api.github.com/users/soumith/subscriptions', 'organizations_url': 'https://api.github.com/users/soumith/orgs', 'repos_url': 'https://api.github.com/users/soumith/repos', 'events_url': 'https://api.github.com/users/soumith/events{/privacy}', 'received_events_url': 'https://api.github.com/users/soumith/received_events', 'type': 'User', 'site_admin': False}",referenced,7b40d9c7ff1a1841c724bddd5476824d68edcdd1,https://api.github.com/repos/pytorch/pytorch/commits/7b40d9c7ff1a1841c724bddd5476824d68edcdd1,2019-01-18T04:02:12Z,39,25,14
15346,2041515696,"{'login': 'facebook-github-bot', 'id': 6422482, 'node_id': 'MDQ6VXNlcjY0MjI0ODI=', 'avatar_url': 'https://avatars3.githubusercontent.com/u/6422482?v=4', 'gravatar_id': '', 'url': 'https://api.github.com/users/facebook-github-bot', 'html_url': 'https://github.com/facebook-github-bot', 'followers_url': 'https://api.github.com/users/facebook-github-bot/followers', 'following_url': 'https://api.github.com/users/facebook-github-bot/following{/other_user}', 'gists_url': 'https://api.github.com/users/facebook-github-bot/gists{/gist_id}', 'starred_url': 'https://api.github.com/users/facebook-github-bot/starred{/owner}{/repo}', 'subscriptions_url': 'https://api.github.com/users/facebook-github-bot/subscriptions', 'organizations_url': 'https://api.github.com/users/facebook-github-bot/orgs', 'repos_url': 'https://api.github.com/users/facebook-github-bot/repos', 'events_url': 'https://api.github.com/users/facebook-github-bot/events{/privacy}', 'received_events_url': 'https://api.github.com/users/facebook-github-bot/received_events', 'type': 'User', 'site_admin': False}",closed,d9cad71b36b678ea70ad2df29578a0aa985cbc3d,https://api.github.com/repos/pytorch/pytorch/commits/d9cad71b36b678ea70ad2df29578a0aa985cbc3d,2018-12-21T19:38:57Z,24,18,6
15344,2041320432,"{'login': 'facebook-github-bot', 'id': 6422482, 'node_id': 'MDQ6VXNlcjY0MjI0ODI=', 'avatar_url': 'https://avatars3.githubusercontent.com/u/6422482?v=4', 'gravatar_id': '', 'url': 'https://api.github.com/users/facebook-github-bot', 'html_url': 'https://github.com/facebook-github-bot', 'followers_url': 'https://api.github.com/users/facebook-github-bot/followers', 'following_url': 'https://api.github.com/users/facebook-github-bot/following{/other_user}', 'gists_url': 'https://api.github.com/users/facebook-github-bot/gists{/gist_id}', 'starred_url': 'https://api.github.com/users/facebook-github-bot/starred{/owner}{/repo}', 'subscriptions_url': 'https://api.github.com/users/facebook-github-bot/subscriptions', 'organizations_url': 'https://api.github.com/users/facebook-github-bot/orgs', 'repos_url': 'https://api.github.com/users/facebook-github-bot/repos', 'events_url': 'https://api.github.com/users/facebook-github-bot/events{/privacy}', 'received_events_url': 'https://api.github.com/users/facebook-github-bot/received_events', 'type': 'User', 'site_admin': False}",closed,614121c1ef6a34e7653f43cb9be89c28d6766b19,https://api.github.com/repos/pytorch/pytorch/commits/614121c1ef6a34e7653f43cb9be89c28d6766b19,2018-12-21T17:41:52Z,5,4,1
15338,2049844711,"{'login': 'facebook-github-bot', 'id': 6422482, 'node_id': 'MDQ6VXNlcjY0MjI0ODI=', 'avatar_url': 'https://avatars3.githubusercontent.com/u/6422482?v=4', 'gravatar_id': '', 'url': 'https://api.github.com/users/facebook-github-bot', 'html_url': 'https://github.com/facebook-github-bot', 'followers_url': 'https://api.github.com/users/facebook-github-bot/followers', 'following_url': 'https://api.github.com/users/facebook-github-bot/following{/other_user}', 'gists_url': 'https://api.github.com/users/facebook-github-bot/gists{/gist_id}', 'starred_url': 'https://api.github.com/users/facebook-github-bot/starred{/owner}{/repo}', 'subscriptions_url': 'https://api.github.com/users/facebook-github-bot/subscriptions', 'organizations_url': 'https://api.github.com/users/facebook-github-bot/orgs', 'repos_url': 'https://api.github.com/users/facebook-github-bot/repos', 'events_url': 'https://api.github.com/users/facebook-github-bot/events{/privacy}', 'received_events_url': 'https://api.github.com/users/facebook-github-bot/received_events', 'type': 'User', 'site_admin': False}",referenced,b52420742d70f01ed79ce9e55ec476f30c6e9423,https://api.github.com/repos/pytorch/pytorch/commits/b52420742d70f01ed79ce9e55ec476f30c6e9423,2019-01-02T07:13:33Z,53,46,7
15330,2044344835,"{'login': 'facebook-github-bot', 'id': 6422482, 'node_id': 'MDQ6VXNlcjY0MjI0ODI=', 'avatar_url': 'https://avatars3.githubusercontent.com/u/6422482?v=4', 'gravatar_id': '', 'url': 'https://api.github.com/users/facebook-github-bot', 'html_url': 'https://github.com/facebook-github-bot', 'followers_url': 'https://api.github.com/users/facebook-github-bot/followers', 'following_url': 'https://api.github.com/users/facebook-github-bot/following{/other_user}', 'gists_url': 'https://api.github.com/users/facebook-github-bot/gists{/gist_id}', 'starred_url': 'https://api.github.com/users/facebook-github-bot/starred{/owner}{/repo}', 'subscriptions_url': 'https://api.github.com/users/facebook-github-bot/subscriptions', 'organizations_url': 'https://api.github.com/users/facebook-github-bot/orgs', 'repos_url': 'https://api.github.com/users/facebook-github-bot/repos', 'events_url': 'https://api.github.com/users/facebook-github-bot/events{/privacy}', 'received_events_url': 'https://api.github.com/users/facebook-github-bot/received_events', 'type': 'User', 'site_admin': False}",closed,6e4be0af2e7f36d4aa65819214ddbd93ab5ac4f6,https://api.github.com/repos/pytorch/pytorch/commits/6e4be0af2e7f36d4aa65819214ddbd93ab5ac4f6,2018-12-26T08:50:12Z,14,10,4
15328,2044802333,"{'login': 'facebook-github-bot', 'id': 6422482, 'node_id': 'MDQ6VXNlcjY0MjI0ODI=', 'avatar_url': 'https://avatars3.githubusercontent.com/u/6422482?v=4', 'gravatar_id': '', 'url': 'https://api.github.com/users/facebook-github-bot', 'html_url': 'https://github.com/facebook-github-bot', 'followers_url': 'https://api.github.com/users/facebook-github-bot/followers', 'following_url': 'https://api.github.com/users/facebook-github-bot/following{/other_user}', 'gists_url': 'https://api.github.com/users/facebook-github-bot/gists{/gist_id}', 'starred_url': 'https://api.github.com/users/facebook-github-bot/starred{/owner}{/repo}', 'subscriptions_url': 'https://api.github.com/users/facebook-github-bot/subscriptions', 'organizations_url': 'https://api.github.com/users/facebook-github-bot/orgs', 'repos_url': 'https://api.github.com/users/facebook-github-bot/repos', 'events_url': 'https://api.github.com/users/facebook-github-bot/events{/privacy}', 'received_events_url': 'https://api.github.com/users/facebook-github-bot/received_events', 'type': 'User', 'site_admin': False}",closed,5ac95758e2d9362f21a33c6846da37804184e198,https://api.github.com/repos/pytorch/pytorch/commits/5ac95758e2d9362f21a33c6846da37804184e198,2018-12-26T16:33:51Z,29,6,23
15328,2083235768,"{'login': 'soumith', 'id': 1310570, 'node_id': 'MDQ6VXNlcjEzMTA1NzA=', 'avatar_url': 'https://avatars0.githubusercontent.com/u/1310570?v=4', 'gravatar_id': '', 'url': 'https://api.github.com/users/soumith', 'html_url': 'https://github.com/soumith', 'followers_url': 'https://api.github.com/users/soumith/followers', 'following_url': 'https://api.github.com/users/soumith/following{/other_user}', 'gists_url': 'https://api.github.com/users/soumith/gists{/gist_id}', 'starred_url': 'https://api.github.com/users/soumith/starred{/owner}{/repo}', 'subscriptions_url': 'https://api.github.com/users/soumith/subscriptions', 'organizations_url': 'https://api.github.com/users/soumith/orgs', 'repos_url': 'https://api.github.com/users/soumith/repos', 'events_url': 'https://api.github.com/users/soumith/events{/privacy}', 'received_events_url': 'https://api.github.com/users/soumith/received_events', 'type': 'User', 'site_admin': False}",referenced,c9962f992b3d446f7115de0661bfcda299b93e79,https://api.github.com/repos/pytorch/pytorch/commits/c9962f992b3d446f7115de0661bfcda299b93e79,2019-01-18T15:41:09Z,29,6,23
15328,2102600436,"{'login': 'soumith', 'id': 1310570, 'node_id': 'MDQ6VXNlcjEzMTA1NzA=', 'avatar_url': 'https://avatars0.githubusercontent.com/u/1310570?v=4', 'gravatar_id': '', 'url': 'https://api.github.com/users/soumith', 'html_url': 'https://github.com/soumith', 'followers_url': 'https://api.github.com/users/soumith/followers', 'following_url': 'https://api.github.com/users/soumith/following{/other_user}', 'gists_url': 'https://api.github.com/users/soumith/gists{/gist_id}', 'starred_url': 'https://api.github.com/users/soumith/starred{/owner}{/repo}', 'subscriptions_url': 'https://api.github.com/users/soumith/subscriptions', 'organizations_url': 'https://api.github.com/users/soumith/orgs', 'repos_url': 'https://api.github.com/users/soumith/repos', 'events_url': 'https://api.github.com/users/soumith/events{/privacy}', 'received_events_url': 'https://api.github.com/users/soumith/received_events', 'type': 'User', 'site_admin': False}",referenced,9c863c1952853209883daf772dcb864ec7bf3b4d,https://api.github.com/repos/pytorch/pytorch/commits/9c863c1952853209883daf772dcb864ec7bf3b4d,2019-01-29T04:12:50Z,29,6,23
15319,2190848818,"{'login': 'facebook-github-bot', 'id': 6422482, 'node_id': 'MDQ6VXNlcjY0MjI0ODI=', 'avatar_url': 'https://avatars3.githubusercontent.com/u/6422482?v=4', 'gravatar_id': '', 'url': 'https://api.github.com/users/facebook-github-bot', 'html_url': 'https://github.com/facebook-github-bot', 'followers_url': 'https://api.github.com/users/facebook-github-bot/followers', 'following_url': 'https://api.github.com/users/facebook-github-bot/following{/other_user}', 'gists_url': 'https://api.github.com/users/facebook-github-bot/gists{/gist_id}', 'starred_url': 'https://api.github.com/users/facebook-github-bot/starred{/owner}{/repo}', 'subscriptions_url': 'https://api.github.com/users/facebook-github-bot/subscriptions', 'organizations_url': 'https://api.github.com/users/facebook-github-bot/orgs', 'repos_url': 'https://api.github.com/users/facebook-github-bot/repos', 'events_url': 'https://api.github.com/users/facebook-github-bot/events{/privacy}', 'received_events_url': 'https://api.github.com/users/facebook-github-bot/received_events', 'type': 'User', 'site_admin': False}",closed,667763a63add80ac136dc5c138d6f79509744643,https://api.github.com/repos/pytorch/pytorch/commits/667763a63add80ac136dc5c138d6f79509744643,2019-03-08T18:38:54Z,9,6,3
15308,2060526347,"{'login': 'facebook-github-bot', 'id': 6422482, 'node_id': 'MDQ6VXNlcjY0MjI0ODI=', 'avatar_url': 'https://avatars3.githubusercontent.com/u/6422482?v=4', 'gravatar_id': '', 'url': 'https://api.github.com/users/facebook-github-bot', 'html_url': 'https://github.com/facebook-github-bot', 'followers_url': 'https://api.github.com/users/facebook-github-bot/followers', 'following_url': 'https://api.github.com/users/facebook-github-bot/following{/other_user}', 'gists_url': 'https://api.github.com/users/facebook-github-bot/gists{/gist_id}', 'starred_url': 'https://api.github.com/users/facebook-github-bot/starred{/owner}{/repo}', 'subscriptions_url': 'https://api.github.com/users/facebook-github-bot/subscriptions', 'organizations_url': 'https://api.github.com/users/facebook-github-bot/orgs', 'repos_url': 'https://api.github.com/users/facebook-github-bot/repos', 'events_url': 'https://api.github.com/users/facebook-github-bot/events{/privacy}', 'received_events_url': 'https://api.github.com/users/facebook-github-bot/received_events', 'type': 'User', 'site_admin': False}",closed,8f11147d43386acec2642a23cf08710ee0ab1af5,https://api.github.com/repos/pytorch/pytorch/commits/8f11147d43386acec2642a23cf08710ee0ab1af5,2019-01-08T15:33:15Z,15,15,0
15308,2081424994,"{'login': 'soumith', 'id': 1310570, 'node_id': 'MDQ6VXNlcjEzMTA1NzA=', 'avatar_url': 'https://avatars0.githubusercontent.com/u/1310570?v=4', 'gravatar_id': '', 'url': 'https://api.github.com/users/soumith', 'html_url': 'https://github.com/soumith', 'followers_url': 'https://api.github.com/users/soumith/followers', 'following_url': 'https://api.github.com/users/soumith/following{/other_user}', 'gists_url': 'https://api.github.com/users/soumith/gists{/gist_id}', 'starred_url': 'https://api.github.com/users/soumith/starred{/owner}{/repo}', 'subscriptions_url': 'https://api.github.com/users/soumith/subscriptions', 'organizations_url': 'https://api.github.com/users/soumith/orgs', 'repos_url': 'https://api.github.com/users/soumith/repos', 'events_url': 'https://api.github.com/users/soumith/events{/privacy}', 'received_events_url': 'https://api.github.com/users/soumith/received_events', 'type': 'User', 'site_admin': False}",referenced,b1441d6d16dddd5da168bd1d7618cbfa5fe4dd3c,https://api.github.com/repos/pytorch/pytorch/commits/b1441d6d16dddd5da168bd1d7618cbfa5fe4dd3c,2019-01-17T21:23:36Z,15,15,0
15308,2083661445,"{'login': 'zou3519', 'id': 5652049, 'node_id': 'MDQ6VXNlcjU2NTIwNDk=', 'avatar_url': 'https://avatars3.githubusercontent.com/u/5652049?v=4', 'gravatar_id': '', 'url': 'https://api.github.com/users/zou3519', 'html_url': 'https://github.com/zou3519', 'followers_url': 'https://api.github.com/users/zou3519/followers', 'following_url': 'https://api.github.com/users/zou3519/following{/other_user}', 'gists_url': 'https://api.github.com/users/zou3519/gists{/gist_id}', 'starred_url': 'https://api.github.com/users/zou3519/starred{/owner}{/repo}', 'subscriptions_url': 'https://api.github.com/users/zou3519/subscriptions', 'organizations_url': 'https://api.github.com/users/zou3519/orgs', 'repos_url': 'https://api.github.com/users/zou3519/repos', 'events_url': 'https://api.github.com/users/zou3519/events{/privacy}', 'received_events_url': 'https://api.github.com/users/zou3519/received_events', 'type': 'User', 'site_admin': False}",referenced,219d1e80ed1461ec8a7f7e0b2f2bc4682b91a23e,https://api.github.com/repos/pytorch/pytorch/commits/219d1e80ed1461ec8a7f7e0b2f2bc4682b91a23e,2019-01-18T18:46:12Z,15,15,0
15308,2102600449,"{'login': 'soumith', 'id': 1310570, 'node_id': 'MDQ6VXNlcjEzMTA1NzA=', 'avatar_url': 'https://avatars0.githubusercontent.com/u/1310570?v=4', 'gravatar_id': '', 'url': 'https://api.github.com/users/soumith', 'html_url': 'https://github.com/soumith', 'followers_url': 'https://api.github.com/users/soumith/followers', 'following_url': 'https://api.github.com/users/soumith/following{/other_user}', 'gists_url': 'https://api.github.com/users/soumith/gists{/gist_id}', 'starred_url': 'https://api.github.com/users/soumith/starred{/owner}{/repo}', 'subscriptions_url': 'https://api.github.com/users/soumith/subscriptions', 'organizations_url': 'https://api.github.com/users/soumith/orgs', 'repos_url': 'https://api.github.com/users/soumith/repos', 'events_url': 'https://api.github.com/users/soumith/events{/privacy}', 'received_events_url': 'https://api.github.com/users/soumith/received_events', 'type': 'User', 'site_admin': False}",referenced,a9cf3f69abf2c13be5585488cd555abe33cd8187,https://api.github.com/repos/pytorch/pytorch/commits/a9cf3f69abf2c13be5585488cd555abe33cd8187,2019-01-29T04:12:50Z,15,15,0
15283,2071088938,"{'login': 'facebook-github-bot', 'id': 6422482, 'node_id': 'MDQ6VXNlcjY0MjI0ODI=', 'avatar_url': 'https://avatars3.githubusercontent.com/u/6422482?v=4', 'gravatar_id': '', 'url': 'https://api.github.com/users/facebook-github-bot', 'html_url': 'https://github.com/facebook-github-bot', 'followers_url': 'https://api.github.com/users/facebook-github-bot/followers', 'following_url': 'https://api.github.com/users/facebook-github-bot/following{/other_user}', 'gists_url': 'https://api.github.com/users/facebook-github-bot/gists{/gist_id}', 'starred_url': 'https://api.github.com/users/facebook-github-bot/starred{/owner}{/repo}', 'subscriptions_url': 'https://api.github.com/users/facebook-github-bot/subscriptions', 'organizations_url': 'https://api.github.com/users/facebook-github-bot/orgs', 'repos_url': 'https://api.github.com/users/facebook-github-bot/repos', 'events_url': 'https://api.github.com/users/facebook-github-bot/events{/privacy}', 'received_events_url': 'https://api.github.com/users/facebook-github-bot/received_events', 'type': 'User', 'site_admin': False}",referenced,492b7d410b03fef9b0438f64fb5d4383402b973e,https://api.github.com/repos/pytorch/pytorch/commits/492b7d410b03fef9b0438f64fb5d4383402b973e,2019-01-14T07:40:00Z,10,5,5
15281,2031578329,"{'login': 'facebook-github-bot', 'id': 6422482, 'node_id': 'MDQ6VXNlcjY0MjI0ODI=', 'avatar_url': 'https://avatars3.githubusercontent.com/u/6422482?v=4', 'gravatar_id': '', 'url': 'https://api.github.com/users/facebook-github-bot', 'html_url': 'https://github.com/facebook-github-bot', 'followers_url': 'https://api.github.com/users/facebook-github-bot/followers', 'following_url': 'https://api.github.com/users/facebook-github-bot/following{/other_user}', 'gists_url': 'https://api.github.com/users/facebook-github-bot/gists{/gist_id}', 'starred_url': 'https://api.github.com/users/facebook-github-bot/starred{/owner}{/repo}', 'subscriptions_url': 'https://api.github.com/users/facebook-github-bot/subscriptions', 'organizations_url': 'https://api.github.com/users/facebook-github-bot/orgs', 'repos_url': 'https://api.github.com/users/facebook-github-bot/repos', 'events_url': 'https://api.github.com/users/facebook-github-bot/events{/privacy}', 'received_events_url': 'https://api.github.com/users/facebook-github-bot/received_events', 'type': 'User', 'site_admin': False}",closed,df4c9471eccb16f6f1c2966803d16f86187e9ed7,https://api.github.com/repos/pytorch/pytorch/commits/df4c9471eccb16f6f1c2966803d16f86187e9ed7,2018-12-17T22:42:27Z,3,3,0
15281,2084121312,"{'login': 'suo', 'id': 1617424, 'node_id': 'MDQ6VXNlcjE2MTc0MjQ=', 'avatar_url': 'https://avatars2.githubusercontent.com/u/1617424?v=4', 'gravatar_id': '', 'url': 'https://api.github.com/users/suo', 'html_url': 'https://github.com/suo', 'followers_url': 'https://api.github.com/users/suo/followers', 'following_url': 'https://api.github.com/users/suo/following{/other_user}', 'gists_url': 'https://api.github.com/users/suo/gists{/gist_id}', 'starred_url': 'https://api.github.com/users/suo/starred{/owner}{/repo}', 'subscriptions_url': 'https://api.github.com/users/suo/subscriptions', 'organizations_url': 'https://api.github.com/users/suo/orgs', 'repos_url': 'https://api.github.com/users/suo/repos', 'events_url': 'https://api.github.com/users/suo/events{/privacy}', 'received_events_url': 'https://api.github.com/users/suo/received_events', 'type': 'User', 'site_admin': False}",referenced,8df172855fec630cad87cf9355a5f5a02e920207,https://api.github.com/repos/pytorch/pytorch/commits/8df172855fec630cad87cf9355a5f5a02e920207,2019-01-18T22:50:32Z,3,3,0
15281,2084701965,"{'login': 'soumith', 'id': 1310570, 'node_id': 'MDQ6VXNlcjEzMTA1NzA=', 'avatar_url': 'https://avatars0.githubusercontent.com/u/1310570?v=4', 'gravatar_id': '', 'url': 'https://api.github.com/users/soumith', 'html_url': 'https://github.com/soumith', 'followers_url': 'https://api.github.com/users/soumith/followers', 'following_url': 'https://api.github.com/users/soumith/following{/other_user}', 'gists_url': 'https://api.github.com/users/soumith/gists{/gist_id}', 'starred_url': 'https://api.github.com/users/soumith/starred{/owner}{/repo}', 'subscriptions_url': 'https://api.github.com/users/soumith/subscriptions', 'organizations_url': 'https://api.github.com/users/soumith/orgs', 'repos_url': 'https://api.github.com/users/soumith/repos', 'events_url': 'https://api.github.com/users/soumith/events{/privacy}', 'received_events_url': 'https://api.github.com/users/soumith/received_events', 'type': 'User', 'site_admin': False}",referenced,40b1feb6e7db0aa8952fd8b9c2a4ed76b509a73a,https://api.github.com/repos/pytorch/pytorch/commits/40b1feb6e7db0aa8952fd8b9c2a4ed76b509a73a,2019-01-19T21:28:35Z,3,3,0
15281,2102600484,"{'login': 'soumith', 'id': 1310570, 'node_id': 'MDQ6VXNlcjEzMTA1NzA=', 'avatar_url': 'https://avatars0.githubusercontent.com/u/1310570?v=4', 'gravatar_id': '', 'url': 'https://api.github.com/users/soumith', 'html_url': 'https://github.com/soumith', 'followers_url': 'https://api.github.com/users/soumith/followers', 'following_url': 'https://api.github.com/users/soumith/following{/other_user}', 'gists_url': 'https://api.github.com/users/soumith/gists{/gist_id}', 'starred_url': 'https://api.github.com/users/soumith/starred{/owner}{/repo}', 'subscriptions_url': 'https://api.github.com/users/soumith/subscriptions', 'organizations_url': 'https://api.github.com/users/soumith/orgs', 'repos_url': 'https://api.github.com/users/soumith/repos', 'events_url': 'https://api.github.com/users/soumith/events{/privacy}', 'received_events_url': 'https://api.github.com/users/soumith/received_events', 'type': 'User', 'site_admin': False}",referenced,98bc784694e1811fe57c17d858fdb1b83998fb95,https://api.github.com/repos/pytorch/pytorch/commits/98bc784694e1811fe57c17d858fdb1b83998fb95,2019-01-29T04:12:51Z,3,3,0
15278,2098487831,"{'login': 'facebook-github-bot', 'id': 6422482, 'node_id': 'MDQ6VXNlcjY0MjI0ODI=', 'avatar_url': 'https://avatars3.githubusercontent.com/u/6422482?v=4', 'gravatar_id': '', 'url': 'https://api.github.com/users/facebook-github-bot', 'html_url': 'https://github.com/facebook-github-bot', 'followers_url': 'https://api.github.com/users/facebook-github-bot/followers', 'following_url': 'https://api.github.com/users/facebook-github-bot/following{/other_user}', 'gists_url': 'https://api.github.com/users/facebook-github-bot/gists{/gist_id}', 'starred_url': 'https://api.github.com/users/facebook-github-bot/starred{/owner}{/repo}', 'subscriptions_url': 'https://api.github.com/users/facebook-github-bot/subscriptions', 'organizations_url': 'https://api.github.com/users/facebook-github-bot/orgs', 'repos_url': 'https://api.github.com/users/facebook-github-bot/repos', 'events_url': 'https://api.github.com/users/facebook-github-bot/events{/privacy}', 'received_events_url': 'https://api.github.com/users/facebook-github-bot/received_events', 'type': 'User', 'site_admin': False}",closed,956cabd8875ad15a7707376e8f313e58ca884329,https://api.github.com/repos/pytorch/pytorch/commits/956cabd8875ad15a7707376e8f313e58ca884329,2019-01-25T23:15:58Z,31,30,1
15271,2093543793,"{'login': 'facebook-github-bot', 'id': 6422482, 'node_id': 'MDQ6VXNlcjY0MjI0ODI=', 'avatar_url': 'https://avatars3.githubusercontent.com/u/6422482?v=4', 'gravatar_id': '', 'url': 'https://api.github.com/users/facebook-github-bot', 'html_url': 'https://github.com/facebook-github-bot', 'followers_url': 'https://api.github.com/users/facebook-github-bot/followers', 'following_url': 'https://api.github.com/users/facebook-github-bot/following{/other_user}', 'gists_url': 'https://api.github.com/users/facebook-github-bot/gists{/gist_id}', 'starred_url': 'https://api.github.com/users/facebook-github-bot/starred{/owner}{/repo}', 'subscriptions_url': 'https://api.github.com/users/facebook-github-bot/subscriptions', 'organizations_url': 'https://api.github.com/users/facebook-github-bot/orgs', 'repos_url': 'https://api.github.com/users/facebook-github-bot/repos', 'events_url': 'https://api.github.com/users/facebook-github-bot/events{/privacy}', 'received_events_url': 'https://api.github.com/users/facebook-github-bot/received_events', 'type': 'User', 'site_admin': False}",closed,8ab4d348f464fe9bf28bf6cbf518f97a65efae1b,https://api.github.com/repos/pytorch/pytorch/commits/8ab4d348f464fe9bf28bf6cbf518f97a65efae1b,2019-01-24T05:37:09Z,17,16,1
15240,2038002742,"{'login': 'facebook-github-bot', 'id': 6422482, 'node_id': 'MDQ6VXNlcjY0MjI0ODI=', 'avatar_url': 'https://avatars3.githubusercontent.com/u/6422482?v=4', 'gravatar_id': '', 'url': 'https://api.github.com/users/facebook-github-bot', 'html_url': 'https://github.com/facebook-github-bot', 'followers_url': 'https://api.github.com/users/facebook-github-bot/followers', 'following_url': 'https://api.github.com/users/facebook-github-bot/following{/other_user}', 'gists_url': 'https://api.github.com/users/facebook-github-bot/gists{/gist_id}', 'starred_url': 'https://api.github.com/users/facebook-github-bot/starred{/owner}{/repo}', 'subscriptions_url': 'https://api.github.com/users/facebook-github-bot/subscriptions', 'organizations_url': 'https://api.github.com/users/facebook-github-bot/orgs', 'repos_url': 'https://api.github.com/users/facebook-github-bot/repos', 'events_url': 'https://api.github.com/users/facebook-github-bot/events{/privacy}', 'received_events_url': 'https://api.github.com/users/facebook-github-bot/received_events', 'type': 'User', 'site_admin': False}",closed,5e624948b65ff32f927eed7e4fa1002b4113f8c1,https://api.github.com/repos/pytorch/pytorch/commits/5e624948b65ff32f927eed7e4fa1002b4113f8c1,2018-12-20T10:30:30Z,23,13,10
15240,2041852374,"{'login': 'facebook-github-bot', 'id': 6422482, 'node_id': 'MDQ6VXNlcjY0MjI0ODI=', 'avatar_url': 'https://avatars3.githubusercontent.com/u/6422482?v=4', 'gravatar_id': '', 'url': 'https://api.github.com/users/facebook-github-bot', 'html_url': 'https://github.com/facebook-github-bot', 'followers_url': 'https://api.github.com/users/facebook-github-bot/followers', 'following_url': 'https://api.github.com/users/facebook-github-bot/following{/other_user}', 'gists_url': 'https://api.github.com/users/facebook-github-bot/gists{/gist_id}', 'starred_url': 'https://api.github.com/users/facebook-github-bot/starred{/owner}{/repo}', 'subscriptions_url': 'https://api.github.com/users/facebook-github-bot/subscriptions', 'organizations_url': 'https://api.github.com/users/facebook-github-bot/orgs', 'repos_url': 'https://api.github.com/users/facebook-github-bot/repos', 'events_url': 'https://api.github.com/users/facebook-github-bot/events{/privacy}', 'received_events_url': 'https://api.github.com/users/facebook-github-bot/received_events', 'type': 'User', 'site_admin': False}",referenced,1dcf2ea0963ece881cd95841e1db8ac920544e15,https://api.github.com/repos/pytorch/pytorch/commits/1dcf2ea0963ece881cd95841e1db8ac920544e15,2018-12-22T00:03:29Z,23,13,10
15240,2084121314,"{'login': 'suo', 'id': 1617424, 'node_id': 'MDQ6VXNlcjE2MTc0MjQ=', 'avatar_url': 'https://avatars2.githubusercontent.com/u/1617424?v=4', 'gravatar_id': '', 'url': 'https://api.github.com/users/suo', 'html_url': 'https://github.com/suo', 'followers_url': 'https://api.github.com/users/suo/followers', 'following_url': 'https://api.github.com/users/suo/following{/other_user}', 'gists_url': 'https://api.github.com/users/suo/gists{/gist_id}', 'starred_url': 'https://api.github.com/users/suo/starred{/owner}{/repo}', 'subscriptions_url': 'https://api.github.com/users/suo/subscriptions', 'organizations_url': 'https://api.github.com/users/suo/orgs', 'repos_url': 'https://api.github.com/users/suo/repos', 'events_url': 'https://api.github.com/users/suo/events{/privacy}', 'received_events_url': 'https://api.github.com/users/suo/received_events', 'type': 'User', 'site_admin': False}",referenced,ad4de26c72a3e1872fa254f8fd4740deeaa29876,https://api.github.com/repos/pytorch/pytorch/commits/ad4de26c72a3e1872fa254f8fd4740deeaa29876,2019-01-18T22:50:32Z,23,13,10
15240,2084701967,"{'login': 'soumith', 'id': 1310570, 'node_id': 'MDQ6VXNlcjEzMTA1NzA=', 'avatar_url': 'https://avatars0.githubusercontent.com/u/1310570?v=4', 'gravatar_id': '', 'url': 'https://api.github.com/users/soumith', 'html_url': 'https://github.com/soumith', 'followers_url': 'https://api.github.com/users/soumith/followers', 'following_url': 'https://api.github.com/users/soumith/following{/other_user}', 'gists_url': 'https://api.github.com/users/soumith/gists{/gist_id}', 'starred_url': 'https://api.github.com/users/soumith/starred{/owner}{/repo}', 'subscriptions_url': 'https://api.github.com/users/soumith/subscriptions', 'organizations_url': 'https://api.github.com/users/soumith/orgs', 'repos_url': 'https://api.github.com/users/soumith/repos', 'events_url': 'https://api.github.com/users/soumith/events{/privacy}', 'received_events_url': 'https://api.github.com/users/soumith/received_events', 'type': 'User', 'site_admin': False}",referenced,d2db2bfa3aca0d77e3ad156462cf47d6516561b8,https://api.github.com/repos/pytorch/pytorch/commits/d2db2bfa3aca0d77e3ad156462cf47d6516561b8,2019-01-19T21:28:35Z,23,13,10
15240,2102600487,"{'login': 'soumith', 'id': 1310570, 'node_id': 'MDQ6VXNlcjEzMTA1NzA=', 'avatar_url': 'https://avatars0.githubusercontent.com/u/1310570?v=4', 'gravatar_id': '', 'url': 'https://api.github.com/users/soumith', 'html_url': 'https://github.com/soumith', 'followers_url': 'https://api.github.com/users/soumith/followers', 'following_url': 'https://api.github.com/users/soumith/following{/other_user}', 'gists_url': 'https://api.github.com/users/soumith/gists{/gist_id}', 'starred_url': 'https://api.github.com/users/soumith/starred{/owner}{/repo}', 'subscriptions_url': 'https://api.github.com/users/soumith/subscriptions', 'organizations_url': 'https://api.github.com/users/soumith/orgs', 'repos_url': 'https://api.github.com/users/soumith/repos', 'events_url': 'https://api.github.com/users/soumith/events{/privacy}', 'received_events_url': 'https://api.github.com/users/soumith/received_events', 'type': 'User', 'site_admin': False}",referenced,7d3e2fa1908336cb1eed80fb9537cd9971a3a119,https://api.github.com/repos/pytorch/pytorch/commits/7d3e2fa1908336cb1eed80fb9537cd9971a3a119,2019-01-29T04:12:51Z,23,13,10
15223,2061360673,"{'login': 'facebook-github-bot', 'id': 6422482, 'node_id': 'MDQ6VXNlcjY0MjI0ODI=', 'avatar_url': 'https://avatars3.githubusercontent.com/u/6422482?v=4', 'gravatar_id': '', 'url': 'https://api.github.com/users/facebook-github-bot', 'html_url': 'https://github.com/facebook-github-bot', 'followers_url': 'https://api.github.com/users/facebook-github-bot/followers', 'following_url': 'https://api.github.com/users/facebook-github-bot/following{/other_user}', 'gists_url': 'https://api.github.com/users/facebook-github-bot/gists{/gist_id}', 'starred_url': 'https://api.github.com/users/facebook-github-bot/starred{/owner}{/repo}', 'subscriptions_url': 'https://api.github.com/users/facebook-github-bot/subscriptions', 'organizations_url': 'https://api.github.com/users/facebook-github-bot/orgs', 'repos_url': 'https://api.github.com/users/facebook-github-bot/repos', 'events_url': 'https://api.github.com/users/facebook-github-bot/events{/privacy}', 'received_events_url': 'https://api.github.com/users/facebook-github-bot/received_events', 'type': 'User', 'site_admin': False}",closed,196eee6ccd9bbab46d712c863265a433832b8f9c,https://api.github.com/repos/pytorch/pytorch/commits/196eee6ccd9bbab46d712c863265a433832b8f9c,2019-01-08T21:21:41Z,12,11,1
15223,2081425010,"{'login': 'soumith', 'id': 1310570, 'node_id': 'MDQ6VXNlcjEzMTA1NzA=', 'avatar_url': 'https://avatars0.githubusercontent.com/u/1310570?v=4', 'gravatar_id': '', 'url': 'https://api.github.com/users/soumith', 'html_url': 'https://github.com/soumith', 'followers_url': 'https://api.github.com/users/soumith/followers', 'following_url': 'https://api.github.com/users/soumith/following{/other_user}', 'gists_url': 'https://api.github.com/users/soumith/gists{/gist_id}', 'starred_url': 'https://api.github.com/users/soumith/starred{/owner}{/repo}', 'subscriptions_url': 'https://api.github.com/users/soumith/subscriptions', 'organizations_url': 'https://api.github.com/users/soumith/orgs', 'repos_url': 'https://api.github.com/users/soumith/repos', 'events_url': 'https://api.github.com/users/soumith/events{/privacy}', 'received_events_url': 'https://api.github.com/users/soumith/received_events', 'type': 'User', 'site_admin': False}",referenced,4dd00a9f61f6361a5742ae3f06bd260be58a9489,https://api.github.com/repos/pytorch/pytorch/commits/4dd00a9f61f6361a5742ae3f06bd260be58a9489,2019-01-17T21:23:36Z,12,11,1
15223,2081539291,"{'login': 'soumith', 'id': 1310570, 'node_id': 'MDQ6VXNlcjEzMTA1NzA=', 'avatar_url': 'https://avatars0.githubusercontent.com/u/1310570?v=4', 'gravatar_id': '', 'url': 'https://api.github.com/users/soumith', 'html_url': 'https://github.com/soumith', 'followers_url': 'https://api.github.com/users/soumith/followers', 'following_url': 'https://api.github.com/users/soumith/following{/other_user}', 'gists_url': 'https://api.github.com/users/soumith/gists{/gist_id}', 'starred_url': 'https://api.github.com/users/soumith/starred{/owner}{/repo}', 'subscriptions_url': 'https://api.github.com/users/soumith/subscriptions', 'organizations_url': 'https://api.github.com/users/soumith/orgs', 'repos_url': 'https://api.github.com/users/soumith/repos', 'events_url': 'https://api.github.com/users/soumith/events{/privacy}', 'received_events_url': 'https://api.github.com/users/soumith/received_events', 'type': 'User', 'site_admin': False}",referenced,3d7fceebbb231215ce9b37946f0bf5f4ca47c3db,https://api.github.com/repos/pytorch/pytorch/commits/3d7fceebbb231215ce9b37946f0bf5f4ca47c3db,2019-01-17T22:19:17Z,12,11,1
15223,2081981224,"{'login': 'soumith', 'id': 1310570, 'node_id': 'MDQ6VXNlcjEzMTA1NzA=', 'avatar_url': 'https://avatars0.githubusercontent.com/u/1310570?v=4', 'gravatar_id': '', 'url': 'https://api.github.com/users/soumith', 'html_url': 'https://github.com/soumith', 'followers_url': 'https://api.github.com/users/soumith/followers', 'following_url': 'https://api.github.com/users/soumith/following{/other_user}', 'gists_url': 'https://api.github.com/users/soumith/gists{/gist_id}', 'starred_url': 'https://api.github.com/users/soumith/starred{/owner}{/repo}', 'subscriptions_url': 'https://api.github.com/users/soumith/subscriptions', 'organizations_url': 'https://api.github.com/users/soumith/orgs', 'repos_url': 'https://api.github.com/users/soumith/repos', 'events_url': 'https://api.github.com/users/soumith/events{/privacy}', 'received_events_url': 'https://api.github.com/users/soumith/received_events', 'type': 'User', 'site_admin': False}",referenced,fe098a3605965ca9bd73224ab198293d367a7463,https://api.github.com/repos/pytorch/pytorch/commits/fe098a3605965ca9bd73224ab198293d367a7463,2019-01-18T04:02:11Z,12,11,1
15216,2053253195,"{'login': 'facebook-github-bot', 'id': 6422482, 'node_id': 'MDQ6VXNlcjY0MjI0ODI=', 'avatar_url': 'https://avatars3.githubusercontent.com/u/6422482?v=4', 'gravatar_id': '', 'url': 'https://api.github.com/users/facebook-github-bot', 'html_url': 'https://github.com/facebook-github-bot', 'followers_url': 'https://api.github.com/users/facebook-github-bot/followers', 'following_url': 'https://api.github.com/users/facebook-github-bot/following{/other_user}', 'gists_url': 'https://api.github.com/users/facebook-github-bot/gists{/gist_id}', 'starred_url': 'https://api.github.com/users/facebook-github-bot/starred{/owner}{/repo}', 'subscriptions_url': 'https://api.github.com/users/facebook-github-bot/subscriptions', 'organizations_url': 'https://api.github.com/users/facebook-github-bot/orgs', 'repos_url': 'https://api.github.com/users/facebook-github-bot/repos', 'events_url': 'https://api.github.com/users/facebook-github-bot/events{/privacy}', 'received_events_url': 'https://api.github.com/users/facebook-github-bot/received_events', 'type': 'User', 'site_admin': False}",closed,d42e90991bf93fcce9fae3f5edeb925876900bfc,https://api.github.com/repos/pytorch/pytorch/commits/d42e90991bf93fcce9fae3f5edeb925876900bfc,2019-01-03T20:29:44Z,50,33,17
15214,2039748227,"{'login': 'facebook-github-bot', 'id': 6422482, 'node_id': 'MDQ6VXNlcjY0MjI0ODI=', 'avatar_url': 'https://avatars3.githubusercontent.com/u/6422482?v=4', 'gravatar_id': '', 'url': 'https://api.github.com/users/facebook-github-bot', 'html_url': 'https://github.com/facebook-github-bot', 'followers_url': 'https://api.github.com/users/facebook-github-bot/followers', 'following_url': 'https://api.github.com/users/facebook-github-bot/following{/other_user}', 'gists_url': 'https://api.github.com/users/facebook-github-bot/gists{/gist_id}', 'starred_url': 'https://api.github.com/users/facebook-github-bot/starred{/owner}{/repo}', 'subscriptions_url': 'https://api.github.com/users/facebook-github-bot/subscriptions', 'organizations_url': 'https://api.github.com/users/facebook-github-bot/orgs', 'repos_url': 'https://api.github.com/users/facebook-github-bot/repos', 'events_url': 'https://api.github.com/users/facebook-github-bot/events{/privacy}', 'received_events_url': 'https://api.github.com/users/facebook-github-bot/received_events', 'type': 'User', 'site_admin': False}",closed,3a6d473b49fc04dc1f086ee7bd8f0a90578e8de6,https://api.github.com/repos/pytorch/pytorch/commits/3a6d473b49fc04dc1f086ee7bd8f0a90578e8de6,2018-12-21T00:57:48Z,4,2,2
15156,2031644794,"{'login': 'facebook-github-bot', 'id': 6422482, 'node_id': 'MDQ6VXNlcjY0MjI0ODI=', 'avatar_url': 'https://avatars3.githubusercontent.com/u/6422482?v=4', 'gravatar_id': '', 'url': 'https://api.github.com/users/facebook-github-bot', 'html_url': 'https://github.com/facebook-github-bot', 'followers_url': 'https://api.github.com/users/facebook-github-bot/followers', 'following_url': 'https://api.github.com/users/facebook-github-bot/following{/other_user}', 'gists_url': 'https://api.github.com/users/facebook-github-bot/gists{/gist_id}', 'starred_url': 'https://api.github.com/users/facebook-github-bot/starred{/owner}{/repo}', 'subscriptions_url': 'https://api.github.com/users/facebook-github-bot/subscriptions', 'organizations_url': 'https://api.github.com/users/facebook-github-bot/orgs', 'repos_url': 'https://api.github.com/users/facebook-github-bot/repos', 'events_url': 'https://api.github.com/users/facebook-github-bot/events{/privacy}', 'received_events_url': 'https://api.github.com/users/facebook-github-bot/received_events', 'type': 'User', 'site_admin': False}",closed,216ab259fb5142c20c9e5aef74accb4fe112858a,https://api.github.com/repos/pytorch/pytorch/commits/216ab259fb5142c20c9e5aef74accb4fe112858a,2018-12-17T23:23:15Z,36,36,0
15135,2031408915,"{'login': 'facebook-github-bot', 'id': 6422482, 'node_id': 'MDQ6VXNlcjY0MjI0ODI=', 'avatar_url': 'https://avatars3.githubusercontent.com/u/6422482?v=4', 'gravatar_id': '', 'url': 'https://api.github.com/users/facebook-github-bot', 'html_url': 'https://github.com/facebook-github-bot', 'followers_url': 'https://api.github.com/users/facebook-github-bot/followers', 'following_url': 'https://api.github.com/users/facebook-github-bot/following{/other_user}', 'gists_url': 'https://api.github.com/users/facebook-github-bot/gists{/gist_id}', 'starred_url': 'https://api.github.com/users/facebook-github-bot/starred{/owner}{/repo}', 'subscriptions_url': 'https://api.github.com/users/facebook-github-bot/subscriptions', 'organizations_url': 'https://api.github.com/users/facebook-github-bot/orgs', 'repos_url': 'https://api.github.com/users/facebook-github-bot/repos', 'events_url': 'https://api.github.com/users/facebook-github-bot/events{/privacy}', 'received_events_url': 'https://api.github.com/users/facebook-github-bot/received_events', 'type': 'User', 'site_admin': False}",closed,1dbc7cff3e654af6d74ebbfb81c6f045c45d7182,https://api.github.com/repos/pytorch/pytorch/commits/1dbc7cff3e654af6d74ebbfb81c6f045c45d7182,2018-12-17T21:19:24Z,14,13,1
15119,2022439631,"{'login': 'facebook-github-bot', 'id': 6422482, 'node_id': 'MDQ6VXNlcjY0MjI0ODI=', 'avatar_url': 'https://avatars3.githubusercontent.com/u/6422482?v=4', 'gravatar_id': '', 'url': 'https://api.github.com/users/facebook-github-bot', 'html_url': 'https://github.com/facebook-github-bot', 'followers_url': 'https://api.github.com/users/facebook-github-bot/followers', 'following_url': 'https://api.github.com/users/facebook-github-bot/following{/other_user}', 'gists_url': 'https://api.github.com/users/facebook-github-bot/gists{/gist_id}', 'starred_url': 'https://api.github.com/users/facebook-github-bot/starred{/owner}{/repo}', 'subscriptions_url': 'https://api.github.com/users/facebook-github-bot/subscriptions', 'organizations_url': 'https://api.github.com/users/facebook-github-bot/orgs', 'repos_url': 'https://api.github.com/users/facebook-github-bot/repos', 'events_url': 'https://api.github.com/users/facebook-github-bot/events{/privacy}', 'received_events_url': 'https://api.github.com/users/facebook-github-bot/received_events', 'type': 'User', 'site_admin': False}",closed,b34ab435efd9b4d839171d27bd6a0f321178d46b,https://api.github.com/repos/pytorch/pytorch/commits/b34ab435efd9b4d839171d27bd6a0f321178d46b,2018-12-12T19:36:56Z,17,17,0
15119,2083822234,"{'login': 'suo', 'id': 1617424, 'node_id': 'MDQ6VXNlcjE2MTc0MjQ=', 'avatar_url': 'https://avatars2.githubusercontent.com/u/1617424?v=4', 'gravatar_id': '', 'url': 'https://api.github.com/users/suo', 'html_url': 'https://github.com/suo', 'followers_url': 'https://api.github.com/users/suo/followers', 'following_url': 'https://api.github.com/users/suo/following{/other_user}', 'gists_url': 'https://api.github.com/users/suo/gists{/gist_id}', 'starred_url': 'https://api.github.com/users/suo/starred{/owner}{/repo}', 'subscriptions_url': 'https://api.github.com/users/suo/subscriptions', 'organizations_url': 'https://api.github.com/users/suo/orgs', 'repos_url': 'https://api.github.com/users/suo/repos', 'events_url': 'https://api.github.com/users/suo/events{/privacy}', 'received_events_url': 'https://api.github.com/users/suo/received_events', 'type': 'User', 'site_admin': False}",referenced,f79d7d99e70cb0dc494b6f0bfeaa4330178b1005,https://api.github.com/repos/pytorch/pytorch/commits/f79d7d99e70cb0dc494b6f0bfeaa4330178b1005,2019-01-18T20:03:58Z,17,17,0
15119,2084701952,"{'login': 'soumith', 'id': 1310570, 'node_id': 'MDQ6VXNlcjEzMTA1NzA=', 'avatar_url': 'https://avatars0.githubusercontent.com/u/1310570?v=4', 'gravatar_id': '', 'url': 'https://api.github.com/users/soumith', 'html_url': 'https://github.com/soumith', 'followers_url': 'https://api.github.com/users/soumith/followers', 'following_url': 'https://api.github.com/users/soumith/following{/other_user}', 'gists_url': 'https://api.github.com/users/soumith/gists{/gist_id}', 'starred_url': 'https://api.github.com/users/soumith/starred{/owner}{/repo}', 'subscriptions_url': 'https://api.github.com/users/soumith/subscriptions', 'organizations_url': 'https://api.github.com/users/soumith/orgs', 'repos_url': 'https://api.github.com/users/soumith/repos', 'events_url': 'https://api.github.com/users/soumith/events{/privacy}', 'received_events_url': 'https://api.github.com/users/soumith/received_events', 'type': 'User', 'site_admin': False}",referenced,b183b17bb40080f1ccc69f52799e8b03dccbaa81,https://api.github.com/repos/pytorch/pytorch/commits/b183b17bb40080f1ccc69f52799e8b03dccbaa81,2019-01-19T21:28:34Z,17,17,0
15119,2102600467,"{'login': 'soumith', 'id': 1310570, 'node_id': 'MDQ6VXNlcjEzMTA1NzA=', 'avatar_url': 'https://avatars0.githubusercontent.com/u/1310570?v=4', 'gravatar_id': '', 'url': 'https://api.github.com/users/soumith', 'html_url': 'https://github.com/soumith', 'followers_url': 'https://api.github.com/users/soumith/followers', 'following_url': 'https://api.github.com/users/soumith/following{/other_user}', 'gists_url': 'https://api.github.com/users/soumith/gists{/gist_id}', 'starred_url': 'https://api.github.com/users/soumith/starred{/owner}{/repo}', 'subscriptions_url': 'https://api.github.com/users/soumith/subscriptions', 'organizations_url': 'https://api.github.com/users/soumith/orgs', 'repos_url': 'https://api.github.com/users/soumith/repos', 'events_url': 'https://api.github.com/users/soumith/events{/privacy}', 'received_events_url': 'https://api.github.com/users/soumith/received_events', 'type': 'User', 'site_admin': False}",referenced,c19b16cc99a742ea73a55b3ce16502b618766805,https://api.github.com/repos/pytorch/pytorch/commits/c19b16cc99a742ea73a55b3ce16502b618766805,2019-01-29T04:12:51Z,17,17,0
15089,2129622299,"{'login': 'facebook-github-bot', 'id': 6422482, 'node_id': 'MDQ6VXNlcjY0MjI0ODI=', 'avatar_url': 'https://avatars3.githubusercontent.com/u/6422482?v=4', 'gravatar_id': '', 'url': 'https://api.github.com/users/facebook-github-bot', 'html_url': 'https://github.com/facebook-github-bot', 'followers_url': 'https://api.github.com/users/facebook-github-bot/followers', 'following_url': 'https://api.github.com/users/facebook-github-bot/following{/other_user}', 'gists_url': 'https://api.github.com/users/facebook-github-bot/gists{/gist_id}', 'starred_url': 'https://api.github.com/users/facebook-github-bot/starred{/owner}{/repo}', 'subscriptions_url': 'https://api.github.com/users/facebook-github-bot/subscriptions', 'organizations_url': 'https://api.github.com/users/facebook-github-bot/orgs', 'repos_url': 'https://api.github.com/users/facebook-github-bot/repos', 'events_url': 'https://api.github.com/users/facebook-github-bot/events{/privacy}', 'received_events_url': 'https://api.github.com/users/facebook-github-bot/received_events', 'type': 'User', 'site_admin': False}",closed,73d7ecd18398cf121a9a2ff2faad302d429bef3e,https://api.github.com/repos/pytorch/pytorch/commits/73d7ecd18398cf121a9a2ff2faad302d429bef3e,2019-02-11T03:33:24Z,53,29,24
15062,2044188410,"{'login': 'facebook-github-bot', 'id': 6422482, 'node_id': 'MDQ6VXNlcjY0MjI0ODI=', 'avatar_url': 'https://avatars3.githubusercontent.com/u/6422482?v=4', 'gravatar_id': '', 'url': 'https://api.github.com/users/facebook-github-bot', 'html_url': 'https://github.com/facebook-github-bot', 'followers_url': 'https://api.github.com/users/facebook-github-bot/followers', 'following_url': 'https://api.github.com/users/facebook-github-bot/following{/other_user}', 'gists_url': 'https://api.github.com/users/facebook-github-bot/gists{/gist_id}', 'starred_url': 'https://api.github.com/users/facebook-github-bot/starred{/owner}{/repo}', 'subscriptions_url': 'https://api.github.com/users/facebook-github-bot/subscriptions', 'organizations_url': 'https://api.github.com/users/facebook-github-bot/orgs', 'repos_url': 'https://api.github.com/users/facebook-github-bot/repos', 'events_url': 'https://api.github.com/users/facebook-github-bot/events{/privacy}', 'received_events_url': 'https://api.github.com/users/facebook-github-bot/received_events', 'type': 'User', 'site_admin': False}",closed,2fe5c29d81771de4acbeb692ed775d15139646b7,https://api.github.com/repos/pytorch/pytorch/commits/2fe5c29d81771de4acbeb692ed775d15139646b7,2018-12-26T05:59:08Z,6,0,6
15060,2039545993,"{'login': 'facebook-github-bot', 'id': 6422482, 'node_id': 'MDQ6VXNlcjY0MjI0ODI=', 'avatar_url': 'https://avatars3.githubusercontent.com/u/6422482?v=4', 'gravatar_id': '', 'url': 'https://api.github.com/users/facebook-github-bot', 'html_url': 'https://github.com/facebook-github-bot', 'followers_url': 'https://api.github.com/users/facebook-github-bot/followers', 'following_url': 'https://api.github.com/users/facebook-github-bot/following{/other_user}', 'gists_url': 'https://api.github.com/users/facebook-github-bot/gists{/gist_id}', 'starred_url': 'https://api.github.com/users/facebook-github-bot/starred{/owner}{/repo}', 'subscriptions_url': 'https://api.github.com/users/facebook-github-bot/subscriptions', 'organizations_url': 'https://api.github.com/users/facebook-github-bot/orgs', 'repos_url': 'https://api.github.com/users/facebook-github-bot/repos', 'events_url': 'https://api.github.com/users/facebook-github-bot/events{/privacy}', 'received_events_url': 'https://api.github.com/users/facebook-github-bot/received_events', 'type': 'User', 'site_admin': False}",closed,a47749cb28bb630bc99601a64e24ad453d9583a9,https://api.github.com/repos/pytorch/pytorch/commits/a47749cb28bb630bc99601a64e24ad453d9583a9,2018-12-20T22:26:22Z,195,170,25
15058,2024889202,"{'login': 'facebook-github-bot', 'id': 6422482, 'node_id': 'MDQ6VXNlcjY0MjI0ODI=', 'avatar_url': 'https://avatars3.githubusercontent.com/u/6422482?v=4', 'gravatar_id': '', 'url': 'https://api.github.com/users/facebook-github-bot', 'html_url': 'https://github.com/facebook-github-bot', 'followers_url': 'https://api.github.com/users/facebook-github-bot/followers', 'following_url': 'https://api.github.com/users/facebook-github-bot/following{/other_user}', 'gists_url': 'https://api.github.com/users/facebook-github-bot/gists{/gist_id}', 'starred_url': 'https://api.github.com/users/facebook-github-bot/starred{/owner}{/repo}', 'subscriptions_url': 'https://api.github.com/users/facebook-github-bot/subscriptions', 'organizations_url': 'https://api.github.com/users/facebook-github-bot/orgs', 'repos_url': 'https://api.github.com/users/facebook-github-bot/repos', 'events_url': 'https://api.github.com/users/facebook-github-bot/events{/privacy}', 'received_events_url': 'https://api.github.com/users/facebook-github-bot/received_events', 'type': 'User', 'site_admin': False}",closed,214f46faf5c5dddb073e09205d047aead814b0c6,https://api.github.com/repos/pytorch/pytorch/commits/214f46faf5c5dddb073e09205d047aead814b0c6,2018-12-13T17:45:45Z,24,20,4
15058,2082115968,"{'login': 'soumith', 'id': 1310570, 'node_id': 'MDQ6VXNlcjEzMTA1NzA=', 'avatar_url': 'https://avatars0.githubusercontent.com/u/1310570?v=4', 'gravatar_id': '', 'url': 'https://api.github.com/users/soumith', 'html_url': 'https://github.com/soumith', 'followers_url': 'https://api.github.com/users/soumith/followers', 'following_url': 'https://api.github.com/users/soumith/following{/other_user}', 'gists_url': 'https://api.github.com/users/soumith/gists{/gist_id}', 'starred_url': 'https://api.github.com/users/soumith/starred{/owner}{/repo}', 'subscriptions_url': 'https://api.github.com/users/soumith/subscriptions', 'organizations_url': 'https://api.github.com/users/soumith/orgs', 'repos_url': 'https://api.github.com/users/soumith/repos', 'events_url': 'https://api.github.com/users/soumith/events{/privacy}', 'received_events_url': 'https://api.github.com/users/soumith/received_events', 'type': 'User', 'site_admin': False}",referenced,dd5f5816d731a47be731c1232b1fcd3f07afe79a,https://api.github.com/repos/pytorch/pytorch/commits/dd5f5816d731a47be731c1232b1fcd3f07afe79a,2019-01-18T06:20:46Z,24,20,4
15058,2102600404,"{'login': 'soumith', 'id': 1310570, 'node_id': 'MDQ6VXNlcjEzMTA1NzA=', 'avatar_url': 'https://avatars0.githubusercontent.com/u/1310570?v=4', 'gravatar_id': '', 'url': 'https://api.github.com/users/soumith', 'html_url': 'https://github.com/soumith', 'followers_url': 'https://api.github.com/users/soumith/followers', 'following_url': 'https://api.github.com/users/soumith/following{/other_user}', 'gists_url': 'https://api.github.com/users/soumith/gists{/gist_id}', 'starred_url': 'https://api.github.com/users/soumith/starred{/owner}{/repo}', 'subscriptions_url': 'https://api.github.com/users/soumith/subscriptions', 'organizations_url': 'https://api.github.com/users/soumith/orgs', 'repos_url': 'https://api.github.com/users/soumith/repos', 'events_url': 'https://api.github.com/users/soumith/events{/privacy}', 'received_events_url': 'https://api.github.com/users/soumith/received_events', 'type': 'User', 'site_admin': False}",referenced,ab1cd6241b97ae95c767e9274e23a854d057093f,https://api.github.com/repos/pytorch/pytorch/commits/ab1cd6241b97ae95c767e9274e23a854d057093f,2019-01-29T04:12:49Z,24,20,4
15052,2032006257,"{'login': 'facebook-github-bot', 'id': 6422482, 'node_id': 'MDQ6VXNlcjY0MjI0ODI=', 'avatar_url': 'https://avatars3.githubusercontent.com/u/6422482?v=4', 'gravatar_id': '', 'url': 'https://api.github.com/users/facebook-github-bot', 'html_url': 'https://github.com/facebook-github-bot', 'followers_url': 'https://api.github.com/users/facebook-github-bot/followers', 'following_url': 'https://api.github.com/users/facebook-github-bot/following{/other_user}', 'gists_url': 'https://api.github.com/users/facebook-github-bot/gists{/gist_id}', 'starred_url': 'https://api.github.com/users/facebook-github-bot/starred{/owner}{/repo}', 'subscriptions_url': 'https://api.github.com/users/facebook-github-bot/subscriptions', 'organizations_url': 'https://api.github.com/users/facebook-github-bot/orgs', 'repos_url': 'https://api.github.com/users/facebook-github-bot/repos', 'events_url': 'https://api.github.com/users/facebook-github-bot/events{/privacy}', 'received_events_url': 'https://api.github.com/users/facebook-github-bot/received_events', 'type': 'User', 'site_admin': False}",closed,e37a22128eca7ccac6e289659587a9e1bfe6d242,https://api.github.com/repos/pytorch/pytorch/commits/e37a22128eca7ccac6e289659587a9e1bfe6d242,2018-12-18T04:35:47Z,108,99,9
15052,2083822238,"{'login': 'suo', 'id': 1617424, 'node_id': 'MDQ6VXNlcjE2MTc0MjQ=', 'avatar_url': 'https://avatars2.githubusercontent.com/u/1617424?v=4', 'gravatar_id': '', 'url': 'https://api.github.com/users/suo', 'html_url': 'https://github.com/suo', 'followers_url': 'https://api.github.com/users/suo/followers', 'following_url': 'https://api.github.com/users/suo/following{/other_user}', 'gists_url': 'https://api.github.com/users/suo/gists{/gist_id}', 'starred_url': 'https://api.github.com/users/suo/starred{/owner}{/repo}', 'subscriptions_url': 'https://api.github.com/users/suo/subscriptions', 'organizations_url': 'https://api.github.com/users/suo/orgs', 'repos_url': 'https://api.github.com/users/suo/repos', 'events_url': 'https://api.github.com/users/suo/events{/privacy}', 'received_events_url': 'https://api.github.com/users/suo/received_events', 'type': 'User', 'site_admin': False}",referenced,93e01d090ef141e472790bd531cec42a2042b1c5,https://api.github.com/repos/pytorch/pytorch/commits/93e01d090ef141e472790bd531cec42a2042b1c5,2019-01-18T20:03:58Z,108,99,9
15052,2084701956,"{'login': 'soumith', 'id': 1310570, 'node_id': 'MDQ6VXNlcjEzMTA1NzA=', 'avatar_url': 'https://avatars0.githubusercontent.com/u/1310570?v=4', 'gravatar_id': '', 'url': 'https://api.github.com/users/soumith', 'html_url': 'https://github.com/soumith', 'followers_url': 'https://api.github.com/users/soumith/followers', 'following_url': 'https://api.github.com/users/soumith/following{/other_user}', 'gists_url': 'https://api.github.com/users/soumith/gists{/gist_id}', 'starred_url': 'https://api.github.com/users/soumith/starred{/owner}{/repo}', 'subscriptions_url': 'https://api.github.com/users/soumith/subscriptions', 'organizations_url': 'https://api.github.com/users/soumith/orgs', 'repos_url': 'https://api.github.com/users/soumith/repos', 'events_url': 'https://api.github.com/users/soumith/events{/privacy}', 'received_events_url': 'https://api.github.com/users/soumith/received_events', 'type': 'User', 'site_admin': False}",referenced,40840c513b6dddb7200cd2f563c3b1b8046a5b9a,https://api.github.com/repos/pytorch/pytorch/commits/40840c513b6dddb7200cd2f563c3b1b8046a5b9a,2019-01-19T21:28:34Z,108,99,9
15052,2102600471,"{'login': 'soumith', 'id': 1310570, 'node_id': 'MDQ6VXNlcjEzMTA1NzA=', 'avatar_url': 'https://avatars0.githubusercontent.com/u/1310570?v=4', 'gravatar_id': '', 'url': 'https://api.github.com/users/soumith', 'html_url': 'https://github.com/soumith', 'followers_url': 'https://api.github.com/users/soumith/followers', 'following_url': 'https://api.github.com/users/soumith/following{/other_user}', 'gists_url': 'https://api.github.com/users/soumith/gists{/gist_id}', 'starred_url': 'https://api.github.com/users/soumith/starred{/owner}{/repo}', 'subscriptions_url': 'https://api.github.com/users/soumith/subscriptions', 'organizations_url': 'https://api.github.com/users/soumith/orgs', 'repos_url': 'https://api.github.com/users/soumith/repos', 'events_url': 'https://api.github.com/users/soumith/events{/privacy}', 'received_events_url': 'https://api.github.com/users/soumith/received_events', 'type': 'User', 'site_admin': False}",referenced,274e7552378664eddabf2f3336093240c7f4f869,https://api.github.com/repos/pytorch/pytorch/commits/274e7552378664eddabf2f3336093240c7f4f869,2019-01-29T04:12:51Z,108,99,9
15038,2022170523,"{'login': 'facebook-github-bot', 'id': 6422482, 'node_id': 'MDQ6VXNlcjY0MjI0ODI=', 'avatar_url': 'https://avatars3.githubusercontent.com/u/6422482?v=4', 'gravatar_id': '', 'url': 'https://api.github.com/users/facebook-github-bot', 'html_url': 'https://github.com/facebook-github-bot', 'followers_url': 'https://api.github.com/users/facebook-github-bot/followers', 'following_url': 'https://api.github.com/users/facebook-github-bot/following{/other_user}', 'gists_url': 'https://api.github.com/users/facebook-github-bot/gists{/gist_id}', 'starred_url': 'https://api.github.com/users/facebook-github-bot/starred{/owner}{/repo}', 'subscriptions_url': 'https://api.github.com/users/facebook-github-bot/subscriptions', 'organizations_url': 'https://api.github.com/users/facebook-github-bot/orgs', 'repos_url': 'https://api.github.com/users/facebook-github-bot/repos', 'events_url': 'https://api.github.com/users/facebook-github-bot/events{/privacy}', 'received_events_url': 'https://api.github.com/users/facebook-github-bot/received_events', 'type': 'User', 'site_admin': False}",closed,0ad39ec5c17864fc7aec2605c82fe82fba71e3c2,https://api.github.com/repos/pytorch/pytorch/commits/0ad39ec5c17864fc7aec2605c82fe82fba71e3c2,2018-12-12T17:41:22Z,29,28,1
15038,2083822227,"{'login': 'suo', 'id': 1617424, 'node_id': 'MDQ6VXNlcjE2MTc0MjQ=', 'avatar_url': 'https://avatars2.githubusercontent.com/u/1617424?v=4', 'gravatar_id': '', 'url': 'https://api.github.com/users/suo', 'html_url': 'https://github.com/suo', 'followers_url': 'https://api.github.com/users/suo/followers', 'following_url': 'https://api.github.com/users/suo/following{/other_user}', 'gists_url': 'https://api.github.com/users/suo/gists{/gist_id}', 'starred_url': 'https://api.github.com/users/suo/starred{/owner}{/repo}', 'subscriptions_url': 'https://api.github.com/users/suo/subscriptions', 'organizations_url': 'https://api.github.com/users/suo/orgs', 'repos_url': 'https://api.github.com/users/suo/repos', 'events_url': 'https://api.github.com/users/suo/events{/privacy}', 'received_events_url': 'https://api.github.com/users/suo/received_events', 'type': 'User', 'site_admin': False}",referenced,07a99c789b789f32be74f9d098b8a43418966e3a,https://api.github.com/repos/pytorch/pytorch/commits/07a99c789b789f32be74f9d098b8a43418966e3a,2019-01-18T20:03:58Z,29,28,1
15038,2084701947,"{'login': 'soumith', 'id': 1310570, 'node_id': 'MDQ6VXNlcjEzMTA1NzA=', 'avatar_url': 'https://avatars0.githubusercontent.com/u/1310570?v=4', 'gravatar_id': '', 'url': 'https://api.github.com/users/soumith', 'html_url': 'https://github.com/soumith', 'followers_url': 'https://api.github.com/users/soumith/followers', 'following_url': 'https://api.github.com/users/soumith/following{/other_user}', 'gists_url': 'https://api.github.com/users/soumith/gists{/gist_id}', 'starred_url': 'https://api.github.com/users/soumith/starred{/owner}{/repo}', 'subscriptions_url': 'https://api.github.com/users/soumith/subscriptions', 'organizations_url': 'https://api.github.com/users/soumith/orgs', 'repos_url': 'https://api.github.com/users/soumith/repos', 'events_url': 'https://api.github.com/users/soumith/events{/privacy}', 'received_events_url': 'https://api.github.com/users/soumith/received_events', 'type': 'User', 'site_admin': False}",referenced,b79fe7bf3e224bbd4c812a2617415bcb0738dd88,https://api.github.com/repos/pytorch/pytorch/commits/b79fe7bf3e224bbd4c812a2617415bcb0738dd88,2019-01-19T21:28:34Z,29,28,1
15038,2102600462,"{'login': 'soumith', 'id': 1310570, 'node_id': 'MDQ6VXNlcjEzMTA1NzA=', 'avatar_url': 'https://avatars0.githubusercontent.com/u/1310570?v=4', 'gravatar_id': '', 'url': 'https://api.github.com/users/soumith', 'html_url': 'https://github.com/soumith', 'followers_url': 'https://api.github.com/users/soumith/followers', 'following_url': 'https://api.github.com/users/soumith/following{/other_user}', 'gists_url': 'https://api.github.com/users/soumith/gists{/gist_id}', 'starred_url': 'https://api.github.com/users/soumith/starred{/owner}{/repo}', 'subscriptions_url': 'https://api.github.com/users/soumith/subscriptions', 'organizations_url': 'https://api.github.com/users/soumith/orgs', 'repos_url': 'https://api.github.com/users/soumith/repos', 'events_url': 'https://api.github.com/users/soumith/events{/privacy}', 'received_events_url': 'https://api.github.com/users/soumith/received_events', 'type': 'User', 'site_admin': False}",referenced,228f73e7a94e75613b8a7bdc1d58a60600805288,https://api.github.com/repos/pytorch/pytorch/commits/228f73e7a94e75613b8a7bdc1d58a60600805288,2019-01-29T04:12:51Z,29,28,1
15015,2025962864,"{'login': 'facebook-github-bot', 'id': 6422482, 'node_id': 'MDQ6VXNlcjY0MjI0ODI=', 'avatar_url': 'https://avatars3.githubusercontent.com/u/6422482?v=4', 'gravatar_id': '', 'url': 'https://api.github.com/users/facebook-github-bot', 'html_url': 'https://github.com/facebook-github-bot', 'followers_url': 'https://api.github.com/users/facebook-github-bot/followers', 'following_url': 'https://api.github.com/users/facebook-github-bot/following{/other_user}', 'gists_url': 'https://api.github.com/users/facebook-github-bot/gists{/gist_id}', 'starred_url': 'https://api.github.com/users/facebook-github-bot/starred{/owner}{/repo}', 'subscriptions_url': 'https://api.github.com/users/facebook-github-bot/subscriptions', 'organizations_url': 'https://api.github.com/users/facebook-github-bot/orgs', 'repos_url': 'https://api.github.com/users/facebook-github-bot/repos', 'events_url': 'https://api.github.com/users/facebook-github-bot/events{/privacy}', 'received_events_url': 'https://api.github.com/users/facebook-github-bot/received_events', 'type': 'User', 'site_admin': False}",closed,81644ed9abbc1690833ea4466a938c04ca584e65,https://api.github.com/repos/pytorch/pytorch/commits/81644ed9abbc1690833ea4466a938c04ca584e65,2018-12-14T04:34:16Z,9,6,3
15015,2083235765,"{'login': 'soumith', 'id': 1310570, 'node_id': 'MDQ6VXNlcjEzMTA1NzA=', 'avatar_url': 'https://avatars0.githubusercontent.com/u/1310570?v=4', 'gravatar_id': '', 'url': 'https://api.github.com/users/soumith', 'html_url': 'https://github.com/soumith', 'followers_url': 'https://api.github.com/users/soumith/followers', 'following_url': 'https://api.github.com/users/soumith/following{/other_user}', 'gists_url': 'https://api.github.com/users/soumith/gists{/gist_id}', 'starred_url': 'https://api.github.com/users/soumith/starred{/owner}{/repo}', 'subscriptions_url': 'https://api.github.com/users/soumith/subscriptions', 'organizations_url': 'https://api.github.com/users/soumith/orgs', 'repos_url': 'https://api.github.com/users/soumith/repos', 'events_url': 'https://api.github.com/users/soumith/events{/privacy}', 'received_events_url': 'https://api.github.com/users/soumith/received_events', 'type': 'User', 'site_admin': False}",referenced,7cc575e1ab7378e769fee7d3666729a89ac6284a,https://api.github.com/repos/pytorch/pytorch/commits/7cc575e1ab7378e769fee7d3666729a89ac6284a,2019-01-18T15:41:09Z,9,6,3
15015,2102600433,"{'login': 'soumith', 'id': 1310570, 'node_id': 'MDQ6VXNlcjEzMTA1NzA=', 'avatar_url': 'https://avatars0.githubusercontent.com/u/1310570?v=4', 'gravatar_id': '', 'url': 'https://api.github.com/users/soumith', 'html_url': 'https://github.com/soumith', 'followers_url': 'https://api.github.com/users/soumith/followers', 'following_url': 'https://api.github.com/users/soumith/following{/other_user}', 'gists_url': 'https://api.github.com/users/soumith/gists{/gist_id}', 'starred_url': 'https://api.github.com/users/soumith/starred{/owner}{/repo}', 'subscriptions_url': 'https://api.github.com/users/soumith/subscriptions', 'organizations_url': 'https://api.github.com/users/soumith/orgs', 'repos_url': 'https://api.github.com/users/soumith/repos', 'events_url': 'https://api.github.com/users/soumith/events{/privacy}', 'received_events_url': 'https://api.github.com/users/soumith/received_events', 'type': 'User', 'site_admin': False}",referenced,84cf1660d2e09edfacd3dbcdcb97993809a21eca,https://api.github.com/repos/pytorch/pytorch/commits/84cf1660d2e09edfacd3dbcdcb97993809a21eca,2019-01-29T04:12:50Z,9,6,3
14984,2019940122,"{'login': 'facebook-github-bot', 'id': 6422482, 'node_id': 'MDQ6VXNlcjY0MjI0ODI=', 'avatar_url': 'https://avatars3.githubusercontent.com/u/6422482?v=4', 'gravatar_id': '', 'url': 'https://api.github.com/users/facebook-github-bot', 'html_url': 'https://github.com/facebook-github-bot', 'followers_url': 'https://api.github.com/users/facebook-github-bot/followers', 'following_url': 'https://api.github.com/users/facebook-github-bot/following{/other_user}', 'gists_url': 'https://api.github.com/users/facebook-github-bot/gists{/gist_id}', 'starred_url': 'https://api.github.com/users/facebook-github-bot/starred{/owner}{/repo}', 'subscriptions_url': 'https://api.github.com/users/facebook-github-bot/subscriptions', 'organizations_url': 'https://api.github.com/users/facebook-github-bot/orgs', 'repos_url': 'https://api.github.com/users/facebook-github-bot/repos', 'events_url': 'https://api.github.com/users/facebook-github-bot/events{/privacy}', 'received_events_url': 'https://api.github.com/users/facebook-github-bot/received_events', 'type': 'User', 'site_admin': False}",referenced,04b65dfd1ff78cdda327aeb6ad33ce1bb444fb9d,https://api.github.com/repos/pytorch/pytorch/commits/04b65dfd1ff78cdda327aeb6ad33ce1bb444fb9d,2018-12-11T21:39:33Z,15,13,2
14984,2081563655,"{'login': 'soumith', 'id': 1310570, 'node_id': 'MDQ6VXNlcjEzMTA1NzA=', 'avatar_url': 'https://avatars0.githubusercontent.com/u/1310570?v=4', 'gravatar_id': '', 'url': 'https://api.github.com/users/soumith', 'html_url': 'https://github.com/soumith', 'followers_url': 'https://api.github.com/users/soumith/followers', 'following_url': 'https://api.github.com/users/soumith/following{/other_user}', 'gists_url': 'https://api.github.com/users/soumith/gists{/gist_id}', 'starred_url': 'https://api.github.com/users/soumith/starred{/owner}{/repo}', 'subscriptions_url': 'https://api.github.com/users/soumith/subscriptions', 'organizations_url': 'https://api.github.com/users/soumith/orgs', 'repos_url': 'https://api.github.com/users/soumith/repos', 'events_url': 'https://api.github.com/users/soumith/events{/privacy}', 'received_events_url': 'https://api.github.com/users/soumith/received_events', 'type': 'User', 'site_admin': False}",referenced,f6658bc8c286d74428f9b2246105ba1d6b7ac5d1,https://api.github.com/repos/pytorch/pytorch/commits/f6658bc8c286d74428f9b2246105ba1d6b7ac5d1,2019-01-17T22:31:56Z,15,13,2
14984,2081981261,"{'login': 'soumith', 'id': 1310570, 'node_id': 'MDQ6VXNlcjEzMTA1NzA=', 'avatar_url': 'https://avatars0.githubusercontent.com/u/1310570?v=4', 'gravatar_id': '', 'url': 'https://api.github.com/users/soumith', 'html_url': 'https://github.com/soumith', 'followers_url': 'https://api.github.com/users/soumith/followers', 'following_url': 'https://api.github.com/users/soumith/following{/other_user}', 'gists_url': 'https://api.github.com/users/soumith/gists{/gist_id}', 'starred_url': 'https://api.github.com/users/soumith/starred{/owner}{/repo}', 'subscriptions_url': 'https://api.github.com/users/soumith/subscriptions', 'organizations_url': 'https://api.github.com/users/soumith/orgs', 'repos_url': 'https://api.github.com/users/soumith/repos', 'events_url': 'https://api.github.com/users/soumith/events{/privacy}', 'received_events_url': 'https://api.github.com/users/soumith/received_events', 'type': 'User', 'site_admin': False}",referenced,95fd0afed5b0078ec3d9343c2d6690106dd5d2f2,https://api.github.com/repos/pytorch/pytorch/commits/95fd0afed5b0078ec3d9343c2d6690106dd5d2f2,2019-01-18T04:02:12Z,15,13,2
14960,2490503521,"{'login': 'ezyang', 'id': 13564, 'node_id': 'MDQ6VXNlcjEzNTY0', 'avatar_url': 'https://avatars0.githubusercontent.com/u/13564?v=4', 'gravatar_id': '', 'url': 'https://api.github.com/users/ezyang', 'html_url': 'https://github.com/ezyang', 'followers_url': 'https://api.github.com/users/ezyang/followers', 'following_url': 'https://api.github.com/users/ezyang/following{/other_user}', 'gists_url': 'https://api.github.com/users/ezyang/gists{/gist_id}', 'starred_url': 'https://api.github.com/users/ezyang/starred{/owner}{/repo}', 'subscriptions_url': 'https://api.github.com/users/ezyang/subscriptions', 'organizations_url': 'https://api.github.com/users/ezyang/orgs', 'repos_url': 'https://api.github.com/users/ezyang/repos', 'events_url': 'https://api.github.com/users/ezyang/events{/privacy}', 'received_events_url': 'https://api.github.com/users/ezyang/received_events', 'type': 'User', 'site_admin': False}",referenced,b119feb3b626bf2fba262b8e111b94270ca52440,https://api.github.com/repos/pytorch/pytorch/commits/b119feb3b626bf2fba262b8e111b94270ca52440,2019-07-17T18:42:17Z,135,98,37
14891,2020660015,"{'login': 'facebook-github-bot', 'id': 6422482, 'node_id': 'MDQ6VXNlcjY0MjI0ODI=', 'avatar_url': 'https://avatars3.githubusercontent.com/u/6422482?v=4', 'gravatar_id': '', 'url': 'https://api.github.com/users/facebook-github-bot', 'html_url': 'https://github.com/facebook-github-bot', 'followers_url': 'https://api.github.com/users/facebook-github-bot/followers', 'following_url': 'https://api.github.com/users/facebook-github-bot/following{/other_user}', 'gists_url': 'https://api.github.com/users/facebook-github-bot/gists{/gist_id}', 'starred_url': 'https://api.github.com/users/facebook-github-bot/starred{/owner}{/repo}', 'subscriptions_url': 'https://api.github.com/users/facebook-github-bot/subscriptions', 'organizations_url': 'https://api.github.com/users/facebook-github-bot/orgs', 'repos_url': 'https://api.github.com/users/facebook-github-bot/repos', 'events_url': 'https://api.github.com/users/facebook-github-bot/events{/privacy}', 'received_events_url': 'https://api.github.com/users/facebook-github-bot/received_events', 'type': 'User', 'site_admin': False}",closed,0dade9862c62a427e5d48d74b1316a079c107726,https://api.github.com/repos/pytorch/pytorch/commits/0dade9862c62a427e5d48d74b1316a079c107726,2018-12-12T06:45:00Z,90,69,21
14891,2081539299,"{'login': 'soumith', 'id': 1310570, 'node_id': 'MDQ6VXNlcjEzMTA1NzA=', 'avatar_url': 'https://avatars0.githubusercontent.com/u/1310570?v=4', 'gravatar_id': '', 'url': 'https://api.github.com/users/soumith', 'html_url': 'https://github.com/soumith', 'followers_url': 'https://api.github.com/users/soumith/followers', 'following_url': 'https://api.github.com/users/soumith/following{/other_user}', 'gists_url': 'https://api.github.com/users/soumith/gists{/gist_id}', 'starred_url': 'https://api.github.com/users/soumith/starred{/owner}{/repo}', 'subscriptions_url': 'https://api.github.com/users/soumith/subscriptions', 'organizations_url': 'https://api.github.com/users/soumith/orgs', 'repos_url': 'https://api.github.com/users/soumith/repos', 'events_url': 'https://api.github.com/users/soumith/events{/privacy}', 'received_events_url': 'https://api.github.com/users/soumith/received_events', 'type': 'User', 'site_admin': False}",referenced,f2c6806ffdefcad1f2689d5af16cffff27d47da1,https://api.github.com/repos/pytorch/pytorch/commits/f2c6806ffdefcad1f2689d5af16cffff27d47da1,2019-01-17T22:19:17Z,90,69,21
14891,2081981230,"{'login': 'soumith', 'id': 1310570, 'node_id': 'MDQ6VXNlcjEzMTA1NzA=', 'avatar_url': 'https://avatars0.githubusercontent.com/u/1310570?v=4', 'gravatar_id': '', 'url': 'https://api.github.com/users/soumith', 'html_url': 'https://github.com/soumith', 'followers_url': 'https://api.github.com/users/soumith/followers', 'following_url': 'https://api.github.com/users/soumith/following{/other_user}', 'gists_url': 'https://api.github.com/users/soumith/gists{/gist_id}', 'starred_url': 'https://api.github.com/users/soumith/starred{/owner}{/repo}', 'subscriptions_url': 'https://api.github.com/users/soumith/subscriptions', 'organizations_url': 'https://api.github.com/users/soumith/orgs', 'repos_url': 'https://api.github.com/users/soumith/repos', 'events_url': 'https://api.github.com/users/soumith/events{/privacy}', 'received_events_url': 'https://api.github.com/users/soumith/received_events', 'type': 'User', 'site_admin': False}",referenced,4909529584036cc989e6076db36fbba3a5bcacdc,https://api.github.com/repos/pytorch/pytorch/commits/4909529584036cc989e6076db36fbba3a5bcacdc,2019-01-18T04:02:12Z,90,69,21
14859,2012749599,"{'login': 'facebook-github-bot', 'id': 6422482, 'node_id': 'MDQ6VXNlcjY0MjI0ODI=', 'avatar_url': 'https://avatars3.githubusercontent.com/u/6422482?v=4', 'gravatar_id': '', 'url': 'https://api.github.com/users/facebook-github-bot', 'html_url': 'https://github.com/facebook-github-bot', 'followers_url': 'https://api.github.com/users/facebook-github-bot/followers', 'following_url': 'https://api.github.com/users/facebook-github-bot/following{/other_user}', 'gists_url': 'https://api.github.com/users/facebook-github-bot/gists{/gist_id}', 'starred_url': 'https://api.github.com/users/facebook-github-bot/starred{/owner}{/repo}', 'subscriptions_url': 'https://api.github.com/users/facebook-github-bot/subscriptions', 'organizations_url': 'https://api.github.com/users/facebook-github-bot/orgs', 'repos_url': 'https://api.github.com/users/facebook-github-bot/repos', 'events_url': 'https://api.github.com/users/facebook-github-bot/events{/privacy}', 'received_events_url': 'https://api.github.com/users/facebook-github-bot/received_events', 'type': 'User', 'site_admin': False}",closed,1c9df7facf1d280e72297654dbf32163e4f0e790,https://api.github.com/repos/pytorch/pytorch/commits/1c9df7facf1d280e72297654dbf32163e4f0e790,2018-12-07T15:44:32Z,2,2,0
14859,2083235779,"{'login': 'soumith', 'id': 1310570, 'node_id': 'MDQ6VXNlcjEzMTA1NzA=', 'avatar_url': 'https://avatars0.githubusercontent.com/u/1310570?v=4', 'gravatar_id': '', 'url': 'https://api.github.com/users/soumith', 'html_url': 'https://github.com/soumith', 'followers_url': 'https://api.github.com/users/soumith/followers', 'following_url': 'https://api.github.com/users/soumith/following{/other_user}', 'gists_url': 'https://api.github.com/users/soumith/gists{/gist_id}', 'starred_url': 'https://api.github.com/users/soumith/starred{/owner}{/repo}', 'subscriptions_url': 'https://api.github.com/users/soumith/subscriptions', 'organizations_url': 'https://api.github.com/users/soumith/orgs', 'repos_url': 'https://api.github.com/users/soumith/repos', 'events_url': 'https://api.github.com/users/soumith/events{/privacy}', 'received_events_url': 'https://api.github.com/users/soumith/received_events', 'type': 'User', 'site_admin': False}",referenced,ce1a3d9e91173bfef475b80be60e4454f848d95b,https://api.github.com/repos/pytorch/pytorch/commits/ce1a3d9e91173bfef475b80be60e4454f848d95b,2019-01-18T15:41:10Z,2,2,0
14859,2102600443,"{'login': 'soumith', 'id': 1310570, 'node_id': 'MDQ6VXNlcjEzMTA1NzA=', 'avatar_url': 'https://avatars0.githubusercontent.com/u/1310570?v=4', 'gravatar_id': '', 'url': 'https://api.github.com/users/soumith', 'html_url': 'https://github.com/soumith', 'followers_url': 'https://api.github.com/users/soumith/followers', 'following_url': 'https://api.github.com/users/soumith/following{/other_user}', 'gists_url': 'https://api.github.com/users/soumith/gists{/gist_id}', 'starred_url': 'https://api.github.com/users/soumith/starred{/owner}{/repo}', 'subscriptions_url': 'https://api.github.com/users/soumith/subscriptions', 'organizations_url': 'https://api.github.com/users/soumith/orgs', 'repos_url': 'https://api.github.com/users/soumith/repos', 'events_url': 'https://api.github.com/users/soumith/events{/privacy}', 'received_events_url': 'https://api.github.com/users/soumith/received_events', 'type': 'User', 'site_admin': False}",referenced,74433436e87d89415e424ff967632893a2431466,https://api.github.com/repos/pytorch/pytorch/commits/74433436e87d89415e424ff967632893a2431466,2019-01-29T04:12:50Z,2,2,0
14801,2029374042,"{'login': 'facebook-github-bot', 'id': 6422482, 'node_id': 'MDQ6VXNlcjY0MjI0ODI=', 'avatar_url': 'https://avatars3.githubusercontent.com/u/6422482?v=4', 'gravatar_id': '', 'url': 'https://api.github.com/users/facebook-github-bot', 'html_url': 'https://github.com/facebook-github-bot', 'followers_url': 'https://api.github.com/users/facebook-github-bot/followers', 'following_url': 'https://api.github.com/users/facebook-github-bot/following{/other_user}', 'gists_url': 'https://api.github.com/users/facebook-github-bot/gists{/gist_id}', 'starred_url': 'https://api.github.com/users/facebook-github-bot/starred{/owner}{/repo}', 'subscriptions_url': 'https://api.github.com/users/facebook-github-bot/subscriptions', 'organizations_url': 'https://api.github.com/users/facebook-github-bot/orgs', 'repos_url': 'https://api.github.com/users/facebook-github-bot/repos', 'events_url': 'https://api.github.com/users/facebook-github-bot/events{/privacy}', 'received_events_url': 'https://api.github.com/users/facebook-github-bot/received_events', 'type': 'User', 'site_admin': False}",closed,d71fac20ebf6b393e464d312b8a38ae1c45c3386,https://api.github.com/repos/pytorch/pytorch/commits/d71fac20ebf6b393e464d312b8a38ae1c45c3386,2018-12-17T05:55:00Z,58,34,24
14801,2077817073,"{'login': 'zou3519', 'id': 5652049, 'node_id': 'MDQ6VXNlcjU2NTIwNDk=', 'avatar_url': 'https://avatars3.githubusercontent.com/u/5652049?v=4', 'gravatar_id': '', 'url': 'https://api.github.com/users/zou3519', 'html_url': 'https://github.com/zou3519', 'followers_url': 'https://api.github.com/users/zou3519/followers', 'following_url': 'https://api.github.com/users/zou3519/following{/other_user}', 'gists_url': 'https://api.github.com/users/zou3519/gists{/gist_id}', 'starred_url': 'https://api.github.com/users/zou3519/starred{/owner}{/repo}', 'subscriptions_url': 'https://api.github.com/users/zou3519/subscriptions', 'organizations_url': 'https://api.github.com/users/zou3519/orgs', 'repos_url': 'https://api.github.com/users/zou3519/repos', 'events_url': 'https://api.github.com/users/zou3519/events{/privacy}', 'received_events_url': 'https://api.github.com/users/zou3519/received_events', 'type': 'User', 'site_admin': False}",referenced,a09b073e851b6bc69fabdb6cdc361b81129c787f,https://api.github.com/repos/pytorch/pytorch/commits/a09b073e851b6bc69fabdb6cdc361b81129c787f,2019-01-16T16:01:00Z,57,34,23
14732,2005605497,"{'login': 'facebook-github-bot', 'id': 6422482, 'node_id': 'MDQ6VXNlcjY0MjI0ODI=', 'avatar_url': 'https://avatars3.githubusercontent.com/u/6422482?v=4', 'gravatar_id': '', 'url': 'https://api.github.com/users/facebook-github-bot', 'html_url': 'https://github.com/facebook-github-bot', 'followers_url': 'https://api.github.com/users/facebook-github-bot/followers', 'following_url': 'https://api.github.com/users/facebook-github-bot/following{/other_user}', 'gists_url': 'https://api.github.com/users/facebook-github-bot/gists{/gist_id}', 'starred_url': 'https://api.github.com/users/facebook-github-bot/starred{/owner}{/repo}', 'subscriptions_url': 'https://api.github.com/users/facebook-github-bot/subscriptions', 'organizations_url': 'https://api.github.com/users/facebook-github-bot/orgs', 'repos_url': 'https://api.github.com/users/facebook-github-bot/repos', 'events_url': 'https://api.github.com/users/facebook-github-bot/events{/privacy}', 'received_events_url': 'https://api.github.com/users/facebook-github-bot/received_events', 'type': 'User', 'site_admin': False}",closed,2d56df7892ff6588da3fd079ee95d679644d6730,https://api.github.com/repos/pytorch/pytorch/commits/2d56df7892ff6588da3fd079ee95d679644d6730,2018-12-04T22:05:43Z,220,65,155
14727,2723419113,"{'login': 'facebook-github-bot', 'id': 6422482, 'node_id': 'MDQ6VXNlcjY0MjI0ODI=', 'avatar_url': 'https://avatars3.githubusercontent.com/u/6422482?v=4', 'gravatar_id': '', 'url': 'https://api.github.com/users/facebook-github-bot', 'html_url': 'https://github.com/facebook-github-bot', 'followers_url': 'https://api.github.com/users/facebook-github-bot/followers', 'following_url': 'https://api.github.com/users/facebook-github-bot/following{/other_user}', 'gists_url': 'https://api.github.com/users/facebook-github-bot/gists{/gist_id}', 'starred_url': 'https://api.github.com/users/facebook-github-bot/starred{/owner}{/repo}', 'subscriptions_url': 'https://api.github.com/users/facebook-github-bot/subscriptions', 'organizations_url': 'https://api.github.com/users/facebook-github-bot/orgs', 'repos_url': 'https://api.github.com/users/facebook-github-bot/repos', 'events_url': 'https://api.github.com/users/facebook-github-bot/events{/privacy}', 'received_events_url': 'https://api.github.com/users/facebook-github-bot/received_events', 'type': 'User', 'site_admin': False}",referenced,5498a15d1040d95d679b6bc2ca90ac95dc6c58e5,https://api.github.com/repos/pytorch/pytorch/commits/5498a15d1040d95d679b6bc2ca90ac95dc6c58e5,2019-10-18T03:39:20Z,29,17,12
14704,2019698862,"{'login': 'facebook-github-bot', 'id': 6422482, 'node_id': 'MDQ6VXNlcjY0MjI0ODI=', 'avatar_url': 'https://avatars3.githubusercontent.com/u/6422482?v=4', 'gravatar_id': '', 'url': 'https://api.github.com/users/facebook-github-bot', 'html_url': 'https://github.com/facebook-github-bot', 'followers_url': 'https://api.github.com/users/facebook-github-bot/followers', 'following_url': 'https://api.github.com/users/facebook-github-bot/following{/other_user}', 'gists_url': 'https://api.github.com/users/facebook-github-bot/gists{/gist_id}', 'starred_url': 'https://api.github.com/users/facebook-github-bot/starred{/owner}{/repo}', 'subscriptions_url': 'https://api.github.com/users/facebook-github-bot/subscriptions', 'organizations_url': 'https://api.github.com/users/facebook-github-bot/orgs', 'repos_url': 'https://api.github.com/users/facebook-github-bot/repos', 'events_url': 'https://api.github.com/users/facebook-github-bot/events{/privacy}', 'received_events_url': 'https://api.github.com/users/facebook-github-bot/received_events', 'type': 'User', 'site_admin': False}",closed,02d149b767e3f5f64a42d7305a8882d0b40fd5ea,https://api.github.com/repos/pytorch/pytorch/commits/02d149b767e3f5f64a42d7305a8882d0b40fd5ea,2018-12-11T19:48:33Z,53,30,23
14703,2008686353,"{'login': 'facebook-github-bot', 'id': 6422482, 'node_id': 'MDQ6VXNlcjY0MjI0ODI=', 'avatar_url': 'https://avatars3.githubusercontent.com/u/6422482?v=4', 'gravatar_id': '', 'url': 'https://api.github.com/users/facebook-github-bot', 'html_url': 'https://github.com/facebook-github-bot', 'followers_url': 'https://api.github.com/users/facebook-github-bot/followers', 'following_url': 'https://api.github.com/users/facebook-github-bot/following{/other_user}', 'gists_url': 'https://api.github.com/users/facebook-github-bot/gists{/gist_id}', 'starred_url': 'https://api.github.com/users/facebook-github-bot/starred{/owner}{/repo}', 'subscriptions_url': 'https://api.github.com/users/facebook-github-bot/subscriptions', 'organizations_url': 'https://api.github.com/users/facebook-github-bot/orgs', 'repos_url': 'https://api.github.com/users/facebook-github-bot/repos', 'events_url': 'https://api.github.com/users/facebook-github-bot/events{/privacy}', 'received_events_url': 'https://api.github.com/users/facebook-github-bot/received_events', 'type': 'User', 'site_admin': False}",closed,c02b3e7cea7e70d132cab164a8e875a330a081e7,https://api.github.com/repos/pytorch/pytorch/commits/c02b3e7cea7e70d132cab164a8e875a330a081e7,2018-12-06T01:11:22Z,1,1,0
14698,2490288971,"{'login': 'facebook-github-bot', 'id': 6422482, 'node_id': 'MDQ6VXNlcjY0MjI0ODI=', 'avatar_url': 'https://avatars3.githubusercontent.com/u/6422482?v=4', 'gravatar_id': '', 'url': 'https://api.github.com/users/facebook-github-bot', 'html_url': 'https://github.com/facebook-github-bot', 'followers_url': 'https://api.github.com/users/facebook-github-bot/followers', 'following_url': 'https://api.github.com/users/facebook-github-bot/following{/other_user}', 'gists_url': 'https://api.github.com/users/facebook-github-bot/gists{/gist_id}', 'starred_url': 'https://api.github.com/users/facebook-github-bot/starred{/owner}{/repo}', 'subscriptions_url': 'https://api.github.com/users/facebook-github-bot/subscriptions', 'organizations_url': 'https://api.github.com/users/facebook-github-bot/orgs', 'repos_url': 'https://api.github.com/users/facebook-github-bot/repos', 'events_url': 'https://api.github.com/users/facebook-github-bot/events{/privacy}', 'received_events_url': 'https://api.github.com/users/facebook-github-bot/received_events', 'type': 'User', 'site_admin': False}",closed,3c0814ffeb93a66dcd8893933cfecf9ab4721a26,https://api.github.com/repos/pytorch/pytorch/commits/3c0814ffeb93a66dcd8893933cfecf9ab4721a26,2019-07-17T17:53:18Z,228,118,110
14678,2002457737,"{'login': 'facebook-github-bot', 'id': 6422482, 'node_id': 'MDQ6VXNlcjY0MjI0ODI=', 'avatar_url': 'https://avatars3.githubusercontent.com/u/6422482?v=4', 'gravatar_id': '', 'url': 'https://api.github.com/users/facebook-github-bot', 'html_url': 'https://github.com/facebook-github-bot', 'followers_url': 'https://api.github.com/users/facebook-github-bot/followers', 'following_url': 'https://api.github.com/users/facebook-github-bot/following{/other_user}', 'gists_url': 'https://api.github.com/users/facebook-github-bot/gists{/gist_id}', 'starred_url': 'https://api.github.com/users/facebook-github-bot/starred{/owner}{/repo}', 'subscriptions_url': 'https://api.github.com/users/facebook-github-bot/subscriptions', 'organizations_url': 'https://api.github.com/users/facebook-github-bot/orgs', 'repos_url': 'https://api.github.com/users/facebook-github-bot/repos', 'events_url': 'https://api.github.com/users/facebook-github-bot/events{/privacy}', 'received_events_url': 'https://api.github.com/users/facebook-github-bot/received_events', 'type': 'User', 'site_admin': False}",closed,cac03280f973b7d4698678a863bd2f982491fd7e,https://api.github.com/repos/pytorch/pytorch/commits/cac03280f973b7d4698678a863bd2f982491fd7e,2018-12-03T20:06:14Z,47,31,16
14676,2000286866,"{'login': 'facebook-github-bot', 'id': 6422482, 'node_id': 'MDQ6VXNlcjY0MjI0ODI=', 'avatar_url': 'https://avatars3.githubusercontent.com/u/6422482?v=4', 'gravatar_id': '', 'url': 'https://api.github.com/users/facebook-github-bot', 'html_url': 'https://github.com/facebook-github-bot', 'followers_url': 'https://api.github.com/users/facebook-github-bot/followers', 'following_url': 'https://api.github.com/users/facebook-github-bot/following{/other_user}', 'gists_url': 'https://api.github.com/users/facebook-github-bot/gists{/gist_id}', 'starred_url': 'https://api.github.com/users/facebook-github-bot/starred{/owner}{/repo}', 'subscriptions_url': 'https://api.github.com/users/facebook-github-bot/subscriptions', 'organizations_url': 'https://api.github.com/users/facebook-github-bot/orgs', 'repos_url': 'https://api.github.com/users/facebook-github-bot/repos', 'events_url': 'https://api.github.com/users/facebook-github-bot/events{/privacy}', 'received_events_url': 'https://api.github.com/users/facebook-github-bot/received_events', 'type': 'User', 'site_admin': False}",referenced,74c3cbc013d61b3622faac7aaf21aff9b7adb360,https://api.github.com/repos/pytorch/pytorch/commits/74c3cbc013d61b3622faac7aaf21aff9b7adb360,2018-12-03T01:48:04Z,7,6,1
14676,2002113006,"{'login': 'facebook-github-bot', 'id': 6422482, 'node_id': 'MDQ6VXNlcjY0MjI0ODI=', 'avatar_url': 'https://avatars3.githubusercontent.com/u/6422482?v=4', 'gravatar_id': '', 'url': 'https://api.github.com/users/facebook-github-bot', 'html_url': 'https://github.com/facebook-github-bot', 'followers_url': 'https://api.github.com/users/facebook-github-bot/followers', 'following_url': 'https://api.github.com/users/facebook-github-bot/following{/other_user}', 'gists_url': 'https://api.github.com/users/facebook-github-bot/gists{/gist_id}', 'starred_url': 'https://api.github.com/users/facebook-github-bot/starred{/owner}{/repo}', 'subscriptions_url': 'https://api.github.com/users/facebook-github-bot/subscriptions', 'organizations_url': 'https://api.github.com/users/facebook-github-bot/orgs', 'repos_url': 'https://api.github.com/users/facebook-github-bot/repos', 'events_url': 'https://api.github.com/users/facebook-github-bot/events{/privacy}', 'received_events_url': 'https://api.github.com/users/facebook-github-bot/received_events', 'type': 'User', 'site_admin': False}",closed,7da2448d6276370edde67ef22582613d819de2c3,https://api.github.com/repos/pytorch/pytorch/commits/7da2448d6276370edde67ef22582613d819de2c3,2018-12-03T17:43:14Z,61,56,5
14674,2004880720,"{'login': 'facebook-github-bot', 'id': 6422482, 'node_id': 'MDQ6VXNlcjY0MjI0ODI=', 'avatar_url': 'https://avatars3.githubusercontent.com/u/6422482?v=4', 'gravatar_id': '', 'url': 'https://api.github.com/users/facebook-github-bot', 'html_url': 'https://github.com/facebook-github-bot', 'followers_url': 'https://api.github.com/users/facebook-github-bot/followers', 'following_url': 'https://api.github.com/users/facebook-github-bot/following{/other_user}', 'gists_url': 'https://api.github.com/users/facebook-github-bot/gists{/gist_id}', 'starred_url': 'https://api.github.com/users/facebook-github-bot/starred{/owner}{/repo}', 'subscriptions_url': 'https://api.github.com/users/facebook-github-bot/subscriptions', 'organizations_url': 'https://api.github.com/users/facebook-github-bot/orgs', 'repos_url': 'https://api.github.com/users/facebook-github-bot/repos', 'events_url': 'https://api.github.com/users/facebook-github-bot/events{/privacy}', 'received_events_url': 'https://api.github.com/users/facebook-github-bot/received_events', 'type': 'User', 'site_admin': False}",closed,7bc489c827b4b1924901520e1e03b04ecfb88471,https://api.github.com/repos/pytorch/pytorch/commits/7bc489c827b4b1924901520e1e03b04ecfb88471,2018-12-04T16:57:34Z,4,3,1
14673,2007630332,"{'login': 'facebook-github-bot', 'id': 6422482, 'node_id': 'MDQ6VXNlcjY0MjI0ODI=', 'avatar_url': 'https://avatars3.githubusercontent.com/u/6422482?v=4', 'gravatar_id': '', 'url': 'https://api.github.com/users/facebook-github-bot', 'html_url': 'https://github.com/facebook-github-bot', 'followers_url': 'https://api.github.com/users/facebook-github-bot/followers', 'following_url': 'https://api.github.com/users/facebook-github-bot/following{/other_user}', 'gists_url': 'https://api.github.com/users/facebook-github-bot/gists{/gist_id}', 'starred_url': 'https://api.github.com/users/facebook-github-bot/starred{/owner}{/repo}', 'subscriptions_url': 'https://api.github.com/users/facebook-github-bot/subscriptions', 'organizations_url': 'https://api.github.com/users/facebook-github-bot/orgs', 'repos_url': 'https://api.github.com/users/facebook-github-bot/repos', 'events_url': 'https://api.github.com/users/facebook-github-bot/events{/privacy}', 'received_events_url': 'https://api.github.com/users/facebook-github-bot/received_events', 'type': 'User', 'site_admin': False}",closed,2d958b7f7745acbe6bd72a4de1781b0b16861095,https://api.github.com/repos/pytorch/pytorch/commits/2d958b7f7745acbe6bd72a4de1781b0b16861095,2018-12-05T16:35:44Z,12,11,1
14663,1999753404,"{'login': 'facebook-github-bot', 'id': 6422482, 'node_id': 'MDQ6VXNlcjY0MjI0ODI=', 'avatar_url': 'https://avatars3.githubusercontent.com/u/6422482?v=4', 'gravatar_id': '', 'url': 'https://api.github.com/users/facebook-github-bot', 'html_url': 'https://github.com/facebook-github-bot', 'followers_url': 'https://api.github.com/users/facebook-github-bot/followers', 'following_url': 'https://api.github.com/users/facebook-github-bot/following{/other_user}', 'gists_url': 'https://api.github.com/users/facebook-github-bot/gists{/gist_id}', 'starred_url': 'https://api.github.com/users/facebook-github-bot/starred{/owner}{/repo}', 'subscriptions_url': 'https://api.github.com/users/facebook-github-bot/subscriptions', 'organizations_url': 'https://api.github.com/users/facebook-github-bot/orgs', 'repos_url': 'https://api.github.com/users/facebook-github-bot/repos', 'events_url': 'https://api.github.com/users/facebook-github-bot/events{/privacy}', 'received_events_url': 'https://api.github.com/users/facebook-github-bot/received_events', 'type': 'User', 'site_admin': False}",closed,35c8f93fd238d42aaea8fd6e730c3da9e18257cc,https://api.github.com/repos/pytorch/pytorch/commits/35c8f93fd238d42aaea8fd6e730c3da9e18257cc,2018-12-02T00:52:25Z,8,8,0
14610,2004825076,"{'login': 'facebook-github-bot', 'id': 6422482, 'node_id': 'MDQ6VXNlcjY0MjI0ODI=', 'avatar_url': 'https://avatars3.githubusercontent.com/u/6422482?v=4', 'gravatar_id': '', 'url': 'https://api.github.com/users/facebook-github-bot', 'html_url': 'https://github.com/facebook-github-bot', 'followers_url': 'https://api.github.com/users/facebook-github-bot/followers', 'following_url': 'https://api.github.com/users/facebook-github-bot/following{/other_user}', 'gists_url': 'https://api.github.com/users/facebook-github-bot/gists{/gist_id}', 'starred_url': 'https://api.github.com/users/facebook-github-bot/starred{/owner}{/repo}', 'subscriptions_url': 'https://api.github.com/users/facebook-github-bot/subscriptions', 'organizations_url': 'https://api.github.com/users/facebook-github-bot/orgs', 'repos_url': 'https://api.github.com/users/facebook-github-bot/repos', 'events_url': 'https://api.github.com/users/facebook-github-bot/events{/privacy}', 'received_events_url': 'https://api.github.com/users/facebook-github-bot/received_events', 'type': 'User', 'site_admin': False}",closed,86ffc2a5f1f004f586526e4c2a7c2f11ed9ea633,https://api.github.com/repos/pytorch/pytorch/commits/86ffc2a5f1f004f586526e4c2a7c2f11ed9ea633,2018-12-04T16:38:56Z,4,2,2
14590,1997041393,"{'login': 'facebook-github-bot', 'id': 6422482, 'node_id': 'MDQ6VXNlcjY0MjI0ODI=', 'avatar_url': 'https://avatars3.githubusercontent.com/u/6422482?v=4', 'gravatar_id': '', 'url': 'https://api.github.com/users/facebook-github-bot', 'html_url': 'https://github.com/facebook-github-bot', 'followers_url': 'https://api.github.com/users/facebook-github-bot/followers', 'following_url': 'https://api.github.com/users/facebook-github-bot/following{/other_user}', 'gists_url': 'https://api.github.com/users/facebook-github-bot/gists{/gist_id}', 'starred_url': 'https://api.github.com/users/facebook-github-bot/starred{/owner}{/repo}', 'subscriptions_url': 'https://api.github.com/users/facebook-github-bot/subscriptions', 'organizations_url': 'https://api.github.com/users/facebook-github-bot/orgs', 'repos_url': 'https://api.github.com/users/facebook-github-bot/repos', 'events_url': 'https://api.github.com/users/facebook-github-bot/events{/privacy}', 'received_events_url': 'https://api.github.com/users/facebook-github-bot/received_events', 'type': 'User', 'site_admin': False}",closed,1975917d0e6ba5580b2f14cfa8dd70b2592c6d3b,https://api.github.com/repos/pytorch/pytorch/commits/1975917d0e6ba5580b2f14cfa8dd70b2592c6d3b,2018-11-30T04:33:30Z,10,9,1
14582,2143759286,"{'login': 'facebook-github-bot', 'id': 6422482, 'node_id': 'MDQ6VXNlcjY0MjI0ODI=', 'avatar_url': 'https://avatars3.githubusercontent.com/u/6422482?v=4', 'gravatar_id': '', 'url': 'https://api.github.com/users/facebook-github-bot', 'html_url': 'https://github.com/facebook-github-bot', 'followers_url': 'https://api.github.com/users/facebook-github-bot/followers', 'following_url': 'https://api.github.com/users/facebook-github-bot/following{/other_user}', 'gists_url': 'https://api.github.com/users/facebook-github-bot/gists{/gist_id}', 'starred_url': 'https://api.github.com/users/facebook-github-bot/starred{/owner}{/repo}', 'subscriptions_url': 'https://api.github.com/users/facebook-github-bot/subscriptions', 'organizations_url': 'https://api.github.com/users/facebook-github-bot/orgs', 'repos_url': 'https://api.github.com/users/facebook-github-bot/repos', 'events_url': 'https://api.github.com/users/facebook-github-bot/events{/privacy}', 'received_events_url': 'https://api.github.com/users/facebook-github-bot/received_events', 'type': 'User', 'site_admin': False}",referenced,1cdcdd78af84ee60777db9b8cd0fc9bb7d441975,https://api.github.com/repos/pytorch/pytorch/commits/1cdcdd78af84ee60777db9b8cd0fc9bb7d441975,2019-02-15T22:59:54Z,486,475,11
14571,2392461418,"{'login': 'facebook-github-bot', 'id': 6422482, 'node_id': 'MDQ6VXNlcjY0MjI0ODI=', 'avatar_url': 'https://avatars3.githubusercontent.com/u/6422482?v=4', 'gravatar_id': '', 'url': 'https://api.github.com/users/facebook-github-bot', 'html_url': 'https://github.com/facebook-github-bot', 'followers_url': 'https://api.github.com/users/facebook-github-bot/followers', 'following_url': 'https://api.github.com/users/facebook-github-bot/following{/other_user}', 'gists_url': 'https://api.github.com/users/facebook-github-bot/gists{/gist_id}', 'starred_url': 'https://api.github.com/users/facebook-github-bot/starred{/owner}{/repo}', 'subscriptions_url': 'https://api.github.com/users/facebook-github-bot/subscriptions', 'organizations_url': 'https://api.github.com/users/facebook-github-bot/orgs', 'repos_url': 'https://api.github.com/users/facebook-github-bot/repos', 'events_url': 'https://api.github.com/users/facebook-github-bot/events{/privacy}', 'received_events_url': 'https://api.github.com/users/facebook-github-bot/received_events', 'type': 'User', 'site_admin': False}",referenced,793b3026534aa284f743886fc3c3ae936b5c1a98,https://api.github.com/repos/pytorch/pytorch/commits/793b3026534aa284f743886fc3c3ae936b5c1a98,2019-06-05T20:38:33Z,2,2,0
14555,2008697349,"{'login': 'facebook-github-bot', 'id': 6422482, 'node_id': 'MDQ6VXNlcjY0MjI0ODI=', 'avatar_url': 'https://avatars3.githubusercontent.com/u/6422482?v=4', 'gravatar_id': '', 'url': 'https://api.github.com/users/facebook-github-bot', 'html_url': 'https://github.com/facebook-github-bot', 'followers_url': 'https://api.github.com/users/facebook-github-bot/followers', 'following_url': 'https://api.github.com/users/facebook-github-bot/following{/other_user}', 'gists_url': 'https://api.github.com/users/facebook-github-bot/gists{/gist_id}', 'starred_url': 'https://api.github.com/users/facebook-github-bot/starred{/owner}{/repo}', 'subscriptions_url': 'https://api.github.com/users/facebook-github-bot/subscriptions', 'organizations_url': 'https://api.github.com/users/facebook-github-bot/orgs', 'repos_url': 'https://api.github.com/users/facebook-github-bot/repos', 'events_url': 'https://api.github.com/users/facebook-github-bot/events{/privacy}', 'received_events_url': 'https://api.github.com/users/facebook-github-bot/received_events', 'type': 'User', 'site_admin': False}",closed,67dcf10631d4854657d3f42e4c7611567039c44c,https://api.github.com/repos/pytorch/pytorch/commits/67dcf10631d4854657d3f42e4c7611567039c44c,2018-12-06T01:19:40Z,2,1,1
14537,1997250284,"{'login': 'facebook-github-bot', 'id': 6422482, 'node_id': 'MDQ6VXNlcjY0MjI0ODI=', 'avatar_url': 'https://avatars3.githubusercontent.com/u/6422482?v=4', 'gravatar_id': '', 'url': 'https://api.github.com/users/facebook-github-bot', 'html_url': 'https://github.com/facebook-github-bot', 'followers_url': 'https://api.github.com/users/facebook-github-bot/followers', 'following_url': 'https://api.github.com/users/facebook-github-bot/following{/other_user}', 'gists_url': 'https://api.github.com/users/facebook-github-bot/gists{/gist_id}', 'starred_url': 'https://api.github.com/users/facebook-github-bot/starred{/owner}{/repo}', 'subscriptions_url': 'https://api.github.com/users/facebook-github-bot/subscriptions', 'organizations_url': 'https://api.github.com/users/facebook-github-bot/orgs', 'repos_url': 'https://api.github.com/users/facebook-github-bot/repos', 'events_url': 'https://api.github.com/users/facebook-github-bot/events{/privacy}', 'received_events_url': 'https://api.github.com/users/facebook-github-bot/received_events', 'type': 'User', 'site_admin': False}",referenced,37627a182ba7af6ee388338d06af5c69d7ba6c59,https://api.github.com/repos/pytorch/pytorch/commits/37627a182ba7af6ee388338d06af5c69d7ba6c59,2018-11-30T07:37:55Z,9,7,2
14536,1997105316,"{'login': 'facebook-github-bot', 'id': 6422482, 'node_id': 'MDQ6VXNlcjY0MjI0ODI=', 'avatar_url': 'https://avatars3.githubusercontent.com/u/6422482?v=4', 'gravatar_id': '', 'url': 'https://api.github.com/users/facebook-github-bot', 'html_url': 'https://github.com/facebook-github-bot', 'followers_url': 'https://api.github.com/users/facebook-github-bot/followers', 'following_url': 'https://api.github.com/users/facebook-github-bot/following{/other_user}', 'gists_url': 'https://api.github.com/users/facebook-github-bot/gists{/gist_id}', 'starred_url': 'https://api.github.com/users/facebook-github-bot/starred{/owner}{/repo}', 'subscriptions_url': 'https://api.github.com/users/facebook-github-bot/subscriptions', 'organizations_url': 'https://api.github.com/users/facebook-github-bot/orgs', 'repos_url': 'https://api.github.com/users/facebook-github-bot/repos', 'events_url': 'https://api.github.com/users/facebook-github-bot/events{/privacy}', 'received_events_url': 'https://api.github.com/users/facebook-github-bot/received_events', 'type': 'User', 'site_admin': False}",closed,11ef5191ff1336b30aaba5971cfde007ba9f18ea,https://api.github.com/repos/pytorch/pytorch/commits/11ef5191ff1336b30aaba5971cfde007ba9f18ea,2018-11-30T05:40:40Z,55,21,34
14528,1997008093,"{'login': 'facebook-github-bot', 'id': 6422482, 'node_id': 'MDQ6VXNlcjY0MjI0ODI=', 'avatar_url': 'https://avatars3.githubusercontent.com/u/6422482?v=4', 'gravatar_id': '', 'url': 'https://api.github.com/users/facebook-github-bot', 'html_url': 'https://github.com/facebook-github-bot', 'followers_url': 'https://api.github.com/users/facebook-github-bot/followers', 'following_url': 'https://api.github.com/users/facebook-github-bot/following{/other_user}', 'gists_url': 'https://api.github.com/users/facebook-github-bot/gists{/gist_id}', 'starred_url': 'https://api.github.com/users/facebook-github-bot/starred{/owner}{/repo}', 'subscriptions_url': 'https://api.github.com/users/facebook-github-bot/subscriptions', 'organizations_url': 'https://api.github.com/users/facebook-github-bot/orgs', 'repos_url': 'https://api.github.com/users/facebook-github-bot/repos', 'events_url': 'https://api.github.com/users/facebook-github-bot/events{/privacy}', 'received_events_url': 'https://api.github.com/users/facebook-github-bot/received_events', 'type': 'User', 'site_admin': False}",referenced,9127ab386602d5b6509246332e71c63e6b741a25,https://api.github.com/repos/pytorch/pytorch/commits/9127ab386602d5b6509246332e71c63e6b741a25,2018-11-30T03:59:23Z,106,88,18
14507,2047685473,"{'login': 'facebook-github-bot', 'id': 6422482, 'node_id': 'MDQ6VXNlcjY0MjI0ODI=', 'avatar_url': 'https://avatars3.githubusercontent.com/u/6422482?v=4', 'gravatar_id': '', 'url': 'https://api.github.com/users/facebook-github-bot', 'html_url': 'https://github.com/facebook-github-bot', 'followers_url': 'https://api.github.com/users/facebook-github-bot/followers', 'following_url': 'https://api.github.com/users/facebook-github-bot/following{/other_user}', 'gists_url': 'https://api.github.com/users/facebook-github-bot/gists{/gist_id}', 'starred_url': 'https://api.github.com/users/facebook-github-bot/starred{/owner}{/repo}', 'subscriptions_url': 'https://api.github.com/users/facebook-github-bot/subscriptions', 'organizations_url': 'https://api.github.com/users/facebook-github-bot/orgs', 'repos_url': 'https://api.github.com/users/facebook-github-bot/repos', 'events_url': 'https://api.github.com/users/facebook-github-bot/events{/privacy}', 'received_events_url': 'https://api.github.com/users/facebook-github-bot/received_events', 'type': 'User', 'site_admin': False}",closed,fb22f76eb6eae224469493b26d88b87fe5455fa7,https://api.github.com/repos/pytorch/pytorch/commits/fb22f76eb6eae224469493b26d88b87fe5455fa7,2018-12-28T20:28:10Z,28,24,4
14502,1994233034,"{'login': 'facebook-github-bot', 'id': 6422482, 'node_id': 'MDQ6VXNlcjY0MjI0ODI=', 'avatar_url': 'https://avatars3.githubusercontent.com/u/6422482?v=4', 'gravatar_id': '', 'url': 'https://api.github.com/users/facebook-github-bot', 'html_url': 'https://github.com/facebook-github-bot', 'followers_url': 'https://api.github.com/users/facebook-github-bot/followers', 'following_url': 'https://api.github.com/users/facebook-github-bot/following{/other_user}', 'gists_url': 'https://api.github.com/users/facebook-github-bot/gists{/gist_id}', 'starred_url': 'https://api.github.com/users/facebook-github-bot/starred{/owner}{/repo}', 'subscriptions_url': 'https://api.github.com/users/facebook-github-bot/subscriptions', 'organizations_url': 'https://api.github.com/users/facebook-github-bot/orgs', 'repos_url': 'https://api.github.com/users/facebook-github-bot/repos', 'events_url': 'https://api.github.com/users/facebook-github-bot/events{/privacy}', 'received_events_url': 'https://api.github.com/users/facebook-github-bot/received_events', 'type': 'User', 'site_admin': False}",closed,db15f2e13f58823f487639f7934e3c21d0a2864d,https://api.github.com/repos/pytorch/pytorch/commits/db15f2e13f58823f487639f7934e3c21d0a2864d,2018-11-29T04:29:10Z,2,1,1
14501,2097611023,"{'login': 'facebook-github-bot', 'id': 6422482, 'node_id': 'MDQ6VXNlcjY0MjI0ODI=', 'avatar_url': 'https://avatars3.githubusercontent.com/u/6422482?v=4', 'gravatar_id': '', 'url': 'https://api.github.com/users/facebook-github-bot', 'html_url': 'https://github.com/facebook-github-bot', 'followers_url': 'https://api.github.com/users/facebook-github-bot/followers', 'following_url': 'https://api.github.com/users/facebook-github-bot/following{/other_user}', 'gists_url': 'https://api.github.com/users/facebook-github-bot/gists{/gist_id}', 'starred_url': 'https://api.github.com/users/facebook-github-bot/starred{/owner}{/repo}', 'subscriptions_url': 'https://api.github.com/users/facebook-github-bot/subscriptions', 'organizations_url': 'https://api.github.com/users/facebook-github-bot/orgs', 'repos_url': 'https://api.github.com/users/facebook-github-bot/repos', 'events_url': 'https://api.github.com/users/facebook-github-bot/events{/privacy}', 'received_events_url': 'https://api.github.com/users/facebook-github-bot/received_events', 'type': 'User', 'site_admin': False}",closed,4aae89fa7ba9f47cfa1cd20d19aca03a33e6ea2f,https://api.github.com/repos/pytorch/pytorch/commits/4aae89fa7ba9f47cfa1cd20d19aca03a33e6ea2f,2019-01-25T16:26:47Z,76,37,39
14501,2255987467,"{'login': 'ezyang', 'id': 13564, 'node_id': 'MDQ6VXNlcjEzNTY0', 'avatar_url': 'https://avatars0.githubusercontent.com/u/13564?v=4', 'gravatar_id': '', 'url': 'https://api.github.com/users/ezyang', 'html_url': 'https://github.com/ezyang', 'followers_url': 'https://api.github.com/users/ezyang/followers', 'following_url': 'https://api.github.com/users/ezyang/following{/other_user}', 'gists_url': 'https://api.github.com/users/ezyang/gists{/gist_id}', 'starred_url': 'https://api.github.com/users/ezyang/starred{/owner}{/repo}', 'subscriptions_url': 'https://api.github.com/users/ezyang/subscriptions', 'organizations_url': 'https://api.github.com/users/ezyang/orgs', 'repos_url': 'https://api.github.com/users/ezyang/repos', 'events_url': 'https://api.github.com/users/ezyang/events{/privacy}', 'received_events_url': 'https://api.github.com/users/ezyang/received_events', 'type': 'User', 'site_admin': False}",referenced,7da5e523e97d9fe37a16dde43b3380ed81da6e93,https://api.github.com/repos/pytorch/pytorch/commits/7da5e523e97d9fe37a16dde43b3380ed81da6e93,2019-04-05T14:29:39Z,1,1,0
14501,2255987849,"{'login': 'ezyang', 'id': 13564, 'node_id': 'MDQ6VXNlcjEzNTY0', 'avatar_url': 'https://avatars0.githubusercontent.com/u/13564?v=4', 'gravatar_id': '', 'url': 'https://api.github.com/users/ezyang', 'html_url': 'https://github.com/ezyang', 'followers_url': 'https://api.github.com/users/ezyang/followers', 'following_url': 'https://api.github.com/users/ezyang/following{/other_user}', 'gists_url': 'https://api.github.com/users/ezyang/gists{/gist_id}', 'starred_url': 'https://api.github.com/users/ezyang/starred{/owner}{/repo}', 'subscriptions_url': 'https://api.github.com/users/ezyang/subscriptions', 'organizations_url': 'https://api.github.com/users/ezyang/orgs', 'repos_url': 'https://api.github.com/users/ezyang/repos', 'events_url': 'https://api.github.com/users/ezyang/events{/privacy}', 'received_events_url': 'https://api.github.com/users/ezyang/received_events', 'type': 'User', 'site_admin': False}",referenced,27bd575fd3c73a51ace1360aa020fa63a792a5d2,https://api.github.com/repos/pytorch/pytorch/commits/27bd575fd3c73a51ace1360aa020fa63a792a5d2,2019-04-05T14:29:45Z,1,1,0
14501,2258451169,"{'login': 'ezyang', 'id': 13564, 'node_id': 'MDQ6VXNlcjEzNTY0', 'avatar_url': 'https://avatars0.githubusercontent.com/u/13564?v=4', 'gravatar_id': '', 'url': 'https://api.github.com/users/ezyang', 'html_url': 'https://github.com/ezyang', 'followers_url': 'https://api.github.com/users/ezyang/followers', 'following_url': 'https://api.github.com/users/ezyang/following{/other_user}', 'gists_url': 'https://api.github.com/users/ezyang/gists{/gist_id}', 'starred_url': 'https://api.github.com/users/ezyang/starred{/owner}{/repo}', 'subscriptions_url': 'https://api.github.com/users/ezyang/subscriptions', 'organizations_url': 'https://api.github.com/users/ezyang/orgs', 'repos_url': 'https://api.github.com/users/ezyang/repos', 'events_url': 'https://api.github.com/users/ezyang/events{/privacy}', 'received_events_url': 'https://api.github.com/users/ezyang/received_events', 'type': 'User', 'site_admin': False}",referenced,fadfe1588fd7c8e278bbb2080914cc7107a28c37,https://api.github.com/repos/pytorch/pytorch/commits/fadfe1588fd7c8e278bbb2080914cc7107a28c37,2019-04-08T04:03:07Z,388,269,119
14483,1996407146,"{'login': 'facebook-github-bot', 'id': 6422482, 'node_id': 'MDQ6VXNlcjY0MjI0ODI=', 'avatar_url': 'https://avatars3.githubusercontent.com/u/6422482?v=4', 'gravatar_id': '', 'url': 'https://api.github.com/users/facebook-github-bot', 'html_url': 'https://github.com/facebook-github-bot', 'followers_url': 'https://api.github.com/users/facebook-github-bot/followers', 'following_url': 'https://api.github.com/users/facebook-github-bot/following{/other_user}', 'gists_url': 'https://api.github.com/users/facebook-github-bot/gists{/gist_id}', 'starred_url': 'https://api.github.com/users/facebook-github-bot/starred{/owner}{/repo}', 'subscriptions_url': 'https://api.github.com/users/facebook-github-bot/subscriptions', 'organizations_url': 'https://api.github.com/users/facebook-github-bot/orgs', 'repos_url': 'https://api.github.com/users/facebook-github-bot/repos', 'events_url': 'https://api.github.com/users/facebook-github-bot/events{/privacy}', 'received_events_url': 'https://api.github.com/users/facebook-github-bot/received_events', 'type': 'User', 'site_admin': False}",closed,31b3d81714653750129a120f6bcf1de34187f40a,https://api.github.com/repos/pytorch/pytorch/commits/31b3d81714653750129a120f6bcf1de34187f40a,2018-11-29T21:06:39Z,27,26,1
14483,2002683246,"{'login': 'facebook-github-bot', 'id': 6422482, 'node_id': 'MDQ6VXNlcjY0MjI0ODI=', 'avatar_url': 'https://avatars3.githubusercontent.com/u/6422482?v=4', 'gravatar_id': '', 'url': 'https://api.github.com/users/facebook-github-bot', 'html_url': 'https://github.com/facebook-github-bot', 'followers_url': 'https://api.github.com/users/facebook-github-bot/followers', 'following_url': 'https://api.github.com/users/facebook-github-bot/following{/other_user}', 'gists_url': 'https://api.github.com/users/facebook-github-bot/gists{/gist_id}', 'starred_url': 'https://api.github.com/users/facebook-github-bot/starred{/owner}{/repo}', 'subscriptions_url': 'https://api.github.com/users/facebook-github-bot/subscriptions', 'organizations_url': 'https://api.github.com/users/facebook-github-bot/orgs', 'repos_url': 'https://api.github.com/users/facebook-github-bot/repos', 'events_url': 'https://api.github.com/users/facebook-github-bot/events{/privacy}', 'received_events_url': 'https://api.github.com/users/facebook-github-bot/received_events', 'type': 'User', 'site_admin': False}",referenced,68ffe469918a5eaa014e230efe81af9c298857aa,https://api.github.com/repos/pytorch/pytorch/commits/68ffe469918a5eaa014e230efe81af9c298857aa,2018-12-03T21:46:03Z,890,536,354
14483,2003562796,"{'login': 'facebook-github-bot', 'id': 6422482, 'node_id': 'MDQ6VXNlcjY0MjI0ODI=', 'avatar_url': 'https://avatars3.githubusercontent.com/u/6422482?v=4', 'gravatar_id': '', 'url': 'https://api.github.com/users/facebook-github-bot', 'html_url': 'https://github.com/facebook-github-bot', 'followers_url': 'https://api.github.com/users/facebook-github-bot/followers', 'following_url': 'https://api.github.com/users/facebook-github-bot/following{/other_user}', 'gists_url': 'https://api.github.com/users/facebook-github-bot/gists{/gist_id}', 'starred_url': 'https://api.github.com/users/facebook-github-bot/starred{/owner}{/repo}', 'subscriptions_url': 'https://api.github.com/users/facebook-github-bot/subscriptions', 'organizations_url': 'https://api.github.com/users/facebook-github-bot/orgs', 'repos_url': 'https://api.github.com/users/facebook-github-bot/repos', 'events_url': 'https://api.github.com/users/facebook-github-bot/events{/privacy}', 'received_events_url': 'https://api.github.com/users/facebook-github-bot/received_events', 'type': 'User', 'site_admin': False}",referenced,8812a5d42e7be858334a4f5bd6acc7e6e942815f,https://api.github.com/repos/pytorch/pytorch/commits/8812a5d42e7be858334a4f5bd6acc7e6e942815f,2018-12-04T08:17:55Z,890,536,354
14470,2004550748,"{'login': 'facebook-github-bot', 'id': 6422482, 'node_id': 'MDQ6VXNlcjY0MjI0ODI=', 'avatar_url': 'https://avatars3.githubusercontent.com/u/6422482?v=4', 'gravatar_id': '', 'url': 'https://api.github.com/users/facebook-github-bot', 'html_url': 'https://github.com/facebook-github-bot', 'followers_url': 'https://api.github.com/users/facebook-github-bot/followers', 'following_url': 'https://api.github.com/users/facebook-github-bot/following{/other_user}', 'gists_url': 'https://api.github.com/users/facebook-github-bot/gists{/gist_id}', 'starred_url': 'https://api.github.com/users/facebook-github-bot/starred{/owner}{/repo}', 'subscriptions_url': 'https://api.github.com/users/facebook-github-bot/subscriptions', 'organizations_url': 'https://api.github.com/users/facebook-github-bot/orgs', 'repos_url': 'https://api.github.com/users/facebook-github-bot/repos', 'events_url': 'https://api.github.com/users/facebook-github-bot/events{/privacy}', 'received_events_url': 'https://api.github.com/users/facebook-github-bot/received_events', 'type': 'User', 'site_admin': False}",closed,1921816f85b6db978175de5029bab03f29718d8d,https://api.github.com/repos/pytorch/pytorch/commits/1921816f85b6db978175de5029bab03f29718d8d,2018-12-04T15:08:59Z,30,12,18
14446,1996936676,"{'login': 'facebook-github-bot', 'id': 6422482, 'node_id': 'MDQ6VXNlcjY0MjI0ODI=', 'avatar_url': 'https://avatars3.githubusercontent.com/u/6422482?v=4', 'gravatar_id': '', 'url': 'https://api.github.com/users/facebook-github-bot', 'html_url': 'https://github.com/facebook-github-bot', 'followers_url': 'https://api.github.com/users/facebook-github-bot/followers', 'following_url': 'https://api.github.com/users/facebook-github-bot/following{/other_user}', 'gists_url': 'https://api.github.com/users/facebook-github-bot/gists{/gist_id}', 'starred_url': 'https://api.github.com/users/facebook-github-bot/starred{/owner}{/repo}', 'subscriptions_url': 'https://api.github.com/users/facebook-github-bot/subscriptions', 'organizations_url': 'https://api.github.com/users/facebook-github-bot/orgs', 'repos_url': 'https://api.github.com/users/facebook-github-bot/repos', 'events_url': 'https://api.github.com/users/facebook-github-bot/events{/privacy}', 'received_events_url': 'https://api.github.com/users/facebook-github-bot/received_events', 'type': 'User', 'site_admin': False}",referenced,0d3cb91d8c8c1bb368128378e2300f96e9217344,https://api.github.com/repos/pytorch/pytorch/commits/0d3cb91d8c8c1bb368128378e2300f96e9217344,2018-11-30T02:49:51Z,92,77,15
14445,1991518519,"{'login': 'facebook-github-bot', 'id': 6422482, 'node_id': 'MDQ6VXNlcjY0MjI0ODI=', 'avatar_url': 'https://avatars3.githubusercontent.com/u/6422482?v=4', 'gravatar_id': '', 'url': 'https://api.github.com/users/facebook-github-bot', 'html_url': 'https://github.com/facebook-github-bot', 'followers_url': 'https://api.github.com/users/facebook-github-bot/followers', 'following_url': 'https://api.github.com/users/facebook-github-bot/following{/other_user}', 'gists_url': 'https://api.github.com/users/facebook-github-bot/gists{/gist_id}', 'starred_url': 'https://api.github.com/users/facebook-github-bot/starred{/owner}{/repo}', 'subscriptions_url': 'https://api.github.com/users/facebook-github-bot/subscriptions', 'organizations_url': 'https://api.github.com/users/facebook-github-bot/orgs', 'repos_url': 'https://api.github.com/users/facebook-github-bot/repos', 'events_url': 'https://api.github.com/users/facebook-github-bot/events{/privacy}', 'received_events_url': 'https://api.github.com/users/facebook-github-bot/received_events', 'type': 'User', 'site_admin': False}",closed,7d07fcd2152bacd16fd76494da0ec15774d881d1,https://api.github.com/repos/pytorch/pytorch/commits/7d07fcd2152bacd16fd76494da0ec15774d881d1,2018-11-28T06:00:04Z,10,5,5
14410,2042715940,"{'login': 'facebook-github-bot', 'id': 6422482, 'node_id': 'MDQ6VXNlcjY0MjI0ODI=', 'avatar_url': 'https://avatars3.githubusercontent.com/u/6422482?v=4', 'gravatar_id': '', 'url': 'https://api.github.com/users/facebook-github-bot', 'html_url': 'https://github.com/facebook-github-bot', 'followers_url': 'https://api.github.com/users/facebook-github-bot/followers', 'following_url': 'https://api.github.com/users/facebook-github-bot/following{/other_user}', 'gists_url': 'https://api.github.com/users/facebook-github-bot/gists{/gist_id}', 'starred_url': 'https://api.github.com/users/facebook-github-bot/starred{/owner}{/repo}', 'subscriptions_url': 'https://api.github.com/users/facebook-github-bot/subscriptions', 'organizations_url': 'https://api.github.com/users/facebook-github-bot/orgs', 'repos_url': 'https://api.github.com/users/facebook-github-bot/repos', 'events_url': 'https://api.github.com/users/facebook-github-bot/events{/privacy}', 'received_events_url': 'https://api.github.com/users/facebook-github-bot/received_events', 'type': 'User', 'site_admin': False}",closed,f8a56bf476e9d0be02a605ba272f7d034c5a1b28,https://api.github.com/repos/pytorch/pytorch/commits/f8a56bf476e9d0be02a605ba272f7d034c5a1b28,2018-12-24T03:51:03Z,2,1,1
14401,2062232397,"{'login': 'facebook-github-bot', 'id': 6422482, 'node_id': 'MDQ6VXNlcjY0MjI0ODI=', 'avatar_url': 'https://avatars3.githubusercontent.com/u/6422482?v=4', 'gravatar_id': '', 'url': 'https://api.github.com/users/facebook-github-bot', 'html_url': 'https://github.com/facebook-github-bot', 'followers_url': 'https://api.github.com/users/facebook-github-bot/followers', 'following_url': 'https://api.github.com/users/facebook-github-bot/following{/other_user}', 'gists_url': 'https://api.github.com/users/facebook-github-bot/gists{/gist_id}', 'starred_url': 'https://api.github.com/users/facebook-github-bot/starred{/owner}{/repo}', 'subscriptions_url': 'https://api.github.com/users/facebook-github-bot/subscriptions', 'organizations_url': 'https://api.github.com/users/facebook-github-bot/orgs', 'repos_url': 'https://api.github.com/users/facebook-github-bot/repos', 'events_url': 'https://api.github.com/users/facebook-github-bot/events{/privacy}', 'received_events_url': 'https://api.github.com/users/facebook-github-bot/received_events', 'type': 'User', 'site_admin': False}",referenced,c93cf89de21ff40d544f2091ea2cdcca629c4353,https://api.github.com/repos/pytorch/pytorch/commits/c93cf89de21ff40d544f2091ea2cdcca629c4353,2019-01-09T06:30:05Z,21,13,8
14401,2081425003,"{'login': 'soumith', 'id': 1310570, 'node_id': 'MDQ6VXNlcjEzMTA1NzA=', 'avatar_url': 'https://avatars0.githubusercontent.com/u/1310570?v=4', 'gravatar_id': '', 'url': 'https://api.github.com/users/soumith', 'html_url': 'https://github.com/soumith', 'followers_url': 'https://api.github.com/users/soumith/followers', 'following_url': 'https://api.github.com/users/soumith/following{/other_user}', 'gists_url': 'https://api.github.com/users/soumith/gists{/gist_id}', 'starred_url': 'https://api.github.com/users/soumith/starred{/owner}{/repo}', 'subscriptions_url': 'https://api.github.com/users/soumith/subscriptions', 'organizations_url': 'https://api.github.com/users/soumith/orgs', 'repos_url': 'https://api.github.com/users/soumith/repos', 'events_url': 'https://api.github.com/users/soumith/events{/privacy}', 'received_events_url': 'https://api.github.com/users/soumith/received_events', 'type': 'User', 'site_admin': False}",referenced,ccae157cd1575837ec40f7e21999cd6128a40307,https://api.github.com/repos/pytorch/pytorch/commits/ccae157cd1575837ec40f7e21999cd6128a40307,2019-01-17T21:23:36Z,21,13,8
14401,2081539287,"{'login': 'soumith', 'id': 1310570, 'node_id': 'MDQ6VXNlcjEzMTA1NzA=', 'avatar_url': 'https://avatars0.githubusercontent.com/u/1310570?v=4', 'gravatar_id': '', 'url': 'https://api.github.com/users/soumith', 'html_url': 'https://github.com/soumith', 'followers_url': 'https://api.github.com/users/soumith/followers', 'following_url': 'https://api.github.com/users/soumith/following{/other_user}', 'gists_url': 'https://api.github.com/users/soumith/gists{/gist_id}', 'starred_url': 'https://api.github.com/users/soumith/starred{/owner}{/repo}', 'subscriptions_url': 'https://api.github.com/users/soumith/subscriptions', 'organizations_url': 'https://api.github.com/users/soumith/orgs', 'repos_url': 'https://api.github.com/users/soumith/repos', 'events_url': 'https://api.github.com/users/soumith/events{/privacy}', 'received_events_url': 'https://api.github.com/users/soumith/received_events', 'type': 'User', 'site_admin': False}",referenced,20cf598dc82f9895d6ba2e5894fa83aabc6bc1e5,https://api.github.com/repos/pytorch/pytorch/commits/20cf598dc82f9895d6ba2e5894fa83aabc6bc1e5,2019-01-17T22:19:17Z,21,13,8
14401,2081981221,"{'login': 'soumith', 'id': 1310570, 'node_id': 'MDQ6VXNlcjEzMTA1NzA=', 'avatar_url': 'https://avatars0.githubusercontent.com/u/1310570?v=4', 'gravatar_id': '', 'url': 'https://api.github.com/users/soumith', 'html_url': 'https://github.com/soumith', 'followers_url': 'https://api.github.com/users/soumith/followers', 'following_url': 'https://api.github.com/users/soumith/following{/other_user}', 'gists_url': 'https://api.github.com/users/soumith/gists{/gist_id}', 'starred_url': 'https://api.github.com/users/soumith/starred{/owner}{/repo}', 'subscriptions_url': 'https://api.github.com/users/soumith/subscriptions', 'organizations_url': 'https://api.github.com/users/soumith/orgs', 'repos_url': 'https://api.github.com/users/soumith/repos', 'events_url': 'https://api.github.com/users/soumith/events{/privacy}', 'received_events_url': 'https://api.github.com/users/soumith/received_events', 'type': 'User', 'site_admin': False}",referenced,3486cebd8736d5f9ea687b29d122903b57e2adf4,https://api.github.com/repos/pytorch/pytorch/commits/3486cebd8736d5f9ea687b29d122903b57e2adf4,2019-01-18T04:02:11Z,21,13,8
14394,1997018867,"{'login': 'facebook-github-bot', 'id': 6422482, 'node_id': 'MDQ6VXNlcjY0MjI0ODI=', 'avatar_url': 'https://avatars3.githubusercontent.com/u/6422482?v=4', 'gravatar_id': '', 'url': 'https://api.github.com/users/facebook-github-bot', 'html_url': 'https://github.com/facebook-github-bot', 'followers_url': 'https://api.github.com/users/facebook-github-bot/followers', 'following_url': 'https://api.github.com/users/facebook-github-bot/following{/other_user}', 'gists_url': 'https://api.github.com/users/facebook-github-bot/gists{/gist_id}', 'starred_url': 'https://api.github.com/users/facebook-github-bot/starred{/owner}{/repo}', 'subscriptions_url': 'https://api.github.com/users/facebook-github-bot/subscriptions', 'organizations_url': 'https://api.github.com/users/facebook-github-bot/orgs', 'repos_url': 'https://api.github.com/users/facebook-github-bot/repos', 'events_url': 'https://api.github.com/users/facebook-github-bot/events{/privacy}', 'received_events_url': 'https://api.github.com/users/facebook-github-bot/received_events', 'type': 'User', 'site_admin': False}",closed,220ce8046e5fcf1434f948795bcdefda33e95e9a,https://api.github.com/repos/pytorch/pytorch/commits/220ce8046e5fcf1434f948795bcdefda33e95e9a,2018-11-30T04:10:56Z,152,152,0
14390,1990708035,"{'login': 'facebook-github-bot', 'id': 6422482, 'node_id': 'MDQ6VXNlcjY0MjI0ODI=', 'avatar_url': 'https://avatars3.githubusercontent.com/u/6422482?v=4', 'gravatar_id': '', 'url': 'https://api.github.com/users/facebook-github-bot', 'html_url': 'https://github.com/facebook-github-bot', 'followers_url': 'https://api.github.com/users/facebook-github-bot/followers', 'following_url': 'https://api.github.com/users/facebook-github-bot/following{/other_user}', 'gists_url': 'https://api.github.com/users/facebook-github-bot/gists{/gist_id}', 'starred_url': 'https://api.github.com/users/facebook-github-bot/starred{/owner}{/repo}', 'subscriptions_url': 'https://api.github.com/users/facebook-github-bot/subscriptions', 'organizations_url': 'https://api.github.com/users/facebook-github-bot/orgs', 'repos_url': 'https://api.github.com/users/facebook-github-bot/repos', 'events_url': 'https://api.github.com/users/facebook-github-bot/events{/privacy}', 'received_events_url': 'https://api.github.com/users/facebook-github-bot/received_events', 'type': 'User', 'site_admin': False}",referenced,ffbc3905a18508ec0d97d54ae5c82c65ebe796f3,https://api.github.com/repos/pytorch/pytorch/commits/ffbc3905a18508ec0d97d54ae5c82c65ebe796f3,2018-11-27T20:39:28Z,6,4,2
14376,1993400216,"{'login': 'facebook-github-bot', 'id': 6422482, 'node_id': 'MDQ6VXNlcjY0MjI0ODI=', 'avatar_url': 'https://avatars3.githubusercontent.com/u/6422482?v=4', 'gravatar_id': '', 'url': 'https://api.github.com/users/facebook-github-bot', 'html_url': 'https://github.com/facebook-github-bot', 'followers_url': 'https://api.github.com/users/facebook-github-bot/followers', 'following_url': 'https://api.github.com/users/facebook-github-bot/following{/other_user}', 'gists_url': 'https://api.github.com/users/facebook-github-bot/gists{/gist_id}', 'starred_url': 'https://api.github.com/users/facebook-github-bot/starred{/owner}{/repo}', 'subscriptions_url': 'https://api.github.com/users/facebook-github-bot/subscriptions', 'organizations_url': 'https://api.github.com/users/facebook-github-bot/orgs', 'repos_url': 'https://api.github.com/users/facebook-github-bot/repos', 'events_url': 'https://api.github.com/users/facebook-github-bot/events{/privacy}', 'received_events_url': 'https://api.github.com/users/facebook-github-bot/received_events', 'type': 'User', 'site_admin': False}",closed,0f62af4ab1883cd59f4dfd71945c9755dc138644,https://api.github.com/repos/pytorch/pytorch/commits/0f62af4ab1883cd59f4dfd71945c9755dc138644,2018-11-28T19:36:33Z,97,85,12
14355,2013723305,"{'login': 'facebook-github-bot', 'id': 6422482, 'node_id': 'MDQ6VXNlcjY0MjI0ODI=', 'avatar_url': 'https://avatars3.githubusercontent.com/u/6422482?v=4', 'gravatar_id': '', 'url': 'https://api.github.com/users/facebook-github-bot', 'html_url': 'https://github.com/facebook-github-bot', 'followers_url': 'https://api.github.com/users/facebook-github-bot/followers', 'following_url': 'https://api.github.com/users/facebook-github-bot/following{/other_user}', 'gists_url': 'https://api.github.com/users/facebook-github-bot/gists{/gist_id}', 'starred_url': 'https://api.github.com/users/facebook-github-bot/starred{/owner}{/repo}', 'subscriptions_url': 'https://api.github.com/users/facebook-github-bot/subscriptions', 'organizations_url': 'https://api.github.com/users/facebook-github-bot/orgs', 'repos_url': 'https://api.github.com/users/facebook-github-bot/repos', 'events_url': 'https://api.github.com/users/facebook-github-bot/events{/privacy}', 'received_events_url': 'https://api.github.com/users/facebook-github-bot/received_events', 'type': 'User', 'site_admin': False}",closed,478eb70c07ea54688b30242a76fb349e3c172dcf,https://api.github.com/repos/pytorch/pytorch/commits/478eb70c07ea54688b30242a76fb349e3c172dcf,2018-12-08T00:42:11Z,16,12,4
14344,1992542659,"{'login': 'facebook-github-bot', 'id': 6422482, 'node_id': 'MDQ6VXNlcjY0MjI0ODI=', 'avatar_url': 'https://avatars3.githubusercontent.com/u/6422482?v=4', 'gravatar_id': '', 'url': 'https://api.github.com/users/facebook-github-bot', 'html_url': 'https://github.com/facebook-github-bot', 'followers_url': 'https://api.github.com/users/facebook-github-bot/followers', 'following_url': 'https://api.github.com/users/facebook-github-bot/following{/other_user}', 'gists_url': 'https://api.github.com/users/facebook-github-bot/gists{/gist_id}', 'starred_url': 'https://api.github.com/users/facebook-github-bot/starred{/owner}{/repo}', 'subscriptions_url': 'https://api.github.com/users/facebook-github-bot/subscriptions', 'organizations_url': 'https://api.github.com/users/facebook-github-bot/orgs', 'repos_url': 'https://api.github.com/users/facebook-github-bot/repos', 'events_url': 'https://api.github.com/users/facebook-github-bot/events{/privacy}', 'received_events_url': 'https://api.github.com/users/facebook-github-bot/received_events', 'type': 'User', 'site_admin': False}",closed,68251fb93196a4c28a0c9f9ce37896b21c6c04e0,https://api.github.com/repos/pytorch/pytorch/commits/68251fb93196a4c28a0c9f9ce37896b21c6c04e0,2018-11-28T14:14:48Z,21,17,4
14335,2131808093,"{'login': 'facebook-github-bot', 'id': 6422482, 'node_id': 'MDQ6VXNlcjY0MjI0ODI=', 'avatar_url': 'https://avatars3.githubusercontent.com/u/6422482?v=4', 'gravatar_id': '', 'url': 'https://api.github.com/users/facebook-github-bot', 'html_url': 'https://github.com/facebook-github-bot', 'followers_url': 'https://api.github.com/users/facebook-github-bot/followers', 'following_url': 'https://api.github.com/users/facebook-github-bot/following{/other_user}', 'gists_url': 'https://api.github.com/users/facebook-github-bot/gists{/gist_id}', 'starred_url': 'https://api.github.com/users/facebook-github-bot/starred{/owner}{/repo}', 'subscriptions_url': 'https://api.github.com/users/facebook-github-bot/subscriptions', 'organizations_url': 'https://api.github.com/users/facebook-github-bot/orgs', 'repos_url': 'https://api.github.com/users/facebook-github-bot/repos', 'events_url': 'https://api.github.com/users/facebook-github-bot/events{/privacy}', 'received_events_url': 'https://api.github.com/users/facebook-github-bot/received_events', 'type': 'User', 'site_admin': False}",referenced,29f096cc70cf9cc1a317ae7107228215b7dde60b,https://api.github.com/repos/pytorch/pytorch/commits/29f096cc70cf9cc1a317ae7107228215b7dde60b,2019-02-11T21:14:25Z,130,92,38
14314,2071638386,"{'login': 'facebook-github-bot', 'id': 6422482, 'node_id': 'MDQ6VXNlcjY0MjI0ODI=', 'avatar_url': 'https://avatars3.githubusercontent.com/u/6422482?v=4', 'gravatar_id': '', 'url': 'https://api.github.com/users/facebook-github-bot', 'html_url': 'https://github.com/facebook-github-bot', 'followers_url': 'https://api.github.com/users/facebook-github-bot/followers', 'following_url': 'https://api.github.com/users/facebook-github-bot/following{/other_user}', 'gists_url': 'https://api.github.com/users/facebook-github-bot/gists{/gist_id}', 'starred_url': 'https://api.github.com/users/facebook-github-bot/starred{/owner}{/repo}', 'subscriptions_url': 'https://api.github.com/users/facebook-github-bot/subscriptions', 'organizations_url': 'https://api.github.com/users/facebook-github-bot/orgs', 'repos_url': 'https://api.github.com/users/facebook-github-bot/repos', 'events_url': 'https://api.github.com/users/facebook-github-bot/events{/privacy}', 'received_events_url': 'https://api.github.com/users/facebook-github-bot/received_events', 'type': 'User', 'site_admin': False}",closed,7c08f1083e56ce7e9799a15b36947c46052f0058,https://api.github.com/repos/pytorch/pytorch/commits/7c08f1083e56ce7e9799a15b36947c46052f0058,2019-01-14T12:32:08Z,60,40,20
14310,2067694676,"{'login': 'facebook-github-bot', 'id': 6422482, 'node_id': 'MDQ6VXNlcjY0MjI0ODI=', 'avatar_url': 'https://avatars3.githubusercontent.com/u/6422482?v=4', 'gravatar_id': '', 'url': 'https://api.github.com/users/facebook-github-bot', 'html_url': 'https://github.com/facebook-github-bot', 'followers_url': 'https://api.github.com/users/facebook-github-bot/followers', 'following_url': 'https://api.github.com/users/facebook-github-bot/following{/other_user}', 'gists_url': 'https://api.github.com/users/facebook-github-bot/gists{/gist_id}', 'starred_url': 'https://api.github.com/users/facebook-github-bot/starred{/owner}{/repo}', 'subscriptions_url': 'https://api.github.com/users/facebook-github-bot/subscriptions', 'organizations_url': 'https://api.github.com/users/facebook-github-bot/orgs', 'repos_url': 'https://api.github.com/users/facebook-github-bot/repos', 'events_url': 'https://api.github.com/users/facebook-github-bot/events{/privacy}', 'received_events_url': 'https://api.github.com/users/facebook-github-bot/received_events', 'type': 'User', 'site_admin': False}",closed,86af14b0c7a9f6fd96ad62a61ce2b6b105761fe1,https://api.github.com/repos/pytorch/pytorch/commits/86af14b0c7a9f6fd96ad62a61ce2b6b105761fe1,2019-01-11T05:46:03Z,136,95,41
14276,1988303290,"{'login': 'facebook-github-bot', 'id': 6422482, 'node_id': 'MDQ6VXNlcjY0MjI0ODI=', 'avatar_url': 'https://avatars3.githubusercontent.com/u/6422482?v=4', 'gravatar_id': '', 'url': 'https://api.github.com/users/facebook-github-bot', 'html_url': 'https://github.com/facebook-github-bot', 'followers_url': 'https://api.github.com/users/facebook-github-bot/followers', 'following_url': 'https://api.github.com/users/facebook-github-bot/following{/other_user}', 'gists_url': 'https://api.github.com/users/facebook-github-bot/gists{/gist_id}', 'starred_url': 'https://api.github.com/users/facebook-github-bot/starred{/owner}{/repo}', 'subscriptions_url': 'https://api.github.com/users/facebook-github-bot/subscriptions', 'organizations_url': 'https://api.github.com/users/facebook-github-bot/orgs', 'repos_url': 'https://api.github.com/users/facebook-github-bot/repos', 'events_url': 'https://api.github.com/users/facebook-github-bot/events{/privacy}', 'received_events_url': 'https://api.github.com/users/facebook-github-bot/received_events', 'type': 'User', 'site_admin': False}",closed,f639249d51562ce90a29ba15584b7a916a39569f,https://api.github.com/repos/pytorch/pytorch/commits/f639249d51562ce90a29ba15584b7a916a39569f,2018-11-27T01:08:17Z,72,50,22
14188,1991227487,"{'login': 'facebook-github-bot', 'id': 6422482, 'node_id': 'MDQ6VXNlcjY0MjI0ODI=', 'avatar_url': 'https://avatars3.githubusercontent.com/u/6422482?v=4', 'gravatar_id': '', 'url': 'https://api.github.com/users/facebook-github-bot', 'html_url': 'https://github.com/facebook-github-bot', 'followers_url': 'https://api.github.com/users/facebook-github-bot/followers', 'following_url': 'https://api.github.com/users/facebook-github-bot/following{/other_user}', 'gists_url': 'https://api.github.com/users/facebook-github-bot/gists{/gist_id}', 'starred_url': 'https://api.github.com/users/facebook-github-bot/starred{/owner}{/repo}', 'subscriptions_url': 'https://api.github.com/users/facebook-github-bot/subscriptions', 'organizations_url': 'https://api.github.com/users/facebook-github-bot/orgs', 'repos_url': 'https://api.github.com/users/facebook-github-bot/repos', 'events_url': 'https://api.github.com/users/facebook-github-bot/events{/privacy}', 'received_events_url': 'https://api.github.com/users/facebook-github-bot/received_events', 'type': 'User', 'site_admin': False}",closed,6f2307ba6ac802f4c4650cd21869e49d1845188d,https://api.github.com/repos/pytorch/pytorch/commits/6f2307ba6ac802f4c4650cd21869e49d1845188d,2018-11-28T01:37:16Z,120,94,26
14170,1973751419,"{'login': 'SsnL', 'id': 5674597, 'node_id': 'MDQ6VXNlcjU2NzQ1OTc=', 'avatar_url': 'https://avatars2.githubusercontent.com/u/5674597?v=4', 'gravatar_id': '', 'url': 'https://api.github.com/users/SsnL', 'html_url': 'https://github.com/SsnL', 'followers_url': 'https://api.github.com/users/SsnL/followers', 'following_url': 'https://api.github.com/users/SsnL/following{/other_user}', 'gists_url': 'https://api.github.com/users/SsnL/gists{/gist_id}', 'starred_url': 'https://api.github.com/users/SsnL/starred{/owner}{/repo}', 'subscriptions_url': 'https://api.github.com/users/SsnL/subscriptions', 'organizations_url': 'https://api.github.com/users/SsnL/orgs', 'repos_url': 'https://api.github.com/users/SsnL/repos', 'events_url': 'https://api.github.com/users/SsnL/events{/privacy}', 'received_events_url': 'https://api.github.com/users/SsnL/received_events', 'type': 'User', 'site_admin': False}",referenced,44fb1a1be12f86df828058ee9d33c76f229dede7,https://api.github.com/repos/pytorch/pytorch/commits/44fb1a1be12f86df828058ee9d33c76f229dede7,2018-11-19T06:02:27Z,6,4,2
14170,1979299471,"{'login': 'facebook-github-bot', 'id': 6422482, 'node_id': 'MDQ6VXNlcjY0MjI0ODI=', 'avatar_url': 'https://avatars3.githubusercontent.com/u/6422482?v=4', 'gravatar_id': '', 'url': 'https://api.github.com/users/facebook-github-bot', 'html_url': 'https://github.com/facebook-github-bot', 'followers_url': 'https://api.github.com/users/facebook-github-bot/followers', 'following_url': 'https://api.github.com/users/facebook-github-bot/following{/other_user}', 'gists_url': 'https://api.github.com/users/facebook-github-bot/gists{/gist_id}', 'starred_url': 'https://api.github.com/users/facebook-github-bot/starred{/owner}{/repo}', 'subscriptions_url': 'https://api.github.com/users/facebook-github-bot/subscriptions', 'organizations_url': 'https://api.github.com/users/facebook-github-bot/orgs', 'repos_url': 'https://api.github.com/users/facebook-github-bot/repos', 'events_url': 'https://api.github.com/users/facebook-github-bot/events{/privacy}', 'received_events_url': 'https://api.github.com/users/facebook-github-bot/received_events', 'type': 'User', 'site_admin': False}",closed,17432a1051af457d1ef48310d64c2b45b5a1b238,https://api.github.com/repos/pytorch/pytorch/commits/17432a1051af457d1ef48310d64c2b45b5a1b238,2018-11-21T07:32:57Z,8,5,3
14104,2062238921,"{'login': 'facebook-github-bot', 'id': 6422482, 'node_id': 'MDQ6VXNlcjY0MjI0ODI=', 'avatar_url': 'https://avatars3.githubusercontent.com/u/6422482?v=4', 'gravatar_id': '', 'url': 'https://api.github.com/users/facebook-github-bot', 'html_url': 'https://github.com/facebook-github-bot', 'followers_url': 'https://api.github.com/users/facebook-github-bot/followers', 'following_url': 'https://api.github.com/users/facebook-github-bot/following{/other_user}', 'gists_url': 'https://api.github.com/users/facebook-github-bot/gists{/gist_id}', 'starred_url': 'https://api.github.com/users/facebook-github-bot/starred{/owner}{/repo}', 'subscriptions_url': 'https://api.github.com/users/facebook-github-bot/subscriptions', 'organizations_url': 'https://api.github.com/users/facebook-github-bot/orgs', 'repos_url': 'https://api.github.com/users/facebook-github-bot/repos', 'events_url': 'https://api.github.com/users/facebook-github-bot/events{/privacy}', 'received_events_url': 'https://api.github.com/users/facebook-github-bot/received_events', 'type': 'User', 'site_admin': False}",closed,5fe26976559490a99cb60a0dd2e457c1fdda65ba,https://api.github.com/repos/pytorch/pytorch/commits/5fe26976559490a99cb60a0dd2e457c1fdda65ba,2019-01-09T06:35:18Z,5,4,1
14099,2011799716,"{'login': 'facebook-github-bot', 'id': 6422482, 'node_id': 'MDQ6VXNlcjY0MjI0ODI=', 'avatar_url': 'https://avatars3.githubusercontent.com/u/6422482?v=4', 'gravatar_id': '', 'url': 'https://api.github.com/users/facebook-github-bot', 'html_url': 'https://github.com/facebook-github-bot', 'followers_url': 'https://api.github.com/users/facebook-github-bot/followers', 'following_url': 'https://api.github.com/users/facebook-github-bot/following{/other_user}', 'gists_url': 'https://api.github.com/users/facebook-github-bot/gists{/gist_id}', 'starred_url': 'https://api.github.com/users/facebook-github-bot/starred{/owner}{/repo}', 'subscriptions_url': 'https://api.github.com/users/facebook-github-bot/subscriptions', 'organizations_url': 'https://api.github.com/users/facebook-github-bot/orgs', 'repos_url': 'https://api.github.com/users/facebook-github-bot/repos', 'events_url': 'https://api.github.com/users/facebook-github-bot/events{/privacy}', 'received_events_url': 'https://api.github.com/users/facebook-github-bot/received_events', 'type': 'User', 'site_admin': False}",closed,6e453e56f991d43ff9d0eac715020b7ef877ca77,https://api.github.com/repos/pytorch/pytorch/commits/6e453e56f991d43ff9d0eac715020b7ef877ca77,2018-12-07T07:59:07Z,25,13,12
14093,2257209440,"{'login': 'facebook-github-bot', 'id': 6422482, 'node_id': 'MDQ6VXNlcjY0MjI0ODI=', 'avatar_url': 'https://avatars3.githubusercontent.com/u/6422482?v=4', 'gravatar_id': '', 'url': 'https://api.github.com/users/facebook-github-bot', 'html_url': 'https://github.com/facebook-github-bot', 'followers_url': 'https://api.github.com/users/facebook-github-bot/followers', 'following_url': 'https://api.github.com/users/facebook-github-bot/following{/other_user}', 'gists_url': 'https://api.github.com/users/facebook-github-bot/gists{/gist_id}', 'starred_url': 'https://api.github.com/users/facebook-github-bot/starred{/owner}{/repo}', 'subscriptions_url': 'https://api.github.com/users/facebook-github-bot/subscriptions', 'organizations_url': 'https://api.github.com/users/facebook-github-bot/orgs', 'repos_url': 'https://api.github.com/users/facebook-github-bot/repos', 'events_url': 'https://api.github.com/users/facebook-github-bot/events{/privacy}', 'received_events_url': 'https://api.github.com/users/facebook-github-bot/received_events', 'type': 'User', 'site_admin': False}",closed,8c9caf185be66b996df5caf4b37a0e902ae3ca41,https://api.github.com/repos/pytorch/pytorch/commits/8c9caf185be66b996df5caf4b37a0e902ae3ca41,2019-04-06T01:18:19Z,222,222,0
14080,1991760835,"{'login': 'facebook-github-bot', 'id': 6422482, 'node_id': 'MDQ6VXNlcjY0MjI0ODI=', 'avatar_url': 'https://avatars3.githubusercontent.com/u/6422482?v=4', 'gravatar_id': '', 'url': 'https://api.github.com/users/facebook-github-bot', 'html_url': 'https://github.com/facebook-github-bot', 'followers_url': 'https://api.github.com/users/facebook-github-bot/followers', 'following_url': 'https://api.github.com/users/facebook-github-bot/following{/other_user}', 'gists_url': 'https://api.github.com/users/facebook-github-bot/gists{/gist_id}', 'starred_url': 'https://api.github.com/users/facebook-github-bot/starred{/owner}{/repo}', 'subscriptions_url': 'https://api.github.com/users/facebook-github-bot/subscriptions', 'organizations_url': 'https://api.github.com/users/facebook-github-bot/orgs', 'repos_url': 'https://api.github.com/users/facebook-github-bot/repos', 'events_url': 'https://api.github.com/users/facebook-github-bot/events{/privacy}', 'received_events_url': 'https://api.github.com/users/facebook-github-bot/received_events', 'type': 'User', 'site_admin': False}",referenced,a38ed0268e72905cf350a2de3fd9521d4cc2df07,https://api.github.com/repos/pytorch/pytorch/commits/a38ed0268e72905cf350a2de3fd9521d4cc2df07,2018-11-28T08:35:43Z,136,123,13
14079,1970980379,"{'login': 'facebook-github-bot', 'id': 6422482, 'node_id': 'MDQ6VXNlcjY0MjI0ODI=', 'avatar_url': 'https://avatars3.githubusercontent.com/u/6422482?v=4', 'gravatar_id': '', 'url': 'https://api.github.com/users/facebook-github-bot', 'html_url': 'https://github.com/facebook-github-bot', 'followers_url': 'https://api.github.com/users/facebook-github-bot/followers', 'following_url': 'https://api.github.com/users/facebook-github-bot/following{/other_user}', 'gists_url': 'https://api.github.com/users/facebook-github-bot/gists{/gist_id}', 'starred_url': 'https://api.github.com/users/facebook-github-bot/starred{/owner}{/repo}', 'subscriptions_url': 'https://api.github.com/users/facebook-github-bot/subscriptions', 'organizations_url': 'https://api.github.com/users/facebook-github-bot/orgs', 'repos_url': 'https://api.github.com/users/facebook-github-bot/repos', 'events_url': 'https://api.github.com/users/facebook-github-bot/events{/privacy}', 'received_events_url': 'https://api.github.com/users/facebook-github-bot/received_events', 'type': 'User', 'site_admin': False}",closed,a3f39f1ebb02498bd7dd6b048a6acd56ff0e5e51,https://api.github.com/repos/pytorch/pytorch/commits/a3f39f1ebb02498bd7dd6b048a6acd56ff0e5e51,2018-11-16T11:05:26Z,20,10,10
14078,1972594030,"{'login': 'facebook-github-bot', 'id': 6422482, 'node_id': 'MDQ6VXNlcjY0MjI0ODI=', 'avatar_url': 'https://avatars3.githubusercontent.com/u/6422482?v=4', 'gravatar_id': '', 'url': 'https://api.github.com/users/facebook-github-bot', 'html_url': 'https://github.com/facebook-github-bot', 'followers_url': 'https://api.github.com/users/facebook-github-bot/followers', 'following_url': 'https://api.github.com/users/facebook-github-bot/following{/other_user}', 'gists_url': 'https://api.github.com/users/facebook-github-bot/gists{/gist_id}', 'starred_url': 'https://api.github.com/users/facebook-github-bot/starred{/owner}{/repo}', 'subscriptions_url': 'https://api.github.com/users/facebook-github-bot/subscriptions', 'organizations_url': 'https://api.github.com/users/facebook-github-bot/orgs', 'repos_url': 'https://api.github.com/users/facebook-github-bot/repos', 'events_url': 'https://api.github.com/users/facebook-github-bot/events{/privacy}', 'received_events_url': 'https://api.github.com/users/facebook-github-bot/received_events', 'type': 'User', 'site_admin': False}",closed,eeb3e67eebbdc8fcb4d7063ee07ec912bda790f6,https://api.github.com/repos/pytorch/pytorch/commits/eeb3e67eebbdc8fcb4d7063ee07ec912bda790f6,2018-11-17T02:55:02Z,9,6,3
14063,1970486316,"{'login': 'facebook-github-bot', 'id': 6422482, 'node_id': 'MDQ6VXNlcjY0MjI0ODI=', 'avatar_url': 'https://avatars3.githubusercontent.com/u/6422482?v=4', 'gravatar_id': '', 'url': 'https://api.github.com/users/facebook-github-bot', 'html_url': 'https://github.com/facebook-github-bot', 'followers_url': 'https://api.github.com/users/facebook-github-bot/followers', 'following_url': 'https://api.github.com/users/facebook-github-bot/following{/other_user}', 'gists_url': 'https://api.github.com/users/facebook-github-bot/gists{/gist_id}', 'starred_url': 'https://api.github.com/users/facebook-github-bot/starred{/owner}{/repo}', 'subscriptions_url': 'https://api.github.com/users/facebook-github-bot/subscriptions', 'organizations_url': 'https://api.github.com/users/facebook-github-bot/orgs', 'repos_url': 'https://api.github.com/users/facebook-github-bot/repos', 'events_url': 'https://api.github.com/users/facebook-github-bot/events{/privacy}', 'received_events_url': 'https://api.github.com/users/facebook-github-bot/received_events', 'type': 'User', 'site_admin': False}",referenced,45fd77d3b7aef27620d924019f6eb0f71cd338e9,https://api.github.com/repos/pytorch/pytorch/commits/45fd77d3b7aef27620d924019f6eb0f71cd338e9,2018-11-16T06:35:29Z,29,18,11
14057,2286704876,"{'login': 'facebook-github-bot', 'id': 6422482, 'node_id': 'MDQ6VXNlcjY0MjI0ODI=', 'avatar_url': 'https://avatars3.githubusercontent.com/u/6422482?v=4', 'gravatar_id': '', 'url': 'https://api.github.com/users/facebook-github-bot', 'html_url': 'https://github.com/facebook-github-bot', 'followers_url': 'https://api.github.com/users/facebook-github-bot/followers', 'following_url': 'https://api.github.com/users/facebook-github-bot/following{/other_user}', 'gists_url': 'https://api.github.com/users/facebook-github-bot/gists{/gist_id}', 'starred_url': 'https://api.github.com/users/facebook-github-bot/starred{/owner}{/repo}', 'subscriptions_url': 'https://api.github.com/users/facebook-github-bot/subscriptions', 'organizations_url': 'https://api.github.com/users/facebook-github-bot/orgs', 'repos_url': 'https://api.github.com/users/facebook-github-bot/repos', 'events_url': 'https://api.github.com/users/facebook-github-bot/events{/privacy}', 'received_events_url': 'https://api.github.com/users/facebook-github-bot/received_events', 'type': 'User', 'site_admin': False}",referenced,88f70a16708369ad5d179fbe515f43739c0f2591,https://api.github.com/repos/pytorch/pytorch/commits/88f70a16708369ad5d179fbe515f43739c0f2591,2019-04-18T19:30:04Z,14,10,4
14026,1972089180,"{'login': 'facebook-github-bot', 'id': 6422482, 'node_id': 'MDQ6VXNlcjY0MjI0ODI=', 'avatar_url': 'https://avatars3.githubusercontent.com/u/6422482?v=4', 'gravatar_id': '', 'url': 'https://api.github.com/users/facebook-github-bot', 'html_url': 'https://github.com/facebook-github-bot', 'followers_url': 'https://api.github.com/users/facebook-github-bot/followers', 'following_url': 'https://api.github.com/users/facebook-github-bot/following{/other_user}', 'gists_url': 'https://api.github.com/users/facebook-github-bot/gists{/gist_id}', 'starred_url': 'https://api.github.com/users/facebook-github-bot/starred{/owner}{/repo}', 'subscriptions_url': 'https://api.github.com/users/facebook-github-bot/subscriptions', 'organizations_url': 'https://api.github.com/users/facebook-github-bot/orgs', 'repos_url': 'https://api.github.com/users/facebook-github-bot/repos', 'events_url': 'https://api.github.com/users/facebook-github-bot/events{/privacy}', 'received_events_url': 'https://api.github.com/users/facebook-github-bot/received_events', 'type': 'User', 'site_admin': False}",closed,1256cbaa6936ecae4db290b3f7af1923da5ba89a,https://api.github.com/repos/pytorch/pytorch/commits/1256cbaa6936ecae4db290b3f7af1923da5ba89a,2018-11-16T19:45:33Z,12,6,6
14025,1996169017,"{'login': 'facebook-github-bot', 'id': 6422482, 'node_id': 'MDQ6VXNlcjY0MjI0ODI=', 'avatar_url': 'https://avatars3.githubusercontent.com/u/6422482?v=4', 'gravatar_id': '', 'url': 'https://api.github.com/users/facebook-github-bot', 'html_url': 'https://github.com/facebook-github-bot', 'followers_url': 'https://api.github.com/users/facebook-github-bot/followers', 'following_url': 'https://api.github.com/users/facebook-github-bot/following{/other_user}', 'gists_url': 'https://api.github.com/users/facebook-github-bot/gists{/gist_id}', 'starred_url': 'https://api.github.com/users/facebook-github-bot/starred{/owner}{/repo}', 'subscriptions_url': 'https://api.github.com/users/facebook-github-bot/subscriptions', 'organizations_url': 'https://api.github.com/users/facebook-github-bot/orgs', 'repos_url': 'https://api.github.com/users/facebook-github-bot/repos', 'events_url': 'https://api.github.com/users/facebook-github-bot/events{/privacy}', 'received_events_url': 'https://api.github.com/users/facebook-github-bot/received_events', 'type': 'User', 'site_admin': False}",closed,cf059028f047001ad13bdd04b66d55e94d390e3f,https://api.github.com/repos/pytorch/pytorch/commits/cf059028f047001ad13bdd04b66d55e94d390e3f,2018-11-29T19:19:12Z,4,2,2
14002,1970177775,"{'login': 'facebook-github-bot', 'id': 6422482, 'node_id': 'MDQ6VXNlcjY0MjI0ODI=', 'avatar_url': 'https://avatars3.githubusercontent.com/u/6422482?v=4', 'gravatar_id': '', 'url': 'https://api.github.com/users/facebook-github-bot', 'html_url': 'https://github.com/facebook-github-bot', 'followers_url': 'https://api.github.com/users/facebook-github-bot/followers', 'following_url': 'https://api.github.com/users/facebook-github-bot/following{/other_user}', 'gists_url': 'https://api.github.com/users/facebook-github-bot/gists{/gist_id}', 'starred_url': 'https://api.github.com/users/facebook-github-bot/starred{/owner}{/repo}', 'subscriptions_url': 'https://api.github.com/users/facebook-github-bot/subscriptions', 'organizations_url': 'https://api.github.com/users/facebook-github-bot/orgs', 'repos_url': 'https://api.github.com/users/facebook-github-bot/repos', 'events_url': 'https://api.github.com/users/facebook-github-bot/events{/privacy}', 'received_events_url': 'https://api.github.com/users/facebook-github-bot/received_events', 'type': 'User', 'site_admin': False}",closed,8f4dc192b6331533f56fc23a86fa055ee4d580c0,https://api.github.com/repos/pytorch/pytorch/commits/8f4dc192b6331533f56fc23a86fa055ee4d580c0,2018-11-16T01:32:12Z,142,107,35
13971,1969794391,"{'login': 'facebook-github-bot', 'id': 6422482, 'node_id': 'MDQ6VXNlcjY0MjI0ODI=', 'avatar_url': 'https://avatars3.githubusercontent.com/u/6422482?v=4', 'gravatar_id': '', 'url': 'https://api.github.com/users/facebook-github-bot', 'html_url': 'https://github.com/facebook-github-bot', 'followers_url': 'https://api.github.com/users/facebook-github-bot/followers', 'following_url': 'https://api.github.com/users/facebook-github-bot/following{/other_user}', 'gists_url': 'https://api.github.com/users/facebook-github-bot/gists{/gist_id}', 'starred_url': 'https://api.github.com/users/facebook-github-bot/starred{/owner}{/repo}', 'subscriptions_url': 'https://api.github.com/users/facebook-github-bot/subscriptions', 'organizations_url': 'https://api.github.com/users/facebook-github-bot/orgs', 'repos_url': 'https://api.github.com/users/facebook-github-bot/repos', 'events_url': 'https://api.github.com/users/facebook-github-bot/events{/privacy}', 'received_events_url': 'https://api.github.com/users/facebook-github-bot/received_events', 'type': 'User', 'site_admin': False}",closed,c7e0db140ef7cb65ed0d391c4f2849a803f3d52f,https://api.github.com/repos/pytorch/pytorch/commits/c7e0db140ef7cb65ed0d391c4f2849a803f3d52f,2018-11-15T21:25:28Z,23,22,1
13969,2005605477,"{'login': 'facebook-github-bot', 'id': 6422482, 'node_id': 'MDQ6VXNlcjY0MjI0ODI=', 'avatar_url': 'https://avatars3.githubusercontent.com/u/6422482?v=4', 'gravatar_id': '', 'url': 'https://api.github.com/users/facebook-github-bot', 'html_url': 'https://github.com/facebook-github-bot', 'followers_url': 'https://api.github.com/users/facebook-github-bot/followers', 'following_url': 'https://api.github.com/users/facebook-github-bot/following{/other_user}', 'gists_url': 'https://api.github.com/users/facebook-github-bot/gists{/gist_id}', 'starred_url': 'https://api.github.com/users/facebook-github-bot/starred{/owner}{/repo}', 'subscriptions_url': 'https://api.github.com/users/facebook-github-bot/subscriptions', 'organizations_url': 'https://api.github.com/users/facebook-github-bot/orgs', 'repos_url': 'https://api.github.com/users/facebook-github-bot/repos', 'events_url': 'https://api.github.com/users/facebook-github-bot/events{/privacy}', 'received_events_url': 'https://api.github.com/users/facebook-github-bot/received_events', 'type': 'User', 'site_admin': False}",referenced,2d56df7892ff6588da3fd079ee95d679644d6730,https://api.github.com/repos/pytorch/pytorch/commits/2d56df7892ff6588da3fd079ee95d679644d6730,2018-12-04T22:05:42Z,220,65,155
13968,2535125774,"{'login': 'facebook-github-bot', 'id': 6422482, 'node_id': 'MDQ6VXNlcjY0MjI0ODI=', 'avatar_url': 'https://avatars3.githubusercontent.com/u/6422482?v=4', 'gravatar_id': '', 'url': 'https://api.github.com/users/facebook-github-bot', 'html_url': 'https://github.com/facebook-github-bot', 'followers_url': 'https://api.github.com/users/facebook-github-bot/followers', 'following_url': 'https://api.github.com/users/facebook-github-bot/following{/other_user}', 'gists_url': 'https://api.github.com/users/facebook-github-bot/gists{/gist_id}', 'starred_url': 'https://api.github.com/users/facebook-github-bot/starred{/owner}{/repo}', 'subscriptions_url': 'https://api.github.com/users/facebook-github-bot/subscriptions', 'organizations_url': 'https://api.github.com/users/facebook-github-bot/orgs', 'repos_url': 'https://api.github.com/users/facebook-github-bot/repos', 'events_url': 'https://api.github.com/users/facebook-github-bot/events{/privacy}', 'received_events_url': 'https://api.github.com/users/facebook-github-bot/received_events', 'type': 'User', 'site_admin': False}",closed,51d59a43bad389f32ef5229c05b46061966e18e0,https://api.github.com/repos/pytorch/pytorch/commits/51d59a43bad389f32ef5229c05b46061966e18e0,2019-08-06T00:46:14Z,4,2,2
13968,2540877894,"{'login': 'soumith', 'id': 1310570, 'node_id': 'MDQ6VXNlcjEzMTA1NzA=', 'avatar_url': 'https://avatars0.githubusercontent.com/u/1310570?v=4', 'gravatar_id': '', 'url': 'https://api.github.com/users/soumith', 'html_url': 'https://github.com/soumith', 'followers_url': 'https://api.github.com/users/soumith/followers', 'following_url': 'https://api.github.com/users/soumith/following{/other_user}', 'gists_url': 'https://api.github.com/users/soumith/gists{/gist_id}', 'starred_url': 'https://api.github.com/users/soumith/starred{/owner}{/repo}', 'subscriptions_url': 'https://api.github.com/users/soumith/subscriptions', 'organizations_url': 'https://api.github.com/users/soumith/orgs', 'repos_url': 'https://api.github.com/users/soumith/repos', 'events_url': 'https://api.github.com/users/soumith/events{/privacy}', 'received_events_url': 'https://api.github.com/users/soumith/received_events', 'type': 'User', 'site_admin': False}",referenced,2ad6f427e88820cf9d52677aa3ee5db1b4ad8144,https://api.github.com/repos/pytorch/pytorch/commits/2ad6f427e88820cf9d52677aa3ee5db1b4ad8144,2019-08-07T17:39:16Z,4,2,2
13913,1972237096,"{'login': 'facebook-github-bot', 'id': 6422482, 'node_id': 'MDQ6VXNlcjY0MjI0ODI=', 'avatar_url': 'https://avatars3.githubusercontent.com/u/6422482?v=4', 'gravatar_id': '', 'url': 'https://api.github.com/users/facebook-github-bot', 'html_url': 'https://github.com/facebook-github-bot', 'followers_url': 'https://api.github.com/users/facebook-github-bot/followers', 'following_url': 'https://api.github.com/users/facebook-github-bot/following{/other_user}', 'gists_url': 'https://api.github.com/users/facebook-github-bot/gists{/gist_id}', 'starred_url': 'https://api.github.com/users/facebook-github-bot/starred{/owner}{/repo}', 'subscriptions_url': 'https://api.github.com/users/facebook-github-bot/subscriptions', 'organizations_url': 'https://api.github.com/users/facebook-github-bot/orgs', 'repos_url': 'https://api.github.com/users/facebook-github-bot/repos', 'events_url': 'https://api.github.com/users/facebook-github-bot/events{/privacy}', 'received_events_url': 'https://api.github.com/users/facebook-github-bot/received_events', 'type': 'User', 'site_admin': False}",referenced,96e5d23bad20be60900e2133d912cdd2190caaa8,https://api.github.com/repos/pytorch/pytorch/commits/96e5d23bad20be60900e2133d912cdd2190caaa8,2018-11-16T21:05:45Z,14,12,2
13909,1964630481,"{'login': 'facebook-github-bot', 'id': 6422482, 'node_id': 'MDQ6VXNlcjY0MjI0ODI=', 'avatar_url': 'https://avatars3.githubusercontent.com/u/6422482?v=4', 'gravatar_id': '', 'url': 'https://api.github.com/users/facebook-github-bot', 'html_url': 'https://github.com/facebook-github-bot', 'followers_url': 'https://api.github.com/users/facebook-github-bot/followers', 'following_url': 'https://api.github.com/users/facebook-github-bot/following{/other_user}', 'gists_url': 'https://api.github.com/users/facebook-github-bot/gists{/gist_id}', 'starred_url': 'https://api.github.com/users/facebook-github-bot/starred{/owner}{/repo}', 'subscriptions_url': 'https://api.github.com/users/facebook-github-bot/subscriptions', 'organizations_url': 'https://api.github.com/users/facebook-github-bot/orgs', 'repos_url': 'https://api.github.com/users/facebook-github-bot/repos', 'events_url': 'https://api.github.com/users/facebook-github-bot/events{/privacy}', 'received_events_url': 'https://api.github.com/users/facebook-github-bot/received_events', 'type': 'User', 'site_admin': False}",closed,c3680e2b19174fea3726d9175715e0e853c96265,https://api.github.com/repos/pytorch/pytorch/commits/c3680e2b19174fea3726d9175715e0e853c96265,2018-11-14T00:52:14Z,18,17,1
13907,1967292049,"{'login': 'facebook-github-bot', 'id': 6422482, 'node_id': 'MDQ6VXNlcjY0MjI0ODI=', 'avatar_url': 'https://avatars3.githubusercontent.com/u/6422482?v=4', 'gravatar_id': '', 'url': 'https://api.github.com/users/facebook-github-bot', 'html_url': 'https://github.com/facebook-github-bot', 'followers_url': 'https://api.github.com/users/facebook-github-bot/followers', 'following_url': 'https://api.github.com/users/facebook-github-bot/following{/other_user}', 'gists_url': 'https://api.github.com/users/facebook-github-bot/gists{/gist_id}', 'starred_url': 'https://api.github.com/users/facebook-github-bot/starred{/owner}{/repo}', 'subscriptions_url': 'https://api.github.com/users/facebook-github-bot/subscriptions', 'organizations_url': 'https://api.github.com/users/facebook-github-bot/orgs', 'repos_url': 'https://api.github.com/users/facebook-github-bot/repos', 'events_url': 'https://api.github.com/users/facebook-github-bot/events{/privacy}', 'received_events_url': 'https://api.github.com/users/facebook-github-bot/received_events', 'type': 'User', 'site_admin': False}",closed,ff4f4a0a35de5b31b0ef7a4a3391c651afb8064d,https://api.github.com/repos/pytorch/pytorch/commits/ff4f4a0a35de5b31b0ef7a4a3391c651afb8064d,2018-11-14T23:24:50Z,23,23,0
13899,2143766904,"{'login': 'facebook-github-bot', 'id': 6422482, 'node_id': 'MDQ6VXNlcjY0MjI0ODI=', 'avatar_url': 'https://avatars3.githubusercontent.com/u/6422482?v=4', 'gravatar_id': '', 'url': 'https://api.github.com/users/facebook-github-bot', 'html_url': 'https://github.com/facebook-github-bot', 'followers_url': 'https://api.github.com/users/facebook-github-bot/followers', 'following_url': 'https://api.github.com/users/facebook-github-bot/following{/other_user}', 'gists_url': 'https://api.github.com/users/facebook-github-bot/gists{/gist_id}', 'starred_url': 'https://api.github.com/users/facebook-github-bot/starred{/owner}{/repo}', 'subscriptions_url': 'https://api.github.com/users/facebook-github-bot/subscriptions', 'organizations_url': 'https://api.github.com/users/facebook-github-bot/orgs', 'repos_url': 'https://api.github.com/users/facebook-github-bot/repos', 'events_url': 'https://api.github.com/users/facebook-github-bot/events{/privacy}', 'received_events_url': 'https://api.github.com/users/facebook-github-bot/received_events', 'type': 'User', 'site_admin': False}",referenced,21696502ffd225e4d5fef0a30082090386e54eaf,https://api.github.com/repos/pytorch/pytorch/commits/21696502ffd225e4d5fef0a30082090386e54eaf,2019-02-15T23:05:21Z,32,32,0
13867,2078525862,"{'login': 'facebook-github-bot', 'id': 6422482, 'node_id': 'MDQ6VXNlcjY0MjI0ODI=', 'avatar_url': 'https://avatars3.githubusercontent.com/u/6422482?v=4', 'gravatar_id': '', 'url': 'https://api.github.com/users/facebook-github-bot', 'html_url': 'https://github.com/facebook-github-bot', 'followers_url': 'https://api.github.com/users/facebook-github-bot/followers', 'following_url': 'https://api.github.com/users/facebook-github-bot/following{/other_user}', 'gists_url': 'https://api.github.com/users/facebook-github-bot/gists{/gist_id}', 'starred_url': 'https://api.github.com/users/facebook-github-bot/starred{/owner}{/repo}', 'subscriptions_url': 'https://api.github.com/users/facebook-github-bot/subscriptions', 'organizations_url': 'https://api.github.com/users/facebook-github-bot/orgs', 'repos_url': 'https://api.github.com/users/facebook-github-bot/repos', 'events_url': 'https://api.github.com/users/facebook-github-bot/events{/privacy}', 'received_events_url': 'https://api.github.com/users/facebook-github-bot/received_events', 'type': 'User', 'site_admin': False}",closed,d33e7d12367db4a7ec8ed920563411b5584dd106,https://api.github.com/repos/pytorch/pytorch/commits/d33e7d12367db4a7ec8ed920563411b5584dd106,2019-01-16T20:52:15Z,27,19,8
13867,2114812279,"{'login': 'soumith', 'id': 1310570, 'node_id': 'MDQ6VXNlcjEzMTA1NzA=', 'avatar_url': 'https://avatars0.githubusercontent.com/u/1310570?v=4', 'gravatar_id': '', 'url': 'https://api.github.com/users/soumith', 'html_url': 'https://github.com/soumith', 'followers_url': 'https://api.github.com/users/soumith/followers', 'following_url': 'https://api.github.com/users/soumith/following{/other_user}', 'gists_url': 'https://api.github.com/users/soumith/gists{/gist_id}', 'starred_url': 'https://api.github.com/users/soumith/starred{/owner}{/repo}', 'subscriptions_url': 'https://api.github.com/users/soumith/subscriptions', 'organizations_url': 'https://api.github.com/users/soumith/orgs', 'repos_url': 'https://api.github.com/users/soumith/repos', 'events_url': 'https://api.github.com/users/soumith/events{/privacy}', 'received_events_url': 'https://api.github.com/users/soumith/received_events', 'type': 'User', 'site_admin': False}",referenced,eb531da9a8e8014338ba2a7417a3ff2d9c084de3,https://api.github.com/repos/pytorch/pytorch/commits/eb531da9a8e8014338ba2a7417a3ff2d9c084de3,2019-02-04T05:47:09Z,27,19,8
13773,1962121733,"{'login': 'facebook-github-bot', 'id': 6422482, 'node_id': 'MDQ6VXNlcjY0MjI0ODI=', 'avatar_url': 'https://avatars3.githubusercontent.com/u/6422482?v=4', 'gravatar_id': '', 'url': 'https://api.github.com/users/facebook-github-bot', 'html_url': 'https://github.com/facebook-github-bot', 'followers_url': 'https://api.github.com/users/facebook-github-bot/followers', 'following_url': 'https://api.github.com/users/facebook-github-bot/following{/other_user}', 'gists_url': 'https://api.github.com/users/facebook-github-bot/gists{/gist_id}', 'starred_url': 'https://api.github.com/users/facebook-github-bot/starred{/owner}{/repo}', 'subscriptions_url': 'https://api.github.com/users/facebook-github-bot/subscriptions', 'organizations_url': 'https://api.github.com/users/facebook-github-bot/orgs', 'repos_url': 'https://api.github.com/users/facebook-github-bot/repos', 'events_url': 'https://api.github.com/users/facebook-github-bot/events{/privacy}', 'received_events_url': 'https://api.github.com/users/facebook-github-bot/received_events', 'type': 'User', 'site_admin': False}",closed,a17c0118a52d34c97ab48bae416ae1896ad14e56,https://api.github.com/repos/pytorch/pytorch/commits/a17c0118a52d34c97ab48bae416ae1896ad14e56,2018-11-13T06:06:02Z,13,12,1
13750,1988306836,"{'login': 'facebook-github-bot', 'id': 6422482, 'node_id': 'MDQ6VXNlcjY0MjI0ODI=', 'avatar_url': 'https://avatars3.githubusercontent.com/u/6422482?v=4', 'gravatar_id': '', 'url': 'https://api.github.com/users/facebook-github-bot', 'html_url': 'https://github.com/facebook-github-bot', 'followers_url': 'https://api.github.com/users/facebook-github-bot/followers', 'following_url': 'https://api.github.com/users/facebook-github-bot/following{/other_user}', 'gists_url': 'https://api.github.com/users/facebook-github-bot/gists{/gist_id}', 'starred_url': 'https://api.github.com/users/facebook-github-bot/starred{/owner}{/repo}', 'subscriptions_url': 'https://api.github.com/users/facebook-github-bot/subscriptions', 'organizations_url': 'https://api.github.com/users/facebook-github-bot/orgs', 'repos_url': 'https://api.github.com/users/facebook-github-bot/repos', 'events_url': 'https://api.github.com/users/facebook-github-bot/events{/privacy}', 'received_events_url': 'https://api.github.com/users/facebook-github-bot/received_events', 'type': 'User', 'site_admin': False}",referenced,2d6f039766193623dbf17c46bfcd17bb8c8bdb32,https://api.github.com/repos/pytorch/pytorch/commits/2d6f039766193623dbf17c46bfcd17bb8c8bdb32,2018-11-27T01:11:13Z,30,24,6
13634,1964916353,"{'login': 'facebook-github-bot', 'id': 6422482, 'node_id': 'MDQ6VXNlcjY0MjI0ODI=', 'avatar_url': 'https://avatars3.githubusercontent.com/u/6422482?v=4', 'gravatar_id': '', 'url': 'https://api.github.com/users/facebook-github-bot', 'html_url': 'https://github.com/facebook-github-bot', 'followers_url': 'https://api.github.com/users/facebook-github-bot/followers', 'following_url': 'https://api.github.com/users/facebook-github-bot/following{/other_user}', 'gists_url': 'https://api.github.com/users/facebook-github-bot/gists{/gist_id}', 'starred_url': 'https://api.github.com/users/facebook-github-bot/starred{/owner}{/repo}', 'subscriptions_url': 'https://api.github.com/users/facebook-github-bot/subscriptions', 'organizations_url': 'https://api.github.com/users/facebook-github-bot/orgs', 'repos_url': 'https://api.github.com/users/facebook-github-bot/repos', 'events_url': 'https://api.github.com/users/facebook-github-bot/events{/privacy}', 'received_events_url': 'https://api.github.com/users/facebook-github-bot/received_events', 'type': 'User', 'site_admin': False}",closed,5151d33287384cef9a0111a0525ff2db59829814,https://api.github.com/repos/pytorch/pytorch/commits/5151d33287384cef9a0111a0525ff2db59829814,2018-11-14T05:06:25Z,50,36,14
13622,1952913279,"{'login': 'facebook-github-bot', 'id': 6422482, 'node_id': 'MDQ6VXNlcjY0MjI0ODI=', 'avatar_url': 'https://avatars3.githubusercontent.com/u/6422482?v=4', 'gravatar_id': '', 'url': 'https://api.github.com/users/facebook-github-bot', 'html_url': 'https://github.com/facebook-github-bot', 'followers_url': 'https://api.github.com/users/facebook-github-bot/followers', 'following_url': 'https://api.github.com/users/facebook-github-bot/following{/other_user}', 'gists_url': 'https://api.github.com/users/facebook-github-bot/gists{/gist_id}', 'starred_url': 'https://api.github.com/users/facebook-github-bot/starred{/owner}{/repo}', 'subscriptions_url': 'https://api.github.com/users/facebook-github-bot/subscriptions', 'organizations_url': 'https://api.github.com/users/facebook-github-bot/orgs', 'repos_url': 'https://api.github.com/users/facebook-github-bot/repos', 'events_url': 'https://api.github.com/users/facebook-github-bot/events{/privacy}', 'received_events_url': 'https://api.github.com/users/facebook-github-bot/received_events', 'type': 'User', 'site_admin': False}",closed,7978ba45ba85d03091b99b375dfb82cf88518c51,https://api.github.com/repos/pytorch/pytorch/commits/7978ba45ba85d03091b99b375dfb82cf88518c51,2018-11-07T22:32:56Z,16,12,4
13574,1976237343,"{'login': 'facebook-github-bot', 'id': 6422482, 'node_id': 'MDQ6VXNlcjY0MjI0ODI=', 'avatar_url': 'https://avatars3.githubusercontent.com/u/6422482?v=4', 'gravatar_id': '', 'url': 'https://api.github.com/users/facebook-github-bot', 'html_url': 'https://github.com/facebook-github-bot', 'followers_url': 'https://api.github.com/users/facebook-github-bot/followers', 'following_url': 'https://api.github.com/users/facebook-github-bot/following{/other_user}', 'gists_url': 'https://api.github.com/users/facebook-github-bot/gists{/gist_id}', 'starred_url': 'https://api.github.com/users/facebook-github-bot/starred{/owner}{/repo}', 'subscriptions_url': 'https://api.github.com/users/facebook-github-bot/subscriptions', 'organizations_url': 'https://api.github.com/users/facebook-github-bot/orgs', 'repos_url': 'https://api.github.com/users/facebook-github-bot/repos', 'events_url': 'https://api.github.com/users/facebook-github-bot/events{/privacy}', 'received_events_url': 'https://api.github.com/users/facebook-github-bot/received_events', 'type': 'User', 'site_admin': False}",referenced,b807970aeaf3bd26068f347a01196b66c0a21bb5,https://api.github.com/repos/pytorch/pytorch/commits/b807970aeaf3bd26068f347a01196b66c0a21bb5,2018-11-20T02:32:43Z,41,41,0
13573,1979122743,"{'login': 'facebook-github-bot', 'id': 6422482, 'node_id': 'MDQ6VXNlcjY0MjI0ODI=', 'avatar_url': 'https://avatars3.githubusercontent.com/u/6422482?v=4', 'gravatar_id': '', 'url': 'https://api.github.com/users/facebook-github-bot', 'html_url': 'https://github.com/facebook-github-bot', 'followers_url': 'https://api.github.com/users/facebook-github-bot/followers', 'following_url': 'https://api.github.com/users/facebook-github-bot/following{/other_user}', 'gists_url': 'https://api.github.com/users/facebook-github-bot/gists{/gist_id}', 'starred_url': 'https://api.github.com/users/facebook-github-bot/starred{/owner}{/repo}', 'subscriptions_url': 'https://api.github.com/users/facebook-github-bot/subscriptions', 'organizations_url': 'https://api.github.com/users/facebook-github-bot/orgs', 'repos_url': 'https://api.github.com/users/facebook-github-bot/repos', 'events_url': 'https://api.github.com/users/facebook-github-bot/events{/privacy}', 'received_events_url': 'https://api.github.com/users/facebook-github-bot/received_events', 'type': 'User', 'site_admin': False}",referenced,bb301a431da886d994fb0155185ab7567d71279d,https://api.github.com/repos/pytorch/pytorch/commits/bb301a431da886d994fb0155185ab7567d71279d,2018-11-21T05:13:51Z,93,83,10
13573,1990449908,"{'login': 'facebook-github-bot', 'id': 6422482, 'node_id': 'MDQ6VXNlcjY0MjI0ODI=', 'avatar_url': 'https://avatars3.githubusercontent.com/u/6422482?v=4', 'gravatar_id': '', 'url': 'https://api.github.com/users/facebook-github-bot', 'html_url': 'https://github.com/facebook-github-bot', 'followers_url': 'https://api.github.com/users/facebook-github-bot/followers', 'following_url': 'https://api.github.com/users/facebook-github-bot/following{/other_user}', 'gists_url': 'https://api.github.com/users/facebook-github-bot/gists{/gist_id}', 'starred_url': 'https://api.github.com/users/facebook-github-bot/starred{/owner}{/repo}', 'subscriptions_url': 'https://api.github.com/users/facebook-github-bot/subscriptions', 'organizations_url': 'https://api.github.com/users/facebook-github-bot/orgs', 'repos_url': 'https://api.github.com/users/facebook-github-bot/repos', 'events_url': 'https://api.github.com/users/facebook-github-bot/events{/privacy}', 'received_events_url': 'https://api.github.com/users/facebook-github-bot/received_events', 'type': 'User', 'site_admin': False}",referenced,2cc35c161ada1fb5e27b7ed9472c21a00c981d89,https://api.github.com/repos/pytorch/pytorch/commits/2cc35c161ada1fb5e27b7ed9472c21a00c981d89,2018-11-27T18:48:21Z,117,78,39
13566,1956965986,"{'login': 'facebook-github-bot', 'id': 6422482, 'node_id': 'MDQ6VXNlcjY0MjI0ODI=', 'avatar_url': 'https://avatars3.githubusercontent.com/u/6422482?v=4', 'gravatar_id': '', 'url': 'https://api.github.com/users/facebook-github-bot', 'html_url': 'https://github.com/facebook-github-bot', 'followers_url': 'https://api.github.com/users/facebook-github-bot/followers', 'following_url': 'https://api.github.com/users/facebook-github-bot/following{/other_user}', 'gists_url': 'https://api.github.com/users/facebook-github-bot/gists{/gist_id}', 'starred_url': 'https://api.github.com/users/facebook-github-bot/starred{/owner}{/repo}', 'subscriptions_url': 'https://api.github.com/users/facebook-github-bot/subscriptions', 'organizations_url': 'https://api.github.com/users/facebook-github-bot/orgs', 'repos_url': 'https://api.github.com/users/facebook-github-bot/repos', 'events_url': 'https://api.github.com/users/facebook-github-bot/events{/privacy}', 'received_events_url': 'https://api.github.com/users/facebook-github-bot/received_events', 'type': 'User', 'site_admin': False}",closed,9ffabcfcaac0df8ec0e183430945d95c772ff5c3,https://api.github.com/repos/pytorch/pytorch/commits/9ffabcfcaac0df8ec0e183430945d95c772ff5c3,2018-11-09T14:25:33Z,47,46,1
13564,1952245660,"{'login': 'facebook-github-bot', 'id': 6422482, 'node_id': 'MDQ6VXNlcjY0MjI0ODI=', 'avatar_url': 'https://avatars3.githubusercontent.com/u/6422482?v=4', 'gravatar_id': '', 'url': 'https://api.github.com/users/facebook-github-bot', 'html_url': 'https://github.com/facebook-github-bot', 'followers_url': 'https://api.github.com/users/facebook-github-bot/followers', 'following_url': 'https://api.github.com/users/facebook-github-bot/following{/other_user}', 'gists_url': 'https://api.github.com/users/facebook-github-bot/gists{/gist_id}', 'starred_url': 'https://api.github.com/users/facebook-github-bot/starred{/owner}{/repo}', 'subscriptions_url': 'https://api.github.com/users/facebook-github-bot/subscriptions', 'organizations_url': 'https://api.github.com/users/facebook-github-bot/orgs', 'repos_url': 'https://api.github.com/users/facebook-github-bot/repos', 'events_url': 'https://api.github.com/users/facebook-github-bot/events{/privacy}', 'received_events_url': 'https://api.github.com/users/facebook-github-bot/received_events', 'type': 'User', 'site_admin': False}",closed,9403eddce41b16ededf6ce72ae5a427c30afadc6,https://api.github.com/repos/pytorch/pytorch/commits/9403eddce41b16ededf6ce72ae5a427c30afadc6,2018-11-07T17:24:21Z,70,54,16
13560,1950459688,"{'login': 'facebook-github-bot', 'id': 6422482, 'node_id': 'MDQ6VXNlcjY0MjI0ODI=', 'avatar_url': 'https://avatars3.githubusercontent.com/u/6422482?v=4', 'gravatar_id': '', 'url': 'https://api.github.com/users/facebook-github-bot', 'html_url': 'https://github.com/facebook-github-bot', 'followers_url': 'https://api.github.com/users/facebook-github-bot/followers', 'following_url': 'https://api.github.com/users/facebook-github-bot/following{/other_user}', 'gists_url': 'https://api.github.com/users/facebook-github-bot/gists{/gist_id}', 'starred_url': 'https://api.github.com/users/facebook-github-bot/starred{/owner}{/repo}', 'subscriptions_url': 'https://api.github.com/users/facebook-github-bot/subscriptions', 'organizations_url': 'https://api.github.com/users/facebook-github-bot/orgs', 'repos_url': 'https://api.github.com/users/facebook-github-bot/repos', 'events_url': 'https://api.github.com/users/facebook-github-bot/events{/privacy}', 'received_events_url': 'https://api.github.com/users/facebook-github-bot/received_events', 'type': 'User', 'site_admin': False}",referenced,6cf450744fd9eee73a55d0aa961d3cce56f83c65,https://api.github.com/repos/pytorch/pytorch/commits/6cf450744fd9eee73a55d0aa961d3cce56f83c65,2018-11-07T00:30:02Z,20,17,3
13559,1955288947,"{'login': 'facebook-github-bot', 'id': 6422482, 'node_id': 'MDQ6VXNlcjY0MjI0ODI=', 'avatar_url': 'https://avatars3.githubusercontent.com/u/6422482?v=4', 'gravatar_id': '', 'url': 'https://api.github.com/users/facebook-github-bot', 'html_url': 'https://github.com/facebook-github-bot', 'followers_url': 'https://api.github.com/users/facebook-github-bot/followers', 'following_url': 'https://api.github.com/users/facebook-github-bot/following{/other_user}', 'gists_url': 'https://api.github.com/users/facebook-github-bot/gists{/gist_id}', 'starred_url': 'https://api.github.com/users/facebook-github-bot/starred{/owner}{/repo}', 'subscriptions_url': 'https://api.github.com/users/facebook-github-bot/subscriptions', 'organizations_url': 'https://api.github.com/users/facebook-github-bot/orgs', 'repos_url': 'https://api.github.com/users/facebook-github-bot/repos', 'events_url': 'https://api.github.com/users/facebook-github-bot/events{/privacy}', 'received_events_url': 'https://api.github.com/users/facebook-github-bot/received_events', 'type': 'User', 'site_admin': False}",closed,0a090fe60a2a2c716a1d709c4236d1c9ca6ebd38,https://api.github.com/repos/pytorch/pytorch/commits/0a090fe60a2a2c716a1d709c4236d1c9ca6ebd38,2018-11-08T20:04:36Z,122,101,21
13545,2194249587,"{'login': 'facebook-github-bot', 'id': 6422482, 'node_id': 'MDQ6VXNlcjY0MjI0ODI=', 'avatar_url': 'https://avatars3.githubusercontent.com/u/6422482?v=4', 'gravatar_id': '', 'url': 'https://api.github.com/users/facebook-github-bot', 'html_url': 'https://github.com/facebook-github-bot', 'followers_url': 'https://api.github.com/users/facebook-github-bot/followers', 'following_url': 'https://api.github.com/users/facebook-github-bot/following{/other_user}', 'gists_url': 'https://api.github.com/users/facebook-github-bot/gists{/gist_id}', 'starred_url': 'https://api.github.com/users/facebook-github-bot/starred{/owner}{/repo}', 'subscriptions_url': 'https://api.github.com/users/facebook-github-bot/subscriptions', 'organizations_url': 'https://api.github.com/users/facebook-github-bot/orgs', 'repos_url': 'https://api.github.com/users/facebook-github-bot/repos', 'events_url': 'https://api.github.com/users/facebook-github-bot/events{/privacy}', 'received_events_url': 'https://api.github.com/users/facebook-github-bot/received_events', 'type': 'User', 'site_admin': False}",referenced,8045b3eb143ed70ab1873e148d266d56e0e1481f,https://api.github.com/repos/pytorch/pytorch/commits/8045b3eb143ed70ab1873e148d266d56e0e1481f,2019-03-11T15:12:27Z,11,11,0
13540,1945293103,"{'login': 'facebook-github-bot', 'id': 6422482, 'node_id': 'MDQ6VXNlcjY0MjI0ODI=', 'avatar_url': 'https://avatars3.githubusercontent.com/u/6422482?v=4', 'gravatar_id': '', 'url': 'https://api.github.com/users/facebook-github-bot', 'html_url': 'https://github.com/facebook-github-bot', 'followers_url': 'https://api.github.com/users/facebook-github-bot/followers', 'following_url': 'https://api.github.com/users/facebook-github-bot/following{/other_user}', 'gists_url': 'https://api.github.com/users/facebook-github-bot/gists{/gist_id}', 'starred_url': 'https://api.github.com/users/facebook-github-bot/starred{/owner}{/repo}', 'subscriptions_url': 'https://api.github.com/users/facebook-github-bot/subscriptions', 'organizations_url': 'https://api.github.com/users/facebook-github-bot/orgs', 'repos_url': 'https://api.github.com/users/facebook-github-bot/repos', 'events_url': 'https://api.github.com/users/facebook-github-bot/events{/privacy}', 'received_events_url': 'https://api.github.com/users/facebook-github-bot/received_events', 'type': 'User', 'site_admin': False}",referenced,246d5282b39f9536249bb85127f90857c976fa8d,https://api.github.com/repos/pytorch/pytorch/commits/246d5282b39f9536249bb85127f90857c976fa8d,2018-11-05T04:30:16Z,36,23,13
13465,2204175737,"{'login': 'facebook-github-bot', 'id': 6422482, 'node_id': 'MDQ6VXNlcjY0MjI0ODI=', 'avatar_url': 'https://avatars3.githubusercontent.com/u/6422482?v=4', 'gravatar_id': '', 'url': 'https://api.github.com/users/facebook-github-bot', 'html_url': 'https://github.com/facebook-github-bot', 'followers_url': 'https://api.github.com/users/facebook-github-bot/followers', 'following_url': 'https://api.github.com/users/facebook-github-bot/following{/other_user}', 'gists_url': 'https://api.github.com/users/facebook-github-bot/gists{/gist_id}', 'starred_url': 'https://api.github.com/users/facebook-github-bot/starred{/owner}{/repo}', 'subscriptions_url': 'https://api.github.com/users/facebook-github-bot/subscriptions', 'organizations_url': 'https://api.github.com/users/facebook-github-bot/orgs', 'repos_url': 'https://api.github.com/users/facebook-github-bot/repos', 'events_url': 'https://api.github.com/users/facebook-github-bot/events{/privacy}', 'received_events_url': 'https://api.github.com/users/facebook-github-bot/received_events', 'type': 'User', 'site_admin': False}",closed,bba906c2cb166c4c303989383ba814c6392543b9,https://api.github.com/repos/pytorch/pytorch/commits/bba906c2cb166c4c303989383ba814c6392543b9,2019-03-14T17:12:44Z,11,11,0
13409,2055364599,"{'login': 'facebook-github-bot', 'id': 6422482, 'node_id': 'MDQ6VXNlcjY0MjI0ODI=', 'avatar_url': 'https://avatars3.githubusercontent.com/u/6422482?v=4', 'gravatar_id': '', 'url': 'https://api.github.com/users/facebook-github-bot', 'html_url': 'https://github.com/facebook-github-bot', 'followers_url': 'https://api.github.com/users/facebook-github-bot/followers', 'following_url': 'https://api.github.com/users/facebook-github-bot/following{/other_user}', 'gists_url': 'https://api.github.com/users/facebook-github-bot/gists{/gist_id}', 'starred_url': 'https://api.github.com/users/facebook-github-bot/starred{/owner}{/repo}', 'subscriptions_url': 'https://api.github.com/users/facebook-github-bot/subscriptions', 'organizations_url': 'https://api.github.com/users/facebook-github-bot/orgs', 'repos_url': 'https://api.github.com/users/facebook-github-bot/repos', 'events_url': 'https://api.github.com/users/facebook-github-bot/events{/privacy}', 'received_events_url': 'https://api.github.com/users/facebook-github-bot/received_events', 'type': 'User', 'site_admin': False}",referenced,b1529eeadb531a2454ec8c851f70034b59664df7,https://api.github.com/repos/pytorch/pytorch/commits/b1529eeadb531a2454ec8c851f70034b59664df7,2019-01-04T21:06:06Z,147,146,1
13404,2023219256,"{'login': 'facebook-github-bot', 'id': 6422482, 'node_id': 'MDQ6VXNlcjY0MjI0ODI=', 'avatar_url': 'https://avatars3.githubusercontent.com/u/6422482?v=4', 'gravatar_id': '', 'url': 'https://api.github.com/users/facebook-github-bot', 'html_url': 'https://github.com/facebook-github-bot', 'followers_url': 'https://api.github.com/users/facebook-github-bot/followers', 'following_url': 'https://api.github.com/users/facebook-github-bot/following{/other_user}', 'gists_url': 'https://api.github.com/users/facebook-github-bot/gists{/gist_id}', 'starred_url': 'https://api.github.com/users/facebook-github-bot/starred{/owner}{/repo}', 'subscriptions_url': 'https://api.github.com/users/facebook-github-bot/subscriptions', 'organizations_url': 'https://api.github.com/users/facebook-github-bot/orgs', 'repos_url': 'https://api.github.com/users/facebook-github-bot/repos', 'events_url': 'https://api.github.com/users/facebook-github-bot/events{/privacy}', 'received_events_url': 'https://api.github.com/users/facebook-github-bot/received_events', 'type': 'User', 'site_admin': False}",referenced,895cb8fcea85d1879ab04599487a678f3b8b61d7,https://api.github.com/repos/pytorch/pytorch/commits/895cb8fcea85d1879ab04599487a678f3b8b61d7,2018-12-13T03:57:45Z,10,10,0
13386,1990288801,"{'login': 'facebook-github-bot', 'id': 6422482, 'node_id': 'MDQ6VXNlcjY0MjI0ODI=', 'avatar_url': 'https://avatars3.githubusercontent.com/u/6422482?v=4', 'gravatar_id': '', 'url': 'https://api.github.com/users/facebook-github-bot', 'html_url': 'https://github.com/facebook-github-bot', 'followers_url': 'https://api.github.com/users/facebook-github-bot/followers', 'following_url': 'https://api.github.com/users/facebook-github-bot/following{/other_user}', 'gists_url': 'https://api.github.com/users/facebook-github-bot/gists{/gist_id}', 'starred_url': 'https://api.github.com/users/facebook-github-bot/starred{/owner}{/repo}', 'subscriptions_url': 'https://api.github.com/users/facebook-github-bot/subscriptions', 'organizations_url': 'https://api.github.com/users/facebook-github-bot/orgs', 'repos_url': 'https://api.github.com/users/facebook-github-bot/repos', 'events_url': 'https://api.github.com/users/facebook-github-bot/events{/privacy}', 'received_events_url': 'https://api.github.com/users/facebook-github-bot/received_events', 'type': 'User', 'site_admin': False}",closed,c19af59a6edd9567d5fb5712ca22cc8e22c7f8fc,https://api.github.com/repos/pytorch/pytorch/commits/c19af59a6edd9567d5fb5712ca22cc8e22c7f8fc,2018-11-27T17:39:40Z,602,161,441
13384,1946368389,"{'login': 'facebook-github-bot', 'id': 6422482, 'node_id': 'MDQ6VXNlcjY0MjI0ODI=', 'avatar_url': 'https://avatars3.githubusercontent.com/u/6422482?v=4', 'gravatar_id': '', 'url': 'https://api.github.com/users/facebook-github-bot', 'html_url': 'https://github.com/facebook-github-bot', 'followers_url': 'https://api.github.com/users/facebook-github-bot/followers', 'following_url': 'https://api.github.com/users/facebook-github-bot/following{/other_user}', 'gists_url': 'https://api.github.com/users/facebook-github-bot/gists{/gist_id}', 'starred_url': 'https://api.github.com/users/facebook-github-bot/starred{/owner}{/repo}', 'subscriptions_url': 'https://api.github.com/users/facebook-github-bot/subscriptions', 'organizations_url': 'https://api.github.com/users/facebook-github-bot/orgs', 'repos_url': 'https://api.github.com/users/facebook-github-bot/repos', 'events_url': 'https://api.github.com/users/facebook-github-bot/events{/privacy}', 'received_events_url': 'https://api.github.com/users/facebook-github-bot/received_events', 'type': 'User', 'site_admin': False}",referenced,e988dc621bc354598bd0ae5b5674a3edd31a046d,https://api.github.com/repos/pytorch/pytorch/commits/e988dc621bc354598bd0ae5b5674a3edd31a046d,2018-11-05T14:34:18Z,438,152,286
13384,1990561318,"{'login': 'facebook-github-bot', 'id': 6422482, 'node_id': 'MDQ6VXNlcjY0MjI0ODI=', 'avatar_url': 'https://avatars3.githubusercontent.com/u/6422482?v=4', 'gravatar_id': '', 'url': 'https://api.github.com/users/facebook-github-bot', 'html_url': 'https://github.com/facebook-github-bot', 'followers_url': 'https://api.github.com/users/facebook-github-bot/followers', 'following_url': 'https://api.github.com/users/facebook-github-bot/following{/other_user}', 'gists_url': 'https://api.github.com/users/facebook-github-bot/gists{/gist_id}', 'starred_url': 'https://api.github.com/users/facebook-github-bot/starred{/owner}{/repo}', 'subscriptions_url': 'https://api.github.com/users/facebook-github-bot/subscriptions', 'organizations_url': 'https://api.github.com/users/facebook-github-bot/orgs', 'repos_url': 'https://api.github.com/users/facebook-github-bot/repos', 'events_url': 'https://api.github.com/users/facebook-github-bot/events{/privacy}', 'received_events_url': 'https://api.github.com/users/facebook-github-bot/received_events', 'type': 'User', 'site_admin': False}",closed,8408dff55af59cc264b0f55db8a8584241d7274c,https://api.github.com/repos/pytorch/pytorch/commits/8408dff55af59cc264b0f55db8a8584241d7274c,2018-11-27T19:34:46Z,216,172,44
13376,1938972392,"{'login': 'facebook-github-bot', 'id': 6422482, 'node_id': 'MDQ6VXNlcjY0MjI0ODI=', 'avatar_url': 'https://avatars3.githubusercontent.com/u/6422482?v=4', 'gravatar_id': '', 'url': 'https://api.github.com/users/facebook-github-bot', 'html_url': 'https://github.com/facebook-github-bot', 'followers_url': 'https://api.github.com/users/facebook-github-bot/followers', 'following_url': 'https://api.github.com/users/facebook-github-bot/following{/other_user}', 'gists_url': 'https://api.github.com/users/facebook-github-bot/gists{/gist_id}', 'starred_url': 'https://api.github.com/users/facebook-github-bot/starred{/owner}{/repo}', 'subscriptions_url': 'https://api.github.com/users/facebook-github-bot/subscriptions', 'organizations_url': 'https://api.github.com/users/facebook-github-bot/orgs', 'repos_url': 'https://api.github.com/users/facebook-github-bot/repos', 'events_url': 'https://api.github.com/users/facebook-github-bot/events{/privacy}', 'received_events_url': 'https://api.github.com/users/facebook-github-bot/received_events', 'type': 'User', 'site_admin': False}",closed,f9c0a08eed723ac14378422f066e6ee1be3854a2,https://api.github.com/repos/pytorch/pytorch/commits/f9c0a08eed723ac14378422f066e6ee1be3854a2,2018-10-31T20:15:08Z,23,21,2
13326,1941992195,"{'login': 'facebook-github-bot', 'id': 6422482, 'node_id': 'MDQ6VXNlcjY0MjI0ODI=', 'avatar_url': 'https://avatars3.githubusercontent.com/u/6422482?v=4', 'gravatar_id': '', 'url': 'https://api.github.com/users/facebook-github-bot', 'html_url': 'https://github.com/facebook-github-bot', 'followers_url': 'https://api.github.com/users/facebook-github-bot/followers', 'following_url': 'https://api.github.com/users/facebook-github-bot/following{/other_user}', 'gists_url': 'https://api.github.com/users/facebook-github-bot/gists{/gist_id}', 'starred_url': 'https://api.github.com/users/facebook-github-bot/starred{/owner}{/repo}', 'subscriptions_url': 'https://api.github.com/users/facebook-github-bot/subscriptions', 'organizations_url': 'https://api.github.com/users/facebook-github-bot/orgs', 'repos_url': 'https://api.github.com/users/facebook-github-bot/repos', 'events_url': 'https://api.github.com/users/facebook-github-bot/events{/privacy}', 'received_events_url': 'https://api.github.com/users/facebook-github-bot/received_events', 'type': 'User', 'site_admin': False}",closed,6d2b3cc869d2d39832800e8127cb66abf3589311,https://api.github.com/repos/pytorch/pytorch/commits/6d2b3cc869d2d39832800e8127cb66abf3589311,2018-11-02T02:09:28Z,206,117,89
13324,1971707086,"{'login': 'facebook-github-bot', 'id': 6422482, 'node_id': 'MDQ6VXNlcjY0MjI0ODI=', 'avatar_url': 'https://avatars3.githubusercontent.com/u/6422482?v=4', 'gravatar_id': '', 'url': 'https://api.github.com/users/facebook-github-bot', 'html_url': 'https://github.com/facebook-github-bot', 'followers_url': 'https://api.github.com/users/facebook-github-bot/followers', 'following_url': 'https://api.github.com/users/facebook-github-bot/following{/other_user}', 'gists_url': 'https://api.github.com/users/facebook-github-bot/gists{/gist_id}', 'starred_url': 'https://api.github.com/users/facebook-github-bot/starred{/owner}{/repo}', 'subscriptions_url': 'https://api.github.com/users/facebook-github-bot/subscriptions', 'organizations_url': 'https://api.github.com/users/facebook-github-bot/orgs', 'repos_url': 'https://api.github.com/users/facebook-github-bot/repos', 'events_url': 'https://api.github.com/users/facebook-github-bot/events{/privacy}', 'received_events_url': 'https://api.github.com/users/facebook-github-bot/received_events', 'type': 'User', 'site_admin': False}",referenced,e4bb56570c7d6c7e17a85cbface4828c62a33564,https://api.github.com/repos/pytorch/pytorch/commits/e4bb56570c7d6c7e17a85cbface4828c62a33564,2018-11-16T16:40:32Z,15,13,2
13292,1953323801,"{'login': 'facebook-github-bot', 'id': 6422482, 'node_id': 'MDQ6VXNlcjY0MjI0ODI=', 'avatar_url': 'https://avatars3.githubusercontent.com/u/6422482?v=4', 'gravatar_id': '', 'url': 'https://api.github.com/users/facebook-github-bot', 'html_url': 'https://github.com/facebook-github-bot', 'followers_url': 'https://api.github.com/users/facebook-github-bot/followers', 'following_url': 'https://api.github.com/users/facebook-github-bot/following{/other_user}', 'gists_url': 'https://api.github.com/users/facebook-github-bot/gists{/gist_id}', 'starred_url': 'https://api.github.com/users/facebook-github-bot/starred{/owner}{/repo}', 'subscriptions_url': 'https://api.github.com/users/facebook-github-bot/subscriptions', 'organizations_url': 'https://api.github.com/users/facebook-github-bot/orgs', 'repos_url': 'https://api.github.com/users/facebook-github-bot/repos', 'events_url': 'https://api.github.com/users/facebook-github-bot/events{/privacy}', 'received_events_url': 'https://api.github.com/users/facebook-github-bot/received_events', 'type': 'User', 'site_admin': False}",referenced,6bfce168730985821687f6adfc643d424e60cb52,https://api.github.com/repos/pytorch/pytorch/commits/6bfce168730985821687f6adfc643d424e60cb52,2018-11-08T03:55:16Z,124,70,54
13273,2244687513,"{'login': 'facebook-github-bot', 'id': 6422482, 'node_id': 'MDQ6VXNlcjY0MjI0ODI=', 'avatar_url': 'https://avatars3.githubusercontent.com/u/6422482?v=4', 'gravatar_id': '', 'url': 'https://api.github.com/users/facebook-github-bot', 'html_url': 'https://github.com/facebook-github-bot', 'followers_url': 'https://api.github.com/users/facebook-github-bot/followers', 'following_url': 'https://api.github.com/users/facebook-github-bot/following{/other_user}', 'gists_url': 'https://api.github.com/users/facebook-github-bot/gists{/gist_id}', 'starred_url': 'https://api.github.com/users/facebook-github-bot/starred{/owner}{/repo}', 'subscriptions_url': 'https://api.github.com/users/facebook-github-bot/subscriptions', 'organizations_url': 'https://api.github.com/users/facebook-github-bot/orgs', 'repos_url': 'https://api.github.com/users/facebook-github-bot/repos', 'events_url': 'https://api.github.com/users/facebook-github-bot/events{/privacy}', 'received_events_url': 'https://api.github.com/users/facebook-github-bot/received_events', 'type': 'User', 'site_admin': False}",referenced,bdfdf6c2b936bc5ae34c6fe52dfbb92847ae4205,https://api.github.com/repos/pytorch/pytorch/commits/bdfdf6c2b936bc5ae34c6fe52dfbb92847ae4205,2019-04-01T21:32:25Z,590,590,0
13273,2277676565,"{'login': 'facebook-github-bot', 'id': 6422482, 'node_id': 'MDQ6VXNlcjY0MjI0ODI=', 'avatar_url': 'https://avatars3.githubusercontent.com/u/6422482?v=4', 'gravatar_id': '', 'url': 'https://api.github.com/users/facebook-github-bot', 'html_url': 'https://github.com/facebook-github-bot', 'followers_url': 'https://api.github.com/users/facebook-github-bot/followers', 'following_url': 'https://api.github.com/users/facebook-github-bot/following{/other_user}', 'gists_url': 'https://api.github.com/users/facebook-github-bot/gists{/gist_id}', 'starred_url': 'https://api.github.com/users/facebook-github-bot/starred{/owner}{/repo}', 'subscriptions_url': 'https://api.github.com/users/facebook-github-bot/subscriptions', 'organizations_url': 'https://api.github.com/users/facebook-github-bot/orgs', 'repos_url': 'https://api.github.com/users/facebook-github-bot/repos', 'events_url': 'https://api.github.com/users/facebook-github-bot/events{/privacy}', 'received_events_url': 'https://api.github.com/users/facebook-github-bot/received_events', 'type': 'User', 'site_admin': False}",closed,a0263ec04765fb9b20decc178241d2668ea58cee,https://api.github.com/repos/pytorch/pytorch/commits/a0263ec04765fb9b20decc178241d2668ea58cee,2019-04-15T19:46:24Z,401,221,180
13254,1975270215,"{'login': 'facebook-github-bot', 'id': 6422482, 'node_id': 'MDQ6VXNlcjY0MjI0ODI=', 'avatar_url': 'https://avatars3.githubusercontent.com/u/6422482?v=4', 'gravatar_id': '', 'url': 'https://api.github.com/users/facebook-github-bot', 'html_url': 'https://github.com/facebook-github-bot', 'followers_url': 'https://api.github.com/users/facebook-github-bot/followers', 'following_url': 'https://api.github.com/users/facebook-github-bot/following{/other_user}', 'gists_url': 'https://api.github.com/users/facebook-github-bot/gists{/gist_id}', 'starred_url': 'https://api.github.com/users/facebook-github-bot/starred{/owner}{/repo}', 'subscriptions_url': 'https://api.github.com/users/facebook-github-bot/subscriptions', 'organizations_url': 'https://api.github.com/users/facebook-github-bot/orgs', 'repos_url': 'https://api.github.com/users/facebook-github-bot/repos', 'events_url': 'https://api.github.com/users/facebook-github-bot/events{/privacy}', 'received_events_url': 'https://api.github.com/users/facebook-github-bot/received_events', 'type': 'User', 'site_admin': False}",closed,751b5ea94103105e9a2617a2eddafc830cd0104d,https://api.github.com/repos/pytorch/pytorch/commits/751b5ea94103105e9a2617a2eddafc830cd0104d,2018-11-19T17:23:39Z,109,52,57
13243,1935435356,"{'login': 'facebook-github-bot', 'id': 6422482, 'node_id': 'MDQ6VXNlcjY0MjI0ODI=', 'avatar_url': 'https://avatars3.githubusercontent.com/u/6422482?v=4', 'gravatar_id': '', 'url': 'https://api.github.com/users/facebook-github-bot', 'html_url': 'https://github.com/facebook-github-bot', 'followers_url': 'https://api.github.com/users/facebook-github-bot/followers', 'following_url': 'https://api.github.com/users/facebook-github-bot/following{/other_user}', 'gists_url': 'https://api.github.com/users/facebook-github-bot/gists{/gist_id}', 'starred_url': 'https://api.github.com/users/facebook-github-bot/starred{/owner}{/repo}', 'subscriptions_url': 'https://api.github.com/users/facebook-github-bot/subscriptions', 'organizations_url': 'https://api.github.com/users/facebook-github-bot/orgs', 'repos_url': 'https://api.github.com/users/facebook-github-bot/repos', 'events_url': 'https://api.github.com/users/facebook-github-bot/events{/privacy}', 'received_events_url': 'https://api.github.com/users/facebook-github-bot/received_events', 'type': 'User', 'site_admin': False}",closed,f06b70a6e9b890c3acc0160c9380605b5e119da5,https://api.github.com/repos/pytorch/pytorch/commits/f06b70a6e9b890c3acc0160c9380605b5e119da5,2018-10-30T15:34:15Z,2,1,1
13229,2212353117,"{'login': 'facebook-github-bot', 'id': 6422482, 'node_id': 'MDQ6VXNlcjY0MjI0ODI=', 'avatar_url': 'https://avatars3.githubusercontent.com/u/6422482?v=4', 'gravatar_id': '', 'url': 'https://api.github.com/users/facebook-github-bot', 'html_url': 'https://github.com/facebook-github-bot', 'followers_url': 'https://api.github.com/users/facebook-github-bot/followers', 'following_url': 'https://api.github.com/users/facebook-github-bot/following{/other_user}', 'gists_url': 'https://api.github.com/users/facebook-github-bot/gists{/gist_id}', 'starred_url': 'https://api.github.com/users/facebook-github-bot/starred{/owner}{/repo}', 'subscriptions_url': 'https://api.github.com/users/facebook-github-bot/subscriptions', 'organizations_url': 'https://api.github.com/users/facebook-github-bot/orgs', 'repos_url': 'https://api.github.com/users/facebook-github-bot/repos', 'events_url': 'https://api.github.com/users/facebook-github-bot/events{/privacy}', 'received_events_url': 'https://api.github.com/users/facebook-github-bot/received_events', 'type': 'User', 'site_admin': False}",referenced,195cba500f2c98c10f3d4b8fc3cca6493099b6df,https://api.github.com/repos/pytorch/pytorch/commits/195cba500f2c98c10f3d4b8fc3cca6493099b6df,2019-03-19T04:02:26Z,51,24,27
13225,1935997456,"{'login': 'facebook-github-bot', 'id': 6422482, 'node_id': 'MDQ6VXNlcjY0MjI0ODI=', 'avatar_url': 'https://avatars3.githubusercontent.com/u/6422482?v=4', 'gravatar_id': '', 'url': 'https://api.github.com/users/facebook-github-bot', 'html_url': 'https://github.com/facebook-github-bot', 'followers_url': 'https://api.github.com/users/facebook-github-bot/followers', 'following_url': 'https://api.github.com/users/facebook-github-bot/following{/other_user}', 'gists_url': 'https://api.github.com/users/facebook-github-bot/gists{/gist_id}', 'starred_url': 'https://api.github.com/users/facebook-github-bot/starred{/owner}{/repo}', 'subscriptions_url': 'https://api.github.com/users/facebook-github-bot/subscriptions', 'organizations_url': 'https://api.github.com/users/facebook-github-bot/orgs', 'repos_url': 'https://api.github.com/users/facebook-github-bot/repos', 'events_url': 'https://api.github.com/users/facebook-github-bot/events{/privacy}', 'received_events_url': 'https://api.github.com/users/facebook-github-bot/received_events', 'type': 'User', 'site_admin': False}",closed,518b0d06008b286aafbfa94122981e5b8e695f8b,https://api.github.com/repos/pytorch/pytorch/commits/518b0d06008b286aafbfa94122981e5b8e695f8b,2018-10-30T18:54:40Z,2,1,1
13209,1932920760,"{'login': 'facebook-github-bot', 'id': 6422482, 'node_id': 'MDQ6VXNlcjY0MjI0ODI=', 'avatar_url': 'https://avatars3.githubusercontent.com/u/6422482?v=4', 'gravatar_id': '', 'url': 'https://api.github.com/users/facebook-github-bot', 'html_url': 'https://github.com/facebook-github-bot', 'followers_url': 'https://api.github.com/users/facebook-github-bot/followers', 'following_url': 'https://api.github.com/users/facebook-github-bot/following{/other_user}', 'gists_url': 'https://api.github.com/users/facebook-github-bot/gists{/gist_id}', 'starred_url': 'https://api.github.com/users/facebook-github-bot/starred{/owner}{/repo}', 'subscriptions_url': 'https://api.github.com/users/facebook-github-bot/subscriptions', 'organizations_url': 'https://api.github.com/users/facebook-github-bot/orgs', 'repos_url': 'https://api.github.com/users/facebook-github-bot/repos', 'events_url': 'https://api.github.com/users/facebook-github-bot/events{/privacy}', 'received_events_url': 'https://api.github.com/users/facebook-github-bot/received_events', 'type': 'User', 'site_admin': False}",closed,52b6460d3aa2714efc1831ed76159d24585481fe,https://api.github.com/repos/pytorch/pytorch/commits/52b6460d3aa2714efc1831ed76159d24585481fe,2018-10-29T17:25:04Z,17,15,2
13200,1937113941,"{'login': 'facebook-github-bot', 'id': 6422482, 'node_id': 'MDQ6VXNlcjY0MjI0ODI=', 'avatar_url': 'https://avatars3.githubusercontent.com/u/6422482?v=4', 'gravatar_id': '', 'url': 'https://api.github.com/users/facebook-github-bot', 'html_url': 'https://github.com/facebook-github-bot', 'followers_url': 'https://api.github.com/users/facebook-github-bot/followers', 'following_url': 'https://api.github.com/users/facebook-github-bot/following{/other_user}', 'gists_url': 'https://api.github.com/users/facebook-github-bot/gists{/gist_id}', 'starred_url': 'https://api.github.com/users/facebook-github-bot/starred{/owner}{/repo}', 'subscriptions_url': 'https://api.github.com/users/facebook-github-bot/subscriptions', 'organizations_url': 'https://api.github.com/users/facebook-github-bot/orgs', 'repos_url': 'https://api.github.com/users/facebook-github-bot/repos', 'events_url': 'https://api.github.com/users/facebook-github-bot/events{/privacy}', 'received_events_url': 'https://api.github.com/users/facebook-github-bot/received_events', 'type': 'User', 'site_admin': False}",closed,e475d3ede37cfec2892cf7e94a3109b6ec1b3cde,https://api.github.com/repos/pytorch/pytorch/commits/e475d3ede37cfec2892cf7e94a3109b6ec1b3cde,2018-10-31T07:45:07Z,36,17,19
12921,1925102134,"{'login': 'facebook-github-bot', 'id': 6422482, 'node_id': 'MDQ6VXNlcjY0MjI0ODI=', 'avatar_url': 'https://avatars3.githubusercontent.com/u/6422482?v=4', 'gravatar_id': '', 'url': 'https://api.github.com/users/facebook-github-bot', 'html_url': 'https://github.com/facebook-github-bot', 'followers_url': 'https://api.github.com/users/facebook-github-bot/followers', 'following_url': 'https://api.github.com/users/facebook-github-bot/following{/other_user}', 'gists_url': 'https://api.github.com/users/facebook-github-bot/gists{/gist_id}', 'starred_url': 'https://api.github.com/users/facebook-github-bot/starred{/owner}{/repo}', 'subscriptions_url': 'https://api.github.com/users/facebook-github-bot/subscriptions', 'organizations_url': 'https://api.github.com/users/facebook-github-bot/orgs', 'repos_url': 'https://api.github.com/users/facebook-github-bot/repos', 'events_url': 'https://api.github.com/users/facebook-github-bot/events{/privacy}', 'received_events_url': 'https://api.github.com/users/facebook-github-bot/received_events', 'type': 'User', 'site_admin': False}",referenced,2d9b1fcd093bfd4680c9db846afed2c1bf51cd5b,https://api.github.com/repos/pytorch/pytorch/commits/2d9b1fcd093bfd4680c9db846afed2c1bf51cd5b,2018-10-25T03:13:16Z,5,4,1
12918,2975554663,"{'login': 'facebook-github-bot', 'id': 6422482, 'node_id': 'MDQ6VXNlcjY0MjI0ODI=', 'avatar_url': 'https://avatars3.githubusercontent.com/u/6422482?v=4', 'gravatar_id': '', 'url': 'https://api.github.com/users/facebook-github-bot', 'html_url': 'https://github.com/facebook-github-bot', 'followers_url': 'https://api.github.com/users/facebook-github-bot/followers', 'following_url': 'https://api.github.com/users/facebook-github-bot/following{/other_user}', 'gists_url': 'https://api.github.com/users/facebook-github-bot/gists{/gist_id}', 'starred_url': 'https://api.github.com/users/facebook-github-bot/starred{/owner}{/repo}', 'subscriptions_url': 'https://api.github.com/users/facebook-github-bot/subscriptions', 'organizations_url': 'https://api.github.com/users/facebook-github-bot/orgs', 'repos_url': 'https://api.github.com/users/facebook-github-bot/repos', 'events_url': 'https://api.github.com/users/facebook-github-bot/events{/privacy}', 'received_events_url': 'https://api.github.com/users/facebook-github-bot/received_events', 'type': 'User', 'site_admin': False}",referenced,49cd83d7356aa40b3223866adab8a7d823f2c9f4,https://api.github.com/repos/pytorch/pytorch/commits/49cd83d7356aa40b3223866adab8a7d823f2c9f4,2020-01-23T22:47:46Z,9,3,6
12565,1911494829,"{'login': 'facebook-github-bot', 'id': 6422482, 'node_id': 'MDQ6VXNlcjY0MjI0ODI=', 'avatar_url': 'https://avatars3.githubusercontent.com/u/6422482?v=4', 'gravatar_id': '', 'url': 'https://api.github.com/users/facebook-github-bot', 'html_url': 'https://github.com/facebook-github-bot', 'followers_url': 'https://api.github.com/users/facebook-github-bot/followers', 'following_url': 'https://api.github.com/users/facebook-github-bot/following{/other_user}', 'gists_url': 'https://api.github.com/users/facebook-github-bot/gists{/gist_id}', 'starred_url': 'https://api.github.com/users/facebook-github-bot/starred{/owner}{/repo}', 'subscriptions_url': 'https://api.github.com/users/facebook-github-bot/subscriptions', 'organizations_url': 'https://api.github.com/users/facebook-github-bot/orgs', 'repos_url': 'https://api.github.com/users/facebook-github-bot/repos', 'events_url': 'https://api.github.com/users/facebook-github-bot/events{/privacy}', 'received_events_url': 'https://api.github.com/users/facebook-github-bot/received_events', 'type': 'User', 'site_admin': False}",closed,710191e292b39c6d26948454fcf1f4a30433d6a0,https://api.github.com/repos/pytorch/pytorch/commits/710191e292b39c6d26948454fcf1f4a30433d6a0,2018-10-18T07:52:29Z,13,10,3
12545,1905484216,"{'login': 'facebook-github-bot', 'id': 6422482, 'node_id': 'MDQ6VXNlcjY0MjI0ODI=', 'avatar_url': 'https://avatars3.githubusercontent.com/u/6422482?v=4', 'gravatar_id': '', 'url': 'https://api.github.com/users/facebook-github-bot', 'html_url': 'https://github.com/facebook-github-bot', 'followers_url': 'https://api.github.com/users/facebook-github-bot/followers', 'following_url': 'https://api.github.com/users/facebook-github-bot/following{/other_user}', 'gists_url': 'https://api.github.com/users/facebook-github-bot/gists{/gist_id}', 'starred_url': 'https://api.github.com/users/facebook-github-bot/starred{/owner}{/repo}', 'subscriptions_url': 'https://api.github.com/users/facebook-github-bot/subscriptions', 'organizations_url': 'https://api.github.com/users/facebook-github-bot/orgs', 'repos_url': 'https://api.github.com/users/facebook-github-bot/repos', 'events_url': 'https://api.github.com/users/facebook-github-bot/events{/privacy}', 'received_events_url': 'https://api.github.com/users/facebook-github-bot/received_events', 'type': 'User', 'site_admin': False}",referenced,52cbf4b7749a94dad280f96388dd358c96d36cbd,https://api.github.com/repos/pytorch/pytorch/commits/52cbf4b7749a94dad280f96388dd358c96d36cbd,2018-10-16T00:03:33Z,2,1,1
12540,1904827692,"{'login': 'facebook-github-bot', 'id': 6422482, 'node_id': 'MDQ6VXNlcjY0MjI0ODI=', 'avatar_url': 'https://avatars3.githubusercontent.com/u/6422482?v=4', 'gravatar_id': '', 'url': 'https://api.github.com/users/facebook-github-bot', 'html_url': 'https://github.com/facebook-github-bot', 'followers_url': 'https://api.github.com/users/facebook-github-bot/followers', 'following_url': 'https://api.github.com/users/facebook-github-bot/following{/other_user}', 'gists_url': 'https://api.github.com/users/facebook-github-bot/gists{/gist_id}', 'starred_url': 'https://api.github.com/users/facebook-github-bot/starred{/owner}{/repo}', 'subscriptions_url': 'https://api.github.com/users/facebook-github-bot/subscriptions', 'organizations_url': 'https://api.github.com/users/facebook-github-bot/orgs', 'repos_url': 'https://api.github.com/users/facebook-github-bot/repos', 'events_url': 'https://api.github.com/users/facebook-github-bot/events{/privacy}', 'received_events_url': 'https://api.github.com/users/facebook-github-bot/received_events', 'type': 'User', 'site_admin': False}",closed,a1bbe80e2199f81973bbeb8e6f0d40c5707d02e7,https://api.github.com/repos/pytorch/pytorch/commits/a1bbe80e2199f81973bbeb8e6f0d40c5707d02e7,2018-10-15T18:06:06Z,787,0,787
12510,1956048617,"{'login': 'facebook-github-bot', 'id': 6422482, 'node_id': 'MDQ6VXNlcjY0MjI0ODI=', 'avatar_url': 'https://avatars3.githubusercontent.com/u/6422482?v=4', 'gravatar_id': '', 'url': 'https://api.github.com/users/facebook-github-bot', 'html_url': 'https://github.com/facebook-github-bot', 'followers_url': 'https://api.github.com/users/facebook-github-bot/followers', 'following_url': 'https://api.github.com/users/facebook-github-bot/following{/other_user}', 'gists_url': 'https://api.github.com/users/facebook-github-bot/gists{/gist_id}', 'starred_url': 'https://api.github.com/users/facebook-github-bot/starred{/owner}{/repo}', 'subscriptions_url': 'https://api.github.com/users/facebook-github-bot/subscriptions', 'organizations_url': 'https://api.github.com/users/facebook-github-bot/orgs', 'repos_url': 'https://api.github.com/users/facebook-github-bot/repos', 'events_url': 'https://api.github.com/users/facebook-github-bot/events{/privacy}', 'received_events_url': 'https://api.github.com/users/facebook-github-bot/received_events', 'type': 'User', 'site_admin': False}",closed,26751ce30064d1d93d744f0d114968bc77dccddc,https://api.github.com/repos/pytorch/pytorch/commits/26751ce30064d1d93d744f0d114968bc77dccddc,2018-11-09T05:11:02Z,22,21,1
12495,1899305933,"{'login': 'facebook-github-bot', 'id': 6422482, 'node_id': 'MDQ6VXNlcjY0MjI0ODI=', 'avatar_url': 'https://avatars3.githubusercontent.com/u/6422482?v=4', 'gravatar_id': '', 'url': 'https://api.github.com/users/facebook-github-bot', 'html_url': 'https://github.com/facebook-github-bot', 'followers_url': 'https://api.github.com/users/facebook-github-bot/followers', 'following_url': 'https://api.github.com/users/facebook-github-bot/following{/other_user}', 'gists_url': 'https://api.github.com/users/facebook-github-bot/gists{/gist_id}', 'starred_url': 'https://api.github.com/users/facebook-github-bot/starred{/owner}{/repo}', 'subscriptions_url': 'https://api.github.com/users/facebook-github-bot/subscriptions', 'organizations_url': 'https://api.github.com/users/facebook-github-bot/orgs', 'repos_url': 'https://api.github.com/users/facebook-github-bot/repos', 'events_url': 'https://api.github.com/users/facebook-github-bot/events{/privacy}', 'received_events_url': 'https://api.github.com/users/facebook-github-bot/received_events', 'type': 'User', 'site_admin': False}",closed,7b0f5d6631321c9758a853dd3ac2c95ebf326d53,https://api.github.com/repos/pytorch/pytorch/commits/7b0f5d6631321c9758a853dd3ac2c95ebf326d53,2018-10-11T20:54:55Z,1,0,1
12459,1941107170,"{'login': 'facebook-github-bot', 'id': 6422482, 'node_id': 'MDQ6VXNlcjY0MjI0ODI=', 'avatar_url': 'https://avatars3.githubusercontent.com/u/6422482?v=4', 'gravatar_id': '', 'url': 'https://api.github.com/users/facebook-github-bot', 'html_url': 'https://github.com/facebook-github-bot', 'followers_url': 'https://api.github.com/users/facebook-github-bot/followers', 'following_url': 'https://api.github.com/users/facebook-github-bot/following{/other_user}', 'gists_url': 'https://api.github.com/users/facebook-github-bot/gists{/gist_id}', 'starred_url': 'https://api.github.com/users/facebook-github-bot/starred{/owner}{/repo}', 'subscriptions_url': 'https://api.github.com/users/facebook-github-bot/subscriptions', 'organizations_url': 'https://api.github.com/users/facebook-github-bot/orgs', 'repos_url': 'https://api.github.com/users/facebook-github-bot/repos', 'events_url': 'https://api.github.com/users/facebook-github-bot/events{/privacy}', 'received_events_url': 'https://api.github.com/users/facebook-github-bot/received_events', 'type': 'User', 'site_admin': False}",closed,99a5d195917a14cdcef83c8c8a9553d30a568f08,https://api.github.com/repos/pytorch/pytorch/commits/99a5d195917a14cdcef83c8c8a9553d30a568f08,2018-11-01T17:33:07Z,491,247,244
12454,1900252319,"{'login': 'facebook-github-bot', 'id': 6422482, 'node_id': 'MDQ6VXNlcjY0MjI0ODI=', 'avatar_url': 'https://avatars3.githubusercontent.com/u/6422482?v=4', 'gravatar_id': '', 'url': 'https://api.github.com/users/facebook-github-bot', 'html_url': 'https://github.com/facebook-github-bot', 'followers_url': 'https://api.github.com/users/facebook-github-bot/followers', 'following_url': 'https://api.github.com/users/facebook-github-bot/following{/other_user}', 'gists_url': 'https://api.github.com/users/facebook-github-bot/gists{/gist_id}', 'starred_url': 'https://api.github.com/users/facebook-github-bot/starred{/owner}{/repo}', 'subscriptions_url': 'https://api.github.com/users/facebook-github-bot/subscriptions', 'organizations_url': 'https://api.github.com/users/facebook-github-bot/orgs', 'repos_url': 'https://api.github.com/users/facebook-github-bot/repos', 'events_url': 'https://api.github.com/users/facebook-github-bot/events{/privacy}', 'received_events_url': 'https://api.github.com/users/facebook-github-bot/received_events', 'type': 'User', 'site_admin': False}",closed,0cf3c1ce66c31e735f0ddce58ad2e3ac3e77a6a9,https://api.github.com/repos/pytorch/pytorch/commits/0cf3c1ce66c31e735f0ddce58ad2e3ac3e77a6a9,2018-10-12T09:12:03Z,114,62,52
12431,1943130964,"{'login': 'facebook-github-bot', 'id': 6422482, 'node_id': 'MDQ6VXNlcjY0MjI0ODI=', 'avatar_url': 'https://avatars3.githubusercontent.com/u/6422482?v=4', 'gravatar_id': '', 'url': 'https://api.github.com/users/facebook-github-bot', 'html_url': 'https://github.com/facebook-github-bot', 'followers_url': 'https://api.github.com/users/facebook-github-bot/followers', 'following_url': 'https://api.github.com/users/facebook-github-bot/following{/other_user}', 'gists_url': 'https://api.github.com/users/facebook-github-bot/gists{/gist_id}', 'starred_url': 'https://api.github.com/users/facebook-github-bot/starred{/owner}{/repo}', 'subscriptions_url': 'https://api.github.com/users/facebook-github-bot/subscriptions', 'organizations_url': 'https://api.github.com/users/facebook-github-bot/orgs', 'repos_url': 'https://api.github.com/users/facebook-github-bot/repos', 'events_url': 'https://api.github.com/users/facebook-github-bot/events{/privacy}', 'received_events_url': 'https://api.github.com/users/facebook-github-bot/received_events', 'type': 'User', 'site_admin': False}",closed,2f82a0682687552c27f86312de012c95cbb754f5,https://api.github.com/repos/pytorch/pytorch/commits/2f82a0682687552c27f86312de012c95cbb754f5,2018-11-02T14:48:28Z,22,15,7
12426,1893641672,"{'login': 'facebook-github-bot', 'id': 6422482, 'node_id': 'MDQ6VXNlcjY0MjI0ODI=', 'avatar_url': 'https://avatars3.githubusercontent.com/u/6422482?v=4', 'gravatar_id': '', 'url': 'https://api.github.com/users/facebook-github-bot', 'html_url': 'https://github.com/facebook-github-bot', 'followers_url': 'https://api.github.com/users/facebook-github-bot/followers', 'following_url': 'https://api.github.com/users/facebook-github-bot/following{/other_user}', 'gists_url': 'https://api.github.com/users/facebook-github-bot/gists{/gist_id}', 'starred_url': 'https://api.github.com/users/facebook-github-bot/starred{/owner}{/repo}', 'subscriptions_url': 'https://api.github.com/users/facebook-github-bot/subscriptions', 'organizations_url': 'https://api.github.com/users/facebook-github-bot/orgs', 'repos_url': 'https://api.github.com/users/facebook-github-bot/repos', 'events_url': 'https://api.github.com/users/facebook-github-bot/events{/privacy}', 'received_events_url': 'https://api.github.com/users/facebook-github-bot/received_events', 'type': 'User', 'site_admin': False}",closed,ea79f7c032112571f0181d2c3199604aafb7b54d,https://api.github.com/repos/pytorch/pytorch/commits/ea79f7c032112571f0181d2c3199604aafb7b54d,2018-10-09T18:40:16Z,11,11,0
12420,1905028355,"{'login': 'facebook-github-bot', 'id': 6422482, 'node_id': 'MDQ6VXNlcjY0MjI0ODI=', 'avatar_url': 'https://avatars3.githubusercontent.com/u/6422482?v=4', 'gravatar_id': '', 'url': 'https://api.github.com/users/facebook-github-bot', 'html_url': 'https://github.com/facebook-github-bot', 'followers_url': 'https://api.github.com/users/facebook-github-bot/followers', 'following_url': 'https://api.github.com/users/facebook-github-bot/following{/other_user}', 'gists_url': 'https://api.github.com/users/facebook-github-bot/gists{/gist_id}', 'starred_url': 'https://api.github.com/users/facebook-github-bot/starred{/owner}{/repo}', 'subscriptions_url': 'https://api.github.com/users/facebook-github-bot/subscriptions', 'organizations_url': 'https://api.github.com/users/facebook-github-bot/orgs', 'repos_url': 'https://api.github.com/users/facebook-github-bot/repos', 'events_url': 'https://api.github.com/users/facebook-github-bot/events{/privacy}', 'received_events_url': 'https://api.github.com/users/facebook-github-bot/received_events', 'type': 'User', 'site_admin': False}",closed,0740a5d521c04c832538767230a9ee7ea2c93bed,https://api.github.com/repos/pytorch/pytorch/commits/0740a5d521c04c832538767230a9ee7ea2c93bed,2018-10-15T19:37:12Z,261,175,86
12406,1889294738,"{'login': 'facebook-github-bot', 'id': 6422482, 'node_id': 'MDQ6VXNlcjY0MjI0ODI=', 'avatar_url': 'https://avatars3.githubusercontent.com/u/6422482?v=4', 'gravatar_id': '', 'url': 'https://api.github.com/users/facebook-github-bot', 'html_url': 'https://github.com/facebook-github-bot', 'followers_url': 'https://api.github.com/users/facebook-github-bot/followers', 'following_url': 'https://api.github.com/users/facebook-github-bot/following{/other_user}', 'gists_url': 'https://api.github.com/users/facebook-github-bot/gists{/gist_id}', 'starred_url': 'https://api.github.com/users/facebook-github-bot/starred{/owner}{/repo}', 'subscriptions_url': 'https://api.github.com/users/facebook-github-bot/subscriptions', 'organizations_url': 'https://api.github.com/users/facebook-github-bot/orgs', 'repos_url': 'https://api.github.com/users/facebook-github-bot/repos', 'events_url': 'https://api.github.com/users/facebook-github-bot/events{/privacy}', 'received_events_url': 'https://api.github.com/users/facebook-github-bot/received_events', 'type': 'User', 'site_admin': False}",closed,0e44db8b0d23431c6db4c79af8b7c66527e2cc73,https://api.github.com/repos/pytorch/pytorch/commits/0e44db8b0d23431c6db4c79af8b7c66527e2cc73,2018-10-08T01:57:07Z,5,5,0
12395,1924318201,"{'login': 'facebook-github-bot', 'id': 6422482, 'node_id': 'MDQ6VXNlcjY0MjI0ODI=', 'avatar_url': 'https://avatars3.githubusercontent.com/u/6422482?v=4', 'gravatar_id': '', 'url': 'https://api.github.com/users/facebook-github-bot', 'html_url': 'https://github.com/facebook-github-bot', 'followers_url': 'https://api.github.com/users/facebook-github-bot/followers', 'following_url': 'https://api.github.com/users/facebook-github-bot/following{/other_user}', 'gists_url': 'https://api.github.com/users/facebook-github-bot/gists{/gist_id}', 'starred_url': 'https://api.github.com/users/facebook-github-bot/starred{/owner}{/repo}', 'subscriptions_url': 'https://api.github.com/users/facebook-github-bot/subscriptions', 'organizations_url': 'https://api.github.com/users/facebook-github-bot/orgs', 'repos_url': 'https://api.github.com/users/facebook-github-bot/repos', 'events_url': 'https://api.github.com/users/facebook-github-bot/events{/privacy}', 'received_events_url': 'https://api.github.com/users/facebook-github-bot/received_events', 'type': 'User', 'site_admin': False}",closed,85273acca8ab534b83886a1ebcc9608acd3bca42,https://api.github.com/repos/pytorch/pytorch/commits/85273acca8ab534b83886a1ebcc9608acd3bca42,2018-10-24T18:48:28Z,6,3,3
12395,1938430702,"{'login': 'facebook-github-bot', 'id': 6422482, 'node_id': 'MDQ6VXNlcjY0MjI0ODI=', 'avatar_url': 'https://avatars3.githubusercontent.com/u/6422482?v=4', 'gravatar_id': '', 'url': 'https://api.github.com/users/facebook-github-bot', 'html_url': 'https://github.com/facebook-github-bot', 'followers_url': 'https://api.github.com/users/facebook-github-bot/followers', 'following_url': 'https://api.github.com/users/facebook-github-bot/following{/other_user}', 'gists_url': 'https://api.github.com/users/facebook-github-bot/gists{/gist_id}', 'starred_url': 'https://api.github.com/users/facebook-github-bot/starred{/owner}{/repo}', 'subscriptions_url': 'https://api.github.com/users/facebook-github-bot/subscriptions', 'organizations_url': 'https://api.github.com/users/facebook-github-bot/orgs', 'repos_url': 'https://api.github.com/users/facebook-github-bot/repos', 'events_url': 'https://api.github.com/users/facebook-github-bot/events{/privacy}', 'received_events_url': 'https://api.github.com/users/facebook-github-bot/received_events', 'type': 'User', 'site_admin': False}",closed,4c06f1f2bbbc655fcbffcd16af1da38f8906c1cc,https://api.github.com/repos/pytorch/pytorch/commits/4c06f1f2bbbc655fcbffcd16af1da38f8906c1cc,2018-10-31T16:36:59Z,17,0,17
12371,2011179637,"{'login': 'facebook-github-bot', 'id': 6422482, 'node_id': 'MDQ6VXNlcjY0MjI0ODI=', 'avatar_url': 'https://avatars3.githubusercontent.com/u/6422482?v=4', 'gravatar_id': '', 'url': 'https://api.github.com/users/facebook-github-bot', 'html_url': 'https://github.com/facebook-github-bot', 'followers_url': 'https://api.github.com/users/facebook-github-bot/followers', 'following_url': 'https://api.github.com/users/facebook-github-bot/following{/other_user}', 'gists_url': 'https://api.github.com/users/facebook-github-bot/gists{/gist_id}', 'starred_url': 'https://api.github.com/users/facebook-github-bot/starred{/owner}{/repo}', 'subscriptions_url': 'https://api.github.com/users/facebook-github-bot/subscriptions', 'organizations_url': 'https://api.github.com/users/facebook-github-bot/orgs', 'repos_url': 'https://api.github.com/users/facebook-github-bot/repos', 'events_url': 'https://api.github.com/users/facebook-github-bot/events{/privacy}', 'received_events_url': 'https://api.github.com/users/facebook-github-bot/received_events', 'type': 'User', 'site_admin': False}",closed,e6a420114f184ecfe58765b934f07831fbbf6d85,https://api.github.com/repos/pytorch/pytorch/commits/e6a420114f184ecfe58765b934f07831fbbf6d85,2018-12-06T22:59:58Z,4,2,2
12364,1901410061,"{'login': 'facebook-github-bot', 'id': 6422482, 'node_id': 'MDQ6VXNlcjY0MjI0ODI=', 'avatar_url': 'https://avatars3.githubusercontent.com/u/6422482?v=4', 'gravatar_id': '', 'url': 'https://api.github.com/users/facebook-github-bot', 'html_url': 'https://github.com/facebook-github-bot', 'followers_url': 'https://api.github.com/users/facebook-github-bot/followers', 'following_url': 'https://api.github.com/users/facebook-github-bot/following{/other_user}', 'gists_url': 'https://api.github.com/users/facebook-github-bot/gists{/gist_id}', 'starred_url': 'https://api.github.com/users/facebook-github-bot/starred{/owner}{/repo}', 'subscriptions_url': 'https://api.github.com/users/facebook-github-bot/subscriptions', 'organizations_url': 'https://api.github.com/users/facebook-github-bot/orgs', 'repos_url': 'https://api.github.com/users/facebook-github-bot/repos', 'events_url': 'https://api.github.com/users/facebook-github-bot/events{/privacy}', 'received_events_url': 'https://api.github.com/users/facebook-github-bot/received_events', 'type': 'User', 'site_admin': False}",closed,97eec33f801609b90f0a5398c087ca9fcce9c87b,https://api.github.com/repos/pytorch/pytorch/commits/97eec33f801609b90f0a5398c087ca9fcce9c87b,2018-10-12T18:30:19Z,105,101,4
12327,1938552096,"{'login': 'facebook-github-bot', 'id': 6422482, 'node_id': 'MDQ6VXNlcjY0MjI0ODI=', 'avatar_url': 'https://avatars3.githubusercontent.com/u/6422482?v=4', 'gravatar_id': '', 'url': 'https://api.github.com/users/facebook-github-bot', 'html_url': 'https://github.com/facebook-github-bot', 'followers_url': 'https://api.github.com/users/facebook-github-bot/followers', 'following_url': 'https://api.github.com/users/facebook-github-bot/following{/other_user}', 'gists_url': 'https://api.github.com/users/facebook-github-bot/gists{/gist_id}', 'starred_url': 'https://api.github.com/users/facebook-github-bot/starred{/owner}{/repo}', 'subscriptions_url': 'https://api.github.com/users/facebook-github-bot/subscriptions', 'organizations_url': 'https://api.github.com/users/facebook-github-bot/orgs', 'repos_url': 'https://api.github.com/users/facebook-github-bot/repos', 'events_url': 'https://api.github.com/users/facebook-github-bot/events{/privacy}', 'received_events_url': 'https://api.github.com/users/facebook-github-bot/received_events', 'type': 'User', 'site_admin': False}",referenced,488d393ea604184eb30e9eaa67b6c60291152e21,https://api.github.com/repos/pytorch/pytorch/commits/488d393ea604184eb30e9eaa67b6c60291152e21,2018-10-31T17:19:30Z,34,29,5
12326,1887765039,"{'login': 'facebook-github-bot', 'id': 6422482, 'node_id': 'MDQ6VXNlcjY0MjI0ODI=', 'avatar_url': 'https://avatars3.githubusercontent.com/u/6422482?v=4', 'gravatar_id': '', 'url': 'https://api.github.com/users/facebook-github-bot', 'html_url': 'https://github.com/facebook-github-bot', 'followers_url': 'https://api.github.com/users/facebook-github-bot/followers', 'following_url': 'https://api.github.com/users/facebook-github-bot/following{/other_user}', 'gists_url': 'https://api.github.com/users/facebook-github-bot/gists{/gist_id}', 'starred_url': 'https://api.github.com/users/facebook-github-bot/starred{/owner}{/repo}', 'subscriptions_url': 'https://api.github.com/users/facebook-github-bot/subscriptions', 'organizations_url': 'https://api.github.com/users/facebook-github-bot/orgs', 'repos_url': 'https://api.github.com/users/facebook-github-bot/repos', 'events_url': 'https://api.github.com/users/facebook-github-bot/events{/privacy}', 'received_events_url': 'https://api.github.com/users/facebook-github-bot/received_events', 'type': 'User', 'site_admin': False}",referenced,9ebac3d7fe93b50db4518a35cc9ed94619e66ead,https://api.github.com/repos/pytorch/pytorch/commits/9ebac3d7fe93b50db4518a35cc9ed94619e66ead,2018-10-05T17:58:41Z,2,1,1
12324,1896926321,"{'login': 'facebook-github-bot', 'id': 6422482, 'node_id': 'MDQ6VXNlcjY0MjI0ODI=', 'avatar_url': 'https://avatars3.githubusercontent.com/u/6422482?v=4', 'gravatar_id': '', 'url': 'https://api.github.com/users/facebook-github-bot', 'html_url': 'https://github.com/facebook-github-bot', 'followers_url': 'https://api.github.com/users/facebook-github-bot/followers', 'following_url': 'https://api.github.com/users/facebook-github-bot/following{/other_user}', 'gists_url': 'https://api.github.com/users/facebook-github-bot/gists{/gist_id}', 'starred_url': 'https://api.github.com/users/facebook-github-bot/starred{/owner}{/repo}', 'subscriptions_url': 'https://api.github.com/users/facebook-github-bot/subscriptions', 'organizations_url': 'https://api.github.com/users/facebook-github-bot/orgs', 'repos_url': 'https://api.github.com/users/facebook-github-bot/repos', 'events_url': 'https://api.github.com/users/facebook-github-bot/events{/privacy}', 'received_events_url': 'https://api.github.com/users/facebook-github-bot/received_events', 'type': 'User', 'site_admin': False}",closed,543048d2758e714a953da6af7082c8fb7b1c98b2,https://api.github.com/repos/pytorch/pytorch/commits/543048d2758e714a953da6af7082c8fb7b1c98b2,2018-10-11T00:11:05Z,16,9,7
12319,1891842059,"{'login': 'facebook-github-bot', 'id': 6422482, 'node_id': 'MDQ6VXNlcjY0MjI0ODI=', 'avatar_url': 'https://avatars3.githubusercontent.com/u/6422482?v=4', 'gravatar_id': '', 'url': 'https://api.github.com/users/facebook-github-bot', 'html_url': 'https://github.com/facebook-github-bot', 'followers_url': 'https://api.github.com/users/facebook-github-bot/followers', 'following_url': 'https://api.github.com/users/facebook-github-bot/following{/other_user}', 'gists_url': 'https://api.github.com/users/facebook-github-bot/gists{/gist_id}', 'starred_url': 'https://api.github.com/users/facebook-github-bot/starred{/owner}{/repo}', 'subscriptions_url': 'https://api.github.com/users/facebook-github-bot/subscriptions', 'organizations_url': 'https://api.github.com/users/facebook-github-bot/orgs', 'repos_url': 'https://api.github.com/users/facebook-github-bot/repos', 'events_url': 'https://api.github.com/users/facebook-github-bot/events{/privacy}', 'received_events_url': 'https://api.github.com/users/facebook-github-bot/received_events', 'type': 'User', 'site_admin': False}",closed,1a0d82e4f43ecce9d13c90d9219f0b419a4852c9,https://api.github.com/repos/pytorch/pytorch/commits/1a0d82e4f43ecce9d13c90d9219f0b419a4852c9,2018-10-09T05:26:46Z,120,55,65
12309,2604240107,"{'login': 'facebook-github-bot', 'id': 6422482, 'node_id': 'MDQ6VXNlcjY0MjI0ODI=', 'avatar_url': 'https://avatars3.githubusercontent.com/u/6422482?v=4', 'gravatar_id': '', 'url': 'https://api.github.com/users/facebook-github-bot', 'html_url': 'https://github.com/facebook-github-bot', 'followers_url': 'https://api.github.com/users/facebook-github-bot/followers', 'following_url': 'https://api.github.com/users/facebook-github-bot/following{/other_user}', 'gists_url': 'https://api.github.com/users/facebook-github-bot/gists{/gist_id}', 'starred_url': 'https://api.github.com/users/facebook-github-bot/starred{/owner}{/repo}', 'subscriptions_url': 'https://api.github.com/users/facebook-github-bot/subscriptions', 'organizations_url': 'https://api.github.com/users/facebook-github-bot/orgs', 'repos_url': 'https://api.github.com/users/facebook-github-bot/repos', 'events_url': 'https://api.github.com/users/facebook-github-bot/events{/privacy}', 'received_events_url': 'https://api.github.com/users/facebook-github-bot/received_events', 'type': 'User', 'site_admin': False}",closed,c89301a6250ca17c568f11e52f715f939c08d7ce,https://api.github.com/repos/pytorch/pytorch/commits/c89301a6250ca17c568f11e52f715f939c08d7ce,2019-09-03T16:38:38Z,361,163,198
12290,1987838783,"{'login': 'facebook-github-bot', 'id': 6422482, 'node_id': 'MDQ6VXNlcjY0MjI0ODI=', 'avatar_url': 'https://avatars3.githubusercontent.com/u/6422482?v=4', 'gravatar_id': '', 'url': 'https://api.github.com/users/facebook-github-bot', 'html_url': 'https://github.com/facebook-github-bot', 'followers_url': 'https://api.github.com/users/facebook-github-bot/followers', 'following_url': 'https://api.github.com/users/facebook-github-bot/following{/other_user}', 'gists_url': 'https://api.github.com/users/facebook-github-bot/gists{/gist_id}', 'starred_url': 'https://api.github.com/users/facebook-github-bot/starred{/owner}{/repo}', 'subscriptions_url': 'https://api.github.com/users/facebook-github-bot/subscriptions', 'organizations_url': 'https://api.github.com/users/facebook-github-bot/orgs', 'repos_url': 'https://api.github.com/users/facebook-github-bot/repos', 'events_url': 'https://api.github.com/users/facebook-github-bot/events{/privacy}', 'received_events_url': 'https://api.github.com/users/facebook-github-bot/received_events', 'type': 'User', 'site_admin': False}",closed,b13f91dbd935cf6282129c2c377231b56d8cc77b,https://api.github.com/repos/pytorch/pytorch/commits/b13f91dbd935cf6282129c2c377231b56d8cc77b,2018-11-26T20:33:27Z,688,485,203
12261,1970222615,"{'login': 'facebook-github-bot', 'id': 6422482, 'node_id': 'MDQ6VXNlcjY0MjI0ODI=', 'avatar_url': 'https://avatars3.githubusercontent.com/u/6422482?v=4', 'gravatar_id': '', 'url': 'https://api.github.com/users/facebook-github-bot', 'html_url': 'https://github.com/facebook-github-bot', 'followers_url': 'https://api.github.com/users/facebook-github-bot/followers', 'following_url': 'https://api.github.com/users/facebook-github-bot/following{/other_user}', 'gists_url': 'https://api.github.com/users/facebook-github-bot/gists{/gist_id}', 'starred_url': 'https://api.github.com/users/facebook-github-bot/starred{/owner}{/repo}', 'subscriptions_url': 'https://api.github.com/users/facebook-github-bot/subscriptions', 'organizations_url': 'https://api.github.com/users/facebook-github-bot/orgs', 'repos_url': 'https://api.github.com/users/facebook-github-bot/repos', 'events_url': 'https://api.github.com/users/facebook-github-bot/events{/privacy}', 'received_events_url': 'https://api.github.com/users/facebook-github-bot/received_events', 'type': 'User', 'site_admin': False}",referenced,f17b2fdf1b9479f1d8ae186d5c17d6a1d4d9c7c9,https://api.github.com/repos/pytorch/pytorch/commits/f17b2fdf1b9479f1d8ae186d5c17d6a1d4d9c7c9,2018-11-16T02:12:16Z,15,7,8
12260,1897137624,"{'login': 'facebook-github-bot', 'id': 6422482, 'node_id': 'MDQ6VXNlcjY0MjI0ODI=', 'avatar_url': 'https://avatars3.githubusercontent.com/u/6422482?v=4', 'gravatar_id': '', 'url': 'https://api.github.com/users/facebook-github-bot', 'html_url': 'https://github.com/facebook-github-bot', 'followers_url': 'https://api.github.com/users/facebook-github-bot/followers', 'following_url': 'https://api.github.com/users/facebook-github-bot/following{/other_user}', 'gists_url': 'https://api.github.com/users/facebook-github-bot/gists{/gist_id}', 'starred_url': 'https://api.github.com/users/facebook-github-bot/starred{/owner}{/repo}', 'subscriptions_url': 'https://api.github.com/users/facebook-github-bot/subscriptions', 'organizations_url': 'https://api.github.com/users/facebook-github-bot/orgs', 'repos_url': 'https://api.github.com/users/facebook-github-bot/repos', 'events_url': 'https://api.github.com/users/facebook-github-bot/events{/privacy}', 'received_events_url': 'https://api.github.com/users/facebook-github-bot/received_events', 'type': 'User', 'site_admin': False}",closed,8734b174cadc8513bef177c57f1f8267898f34d0,https://api.github.com/repos/pytorch/pytorch/commits/8734b174cadc8513bef177c57f1f8267898f34d0,2018-10-11T03:40:27Z,46,24,22
12259,1955931524,"{'login': 'facebook-github-bot', 'id': 6422482, 'node_id': 'MDQ6VXNlcjY0MjI0ODI=', 'avatar_url': 'https://avatars3.githubusercontent.com/u/6422482?v=4', 'gravatar_id': '', 'url': 'https://api.github.com/users/facebook-github-bot', 'html_url': 'https://github.com/facebook-github-bot', 'followers_url': 'https://api.github.com/users/facebook-github-bot/followers', 'following_url': 'https://api.github.com/users/facebook-github-bot/following{/other_user}', 'gists_url': 'https://api.github.com/users/facebook-github-bot/gists{/gist_id}', 'starred_url': 'https://api.github.com/users/facebook-github-bot/starred{/owner}{/repo}', 'subscriptions_url': 'https://api.github.com/users/facebook-github-bot/subscriptions', 'organizations_url': 'https://api.github.com/users/facebook-github-bot/orgs', 'repos_url': 'https://api.github.com/users/facebook-github-bot/repos', 'events_url': 'https://api.github.com/users/facebook-github-bot/events{/privacy}', 'received_events_url': 'https://api.github.com/users/facebook-github-bot/received_events', 'type': 'User', 'site_admin': False}",closed,c9be135bb9284461d0ec377cb71c0e796fcb5090,https://api.github.com/repos/pytorch/pytorch/commits/c9be135bb9284461d0ec377cb71c0e796fcb5090,2018-11-09T03:01:29Z,14,7,7
12259,2397532455,"{'login': 'facebook-github-bot', 'id': 6422482, 'node_id': 'MDQ6VXNlcjY0MjI0ODI=', 'avatar_url': 'https://avatars3.githubusercontent.com/u/6422482?v=4', 'gravatar_id': '', 'url': 'https://api.github.com/users/facebook-github-bot', 'html_url': 'https://github.com/facebook-github-bot', 'followers_url': 'https://api.github.com/users/facebook-github-bot/followers', 'following_url': 'https://api.github.com/users/facebook-github-bot/following{/other_user}', 'gists_url': 'https://api.github.com/users/facebook-github-bot/gists{/gist_id}', 'starred_url': 'https://api.github.com/users/facebook-github-bot/starred{/owner}{/repo}', 'subscriptions_url': 'https://api.github.com/users/facebook-github-bot/subscriptions', 'organizations_url': 'https://api.github.com/users/facebook-github-bot/orgs', 'repos_url': 'https://api.github.com/users/facebook-github-bot/repos', 'events_url': 'https://api.github.com/users/facebook-github-bot/events{/privacy}', 'received_events_url': 'https://api.github.com/users/facebook-github-bot/received_events', 'type': 'User', 'site_admin': False}",referenced,c60465873c5cf8f1a36da39f7875224d4c48d7ca,https://api.github.com/repos/pytorch/pytorch/commits/c60465873c5cf8f1a36da39f7875224d4c48d7ca,2019-06-07T14:54:05Z,20,10,10
12251,1910040978,"{'login': 'facebook-github-bot', 'id': 6422482, 'node_id': 'MDQ6VXNlcjY0MjI0ODI=', 'avatar_url': 'https://avatars3.githubusercontent.com/u/6422482?v=4', 'gravatar_id': '', 'url': 'https://api.github.com/users/facebook-github-bot', 'html_url': 'https://github.com/facebook-github-bot', 'followers_url': 'https://api.github.com/users/facebook-github-bot/followers', 'following_url': 'https://api.github.com/users/facebook-github-bot/following{/other_user}', 'gists_url': 'https://api.github.com/users/facebook-github-bot/gists{/gist_id}', 'starred_url': 'https://api.github.com/users/facebook-github-bot/starred{/owner}{/repo}', 'subscriptions_url': 'https://api.github.com/users/facebook-github-bot/subscriptions', 'organizations_url': 'https://api.github.com/users/facebook-github-bot/orgs', 'repos_url': 'https://api.github.com/users/facebook-github-bot/repos', 'events_url': 'https://api.github.com/users/facebook-github-bot/events{/privacy}', 'received_events_url': 'https://api.github.com/users/facebook-github-bot/received_events', 'type': 'User', 'site_admin': False}",closed,1a6071d436c63cb9174b07726d302de70989ec0b,https://api.github.com/repos/pytorch/pytorch/commits/1a6071d436c63cb9174b07726d302de70989ec0b,2018-10-17T16:17:19Z,4,2,2
12241,1992011818,"{'login': 'facebook-github-bot', 'id': 6422482, 'node_id': 'MDQ6VXNlcjY0MjI0ODI=', 'avatar_url': 'https://avatars3.githubusercontent.com/u/6422482?v=4', 'gravatar_id': '', 'url': 'https://api.github.com/users/facebook-github-bot', 'html_url': 'https://github.com/facebook-github-bot', 'followers_url': 'https://api.github.com/users/facebook-github-bot/followers', 'following_url': 'https://api.github.com/users/facebook-github-bot/following{/other_user}', 'gists_url': 'https://api.github.com/users/facebook-github-bot/gists{/gist_id}', 'starred_url': 'https://api.github.com/users/facebook-github-bot/starred{/owner}{/repo}', 'subscriptions_url': 'https://api.github.com/users/facebook-github-bot/subscriptions', 'organizations_url': 'https://api.github.com/users/facebook-github-bot/orgs', 'repos_url': 'https://api.github.com/users/facebook-github-bot/repos', 'events_url': 'https://api.github.com/users/facebook-github-bot/events{/privacy}', 'received_events_url': 'https://api.github.com/users/facebook-github-bot/received_events', 'type': 'User', 'site_admin': False}",closed,be7c618fd7fadb9db58aae8bef16638912748cfa,https://api.github.com/repos/pytorch/pytorch/commits/be7c618fd7fadb9db58aae8bef16638912748cfa,2018-11-28T10:20:45Z,601,599,2
12230,1903155912,"{'login': 'facebook-github-bot', 'id': 6422482, 'node_id': 'MDQ6VXNlcjY0MjI0ODI=', 'avatar_url': 'https://avatars3.githubusercontent.com/u/6422482?v=4', 'gravatar_id': '', 'url': 'https://api.github.com/users/facebook-github-bot', 'html_url': 'https://github.com/facebook-github-bot', 'followers_url': 'https://api.github.com/users/facebook-github-bot/followers', 'following_url': 'https://api.github.com/users/facebook-github-bot/following{/other_user}', 'gists_url': 'https://api.github.com/users/facebook-github-bot/gists{/gist_id}', 'starred_url': 'https://api.github.com/users/facebook-github-bot/starred{/owner}{/repo}', 'subscriptions_url': 'https://api.github.com/users/facebook-github-bot/subscriptions', 'organizations_url': 'https://api.github.com/users/facebook-github-bot/orgs', 'repos_url': 'https://api.github.com/users/facebook-github-bot/repos', 'events_url': 'https://api.github.com/users/facebook-github-bot/events{/privacy}', 'received_events_url': 'https://api.github.com/users/facebook-github-bot/received_events', 'type': 'User', 'site_admin': False}",referenced,02695c11db939180f25bfbbc82a922a9c339d50a,https://api.github.com/repos/pytorch/pytorch/commits/02695c11db939180f25bfbbc82a922a9c339d50a,2018-10-15T06:13:42Z,15,11,4
12207,1908680779,"{'login': 'facebook-github-bot', 'id': 6422482, 'node_id': 'MDQ6VXNlcjY0MjI0ODI=', 'avatar_url': 'https://avatars3.githubusercontent.com/u/6422482?v=4', 'gravatar_id': '', 'url': 'https://api.github.com/users/facebook-github-bot', 'html_url': 'https://github.com/facebook-github-bot', 'followers_url': 'https://api.github.com/users/facebook-github-bot/followers', 'following_url': 'https://api.github.com/users/facebook-github-bot/following{/other_user}', 'gists_url': 'https://api.github.com/users/facebook-github-bot/gists{/gist_id}', 'starred_url': 'https://api.github.com/users/facebook-github-bot/starred{/owner}{/repo}', 'subscriptions_url': 'https://api.github.com/users/facebook-github-bot/subscriptions', 'organizations_url': 'https://api.github.com/users/facebook-github-bot/orgs', 'repos_url': 'https://api.github.com/users/facebook-github-bot/repos', 'events_url': 'https://api.github.com/users/facebook-github-bot/events{/privacy}', 'received_events_url': 'https://api.github.com/users/facebook-github-bot/received_events', 'type': 'User', 'site_admin': False}",referenced,0521c47c9150332dea65c41a4139bf987b06ac3a,https://api.github.com/repos/pytorch/pytorch/commits/0521c47c9150332dea65c41a4139bf987b06ac3a,2018-10-17T07:00:38Z,44,42,2
12193,1897353220,"{'login': 'facebook-github-bot', 'id': 6422482, 'node_id': 'MDQ6VXNlcjY0MjI0ODI=', 'avatar_url': 'https://avatars3.githubusercontent.com/u/6422482?v=4', 'gravatar_id': '', 'url': 'https://api.github.com/users/facebook-github-bot', 'html_url': 'https://github.com/facebook-github-bot', 'followers_url': 'https://api.github.com/users/facebook-github-bot/followers', 'following_url': 'https://api.github.com/users/facebook-github-bot/following{/other_user}', 'gists_url': 'https://api.github.com/users/facebook-github-bot/gists{/gist_id}', 'starred_url': 'https://api.github.com/users/facebook-github-bot/starred{/owner}{/repo}', 'subscriptions_url': 'https://api.github.com/users/facebook-github-bot/subscriptions', 'organizations_url': 'https://api.github.com/users/facebook-github-bot/orgs', 'repos_url': 'https://api.github.com/users/facebook-github-bot/repos', 'events_url': 'https://api.github.com/users/facebook-github-bot/events{/privacy}', 'received_events_url': 'https://api.github.com/users/facebook-github-bot/received_events', 'type': 'User', 'site_admin': False}",closed,2b033332c8b7720b16b7a442311aeb4adfaab84c,https://api.github.com/repos/pytorch/pytorch/commits/2b033332c8b7720b16b7a442311aeb4adfaab84c,2018-10-11T06:58:33Z,18,15,3
12174,2126200033,"{'login': 'facebook-github-bot', 'id': 6422482, 'node_id': 'MDQ6VXNlcjY0MjI0ODI=', 'avatar_url': 'https://avatars3.githubusercontent.com/u/6422482?v=4', 'gravatar_id': '', 'url': 'https://api.github.com/users/facebook-github-bot', 'html_url': 'https://github.com/facebook-github-bot', 'followers_url': 'https://api.github.com/users/facebook-github-bot/followers', 'following_url': 'https://api.github.com/users/facebook-github-bot/following{/other_user}', 'gists_url': 'https://api.github.com/users/facebook-github-bot/gists{/gist_id}', 'starred_url': 'https://api.github.com/users/facebook-github-bot/starred{/owner}{/repo}', 'subscriptions_url': 'https://api.github.com/users/facebook-github-bot/subscriptions', 'organizations_url': 'https://api.github.com/users/facebook-github-bot/orgs', 'repos_url': 'https://api.github.com/users/facebook-github-bot/repos', 'events_url': 'https://api.github.com/users/facebook-github-bot/events{/privacy}', 'received_events_url': 'https://api.github.com/users/facebook-github-bot/received_events', 'type': 'User', 'site_admin': False}",referenced,7ce33c586de4c73a618430fdbf8f52ac1b9cc9f6,https://api.github.com/repos/pytorch/pytorch/commits/7ce33c586de4c73a618430fdbf8f52ac1b9cc9f6,2019-02-08T04:36:15Z,17,14,3
12174,2135163776,"{'login': 'facebook-github-bot', 'id': 6422482, 'node_id': 'MDQ6VXNlcjY0MjI0ODI=', 'avatar_url': 'https://avatars3.githubusercontent.com/u/6422482?v=4', 'gravatar_id': '', 'url': 'https://api.github.com/users/facebook-github-bot', 'html_url': 'https://github.com/facebook-github-bot', 'followers_url': 'https://api.github.com/users/facebook-github-bot/followers', 'following_url': 'https://api.github.com/users/facebook-github-bot/following{/other_user}', 'gists_url': 'https://api.github.com/users/facebook-github-bot/gists{/gist_id}', 'starred_url': 'https://api.github.com/users/facebook-github-bot/starred{/owner}{/repo}', 'subscriptions_url': 'https://api.github.com/users/facebook-github-bot/subscriptions', 'organizations_url': 'https://api.github.com/users/facebook-github-bot/orgs', 'repos_url': 'https://api.github.com/users/facebook-github-bot/repos', 'events_url': 'https://api.github.com/users/facebook-github-bot/events{/privacy}', 'received_events_url': 'https://api.github.com/users/facebook-github-bot/received_events', 'type': 'User', 'site_admin': False}",referenced,7c1e4258a958863ee5363373289d05418be06887,https://api.github.com/repos/pytorch/pytorch/commits/7c1e4258a958863ee5363373289d05418be06887,2019-02-12T22:41:02Z,22,19,3
12160,1946782874,"{'login': 'facebook-github-bot', 'id': 6422482, 'node_id': 'MDQ6VXNlcjY0MjI0ODI=', 'avatar_url': 'https://avatars3.githubusercontent.com/u/6422482?v=4', 'gravatar_id': '', 'url': 'https://api.github.com/users/facebook-github-bot', 'html_url': 'https://github.com/facebook-github-bot', 'followers_url': 'https://api.github.com/users/facebook-github-bot/followers', 'following_url': 'https://api.github.com/users/facebook-github-bot/following{/other_user}', 'gists_url': 'https://api.github.com/users/facebook-github-bot/gists{/gist_id}', 'starred_url': 'https://api.github.com/users/facebook-github-bot/starred{/owner}{/repo}', 'subscriptions_url': 'https://api.github.com/users/facebook-github-bot/subscriptions', 'organizations_url': 'https://api.github.com/users/facebook-github-bot/orgs', 'repos_url': 'https://api.github.com/users/facebook-github-bot/repos', 'events_url': 'https://api.github.com/users/facebook-github-bot/events{/privacy}', 'received_events_url': 'https://api.github.com/users/facebook-github-bot/received_events', 'type': 'User', 'site_admin': False}",closed,f0ed927b625068a636d2f2de7d19e505e06a3fb9,https://api.github.com/repos/pytorch/pytorch/commits/f0ed927b625068a636d2f2de7d19e505e06a3fb9,2018-11-05T16:57:08Z,118,117,1
12150,1947721933,"{'login': 'facebook-github-bot', 'id': 6422482, 'node_id': 'MDQ6VXNlcjY0MjI0ODI=', 'avatar_url': 'https://avatars3.githubusercontent.com/u/6422482?v=4', 'gravatar_id': '', 'url': 'https://api.github.com/users/facebook-github-bot', 'html_url': 'https://github.com/facebook-github-bot', 'followers_url': 'https://api.github.com/users/facebook-github-bot/followers', 'following_url': 'https://api.github.com/users/facebook-github-bot/following{/other_user}', 'gists_url': 'https://api.github.com/users/facebook-github-bot/gists{/gist_id}', 'starred_url': 'https://api.github.com/users/facebook-github-bot/starred{/owner}{/repo}', 'subscriptions_url': 'https://api.github.com/users/facebook-github-bot/subscriptions', 'organizations_url': 'https://api.github.com/users/facebook-github-bot/orgs', 'repos_url': 'https://api.github.com/users/facebook-github-bot/repos', 'events_url': 'https://api.github.com/users/facebook-github-bot/events{/privacy}', 'received_events_url': 'https://api.github.com/users/facebook-github-bot/received_events', 'type': 'User', 'site_admin': False}",closed,74819087de17de4c8215a7f631d8d4d18dd13d45,https://api.github.com/repos/pytorch/pytorch/commits/74819087de17de4c8215a7f631d8d4d18dd13d45,2018-11-06T00:23:49Z,172,138,34
12129,1938552086,"{'login': 'facebook-github-bot', 'id': 6422482, 'node_id': 'MDQ6VXNlcjY0MjI0ODI=', 'avatar_url': 'https://avatars3.githubusercontent.com/u/6422482?v=4', 'gravatar_id': '', 'url': 'https://api.github.com/users/facebook-github-bot', 'html_url': 'https://github.com/facebook-github-bot', 'followers_url': 'https://api.github.com/users/facebook-github-bot/followers', 'following_url': 'https://api.github.com/users/facebook-github-bot/following{/other_user}', 'gists_url': 'https://api.github.com/users/facebook-github-bot/gists{/gist_id}', 'starred_url': 'https://api.github.com/users/facebook-github-bot/starred{/owner}{/repo}', 'subscriptions_url': 'https://api.github.com/users/facebook-github-bot/subscriptions', 'organizations_url': 'https://api.github.com/users/facebook-github-bot/orgs', 'repos_url': 'https://api.github.com/users/facebook-github-bot/repos', 'events_url': 'https://api.github.com/users/facebook-github-bot/events{/privacy}', 'received_events_url': 'https://api.github.com/users/facebook-github-bot/received_events', 'type': 'User', 'site_admin': False}",closed,488d393ea604184eb30e9eaa67b6c60291152e21,https://api.github.com/repos/pytorch/pytorch/commits/488d393ea604184eb30e9eaa67b6c60291152e21,2018-10-31T17:19:30Z,34,29,5
12120,1875220252,"{'login': 'facebook-github-bot', 'id': 6422482, 'node_id': 'MDQ6VXNlcjY0MjI0ODI=', 'avatar_url': 'https://avatars3.githubusercontent.com/u/6422482?v=4', 'gravatar_id': '', 'url': 'https://api.github.com/users/facebook-github-bot', 'html_url': 'https://github.com/facebook-github-bot', 'followers_url': 'https://api.github.com/users/facebook-github-bot/followers', 'following_url': 'https://api.github.com/users/facebook-github-bot/following{/other_user}', 'gists_url': 'https://api.github.com/users/facebook-github-bot/gists{/gist_id}', 'starred_url': 'https://api.github.com/users/facebook-github-bot/starred{/owner}{/repo}', 'subscriptions_url': 'https://api.github.com/users/facebook-github-bot/subscriptions', 'organizations_url': 'https://api.github.com/users/facebook-github-bot/orgs', 'repos_url': 'https://api.github.com/users/facebook-github-bot/repos', 'events_url': 'https://api.github.com/users/facebook-github-bot/events{/privacy}', 'received_events_url': 'https://api.github.com/users/facebook-github-bot/received_events', 'type': 'User', 'site_admin': False}",closed,5ffc915f26a7759d3a24b692599a49db2ef6b0c0,https://api.github.com/repos/pytorch/pytorch/commits/5ffc915f26a7759d3a24b692599a49db2ef6b0c0,2018-09-30T05:28:10Z,49,30,19
12118,1883356359,"{'login': 'facebook-github-bot', 'id': 6422482, 'node_id': 'MDQ6VXNlcjY0MjI0ODI=', 'avatar_url': 'https://avatars3.githubusercontent.com/u/6422482?v=4', 'gravatar_id': '', 'url': 'https://api.github.com/users/facebook-github-bot', 'html_url': 'https://github.com/facebook-github-bot', 'followers_url': 'https://api.github.com/users/facebook-github-bot/followers', 'following_url': 'https://api.github.com/users/facebook-github-bot/following{/other_user}', 'gists_url': 'https://api.github.com/users/facebook-github-bot/gists{/gist_id}', 'starred_url': 'https://api.github.com/users/facebook-github-bot/starred{/owner}{/repo}', 'subscriptions_url': 'https://api.github.com/users/facebook-github-bot/subscriptions', 'organizations_url': 'https://api.github.com/users/facebook-github-bot/orgs', 'repos_url': 'https://api.github.com/users/facebook-github-bot/repos', 'events_url': 'https://api.github.com/users/facebook-github-bot/events{/privacy}', 'received_events_url': 'https://api.github.com/users/facebook-github-bot/received_events', 'type': 'User', 'site_admin': False}",closed,c9f9df002dc9e2b0c4648cb6148030b5405c55d3,https://api.github.com/repos/pytorch/pytorch/commits/c9f9df002dc9e2b0c4648cb6148030b5405c55d3,2018-10-04T00:26:27Z,20,18,2
12115,2031986504,"{'login': 'facebook-github-bot', 'id': 6422482, 'node_id': 'MDQ6VXNlcjY0MjI0ODI=', 'avatar_url': 'https://avatars3.githubusercontent.com/u/6422482?v=4', 'gravatar_id': '', 'url': 'https://api.github.com/users/facebook-github-bot', 'html_url': 'https://github.com/facebook-github-bot', 'followers_url': 'https://api.github.com/users/facebook-github-bot/followers', 'following_url': 'https://api.github.com/users/facebook-github-bot/following{/other_user}', 'gists_url': 'https://api.github.com/users/facebook-github-bot/gists{/gist_id}', 'starred_url': 'https://api.github.com/users/facebook-github-bot/starred{/owner}{/repo}', 'subscriptions_url': 'https://api.github.com/users/facebook-github-bot/subscriptions', 'organizations_url': 'https://api.github.com/users/facebook-github-bot/orgs', 'repos_url': 'https://api.github.com/users/facebook-github-bot/repos', 'events_url': 'https://api.github.com/users/facebook-github-bot/events{/privacy}', 'received_events_url': 'https://api.github.com/users/facebook-github-bot/received_events', 'type': 'User', 'site_admin': False}",referenced,bd958cde685c2de67ecf691934470ef3c289e00d,https://api.github.com/repos/pytorch/pytorch/commits/bd958cde685c2de67ecf691934470ef3c289e00d,2018-12-18T04:14:48Z,233,151,82
12112,2340564857,"{'login': 'facebook-github-bot', 'id': 6422482, 'node_id': 'MDQ6VXNlcjY0MjI0ODI=', 'avatar_url': 'https://avatars3.githubusercontent.com/u/6422482?v=4', 'gravatar_id': '', 'url': 'https://api.github.com/users/facebook-github-bot', 'html_url': 'https://github.com/facebook-github-bot', 'followers_url': 'https://api.github.com/users/facebook-github-bot/followers', 'following_url': 'https://api.github.com/users/facebook-github-bot/following{/other_user}', 'gists_url': 'https://api.github.com/users/facebook-github-bot/gists{/gist_id}', 'starred_url': 'https://api.github.com/users/facebook-github-bot/starred{/owner}{/repo}', 'subscriptions_url': 'https://api.github.com/users/facebook-github-bot/subscriptions', 'organizations_url': 'https://api.github.com/users/facebook-github-bot/orgs', 'repos_url': 'https://api.github.com/users/facebook-github-bot/repos', 'events_url': 'https://api.github.com/users/facebook-github-bot/events{/privacy}', 'received_events_url': 'https://api.github.com/users/facebook-github-bot/received_events', 'type': 'User', 'site_admin': False}",closed,b46a630836973c8101a4d806e44246cda4693dcb,https://api.github.com/repos/pytorch/pytorch/commits/b46a630836973c8101a4d806e44246cda4693dcb,2019-05-14T15:36:33Z,2,1,1
12067,1874478134,"{'login': 'facebook-github-bot', 'id': 6422482, 'node_id': 'MDQ6VXNlcjY0MjI0ODI=', 'avatar_url': 'https://avatars3.githubusercontent.com/u/6422482?v=4', 'gravatar_id': '', 'url': 'https://api.github.com/users/facebook-github-bot', 'html_url': 'https://github.com/facebook-github-bot', 'followers_url': 'https://api.github.com/users/facebook-github-bot/followers', 'following_url': 'https://api.github.com/users/facebook-github-bot/following{/other_user}', 'gists_url': 'https://api.github.com/users/facebook-github-bot/gists{/gist_id}', 'starred_url': 'https://api.github.com/users/facebook-github-bot/starred{/owner}{/repo}', 'subscriptions_url': 'https://api.github.com/users/facebook-github-bot/subscriptions', 'organizations_url': 'https://api.github.com/users/facebook-github-bot/orgs', 'repos_url': 'https://api.github.com/users/facebook-github-bot/repos', 'events_url': 'https://api.github.com/users/facebook-github-bot/events{/privacy}', 'received_events_url': 'https://api.github.com/users/facebook-github-bot/received_events', 'type': 'User', 'site_admin': False}",referenced,7b2c0a09e4795bb8dc06c3d1881289fbe75d84e2,https://api.github.com/repos/pytorch/pytorch/commits/7b2c0a09e4795bb8dc06c3d1881289fbe75d84e2,2018-09-28T21:13:15Z,41,34,7
12042,1872501567,"{'login': 'facebook-github-bot', 'id': 6422482, 'node_id': 'MDQ6VXNlcjY0MjI0ODI=', 'avatar_url': 'https://avatars3.githubusercontent.com/u/6422482?v=4', 'gravatar_id': '', 'url': 'https://api.github.com/users/facebook-github-bot', 'html_url': 'https://github.com/facebook-github-bot', 'followers_url': 'https://api.github.com/users/facebook-github-bot/followers', 'following_url': 'https://api.github.com/users/facebook-github-bot/following{/other_user}', 'gists_url': 'https://api.github.com/users/facebook-github-bot/gists{/gist_id}', 'starred_url': 'https://api.github.com/users/facebook-github-bot/starred{/owner}{/repo}', 'subscriptions_url': 'https://api.github.com/users/facebook-github-bot/subscriptions', 'organizations_url': 'https://api.github.com/users/facebook-github-bot/orgs', 'repos_url': 'https://api.github.com/users/facebook-github-bot/repos', 'events_url': 'https://api.github.com/users/facebook-github-bot/events{/privacy}', 'received_events_url': 'https://api.github.com/users/facebook-github-bot/received_events', 'type': 'User', 'site_admin': False}",closed,a5818047c4c297de7ccb41c32fb98609ab3eaab7,https://api.github.com/repos/pytorch/pytorch/commits/a5818047c4c297de7ccb41c32fb98609ab3eaab7,2018-09-28T02:11:09Z,193,112,81
12014,1967727752,"{'login': 'facebook-github-bot', 'id': 6422482, 'node_id': 'MDQ6VXNlcjY0MjI0ODI=', 'avatar_url': 'https://avatars3.githubusercontent.com/u/6422482?v=4', 'gravatar_id': '', 'url': 'https://api.github.com/users/facebook-github-bot', 'html_url': 'https://github.com/facebook-github-bot', 'followers_url': 'https://api.github.com/users/facebook-github-bot/followers', 'following_url': 'https://api.github.com/users/facebook-github-bot/following{/other_user}', 'gists_url': 'https://api.github.com/users/facebook-github-bot/gists{/gist_id}', 'starred_url': 'https://api.github.com/users/facebook-github-bot/starred{/owner}{/repo}', 'subscriptions_url': 'https://api.github.com/users/facebook-github-bot/subscriptions', 'organizations_url': 'https://api.github.com/users/facebook-github-bot/orgs', 'repos_url': 'https://api.github.com/users/facebook-github-bot/repos', 'events_url': 'https://api.github.com/users/facebook-github-bot/events{/privacy}', 'received_events_url': 'https://api.github.com/users/facebook-github-bot/received_events', 'type': 'User', 'site_admin': False}",referenced,20e395a1302966349841aab04a45a614d6354c11,https://api.github.com/repos/pytorch/pytorch/commits/20e395a1302966349841aab04a45a614d6354c11,2018-11-15T05:38:29Z,2,1,1
12006,1928027039,"{'login': 'facebook-github-bot', 'id': 6422482, 'node_id': 'MDQ6VXNlcjY0MjI0ODI=', 'avatar_url': 'https://avatars3.githubusercontent.com/u/6422482?v=4', 'gravatar_id': '', 'url': 'https://api.github.com/users/facebook-github-bot', 'html_url': 'https://github.com/facebook-github-bot', 'followers_url': 'https://api.github.com/users/facebook-github-bot/followers', 'following_url': 'https://api.github.com/users/facebook-github-bot/following{/other_user}', 'gists_url': 'https://api.github.com/users/facebook-github-bot/gists{/gist_id}', 'starred_url': 'https://api.github.com/users/facebook-github-bot/starred{/owner}{/repo}', 'subscriptions_url': 'https://api.github.com/users/facebook-github-bot/subscriptions', 'organizations_url': 'https://api.github.com/users/facebook-github-bot/orgs', 'repos_url': 'https://api.github.com/users/facebook-github-bot/repos', 'events_url': 'https://api.github.com/users/facebook-github-bot/events{/privacy}', 'received_events_url': 'https://api.github.com/users/facebook-github-bot/received_events', 'type': 'User', 'site_admin': False}",referenced,dc211c7de41a4a7c05e480b6277a5f2e91beb71a,https://api.github.com/repos/pytorch/pytorch/commits/dc211c7de41a4a7c05e480b6277a5f2e91beb71a,2018-10-26T06:42:32Z,1607,887,720
12006,1950707079,"{'login': 'facebook-github-bot', 'id': 6422482, 'node_id': 'MDQ6VXNlcjY0MjI0ODI=', 'avatar_url': 'https://avatars3.githubusercontent.com/u/6422482?v=4', 'gravatar_id': '', 'url': 'https://api.github.com/users/facebook-github-bot', 'html_url': 'https://github.com/facebook-github-bot', 'followers_url': 'https://api.github.com/users/facebook-github-bot/followers', 'following_url': 'https://api.github.com/users/facebook-github-bot/following{/other_user}', 'gists_url': 'https://api.github.com/users/facebook-github-bot/gists{/gist_id}', 'starred_url': 'https://api.github.com/users/facebook-github-bot/starred{/owner}{/repo}', 'subscriptions_url': 'https://api.github.com/users/facebook-github-bot/subscriptions', 'organizations_url': 'https://api.github.com/users/facebook-github-bot/orgs', 'repos_url': 'https://api.github.com/users/facebook-github-bot/repos', 'events_url': 'https://api.github.com/users/facebook-github-bot/events{/privacy}', 'received_events_url': 'https://api.github.com/users/facebook-github-bot/received_events', 'type': 'User', 'site_admin': False}",referenced,14004cbef67c8cb933938bd61b75fd46857bd903,https://api.github.com/repos/pytorch/pytorch/commits/14004cbef67c8cb933938bd61b75fd46857bd903,2018-11-07T04:07:28Z,1638,909,729
11995,1875223262,"{'login': 'facebook-github-bot', 'id': 6422482, 'node_id': 'MDQ6VXNlcjY0MjI0ODI=', 'avatar_url': 'https://avatars3.githubusercontent.com/u/6422482?v=4', 'gravatar_id': '', 'url': 'https://api.github.com/users/facebook-github-bot', 'html_url': 'https://github.com/facebook-github-bot', 'followers_url': 'https://api.github.com/users/facebook-github-bot/followers', 'following_url': 'https://api.github.com/users/facebook-github-bot/following{/other_user}', 'gists_url': 'https://api.github.com/users/facebook-github-bot/gists{/gist_id}', 'starred_url': 'https://api.github.com/users/facebook-github-bot/starred{/owner}{/repo}', 'subscriptions_url': 'https://api.github.com/users/facebook-github-bot/subscriptions', 'organizations_url': 'https://api.github.com/users/facebook-github-bot/orgs', 'repos_url': 'https://api.github.com/users/facebook-github-bot/repos', 'events_url': 'https://api.github.com/users/facebook-github-bot/events{/privacy}', 'received_events_url': 'https://api.github.com/users/facebook-github-bot/received_events', 'type': 'User', 'site_admin': False}",closed,93ecf4d72ada7fd6cbcf9ec582ecb0e37344bc7c,https://api.github.com/repos/pytorch/pytorch/commits/93ecf4d72ada7fd6cbcf9ec582ecb0e37344bc7c,2018-09-30T05:43:28Z,4,1,3
11991,2239298599,"{'login': 'facebook-github-bot', 'id': 6422482, 'node_id': 'MDQ6VXNlcjY0MjI0ODI=', 'avatar_url': 'https://avatars3.githubusercontent.com/u/6422482?v=4', 'gravatar_id': '', 'url': 'https://api.github.com/users/facebook-github-bot', 'html_url': 'https://github.com/facebook-github-bot', 'followers_url': 'https://api.github.com/users/facebook-github-bot/followers', 'following_url': 'https://api.github.com/users/facebook-github-bot/following{/other_user}', 'gists_url': 'https://api.github.com/users/facebook-github-bot/gists{/gist_id}', 'starred_url': 'https://api.github.com/users/facebook-github-bot/starred{/owner}{/repo}', 'subscriptions_url': 'https://api.github.com/users/facebook-github-bot/subscriptions', 'organizations_url': 'https://api.github.com/users/facebook-github-bot/orgs', 'repos_url': 'https://api.github.com/users/facebook-github-bot/repos', 'events_url': 'https://api.github.com/users/facebook-github-bot/events{/privacy}', 'received_events_url': 'https://api.github.com/users/facebook-github-bot/received_events', 'type': 'User', 'site_admin': False}",closed,cf444f354450821a9e4288a8eb32a2a6571754e9,https://api.github.com/repos/pytorch/pytorch/commits/cf444f354450821a9e4288a8eb32a2a6571754e9,2019-03-29T13:52:20Z,13,10,3
11913,1860257284,"{'login': 'facebook-github-bot', 'id': 6422482, 'node_id': 'MDQ6VXNlcjY0MjI0ODI=', 'avatar_url': 'https://avatars3.githubusercontent.com/u/6422482?v=4', 'gravatar_id': '', 'url': 'https://api.github.com/users/facebook-github-bot', 'html_url': 'https://github.com/facebook-github-bot', 'followers_url': 'https://api.github.com/users/facebook-github-bot/followers', 'following_url': 'https://api.github.com/users/facebook-github-bot/following{/other_user}', 'gists_url': 'https://api.github.com/users/facebook-github-bot/gists{/gist_id}', 'starred_url': 'https://api.github.com/users/facebook-github-bot/starred{/owner}{/repo}', 'subscriptions_url': 'https://api.github.com/users/facebook-github-bot/subscriptions', 'organizations_url': 'https://api.github.com/users/facebook-github-bot/orgs', 'repos_url': 'https://api.github.com/users/facebook-github-bot/repos', 'events_url': 'https://api.github.com/users/facebook-github-bot/events{/privacy}', 'received_events_url': 'https://api.github.com/users/facebook-github-bot/received_events', 'type': 'User', 'site_admin': False}",closed,58d28a5f126fedbf47d87b16708357c1319fb1d0,https://api.github.com/repos/pytorch/pytorch/commits/58d28a5f126fedbf47d87b16708357c1319fb1d0,2018-09-21T13:59:38Z,9,8,1
11912,1990449818,"{'login': 'facebook-github-bot', 'id': 6422482, 'node_id': 'MDQ6VXNlcjY0MjI0ODI=', 'avatar_url': 'https://avatars3.githubusercontent.com/u/6422482?v=4', 'gravatar_id': '', 'url': 'https://api.github.com/users/facebook-github-bot', 'html_url': 'https://github.com/facebook-github-bot', 'followers_url': 'https://api.github.com/users/facebook-github-bot/followers', 'following_url': 'https://api.github.com/users/facebook-github-bot/following{/other_user}', 'gists_url': 'https://api.github.com/users/facebook-github-bot/gists{/gist_id}', 'starred_url': 'https://api.github.com/users/facebook-github-bot/starred{/owner}{/repo}', 'subscriptions_url': 'https://api.github.com/users/facebook-github-bot/subscriptions', 'organizations_url': 'https://api.github.com/users/facebook-github-bot/orgs', 'repos_url': 'https://api.github.com/users/facebook-github-bot/repos', 'events_url': 'https://api.github.com/users/facebook-github-bot/events{/privacy}', 'received_events_url': 'https://api.github.com/users/facebook-github-bot/received_events', 'type': 'User', 'site_admin': False}",referenced,5865561a9a8daf4735fdbd1091fd028dd79df0e5,https://api.github.com/repos/pytorch/pytorch/commits/5865561a9a8daf4735fdbd1091fd028dd79df0e5,2018-11-27T18:48:19Z,626,24,602
11905,1861018631,"{'login': 'facebook-github-bot', 'id': 6422482, 'node_id': 'MDQ6VXNlcjY0MjI0ODI=', 'avatar_url': 'https://avatars3.githubusercontent.com/u/6422482?v=4', 'gravatar_id': '', 'url': 'https://api.github.com/users/facebook-github-bot', 'html_url': 'https://github.com/facebook-github-bot', 'followers_url': 'https://api.github.com/users/facebook-github-bot/followers', 'following_url': 'https://api.github.com/users/facebook-github-bot/following{/other_user}', 'gists_url': 'https://api.github.com/users/facebook-github-bot/gists{/gist_id}', 'starred_url': 'https://api.github.com/users/facebook-github-bot/starred{/owner}{/repo}', 'subscriptions_url': 'https://api.github.com/users/facebook-github-bot/subscriptions', 'organizations_url': 'https://api.github.com/users/facebook-github-bot/orgs', 'repos_url': 'https://api.github.com/users/facebook-github-bot/repos', 'events_url': 'https://api.github.com/users/facebook-github-bot/events{/privacy}', 'received_events_url': 'https://api.github.com/users/facebook-github-bot/received_events', 'type': 'User', 'site_admin': False}",closed,775358e4c2543af4da39387385e39da6cfed5ece,https://api.github.com/repos/pytorch/pytorch/commits/775358e4c2543af4da39387385e39da6cfed5ece,2018-09-21T19:44:52Z,15,15,0
11888,1863928057,"{'login': 'facebook-github-bot', 'id': 6422482, 'node_id': 'MDQ6VXNlcjY0MjI0ODI=', 'avatar_url': 'https://avatars3.githubusercontent.com/u/6422482?v=4', 'gravatar_id': '', 'url': 'https://api.github.com/users/facebook-github-bot', 'html_url': 'https://github.com/facebook-github-bot', 'followers_url': 'https://api.github.com/users/facebook-github-bot/followers', 'following_url': 'https://api.github.com/users/facebook-github-bot/following{/other_user}', 'gists_url': 'https://api.github.com/users/facebook-github-bot/gists{/gist_id}', 'starred_url': 'https://api.github.com/users/facebook-github-bot/starred{/owner}{/repo}', 'subscriptions_url': 'https://api.github.com/users/facebook-github-bot/subscriptions', 'organizations_url': 'https://api.github.com/users/facebook-github-bot/orgs', 'repos_url': 'https://api.github.com/users/facebook-github-bot/repos', 'events_url': 'https://api.github.com/users/facebook-github-bot/events{/privacy}', 'received_events_url': 'https://api.github.com/users/facebook-github-bot/received_events', 'type': 'User', 'site_admin': False}",referenced,ffbac7d0bb4e0772cab0054f79339478124ea9aa,https://api.github.com/repos/pytorch/pytorch/commits/ffbac7d0bb4e0772cab0054f79339478124ea9aa,2018-09-24T19:00:04Z,22,19,3
11886,2321007939,"{'login': 'facebook-github-bot', 'id': 6422482, 'node_id': 'MDQ6VXNlcjY0MjI0ODI=', 'avatar_url': 'https://avatars3.githubusercontent.com/u/6422482?v=4', 'gravatar_id': '', 'url': 'https://api.github.com/users/facebook-github-bot', 'html_url': 'https://github.com/facebook-github-bot', 'followers_url': 'https://api.github.com/users/facebook-github-bot/followers', 'following_url': 'https://api.github.com/users/facebook-github-bot/following{/other_user}', 'gists_url': 'https://api.github.com/users/facebook-github-bot/gists{/gist_id}', 'starred_url': 'https://api.github.com/users/facebook-github-bot/starred{/owner}{/repo}', 'subscriptions_url': 'https://api.github.com/users/facebook-github-bot/subscriptions', 'organizations_url': 'https://api.github.com/users/facebook-github-bot/orgs', 'repos_url': 'https://api.github.com/users/facebook-github-bot/repos', 'events_url': 'https://api.github.com/users/facebook-github-bot/events{/privacy}', 'received_events_url': 'https://api.github.com/users/facebook-github-bot/received_events', 'type': 'User', 'site_admin': False}",referenced,f6609daad7b03dcf32cc62bb78a96de4099c2ce4,https://api.github.com/repos/pytorch/pytorch/commits/f6609daad7b03dcf32cc62bb78a96de4099c2ce4,2019-05-06T13:40:27Z,6,3,3
11878,2023555488,"{'login': 'facebook-github-bot', 'id': 6422482, 'node_id': 'MDQ6VXNlcjY0MjI0ODI=', 'avatar_url': 'https://avatars3.githubusercontent.com/u/6422482?v=4', 'gravatar_id': '', 'url': 'https://api.github.com/users/facebook-github-bot', 'html_url': 'https://github.com/facebook-github-bot', 'followers_url': 'https://api.github.com/users/facebook-github-bot/followers', 'following_url': 'https://api.github.com/users/facebook-github-bot/following{/other_user}', 'gists_url': 'https://api.github.com/users/facebook-github-bot/gists{/gist_id}', 'starred_url': 'https://api.github.com/users/facebook-github-bot/starred{/owner}{/repo}', 'subscriptions_url': 'https://api.github.com/users/facebook-github-bot/subscriptions', 'organizations_url': 'https://api.github.com/users/facebook-github-bot/orgs', 'repos_url': 'https://api.github.com/users/facebook-github-bot/repos', 'events_url': 'https://api.github.com/users/facebook-github-bot/events{/privacy}', 'received_events_url': 'https://api.github.com/users/facebook-github-bot/received_events', 'type': 'User', 'site_admin': False}",closed,aa022313cb694546cca7fcb0123a818bf2d668b9,https://api.github.com/repos/pytorch/pytorch/commits/aa022313cb694546cca7fcb0123a818bf2d668b9,2018-12-13T08:25:42Z,11,5,6
11874,1965342276,"{'login': 'facebook-github-bot', 'id': 6422482, 'node_id': 'MDQ6VXNlcjY0MjI0ODI=', 'avatar_url': 'https://avatars3.githubusercontent.com/u/6422482?v=4', 'gravatar_id': '', 'url': 'https://api.github.com/users/facebook-github-bot', 'html_url': 'https://github.com/facebook-github-bot', 'followers_url': 'https://api.github.com/users/facebook-github-bot/followers', 'following_url': 'https://api.github.com/users/facebook-github-bot/following{/other_user}', 'gists_url': 'https://api.github.com/users/facebook-github-bot/gists{/gist_id}', 'starred_url': 'https://api.github.com/users/facebook-github-bot/starred{/owner}{/repo}', 'subscriptions_url': 'https://api.github.com/users/facebook-github-bot/subscriptions', 'organizations_url': 'https://api.github.com/users/facebook-github-bot/orgs', 'repos_url': 'https://api.github.com/users/facebook-github-bot/repos', 'events_url': 'https://api.github.com/users/facebook-github-bot/events{/privacy}', 'received_events_url': 'https://api.github.com/users/facebook-github-bot/received_events', 'type': 'User', 'site_admin': False}",referenced,97036d3c3043b99b9015bf44f9a58eb14f106a80,https://api.github.com/repos/pytorch/pytorch/commits/97036d3c3043b99b9015bf44f9a58eb14f106a80,2018-11-14T09:35:59Z,185,122,63
11847,1943484869,"{'login': 'facebook-github-bot', 'id': 6422482, 'node_id': 'MDQ6VXNlcjY0MjI0ODI=', 'avatar_url': 'https://avatars3.githubusercontent.com/u/6422482?v=4', 'gravatar_id': '', 'url': 'https://api.github.com/users/facebook-github-bot', 'html_url': 'https://github.com/facebook-github-bot', 'followers_url': 'https://api.github.com/users/facebook-github-bot/followers', 'following_url': 'https://api.github.com/users/facebook-github-bot/following{/other_user}', 'gists_url': 'https://api.github.com/users/facebook-github-bot/gists{/gist_id}', 'starred_url': 'https://api.github.com/users/facebook-github-bot/starred{/owner}{/repo}', 'subscriptions_url': 'https://api.github.com/users/facebook-github-bot/subscriptions', 'organizations_url': 'https://api.github.com/users/facebook-github-bot/orgs', 'repos_url': 'https://api.github.com/users/facebook-github-bot/repos', 'events_url': 'https://api.github.com/users/facebook-github-bot/events{/privacy}', 'received_events_url': 'https://api.github.com/users/facebook-github-bot/received_events', 'type': 'User', 'site_admin': False}",closed,9f2b2cac37da4476dde478d063cc5a5f2edb0e91,https://api.github.com/repos/pytorch/pytorch/commits/9f2b2cac37da4476dde478d063cc5a5f2edb0e91,2018-11-02T17:22:50Z,24,18,6
11804,1995883879,"{'login': 'facebook-github-bot', 'id': 6422482, 'node_id': 'MDQ6VXNlcjY0MjI0ODI=', 'avatar_url': 'https://avatars3.githubusercontent.com/u/6422482?v=4', 'gravatar_id': '', 'url': 'https://api.github.com/users/facebook-github-bot', 'html_url': 'https://github.com/facebook-github-bot', 'followers_url': 'https://api.github.com/users/facebook-github-bot/followers', 'following_url': 'https://api.github.com/users/facebook-github-bot/following{/other_user}', 'gists_url': 'https://api.github.com/users/facebook-github-bot/gists{/gist_id}', 'starred_url': 'https://api.github.com/users/facebook-github-bot/starred{/owner}{/repo}', 'subscriptions_url': 'https://api.github.com/users/facebook-github-bot/subscriptions', 'organizations_url': 'https://api.github.com/users/facebook-github-bot/orgs', 'repos_url': 'https://api.github.com/users/facebook-github-bot/repos', 'events_url': 'https://api.github.com/users/facebook-github-bot/events{/privacy}', 'received_events_url': 'https://api.github.com/users/facebook-github-bot/received_events', 'type': 'User', 'site_admin': False}",closed,4ec6bd73566bb5372e615b963db068143f417bfb,https://api.github.com/repos/pytorch/pytorch/commits/4ec6bd73566bb5372e615b963db068143f417bfb,2018-11-29T17:18:33Z,95,39,56
11803,1952601751,"{'login': 'facebook-github-bot', 'id': 6422482, 'node_id': 'MDQ6VXNlcjY0MjI0ODI=', 'avatar_url': 'https://avatars3.githubusercontent.com/u/6422482?v=4', 'gravatar_id': '', 'url': 'https://api.github.com/users/facebook-github-bot', 'html_url': 'https://github.com/facebook-github-bot', 'followers_url': 'https://api.github.com/users/facebook-github-bot/followers', 'following_url': 'https://api.github.com/users/facebook-github-bot/following{/other_user}', 'gists_url': 'https://api.github.com/users/facebook-github-bot/gists{/gist_id}', 'starred_url': 'https://api.github.com/users/facebook-github-bot/starred{/owner}{/repo}', 'subscriptions_url': 'https://api.github.com/users/facebook-github-bot/subscriptions', 'organizations_url': 'https://api.github.com/users/facebook-github-bot/orgs', 'repos_url': 'https://api.github.com/users/facebook-github-bot/repos', 'events_url': 'https://api.github.com/users/facebook-github-bot/events{/privacy}', 'received_events_url': 'https://api.github.com/users/facebook-github-bot/received_events', 'type': 'User', 'site_admin': False}",closed,044d00516ccd6572c0d6ab6d54587155b02a3b86,https://api.github.com/repos/pytorch/pytorch/commits/044d00516ccd6572c0d6ab6d54587155b02a3b86,2018-11-07T19:59:41Z,219,132,87
11800,1860489597,"{'login': 'facebook-github-bot', 'id': 6422482, 'node_id': 'MDQ6VXNlcjY0MjI0ODI=', 'avatar_url': 'https://avatars3.githubusercontent.com/u/6422482?v=4', 'gravatar_id': '', 'url': 'https://api.github.com/users/facebook-github-bot', 'html_url': 'https://github.com/facebook-github-bot', 'followers_url': 'https://api.github.com/users/facebook-github-bot/followers', 'following_url': 'https://api.github.com/users/facebook-github-bot/following{/other_user}', 'gists_url': 'https://api.github.com/users/facebook-github-bot/gists{/gist_id}', 'starred_url': 'https://api.github.com/users/facebook-github-bot/starred{/owner}{/repo}', 'subscriptions_url': 'https://api.github.com/users/facebook-github-bot/subscriptions', 'organizations_url': 'https://api.github.com/users/facebook-github-bot/orgs', 'repos_url': 'https://api.github.com/users/facebook-github-bot/repos', 'events_url': 'https://api.github.com/users/facebook-github-bot/events{/privacy}', 'received_events_url': 'https://api.github.com/users/facebook-github-bot/received_events', 'type': 'User', 'site_admin': False}",closed,4fb7e72fe5969b9de7dde1fbc4499eb1dc8486c8,https://api.github.com/repos/pytorch/pytorch/commits/4fb7e72fe5969b9de7dde1fbc4499eb1dc8486c8,2018-09-21T15:26:22Z,28,20,8
11795,1861185834,"{'login': 'facebook-github-bot', 'id': 6422482, 'node_id': 'MDQ6VXNlcjY0MjI0ODI=', 'avatar_url': 'https://avatars3.githubusercontent.com/u/6422482?v=4', 'gravatar_id': '', 'url': 'https://api.github.com/users/facebook-github-bot', 'html_url': 'https://github.com/facebook-github-bot', 'followers_url': 'https://api.github.com/users/facebook-github-bot/followers', 'following_url': 'https://api.github.com/users/facebook-github-bot/following{/other_user}', 'gists_url': 'https://api.github.com/users/facebook-github-bot/gists{/gist_id}', 'starred_url': 'https://api.github.com/users/facebook-github-bot/starred{/owner}{/repo}', 'subscriptions_url': 'https://api.github.com/users/facebook-github-bot/subscriptions', 'organizations_url': 'https://api.github.com/users/facebook-github-bot/orgs', 'repos_url': 'https://api.github.com/users/facebook-github-bot/repos', 'events_url': 'https://api.github.com/users/facebook-github-bot/events{/privacy}', 'received_events_url': 'https://api.github.com/users/facebook-github-bot/received_events', 'type': 'User', 'site_admin': False}",closed,1cf5b0c7c19f55411a01c936fb265dd6b7847392,https://api.github.com/repos/pytorch/pytorch/commits/1cf5b0c7c19f55411a01c936fb265dd6b7847392,2018-09-21T21:21:44Z,52,43,9
11788,1866759467,"{'login': 'facebook-github-bot', 'id': 6422482, 'node_id': 'MDQ6VXNlcjY0MjI0ODI=', 'avatar_url': 'https://avatars3.githubusercontent.com/u/6422482?v=4', 'gravatar_id': '', 'url': 'https://api.github.com/users/facebook-github-bot', 'html_url': 'https://github.com/facebook-github-bot', 'followers_url': 'https://api.github.com/users/facebook-github-bot/followers', 'following_url': 'https://api.github.com/users/facebook-github-bot/following{/other_user}', 'gists_url': 'https://api.github.com/users/facebook-github-bot/gists{/gist_id}', 'starred_url': 'https://api.github.com/users/facebook-github-bot/starred{/owner}{/repo}', 'subscriptions_url': 'https://api.github.com/users/facebook-github-bot/subscriptions', 'organizations_url': 'https://api.github.com/users/facebook-github-bot/orgs', 'repos_url': 'https://api.github.com/users/facebook-github-bot/repos', 'events_url': 'https://api.github.com/users/facebook-github-bot/events{/privacy}', 'received_events_url': 'https://api.github.com/users/facebook-github-bot/received_events', 'type': 'User', 'site_admin': False}",closed,b263078bc3528c1e64a93290d2eaa473bce6ed92,https://api.github.com/repos/pytorch/pytorch/commits/b263078bc3528c1e64a93290d2eaa473bce6ed92,2018-09-25T20:11:48Z,38,38,0
11762,1853088474,"{'login': 'facebook-github-bot', 'id': 6422482, 'node_id': 'MDQ6VXNlcjY0MjI0ODI=', 'avatar_url': 'https://avatars3.githubusercontent.com/u/6422482?v=4', 'gravatar_id': '', 'url': 'https://api.github.com/users/facebook-github-bot', 'html_url': 'https://github.com/facebook-github-bot', 'followers_url': 'https://api.github.com/users/facebook-github-bot/followers', 'following_url': 'https://api.github.com/users/facebook-github-bot/following{/other_user}', 'gists_url': 'https://api.github.com/users/facebook-github-bot/gists{/gist_id}', 'starred_url': 'https://api.github.com/users/facebook-github-bot/starred{/owner}{/repo}', 'subscriptions_url': 'https://api.github.com/users/facebook-github-bot/subscriptions', 'organizations_url': 'https://api.github.com/users/facebook-github-bot/orgs', 'repos_url': 'https://api.github.com/users/facebook-github-bot/repos', 'events_url': 'https://api.github.com/users/facebook-github-bot/events{/privacy}', 'received_events_url': 'https://api.github.com/users/facebook-github-bot/received_events', 'type': 'User', 'site_admin': False}",referenced,2732c8bae10881bc7a359af2dfbc812238efb436,https://api.github.com/repos/pytorch/pytorch/commits/2732c8bae10881bc7a359af2dfbc812238efb436,2018-09-18T17:57:46Z,2,1,1
11757,1885483372,"{'login': 'facebook-github-bot', 'id': 6422482, 'node_id': 'MDQ6VXNlcjY0MjI0ODI=', 'avatar_url': 'https://avatars3.githubusercontent.com/u/6422482?v=4', 'gravatar_id': '', 'url': 'https://api.github.com/users/facebook-github-bot', 'html_url': 'https://github.com/facebook-github-bot', 'followers_url': 'https://api.github.com/users/facebook-github-bot/followers', 'following_url': 'https://api.github.com/users/facebook-github-bot/following{/other_user}', 'gists_url': 'https://api.github.com/users/facebook-github-bot/gists{/gist_id}', 'starred_url': 'https://api.github.com/users/facebook-github-bot/starred{/owner}{/repo}', 'subscriptions_url': 'https://api.github.com/users/facebook-github-bot/subscriptions', 'organizations_url': 'https://api.github.com/users/facebook-github-bot/orgs', 'repos_url': 'https://api.github.com/users/facebook-github-bot/repos', 'events_url': 'https://api.github.com/users/facebook-github-bot/events{/privacy}', 'received_events_url': 'https://api.github.com/users/facebook-github-bot/received_events', 'type': 'User', 'site_admin': False}",closed,39bd73ae513358e1fe5881e58b1ab6aea14bed41,https://api.github.com/repos/pytorch/pytorch/commits/39bd73ae513358e1fe5881e58b1ab6aea14bed41,2018-10-04T19:12:34Z,115,109,6
11755,2324476886,"{'login': 'zou3519', 'id': 5652049, 'node_id': 'MDQ6VXNlcjU2NTIwNDk=', 'avatar_url': 'https://avatars3.githubusercontent.com/u/5652049?v=4', 'gravatar_id': '', 'url': 'https://api.github.com/users/zou3519', 'html_url': 'https://github.com/zou3519', 'followers_url': 'https://api.github.com/users/zou3519/followers', 'following_url': 'https://api.github.com/users/zou3519/following{/other_user}', 'gists_url': 'https://api.github.com/users/zou3519/gists{/gist_id}', 'starred_url': 'https://api.github.com/users/zou3519/starred{/owner}{/repo}', 'subscriptions_url': 'https://api.github.com/users/zou3519/subscriptions', 'organizations_url': 'https://api.github.com/users/zou3519/orgs', 'repos_url': 'https://api.github.com/users/zou3519/repos', 'events_url': 'https://api.github.com/users/zou3519/events{/privacy}', 'received_events_url': 'https://api.github.com/users/zou3519/received_events', 'type': 'User', 'site_admin': False}",referenced,b8256280ce45f02a7e105d3b3db4a547990e683d,https://api.github.com/repos/pytorch/pytorch/commits/b8256280ce45f02a7e105d3b3db4a547990e683d,2019-05-07T14:50:58Z,328,325,3
11752,1856407057,"{'login': 'facebook-github-bot', 'id': 6422482, 'node_id': 'MDQ6VXNlcjY0MjI0ODI=', 'avatar_url': 'https://avatars3.githubusercontent.com/u/6422482?v=4', 'gravatar_id': '', 'url': 'https://api.github.com/users/facebook-github-bot', 'html_url': 'https://github.com/facebook-github-bot', 'followers_url': 'https://api.github.com/users/facebook-github-bot/followers', 'following_url': 'https://api.github.com/users/facebook-github-bot/following{/other_user}', 'gists_url': 'https://api.github.com/users/facebook-github-bot/gists{/gist_id}', 'starred_url': 'https://api.github.com/users/facebook-github-bot/starred{/owner}{/repo}', 'subscriptions_url': 'https://api.github.com/users/facebook-github-bot/subscriptions', 'organizations_url': 'https://api.github.com/users/facebook-github-bot/orgs', 'repos_url': 'https://api.github.com/users/facebook-github-bot/repos', 'events_url': 'https://api.github.com/users/facebook-github-bot/events{/privacy}', 'received_events_url': 'https://api.github.com/users/facebook-github-bot/received_events', 'type': 'User', 'site_admin': False}",referenced,ae1a972d78950abc4dab372f496914b5e78b9637,https://api.github.com/repos/pytorch/pytorch/commits/ae1a972d78950abc4dab372f496914b5e78b9637,2018-09-20T00:11:09Z,5,3,2
11752,2418736117,"{'login': 'facebook-github-bot', 'id': 6422482, 'node_id': 'MDQ6VXNlcjY0MjI0ODI=', 'avatar_url': 'https://avatars3.githubusercontent.com/u/6422482?v=4', 'gravatar_id': '', 'url': 'https://api.github.com/users/facebook-github-bot', 'html_url': 'https://github.com/facebook-github-bot', 'followers_url': 'https://api.github.com/users/facebook-github-bot/followers', 'following_url': 'https://api.github.com/users/facebook-github-bot/following{/other_user}', 'gists_url': 'https://api.github.com/users/facebook-github-bot/gists{/gist_id}', 'starred_url': 'https://api.github.com/users/facebook-github-bot/starred{/owner}{/repo}', 'subscriptions_url': 'https://api.github.com/users/facebook-github-bot/subscriptions', 'organizations_url': 'https://api.github.com/users/facebook-github-bot/orgs', 'repos_url': 'https://api.github.com/users/facebook-github-bot/repos', 'events_url': 'https://api.github.com/users/facebook-github-bot/events{/privacy}', 'received_events_url': 'https://api.github.com/users/facebook-github-bot/received_events', 'type': 'User', 'site_admin': False}",referenced,b403b10ff98a6bc1a238e7ba4eee6393b6b89048,https://api.github.com/repos/pytorch/pytorch/commits/b403b10ff98a6bc1a238e7ba4eee6393b6b89048,2019-06-17T20:01:57Z,19,15,4
11751,1867261325,"{'login': 'facebook-github-bot', 'id': 6422482, 'node_id': 'MDQ6VXNlcjY0MjI0ODI=', 'avatar_url': 'https://avatars3.githubusercontent.com/u/6422482?v=4', 'gravatar_id': '', 'url': 'https://api.github.com/users/facebook-github-bot', 'html_url': 'https://github.com/facebook-github-bot', 'followers_url': 'https://api.github.com/users/facebook-github-bot/followers', 'following_url': 'https://api.github.com/users/facebook-github-bot/following{/other_user}', 'gists_url': 'https://api.github.com/users/facebook-github-bot/gists{/gist_id}', 'starred_url': 'https://api.github.com/users/facebook-github-bot/starred{/owner}{/repo}', 'subscriptions_url': 'https://api.github.com/users/facebook-github-bot/subscriptions', 'organizations_url': 'https://api.github.com/users/facebook-github-bot/orgs', 'repos_url': 'https://api.github.com/users/facebook-github-bot/repos', 'events_url': 'https://api.github.com/users/facebook-github-bot/events{/privacy}', 'received_events_url': 'https://api.github.com/users/facebook-github-bot/received_events', 'type': 'User', 'site_admin': False}",closed,807de9a1e3cff49dd23fb7df83aea38269ccdd23,https://api.github.com/repos/pytorch/pytorch/commits/807de9a1e3cff49dd23fb7df83aea38269ccdd23,2018-09-26T02:11:44Z,29,28,1
11750,1850297908,"{'login': 'facebook-github-bot', 'id': 6422482, 'node_id': 'MDQ6VXNlcjY0MjI0ODI=', 'avatar_url': 'https://avatars3.githubusercontent.com/u/6422482?v=4', 'gravatar_id': '', 'url': 'https://api.github.com/users/facebook-github-bot', 'html_url': 'https://github.com/facebook-github-bot', 'followers_url': 'https://api.github.com/users/facebook-github-bot/followers', 'following_url': 'https://api.github.com/users/facebook-github-bot/following{/other_user}', 'gists_url': 'https://api.github.com/users/facebook-github-bot/gists{/gist_id}', 'starred_url': 'https://api.github.com/users/facebook-github-bot/starred{/owner}{/repo}', 'subscriptions_url': 'https://api.github.com/users/facebook-github-bot/subscriptions', 'organizations_url': 'https://api.github.com/users/facebook-github-bot/orgs', 'repos_url': 'https://api.github.com/users/facebook-github-bot/repos', 'events_url': 'https://api.github.com/users/facebook-github-bot/events{/privacy}', 'received_events_url': 'https://api.github.com/users/facebook-github-bot/received_events', 'type': 'User', 'site_admin': False}",closed,a7e3cd09e023685a96f65d8447490455a16a4ebb,https://api.github.com/repos/pytorch/pytorch/commits/a7e3cd09e023685a96f65d8447490455a16a4ebb,2018-09-17T16:56:08Z,46,41,5
11739,1850918322,"{'login': 'facebook-github-bot', 'id': 6422482, 'node_id': 'MDQ6VXNlcjY0MjI0ODI=', 'avatar_url': 'https://avatars3.githubusercontent.com/u/6422482?v=4', 'gravatar_id': '', 'url': 'https://api.github.com/users/facebook-github-bot', 'html_url': 'https://github.com/facebook-github-bot', 'followers_url': 'https://api.github.com/users/facebook-github-bot/followers', 'following_url': 'https://api.github.com/users/facebook-github-bot/following{/other_user}', 'gists_url': 'https://api.github.com/users/facebook-github-bot/gists{/gist_id}', 'starred_url': 'https://api.github.com/users/facebook-github-bot/starred{/owner}{/repo}', 'subscriptions_url': 'https://api.github.com/users/facebook-github-bot/subscriptions', 'organizations_url': 'https://api.github.com/users/facebook-github-bot/orgs', 'repos_url': 'https://api.github.com/users/facebook-github-bot/repos', 'events_url': 'https://api.github.com/users/facebook-github-bot/events{/privacy}', 'received_events_url': 'https://api.github.com/users/facebook-github-bot/received_events', 'type': 'User', 'site_admin': False}",closed,7df6650e9c23c507137b9af7ffb94053b8a86a2d,https://api.github.com/repos/pytorch/pytorch/commits/7df6650e9c23c507137b9af7ffb94053b8a86a2d,2018-09-17T21:41:31Z,50,29,21
11736,2002683242,"{'login': 'facebook-github-bot', 'id': 6422482, 'node_id': 'MDQ6VXNlcjY0MjI0ODI=', 'avatar_url': 'https://avatars3.githubusercontent.com/u/6422482?v=4', 'gravatar_id': '', 'url': 'https://api.github.com/users/facebook-github-bot', 'html_url': 'https://github.com/facebook-github-bot', 'followers_url': 'https://api.github.com/users/facebook-github-bot/followers', 'following_url': 'https://api.github.com/users/facebook-github-bot/following{/other_user}', 'gists_url': 'https://api.github.com/users/facebook-github-bot/gists{/gist_id}', 'starred_url': 'https://api.github.com/users/facebook-github-bot/starred{/owner}{/repo}', 'subscriptions_url': 'https://api.github.com/users/facebook-github-bot/subscriptions', 'organizations_url': 'https://api.github.com/users/facebook-github-bot/orgs', 'repos_url': 'https://api.github.com/users/facebook-github-bot/repos', 'events_url': 'https://api.github.com/users/facebook-github-bot/events{/privacy}', 'received_events_url': 'https://api.github.com/users/facebook-github-bot/received_events', 'type': 'User', 'site_admin': False}",referenced,68ffe469918a5eaa014e230efe81af9c298857aa,https://api.github.com/repos/pytorch/pytorch/commits/68ffe469918a5eaa014e230efe81af9c298857aa,2018-12-03T21:46:03Z,890,536,354
11736,2003562795,"{'login': 'facebook-github-bot', 'id': 6422482, 'node_id': 'MDQ6VXNlcjY0MjI0ODI=', 'avatar_url': 'https://avatars3.githubusercontent.com/u/6422482?v=4', 'gravatar_id': '', 'url': 'https://api.github.com/users/facebook-github-bot', 'html_url': 'https://github.com/facebook-github-bot', 'followers_url': 'https://api.github.com/users/facebook-github-bot/followers', 'following_url': 'https://api.github.com/users/facebook-github-bot/following{/other_user}', 'gists_url': 'https://api.github.com/users/facebook-github-bot/gists{/gist_id}', 'starred_url': 'https://api.github.com/users/facebook-github-bot/starred{/owner}{/repo}', 'subscriptions_url': 'https://api.github.com/users/facebook-github-bot/subscriptions', 'organizations_url': 'https://api.github.com/users/facebook-github-bot/orgs', 'repos_url': 'https://api.github.com/users/facebook-github-bot/repos', 'events_url': 'https://api.github.com/users/facebook-github-bot/events{/privacy}', 'received_events_url': 'https://api.github.com/users/facebook-github-bot/received_events', 'type': 'User', 'site_admin': False}",referenced,8812a5d42e7be858334a4f5bd6acc7e6e942815f,https://api.github.com/repos/pytorch/pytorch/commits/8812a5d42e7be858334a4f5bd6acc7e6e942815f,2018-12-04T08:17:55Z,890,536,354
11732,2062083742,"{'login': 'facebook-github-bot', 'id': 6422482, 'node_id': 'MDQ6VXNlcjY0MjI0ODI=', 'avatar_url': 'https://avatars3.githubusercontent.com/u/6422482?v=4', 'gravatar_id': '', 'url': 'https://api.github.com/users/facebook-github-bot', 'html_url': 'https://github.com/facebook-github-bot', 'followers_url': 'https://api.github.com/users/facebook-github-bot/followers', 'following_url': 'https://api.github.com/users/facebook-github-bot/following{/other_user}', 'gists_url': 'https://api.github.com/users/facebook-github-bot/gists{/gist_id}', 'starred_url': 'https://api.github.com/users/facebook-github-bot/starred{/owner}{/repo}', 'subscriptions_url': 'https://api.github.com/users/facebook-github-bot/subscriptions', 'organizations_url': 'https://api.github.com/users/facebook-github-bot/orgs', 'repos_url': 'https://api.github.com/users/facebook-github-bot/repos', 'events_url': 'https://api.github.com/users/facebook-github-bot/events{/privacy}', 'received_events_url': 'https://api.github.com/users/facebook-github-bot/received_events', 'type': 'User', 'site_admin': False}",closed,828cb18fa35c7c132ab920de1c0dc6d859f152d6,https://api.github.com/repos/pytorch/pytorch/commits/828cb18fa35c7c132ab920de1c0dc6d859f152d6,2019-01-09T04:07:27Z,41,40,1
11732,2081425023,"{'login': 'soumith', 'id': 1310570, 'node_id': 'MDQ6VXNlcjEzMTA1NzA=', 'avatar_url': 'https://avatars0.githubusercontent.com/u/1310570?v=4', 'gravatar_id': '', 'url': 'https://api.github.com/users/soumith', 'html_url': 'https://github.com/soumith', 'followers_url': 'https://api.github.com/users/soumith/followers', 'following_url': 'https://api.github.com/users/soumith/following{/other_user}', 'gists_url': 'https://api.github.com/users/soumith/gists{/gist_id}', 'starred_url': 'https://api.github.com/users/soumith/starred{/owner}{/repo}', 'subscriptions_url': 'https://api.github.com/users/soumith/subscriptions', 'organizations_url': 'https://api.github.com/users/soumith/orgs', 'repos_url': 'https://api.github.com/users/soumith/repos', 'events_url': 'https://api.github.com/users/soumith/events{/privacy}', 'received_events_url': 'https://api.github.com/users/soumith/received_events', 'type': 'User', 'site_admin': False}",referenced,f450fd1e75b34fd2720a5a907d49c11b302866ae,https://api.github.com/repos/pytorch/pytorch/commits/f450fd1e75b34fd2720a5a907d49c11b302866ae,2019-01-17T21:23:36Z,41,40,1
11732,2081539296,"{'login': 'soumith', 'id': 1310570, 'node_id': 'MDQ6VXNlcjEzMTA1NzA=', 'avatar_url': 'https://avatars0.githubusercontent.com/u/1310570?v=4', 'gravatar_id': '', 'url': 'https://api.github.com/users/soumith', 'html_url': 'https://github.com/soumith', 'followers_url': 'https://api.github.com/users/soumith/followers', 'following_url': 'https://api.github.com/users/soumith/following{/other_user}', 'gists_url': 'https://api.github.com/users/soumith/gists{/gist_id}', 'starred_url': 'https://api.github.com/users/soumith/starred{/owner}{/repo}', 'subscriptions_url': 'https://api.github.com/users/soumith/subscriptions', 'organizations_url': 'https://api.github.com/users/soumith/orgs', 'repos_url': 'https://api.github.com/users/soumith/repos', 'events_url': 'https://api.github.com/users/soumith/events{/privacy}', 'received_events_url': 'https://api.github.com/users/soumith/received_events', 'type': 'User', 'site_admin': False}",referenced,8a8b97b9e97bae8c775c52c672aa3c02a944de2d,https://api.github.com/repos/pytorch/pytorch/commits/8a8b97b9e97bae8c775c52c672aa3c02a944de2d,2019-01-17T22:19:17Z,41,40,1
11732,2081981228,"{'login': 'soumith', 'id': 1310570, 'node_id': 'MDQ6VXNlcjEzMTA1NzA=', 'avatar_url': 'https://avatars0.githubusercontent.com/u/1310570?v=4', 'gravatar_id': '', 'url': 'https://api.github.com/users/soumith', 'html_url': 'https://github.com/soumith', 'followers_url': 'https://api.github.com/users/soumith/followers', 'following_url': 'https://api.github.com/users/soumith/following{/other_user}', 'gists_url': 'https://api.github.com/users/soumith/gists{/gist_id}', 'starred_url': 'https://api.github.com/users/soumith/starred{/owner}{/repo}', 'subscriptions_url': 'https://api.github.com/users/soumith/subscriptions', 'organizations_url': 'https://api.github.com/users/soumith/orgs', 'repos_url': 'https://api.github.com/users/soumith/repos', 'events_url': 'https://api.github.com/users/soumith/events{/privacy}', 'received_events_url': 'https://api.github.com/users/soumith/received_events', 'type': 'User', 'site_admin': False}",referenced,7b98af16eeb90a19507ef98db35b325513750cf2,https://api.github.com/repos/pytorch/pytorch/commits/7b98af16eeb90a19507ef98db35b325513750cf2,2019-01-18T04:02:11Z,41,40,1
11683,1908426020,"{'login': 'facebook-github-bot', 'id': 6422482, 'node_id': 'MDQ6VXNlcjY0MjI0ODI=', 'avatar_url': 'https://avatars3.githubusercontent.com/u/6422482?v=4', 'gravatar_id': '', 'url': 'https://api.github.com/users/facebook-github-bot', 'html_url': 'https://github.com/facebook-github-bot', 'followers_url': 'https://api.github.com/users/facebook-github-bot/followers', 'following_url': 'https://api.github.com/users/facebook-github-bot/following{/other_user}', 'gists_url': 'https://api.github.com/users/facebook-github-bot/gists{/gist_id}', 'starred_url': 'https://api.github.com/users/facebook-github-bot/starred{/owner}{/repo}', 'subscriptions_url': 'https://api.github.com/users/facebook-github-bot/subscriptions', 'organizations_url': 'https://api.github.com/users/facebook-github-bot/orgs', 'repos_url': 'https://api.github.com/users/facebook-github-bot/repos', 'events_url': 'https://api.github.com/users/facebook-github-bot/events{/privacy}', 'received_events_url': 'https://api.github.com/users/facebook-github-bot/received_events', 'type': 'User', 'site_admin': False}",closed,3bfa7258b3ec680328e0ebf9dc72a92833bcd2f3,https://api.github.com/repos/pytorch/pytorch/commits/3bfa7258b3ec680328e0ebf9dc72a92833bcd2f3,2018-10-17T03:12:10Z,162,139,23
11663,1847001373,"{'login': 'facebook-github-bot', 'id': 6422482, 'node_id': 'MDQ6VXNlcjY0MjI0ODI=', 'avatar_url': 'https://avatars3.githubusercontent.com/u/6422482?v=4', 'gravatar_id': '', 'url': 'https://api.github.com/users/facebook-github-bot', 'html_url': 'https://github.com/facebook-github-bot', 'followers_url': 'https://api.github.com/users/facebook-github-bot/followers', 'following_url': 'https://api.github.com/users/facebook-github-bot/following{/other_user}', 'gists_url': 'https://api.github.com/users/facebook-github-bot/gists{/gist_id}', 'starred_url': 'https://api.github.com/users/facebook-github-bot/starred{/owner}{/repo}', 'subscriptions_url': 'https://api.github.com/users/facebook-github-bot/subscriptions', 'organizations_url': 'https://api.github.com/users/facebook-github-bot/orgs', 'repos_url': 'https://api.github.com/users/facebook-github-bot/repos', 'events_url': 'https://api.github.com/users/facebook-github-bot/events{/privacy}', 'received_events_url': 'https://api.github.com/users/facebook-github-bot/received_events', 'type': 'User', 'site_admin': False}",closed,70e68e755a8fdd94218e9b8e0abfb6b805354a08,https://api.github.com/repos/pytorch/pytorch/commits/70e68e755a8fdd94218e9b8e0abfb6b805354a08,2018-09-14T20:41:43Z,18,17,1
11652,1852602475,"{'login': 'facebook-github-bot', 'id': 6422482, 'node_id': 'MDQ6VXNlcjY0MjI0ODI=', 'avatar_url': 'https://avatars3.githubusercontent.com/u/6422482?v=4', 'gravatar_id': '', 'url': 'https://api.github.com/users/facebook-github-bot', 'html_url': 'https://github.com/facebook-github-bot', 'followers_url': 'https://api.github.com/users/facebook-github-bot/followers', 'following_url': 'https://api.github.com/users/facebook-github-bot/following{/other_user}', 'gists_url': 'https://api.github.com/users/facebook-github-bot/gists{/gist_id}', 'starred_url': 'https://api.github.com/users/facebook-github-bot/starred{/owner}{/repo}', 'subscriptions_url': 'https://api.github.com/users/facebook-github-bot/subscriptions', 'organizations_url': 'https://api.github.com/users/facebook-github-bot/orgs', 'repos_url': 'https://api.github.com/users/facebook-github-bot/repos', 'events_url': 'https://api.github.com/users/facebook-github-bot/events{/privacy}', 'received_events_url': 'https://api.github.com/users/facebook-github-bot/received_events', 'type': 'User', 'site_admin': False}",closed,e2bc95e1bd39f4cd1813a21290f2f8f6fb51c0eb,https://api.github.com/repos/pytorch/pytorch/commits/e2bc95e1bd39f4cd1813a21290f2f8f6fb51c0eb,2018-09-18T14:42:49Z,14,14,0
11647,1991050984,"{'login': 'facebook-github-bot', 'id': 6422482, 'node_id': 'MDQ6VXNlcjY0MjI0ODI=', 'avatar_url': 'https://avatars3.githubusercontent.com/u/6422482?v=4', 'gravatar_id': '', 'url': 'https://api.github.com/users/facebook-github-bot', 'html_url': 'https://github.com/facebook-github-bot', 'followers_url': 'https://api.github.com/users/facebook-github-bot/followers', 'following_url': 'https://api.github.com/users/facebook-github-bot/following{/other_user}', 'gists_url': 'https://api.github.com/users/facebook-github-bot/gists{/gist_id}', 'starred_url': 'https://api.github.com/users/facebook-github-bot/starred{/owner}{/repo}', 'subscriptions_url': 'https://api.github.com/users/facebook-github-bot/subscriptions', 'organizations_url': 'https://api.github.com/users/facebook-github-bot/orgs', 'repos_url': 'https://api.github.com/users/facebook-github-bot/repos', 'events_url': 'https://api.github.com/users/facebook-github-bot/events{/privacy}', 'received_events_url': 'https://api.github.com/users/facebook-github-bot/received_events', 'type': 'User', 'site_admin': False}",referenced,006505bb8f9dcf0f38b32518308d071c8a1ccec6,https://api.github.com/repos/pytorch/pytorch/commits/006505bb8f9dcf0f38b32518308d071c8a1ccec6,2018-11-27T23:25:32Z,683,584,99
11625,1846612795,"{'login': 'facebook-github-bot', 'id': 6422482, 'node_id': 'MDQ6VXNlcjY0MjI0ODI=', 'avatar_url': 'https://avatars3.githubusercontent.com/u/6422482?v=4', 'gravatar_id': '', 'url': 'https://api.github.com/users/facebook-github-bot', 'html_url': 'https://github.com/facebook-github-bot', 'followers_url': 'https://api.github.com/users/facebook-github-bot/followers', 'following_url': 'https://api.github.com/users/facebook-github-bot/following{/other_user}', 'gists_url': 'https://api.github.com/users/facebook-github-bot/gists{/gist_id}', 'starred_url': 'https://api.github.com/users/facebook-github-bot/starred{/owner}{/repo}', 'subscriptions_url': 'https://api.github.com/users/facebook-github-bot/subscriptions', 'organizations_url': 'https://api.github.com/users/facebook-github-bot/orgs', 'repos_url': 'https://api.github.com/users/facebook-github-bot/repos', 'events_url': 'https://api.github.com/users/facebook-github-bot/events{/privacy}', 'received_events_url': 'https://api.github.com/users/facebook-github-bot/received_events', 'type': 'User', 'site_admin': False}",closed,278e304c18b0da89cbc58ac43b2d5eabdd3fd6f3,https://api.github.com/repos/pytorch/pytorch/commits/278e304c18b0da89cbc58ac43b2d5eabdd3fd6f3,2018-09-14T17:10:57Z,41,35,6
11618,1842716621,"{'login': 'facebook-github-bot', 'id': 6422482, 'node_id': 'MDQ6VXNlcjY0MjI0ODI=', 'avatar_url': 'https://avatars3.githubusercontent.com/u/6422482?v=4', 'gravatar_id': '', 'url': 'https://api.github.com/users/facebook-github-bot', 'html_url': 'https://github.com/facebook-github-bot', 'followers_url': 'https://api.github.com/users/facebook-github-bot/followers', 'following_url': 'https://api.github.com/users/facebook-github-bot/following{/other_user}', 'gists_url': 'https://api.github.com/users/facebook-github-bot/gists{/gist_id}', 'starred_url': 'https://api.github.com/users/facebook-github-bot/starred{/owner}{/repo}', 'subscriptions_url': 'https://api.github.com/users/facebook-github-bot/subscriptions', 'organizations_url': 'https://api.github.com/users/facebook-github-bot/orgs', 'repos_url': 'https://api.github.com/users/facebook-github-bot/repos', 'events_url': 'https://api.github.com/users/facebook-github-bot/events{/privacy}', 'received_events_url': 'https://api.github.com/users/facebook-github-bot/received_events', 'type': 'User', 'site_admin': False}",referenced,6f05b5ee5464d8c3386a8d1a059c327a6aaf5a59,https://api.github.com/repos/pytorch/pytorch/commits/6f05b5ee5464d8c3386a8d1a059c327a6aaf5a59,2018-09-13T04:56:33Z,7,3,4
11618,1963761500,"{'login': 'facebook-github-bot', 'id': 6422482, 'node_id': 'MDQ6VXNlcjY0MjI0ODI=', 'avatar_url': 'https://avatars3.githubusercontent.com/u/6422482?v=4', 'gravatar_id': '', 'url': 'https://api.github.com/users/facebook-github-bot', 'html_url': 'https://github.com/facebook-github-bot', 'followers_url': 'https://api.github.com/users/facebook-github-bot/followers', 'following_url': 'https://api.github.com/users/facebook-github-bot/following{/other_user}', 'gists_url': 'https://api.github.com/users/facebook-github-bot/gists{/gist_id}', 'starred_url': 'https://api.github.com/users/facebook-github-bot/starred{/owner}{/repo}', 'subscriptions_url': 'https://api.github.com/users/facebook-github-bot/subscriptions', 'organizations_url': 'https://api.github.com/users/facebook-github-bot/orgs', 'repos_url': 'https://api.github.com/users/facebook-github-bot/repos', 'events_url': 'https://api.github.com/users/facebook-github-bot/events{/privacy}', 'received_events_url': 'https://api.github.com/users/facebook-github-bot/received_events', 'type': 'User', 'site_admin': False}",closed,8559fcf7917fe4f1c3909ce98d947eb8d686a947,https://api.github.com/repos/pytorch/pytorch/commits/8559fcf7917fe4f1c3909ce98d947eb8d686a947,2018-11-13T17:46:57Z,2,1,1
11582,1842289163,"{'login': 'facebook-github-bot', 'id': 6422482, 'node_id': 'MDQ6VXNlcjY0MjI0ODI=', 'avatar_url': 'https://avatars3.githubusercontent.com/u/6422482?v=4', 'gravatar_id': '', 'url': 'https://api.github.com/users/facebook-github-bot', 'html_url': 'https://github.com/facebook-github-bot', 'followers_url': 'https://api.github.com/users/facebook-github-bot/followers', 'following_url': 'https://api.github.com/users/facebook-github-bot/following{/other_user}', 'gists_url': 'https://api.github.com/users/facebook-github-bot/gists{/gist_id}', 'starred_url': 'https://api.github.com/users/facebook-github-bot/starred{/owner}{/repo}', 'subscriptions_url': 'https://api.github.com/users/facebook-github-bot/subscriptions', 'organizations_url': 'https://api.github.com/users/facebook-github-bot/orgs', 'repos_url': 'https://api.github.com/users/facebook-github-bot/repos', 'events_url': 'https://api.github.com/users/facebook-github-bot/events{/privacy}', 'received_events_url': 'https://api.github.com/users/facebook-github-bot/received_events', 'type': 'User', 'site_admin': False}",referenced,02c4cd3c8a3a4234ffbddde8d1214f0cfb209086,https://api.github.com/repos/pytorch/pytorch/commits/02c4cd3c8a3a4234ffbddde8d1214f0cfb209086,2018-09-12T21:59:15Z,4,4,0
11582,1851136286,"{'login': 'facebook-github-bot', 'id': 6422482, 'node_id': 'MDQ6VXNlcjY0MjI0ODI=', 'avatar_url': 'https://avatars3.githubusercontent.com/u/6422482?v=4', 'gravatar_id': '', 'url': 'https://api.github.com/users/facebook-github-bot', 'html_url': 'https://github.com/facebook-github-bot', 'followers_url': 'https://api.github.com/users/facebook-github-bot/followers', 'following_url': 'https://api.github.com/users/facebook-github-bot/following{/other_user}', 'gists_url': 'https://api.github.com/users/facebook-github-bot/gists{/gist_id}', 'starred_url': 'https://api.github.com/users/facebook-github-bot/starred{/owner}{/repo}', 'subscriptions_url': 'https://api.github.com/users/facebook-github-bot/subscriptions', 'organizations_url': 'https://api.github.com/users/facebook-github-bot/orgs', 'repos_url': 'https://api.github.com/users/facebook-github-bot/repos', 'events_url': 'https://api.github.com/users/facebook-github-bot/events{/privacy}', 'received_events_url': 'https://api.github.com/users/facebook-github-bot/received_events', 'type': 'User', 'site_admin': False}",closed,24a8c13f3620b6f2cdef16e8749b7e49b50de3ed,https://api.github.com/repos/pytorch/pytorch/commits/24a8c13f3620b6f2cdef16e8749b7e49b50de3ed,2018-09-18T00:33:00Z,10,6,4
11570,1866531518,"{'login': 'facebook-github-bot', 'id': 6422482, 'node_id': 'MDQ6VXNlcjY0MjI0ODI=', 'avatar_url': 'https://avatars3.githubusercontent.com/u/6422482?v=4', 'gravatar_id': '', 'url': 'https://api.github.com/users/facebook-github-bot', 'html_url': 'https://github.com/facebook-github-bot', 'followers_url': 'https://api.github.com/users/facebook-github-bot/followers', 'following_url': 'https://api.github.com/users/facebook-github-bot/following{/other_user}', 'gists_url': 'https://api.github.com/users/facebook-github-bot/gists{/gist_id}', 'starred_url': 'https://api.github.com/users/facebook-github-bot/starred{/owner}{/repo}', 'subscriptions_url': 'https://api.github.com/users/facebook-github-bot/subscriptions', 'organizations_url': 'https://api.github.com/users/facebook-github-bot/orgs', 'repos_url': 'https://api.github.com/users/facebook-github-bot/repos', 'events_url': 'https://api.github.com/users/facebook-github-bot/events{/privacy}', 'received_events_url': 'https://api.github.com/users/facebook-github-bot/received_events', 'type': 'User', 'site_admin': False}",referenced,94c513cc7f27d98ec6b5dead0af7fabcf5c5cd13,https://api.github.com/repos/pytorch/pytorch/commits/94c513cc7f27d98ec6b5dead0af7fabcf5c5cd13,2018-09-25T18:27:35Z,4,3,1
11535,1839958525,"{'login': 'facebook-github-bot', 'id': 6422482, 'node_id': 'MDQ6VXNlcjY0MjI0ODI=', 'avatar_url': 'https://avatars3.githubusercontent.com/u/6422482?v=4', 'gravatar_id': '', 'url': 'https://api.github.com/users/facebook-github-bot', 'html_url': 'https://github.com/facebook-github-bot', 'followers_url': 'https://api.github.com/users/facebook-github-bot/followers', 'following_url': 'https://api.github.com/users/facebook-github-bot/following{/other_user}', 'gists_url': 'https://api.github.com/users/facebook-github-bot/gists{/gist_id}', 'starred_url': 'https://api.github.com/users/facebook-github-bot/starred{/owner}{/repo}', 'subscriptions_url': 'https://api.github.com/users/facebook-github-bot/subscriptions', 'organizations_url': 'https://api.github.com/users/facebook-github-bot/orgs', 'repos_url': 'https://api.github.com/users/facebook-github-bot/repos', 'events_url': 'https://api.github.com/users/facebook-github-bot/events{/privacy}', 'received_events_url': 'https://api.github.com/users/facebook-github-bot/received_events', 'type': 'User', 'site_admin': False}",referenced,bbf54ea37cc063503d6e30ffe2124031f3c87f59,https://api.github.com/repos/pytorch/pytorch/commits/bbf54ea37cc063503d6e30ffe2124031f3c87f59,2018-09-12T01:27:33Z,21,10,11
11518,1858181217,"{'login': 'facebook-github-bot', 'id': 6422482, 'node_id': 'MDQ6VXNlcjY0MjI0ODI=', 'avatar_url': 'https://avatars3.githubusercontent.com/u/6422482?v=4', 'gravatar_id': '', 'url': 'https://api.github.com/users/facebook-github-bot', 'html_url': 'https://github.com/facebook-github-bot', 'followers_url': 'https://api.github.com/users/facebook-github-bot/followers', 'following_url': 'https://api.github.com/users/facebook-github-bot/following{/other_user}', 'gists_url': 'https://api.github.com/users/facebook-github-bot/gists{/gist_id}', 'starred_url': 'https://api.github.com/users/facebook-github-bot/starred{/owner}{/repo}', 'subscriptions_url': 'https://api.github.com/users/facebook-github-bot/subscriptions', 'organizations_url': 'https://api.github.com/users/facebook-github-bot/orgs', 'repos_url': 'https://api.github.com/users/facebook-github-bot/repos', 'events_url': 'https://api.github.com/users/facebook-github-bot/events{/privacy}', 'received_events_url': 'https://api.github.com/users/facebook-github-bot/received_events', 'type': 'User', 'site_admin': False}",closed,09273868903b0b657250bcdd9555aaa49506017f,https://api.github.com/repos/pytorch/pytorch/commits/09273868903b0b657250bcdd9555aaa49506017f,2018-09-20T16:27:18Z,3,3,0
11504,1839928719,"{'login': 'facebook-github-bot', 'id': 6422482, 'node_id': 'MDQ6VXNlcjY0MjI0ODI=', 'avatar_url': 'https://avatars3.githubusercontent.com/u/6422482?v=4', 'gravatar_id': '', 'url': 'https://api.github.com/users/facebook-github-bot', 'html_url': 'https://github.com/facebook-github-bot', 'followers_url': 'https://api.github.com/users/facebook-github-bot/followers', 'following_url': 'https://api.github.com/users/facebook-github-bot/following{/other_user}', 'gists_url': 'https://api.github.com/users/facebook-github-bot/gists{/gist_id}', 'starred_url': 'https://api.github.com/users/facebook-github-bot/starred{/owner}{/repo}', 'subscriptions_url': 'https://api.github.com/users/facebook-github-bot/subscriptions', 'organizations_url': 'https://api.github.com/users/facebook-github-bot/orgs', 'repos_url': 'https://api.github.com/users/facebook-github-bot/repos', 'events_url': 'https://api.github.com/users/facebook-github-bot/events{/privacy}', 'received_events_url': 'https://api.github.com/users/facebook-github-bot/received_events', 'type': 'User', 'site_admin': False}",closed,8b196d671b1a2be26fd6fe73f55aa45fb8a91e1e,https://api.github.com/repos/pytorch/pytorch/commits/8b196d671b1a2be26fd6fe73f55aa45fb8a91e1e,2018-09-12T00:58:01Z,54,44,10
11476,1908162656,"{'login': 'facebook-github-bot', 'id': 6422482, 'node_id': 'MDQ6VXNlcjY0MjI0ODI=', 'avatar_url': 'https://avatars3.githubusercontent.com/u/6422482?v=4', 'gravatar_id': '', 'url': 'https://api.github.com/users/facebook-github-bot', 'html_url': 'https://github.com/facebook-github-bot', 'followers_url': 'https://api.github.com/users/facebook-github-bot/followers', 'following_url': 'https://api.github.com/users/facebook-github-bot/following{/other_user}', 'gists_url': 'https://api.github.com/users/facebook-github-bot/gists{/gist_id}', 'starred_url': 'https://api.github.com/users/facebook-github-bot/starred{/owner}{/repo}', 'subscriptions_url': 'https://api.github.com/users/facebook-github-bot/subscriptions', 'organizations_url': 'https://api.github.com/users/facebook-github-bot/orgs', 'repos_url': 'https://api.github.com/users/facebook-github-bot/repos', 'events_url': 'https://api.github.com/users/facebook-github-bot/events{/privacy}', 'received_events_url': 'https://api.github.com/users/facebook-github-bot/received_events', 'type': 'User', 'site_admin': False}",closed,ac994f2c788a8e02fe7756a91a2d0bc292f32b36,https://api.github.com/repos/pytorch/pytorch/commits/ac994f2c788a8e02fe7756a91a2d0bc292f32b36,2018-10-16T23:03:26Z,86,77,9
11453,1839099944,"{'login': 'facebook-github-bot', 'id': 6422482, 'node_id': 'MDQ6VXNlcjY0MjI0ODI=', 'avatar_url': 'https://avatars3.githubusercontent.com/u/6422482?v=4', 'gravatar_id': '', 'url': 'https://api.github.com/users/facebook-github-bot', 'html_url': 'https://github.com/facebook-github-bot', 'followers_url': 'https://api.github.com/users/facebook-github-bot/followers', 'following_url': 'https://api.github.com/users/facebook-github-bot/following{/other_user}', 'gists_url': 'https://api.github.com/users/facebook-github-bot/gists{/gist_id}', 'starred_url': 'https://api.github.com/users/facebook-github-bot/starred{/owner}{/repo}', 'subscriptions_url': 'https://api.github.com/users/facebook-github-bot/subscriptions', 'organizations_url': 'https://api.github.com/users/facebook-github-bot/orgs', 'repos_url': 'https://api.github.com/users/facebook-github-bot/repos', 'events_url': 'https://api.github.com/users/facebook-github-bot/events{/privacy}', 'received_events_url': 'https://api.github.com/users/facebook-github-bot/received_events', 'type': 'User', 'site_admin': False}",referenced,d32b41003aa5d0ec10aa72be126ad9c136b50111,https://api.github.com/repos/pytorch/pytorch/commits/d32b41003aa5d0ec10aa72be126ad9c136b50111,2018-09-11T17:11:21Z,22,13,9
11452,1847265819,"{'login': 'facebook-github-bot', 'id': 6422482, 'node_id': 'MDQ6VXNlcjY0MjI0ODI=', 'avatar_url': 'https://avatars3.githubusercontent.com/u/6422482?v=4', 'gravatar_id': '', 'url': 'https://api.github.com/users/facebook-github-bot', 'html_url': 'https://github.com/facebook-github-bot', 'followers_url': 'https://api.github.com/users/facebook-github-bot/followers', 'following_url': 'https://api.github.com/users/facebook-github-bot/following{/other_user}', 'gists_url': 'https://api.github.com/users/facebook-github-bot/gists{/gist_id}', 'starred_url': 'https://api.github.com/users/facebook-github-bot/starred{/owner}{/repo}', 'subscriptions_url': 'https://api.github.com/users/facebook-github-bot/subscriptions', 'organizations_url': 'https://api.github.com/users/facebook-github-bot/orgs', 'repos_url': 'https://api.github.com/users/facebook-github-bot/repos', 'events_url': 'https://api.github.com/users/facebook-github-bot/events{/privacy}', 'received_events_url': 'https://api.github.com/users/facebook-github-bot/received_events', 'type': 'User', 'site_admin': False}",closed,f09054f8d09cca58e3ef63568b18977e66ca56a6,https://api.github.com/repos/pytorch/pytorch/commits/f09054f8d09cca58e3ef63568b18977e66ca56a6,2018-09-15T00:55:51Z,5,2,3
11430,1846499387,"{'login': 'facebook-github-bot', 'id': 6422482, 'node_id': 'MDQ6VXNlcjY0MjI0ODI=', 'avatar_url': 'https://avatars3.githubusercontent.com/u/6422482?v=4', 'gravatar_id': '', 'url': 'https://api.github.com/users/facebook-github-bot', 'html_url': 'https://github.com/facebook-github-bot', 'followers_url': 'https://api.github.com/users/facebook-github-bot/followers', 'following_url': 'https://api.github.com/users/facebook-github-bot/following{/other_user}', 'gists_url': 'https://api.github.com/users/facebook-github-bot/gists{/gist_id}', 'starred_url': 'https://api.github.com/users/facebook-github-bot/starred{/owner}{/repo}', 'subscriptions_url': 'https://api.github.com/users/facebook-github-bot/subscriptions', 'organizations_url': 'https://api.github.com/users/facebook-github-bot/orgs', 'repos_url': 'https://api.github.com/users/facebook-github-bot/repos', 'events_url': 'https://api.github.com/users/facebook-github-bot/events{/privacy}', 'received_events_url': 'https://api.github.com/users/facebook-github-bot/received_events', 'type': 'User', 'site_admin': False}",closed,72822ee6b251118aefbe9af75ac0fcb4ee56a0ee,https://api.github.com/repos/pytorch/pytorch/commits/72822ee6b251118aefbe9af75ac0fcb4ee56a0ee,2018-09-14T16:11:26Z,69,50,19
11427,1850070424,"{'login': 'facebook-github-bot', 'id': 6422482, 'node_id': 'MDQ6VXNlcjY0MjI0ODI=', 'avatar_url': 'https://avatars3.githubusercontent.com/u/6422482?v=4', 'gravatar_id': '', 'url': 'https://api.github.com/users/facebook-github-bot', 'html_url': 'https://github.com/facebook-github-bot', 'followers_url': 'https://api.github.com/users/facebook-github-bot/followers', 'following_url': 'https://api.github.com/users/facebook-github-bot/following{/other_user}', 'gists_url': 'https://api.github.com/users/facebook-github-bot/gists{/gist_id}', 'starred_url': 'https://api.github.com/users/facebook-github-bot/starred{/owner}{/repo}', 'subscriptions_url': 'https://api.github.com/users/facebook-github-bot/subscriptions', 'organizations_url': 'https://api.github.com/users/facebook-github-bot/orgs', 'repos_url': 'https://api.github.com/users/facebook-github-bot/repos', 'events_url': 'https://api.github.com/users/facebook-github-bot/events{/privacy}', 'received_events_url': 'https://api.github.com/users/facebook-github-bot/received_events', 'type': 'User', 'site_admin': False}",closed,a8b1755de6c967bd8e9d777b6a0dddf4e7a6eed1,https://api.github.com/repos/pytorch/pytorch/commits/a8b1755de6c967bd8e9d777b6a0dddf4e7a6eed1,2018-09-17T15:25:42Z,131,118,13
11422,2007986794,"{'login': 'facebook-github-bot', 'id': 6422482, 'node_id': 'MDQ6VXNlcjY0MjI0ODI=', 'avatar_url': 'https://avatars3.githubusercontent.com/u/6422482?v=4', 'gravatar_id': '', 'url': 'https://api.github.com/users/facebook-github-bot', 'html_url': 'https://github.com/facebook-github-bot', 'followers_url': 'https://api.github.com/users/facebook-github-bot/followers', 'following_url': 'https://api.github.com/users/facebook-github-bot/following{/other_user}', 'gists_url': 'https://api.github.com/users/facebook-github-bot/gists{/gist_id}', 'starred_url': 'https://api.github.com/users/facebook-github-bot/starred{/owner}{/repo}', 'subscriptions_url': 'https://api.github.com/users/facebook-github-bot/subscriptions', 'organizations_url': 'https://api.github.com/users/facebook-github-bot/orgs', 'repos_url': 'https://api.github.com/users/facebook-github-bot/repos', 'events_url': 'https://api.github.com/users/facebook-github-bot/events{/privacy}', 'received_events_url': 'https://api.github.com/users/facebook-github-bot/received_events', 'type': 'User', 'site_admin': False}",closed,be47470c91e467d8bddbc0e07f099cf2a200e5c0,https://api.github.com/repos/pytorch/pytorch/commits/be47470c91e467d8bddbc0e07f099cf2a200e5c0,2018-12-05T18:57:31Z,277,222,55
11419,1839429155,"{'login': 'facebook-github-bot', 'id': 6422482, 'node_id': 'MDQ6VXNlcjY0MjI0ODI=', 'avatar_url': 'https://avatars3.githubusercontent.com/u/6422482?v=4', 'gravatar_id': '', 'url': 'https://api.github.com/users/facebook-github-bot', 'html_url': 'https://github.com/facebook-github-bot', 'followers_url': 'https://api.github.com/users/facebook-github-bot/followers', 'following_url': 'https://api.github.com/users/facebook-github-bot/following{/other_user}', 'gists_url': 'https://api.github.com/users/facebook-github-bot/gists{/gist_id}', 'starred_url': 'https://api.github.com/users/facebook-github-bot/starred{/owner}{/repo}', 'subscriptions_url': 'https://api.github.com/users/facebook-github-bot/subscriptions', 'organizations_url': 'https://api.github.com/users/facebook-github-bot/orgs', 'repos_url': 'https://api.github.com/users/facebook-github-bot/repos', 'events_url': 'https://api.github.com/users/facebook-github-bot/events{/privacy}', 'received_events_url': 'https://api.github.com/users/facebook-github-bot/received_events', 'type': 'User', 'site_admin': False}",closed,fbc17321fdd96ce4dcc275ff61264d04f2fbd6e2,https://api.github.com/repos/pytorch/pytorch/commits/fbc17321fdd96ce4dcc275ff61264d04f2fbd6e2,2018-09-11T19:41:02Z,2,1,1
11398,1858848180,"{'login': 'facebook-github-bot', 'id': 6422482, 'node_id': 'MDQ6VXNlcjY0MjI0ODI=', 'avatar_url': 'https://avatars3.githubusercontent.com/u/6422482?v=4', 'gravatar_id': '', 'url': 'https://api.github.com/users/facebook-github-bot', 'html_url': 'https://github.com/facebook-github-bot', 'followers_url': 'https://api.github.com/users/facebook-github-bot/followers', 'following_url': 'https://api.github.com/users/facebook-github-bot/following{/other_user}', 'gists_url': 'https://api.github.com/users/facebook-github-bot/gists{/gist_id}', 'starred_url': 'https://api.github.com/users/facebook-github-bot/starred{/owner}{/repo}', 'subscriptions_url': 'https://api.github.com/users/facebook-github-bot/subscriptions', 'organizations_url': 'https://api.github.com/users/facebook-github-bot/orgs', 'repos_url': 'https://api.github.com/users/facebook-github-bot/repos', 'events_url': 'https://api.github.com/users/facebook-github-bot/events{/privacy}', 'received_events_url': 'https://api.github.com/users/facebook-github-bot/received_events', 'type': 'User', 'site_admin': False}",closed,6100c0ea14306f409bc6d7ba46b149c64a2417b3,https://api.github.com/repos/pytorch/pytorch/commits/6100c0ea14306f409bc6d7ba46b149c64a2417b3,2018-09-20T21:44:31Z,269,204,65
11362,1866392600,"{'login': 'facebook-github-bot', 'id': 6422482, 'node_id': 'MDQ6VXNlcjY0MjI0ODI=', 'avatar_url': 'https://avatars3.githubusercontent.com/u/6422482?v=4', 'gravatar_id': '', 'url': 'https://api.github.com/users/facebook-github-bot', 'html_url': 'https://github.com/facebook-github-bot', 'followers_url': 'https://api.github.com/users/facebook-github-bot/followers', 'following_url': 'https://api.github.com/users/facebook-github-bot/following{/other_user}', 'gists_url': 'https://api.github.com/users/facebook-github-bot/gists{/gist_id}', 'starred_url': 'https://api.github.com/users/facebook-github-bot/starred{/owner}{/repo}', 'subscriptions_url': 'https://api.github.com/users/facebook-github-bot/subscriptions', 'organizations_url': 'https://api.github.com/users/facebook-github-bot/orgs', 'repos_url': 'https://api.github.com/users/facebook-github-bot/repos', 'events_url': 'https://api.github.com/users/facebook-github-bot/events{/privacy}', 'received_events_url': 'https://api.github.com/users/facebook-github-bot/received_events', 'type': 'User', 'site_admin': False}",closed,7122f8b3bb7f7287cf0410a5ced2c5b120d15d30,https://api.github.com/repos/pytorch/pytorch/commits/7122f8b3bb7f7287cf0410a5ced2c5b120d15d30,2018-09-25T17:26:58Z,12,12,0
11360,1831929264,"{'login': 'facebook-github-bot', 'id': 6422482, 'node_id': 'MDQ6VXNlcjY0MjI0ODI=', 'avatar_url': 'https://avatars3.githubusercontent.com/u/6422482?v=4', 'gravatar_id': '', 'url': 'https://api.github.com/users/facebook-github-bot', 'html_url': 'https://github.com/facebook-github-bot', 'followers_url': 'https://api.github.com/users/facebook-github-bot/followers', 'following_url': 'https://api.github.com/users/facebook-github-bot/following{/other_user}', 'gists_url': 'https://api.github.com/users/facebook-github-bot/gists{/gist_id}', 'starred_url': 'https://api.github.com/users/facebook-github-bot/starred{/owner}{/repo}', 'subscriptions_url': 'https://api.github.com/users/facebook-github-bot/subscriptions', 'organizations_url': 'https://api.github.com/users/facebook-github-bot/orgs', 'repos_url': 'https://api.github.com/users/facebook-github-bot/repos', 'events_url': 'https://api.github.com/users/facebook-github-bot/events{/privacy}', 'received_events_url': 'https://api.github.com/users/facebook-github-bot/received_events', 'type': 'User', 'site_admin': False}",referenced,2946b021e38dd4cd4d6465b5aa4a8efbb160c2e5,https://api.github.com/repos/pytorch/pytorch/commits/2946b021e38dd4cd4d6465b5aa4a8efbb160c2e5,2018-09-07T03:41:12Z,1,1,0
11339,2039351888,"{'login': 'facebook-github-bot', 'id': 6422482, 'node_id': 'MDQ6VXNlcjY0MjI0ODI=', 'avatar_url': 'https://avatars3.githubusercontent.com/u/6422482?v=4', 'gravatar_id': '', 'url': 'https://api.github.com/users/facebook-github-bot', 'html_url': 'https://github.com/facebook-github-bot', 'followers_url': 'https://api.github.com/users/facebook-github-bot/followers', 'following_url': 'https://api.github.com/users/facebook-github-bot/following{/other_user}', 'gists_url': 'https://api.github.com/users/facebook-github-bot/gists{/gist_id}', 'starred_url': 'https://api.github.com/users/facebook-github-bot/starred{/owner}{/repo}', 'subscriptions_url': 'https://api.github.com/users/facebook-github-bot/subscriptions', 'organizations_url': 'https://api.github.com/users/facebook-github-bot/orgs', 'repos_url': 'https://api.github.com/users/facebook-github-bot/repos', 'events_url': 'https://api.github.com/users/facebook-github-bot/events{/privacy}', 'received_events_url': 'https://api.github.com/users/facebook-github-bot/received_events', 'type': 'User', 'site_admin': False}",referenced,f0f9277c3cda0b022af0dfaf21d043641bea80d2,https://api.github.com/repos/pytorch/pytorch/commits/f0f9277c3cda0b022af0dfaf21d043641bea80d2,2018-12-20T20:38:45Z,143,112,31
11339,2053034251,"{'login': 'facebook-github-bot', 'id': 6422482, 'node_id': 'MDQ6VXNlcjY0MjI0ODI=', 'avatar_url': 'https://avatars3.githubusercontent.com/u/6422482?v=4', 'gravatar_id': '', 'url': 'https://api.github.com/users/facebook-github-bot', 'html_url': 'https://github.com/facebook-github-bot', 'followers_url': 'https://api.github.com/users/facebook-github-bot/followers', 'following_url': 'https://api.github.com/users/facebook-github-bot/following{/other_user}', 'gists_url': 'https://api.github.com/users/facebook-github-bot/gists{/gist_id}', 'starred_url': 'https://api.github.com/users/facebook-github-bot/starred{/owner}{/repo}', 'subscriptions_url': 'https://api.github.com/users/facebook-github-bot/subscriptions', 'organizations_url': 'https://api.github.com/users/facebook-github-bot/orgs', 'repos_url': 'https://api.github.com/users/facebook-github-bot/repos', 'events_url': 'https://api.github.com/users/facebook-github-bot/events{/privacy}', 'received_events_url': 'https://api.github.com/users/facebook-github-bot/received_events', 'type': 'User', 'site_admin': False}",referenced,947229ebd780b0ecead66029691fd18881947b59,https://api.github.com/repos/pytorch/pytorch/commits/947229ebd780b0ecead66029691fd18881947b59,2019-01-03T18:36:57Z,173,133,40
11326,1910251961,"{'login': 'facebook-github-bot', 'id': 6422482, 'node_id': 'MDQ6VXNlcjY0MjI0ODI=', 'avatar_url': 'https://avatars3.githubusercontent.com/u/6422482?v=4', 'gravatar_id': '', 'url': 'https://api.github.com/users/facebook-github-bot', 'html_url': 'https://github.com/facebook-github-bot', 'followers_url': 'https://api.github.com/users/facebook-github-bot/followers', 'following_url': 'https://api.github.com/users/facebook-github-bot/following{/other_user}', 'gists_url': 'https://api.github.com/users/facebook-github-bot/gists{/gist_id}', 'starred_url': 'https://api.github.com/users/facebook-github-bot/starred{/owner}{/repo}', 'subscriptions_url': 'https://api.github.com/users/facebook-github-bot/subscriptions', 'organizations_url': 'https://api.github.com/users/facebook-github-bot/orgs', 'repos_url': 'https://api.github.com/users/facebook-github-bot/repos', 'events_url': 'https://api.github.com/users/facebook-github-bot/events{/privacy}', 'received_events_url': 'https://api.github.com/users/facebook-github-bot/received_events', 'type': 'User', 'site_admin': False}",referenced,9a76e84a08cbbec0c8be4984ee5931b048bd6756,https://api.github.com/repos/pytorch/pytorch/commits/9a76e84a08cbbec0c8be4984ee5931b048bd6756,2018-10-17T17:43:56Z,19,18,1
11206,1826620173,"{'login': 'facebook-github-bot', 'id': 6422482, 'node_id': 'MDQ6VXNlcjY0MjI0ODI=', 'avatar_url': 'https://avatars3.githubusercontent.com/u/6422482?v=4', 'gravatar_id': '', 'url': 'https://api.github.com/users/facebook-github-bot', 'html_url': 'https://github.com/facebook-github-bot', 'followers_url': 'https://api.github.com/users/facebook-github-bot/followers', 'following_url': 'https://api.github.com/users/facebook-github-bot/following{/other_user}', 'gists_url': 'https://api.github.com/users/facebook-github-bot/gists{/gist_id}', 'starred_url': 'https://api.github.com/users/facebook-github-bot/starred{/owner}{/repo}', 'subscriptions_url': 'https://api.github.com/users/facebook-github-bot/subscriptions', 'organizations_url': 'https://api.github.com/users/facebook-github-bot/orgs', 'repos_url': 'https://api.github.com/users/facebook-github-bot/repos', 'events_url': 'https://api.github.com/users/facebook-github-bot/events{/privacy}', 'received_events_url': 'https://api.github.com/users/facebook-github-bot/received_events', 'type': 'User', 'site_admin': False}",closed,313e89d8db87cadaa13a1d28c797610e2f56d10a,https://api.github.com/repos/pytorch/pytorch/commits/313e89d8db87cadaa13a1d28c797610e2f56d10a,2018-09-05T00:29:11Z,14,12,2
11204,1834666026,"{'login': 'facebook-github-bot', 'id': 6422482, 'node_id': 'MDQ6VXNlcjY0MjI0ODI=', 'avatar_url': 'https://avatars3.githubusercontent.com/u/6422482?v=4', 'gravatar_id': '', 'url': 'https://api.github.com/users/facebook-github-bot', 'html_url': 'https://github.com/facebook-github-bot', 'followers_url': 'https://api.github.com/users/facebook-github-bot/followers', 'following_url': 'https://api.github.com/users/facebook-github-bot/following{/other_user}', 'gists_url': 'https://api.github.com/users/facebook-github-bot/gists{/gist_id}', 'starred_url': 'https://api.github.com/users/facebook-github-bot/starred{/owner}{/repo}', 'subscriptions_url': 'https://api.github.com/users/facebook-github-bot/subscriptions', 'organizations_url': 'https://api.github.com/users/facebook-github-bot/orgs', 'repos_url': 'https://api.github.com/users/facebook-github-bot/repos', 'events_url': 'https://api.github.com/users/facebook-github-bot/events{/privacy}', 'received_events_url': 'https://api.github.com/users/facebook-github-bot/received_events', 'type': 'User', 'site_admin': False}",closed,581099a7b22027a43ca0c7b443a2d70ca70ee05d,https://api.github.com/repos/pytorch/pytorch/commits/581099a7b22027a43ca0c7b443a2d70ca70ee05d,2018-09-09T17:40:56Z,258,160,98
11195,1840112994,"{'login': 'facebook-github-bot', 'id': 6422482, 'node_id': 'MDQ6VXNlcjY0MjI0ODI=', 'avatar_url': 'https://avatars3.githubusercontent.com/u/6422482?v=4', 'gravatar_id': '', 'url': 'https://api.github.com/users/facebook-github-bot', 'html_url': 'https://github.com/facebook-github-bot', 'followers_url': 'https://api.github.com/users/facebook-github-bot/followers', 'following_url': 'https://api.github.com/users/facebook-github-bot/following{/other_user}', 'gists_url': 'https://api.github.com/users/facebook-github-bot/gists{/gist_id}', 'starred_url': 'https://api.github.com/users/facebook-github-bot/starred{/owner}{/repo}', 'subscriptions_url': 'https://api.github.com/users/facebook-github-bot/subscriptions', 'organizations_url': 'https://api.github.com/users/facebook-github-bot/orgs', 'repos_url': 'https://api.github.com/users/facebook-github-bot/repos', 'events_url': 'https://api.github.com/users/facebook-github-bot/events{/privacy}', 'received_events_url': 'https://api.github.com/users/facebook-github-bot/received_events', 'type': 'User', 'site_admin': False}",closed,a11ebfa195db22268e9db562a6295752f55bec4a,https://api.github.com/repos/pytorch/pytorch/commits/a11ebfa195db22268e9db562a6295752f55bec4a,2018-09-12T04:11:02Z,2,1,1
11186,2223797864,"{'login': 'facebook-github-bot', 'id': 6422482, 'node_id': 'MDQ6VXNlcjY0MjI0ODI=', 'avatar_url': 'https://avatars3.githubusercontent.com/u/6422482?v=4', 'gravatar_id': '', 'url': 'https://api.github.com/users/facebook-github-bot', 'html_url': 'https://github.com/facebook-github-bot', 'followers_url': 'https://api.github.com/users/facebook-github-bot/followers', 'following_url': 'https://api.github.com/users/facebook-github-bot/following{/other_user}', 'gists_url': 'https://api.github.com/users/facebook-github-bot/gists{/gist_id}', 'starred_url': 'https://api.github.com/users/facebook-github-bot/starred{/owner}{/repo}', 'subscriptions_url': 'https://api.github.com/users/facebook-github-bot/subscriptions', 'organizations_url': 'https://api.github.com/users/facebook-github-bot/orgs', 'repos_url': 'https://api.github.com/users/facebook-github-bot/repos', 'events_url': 'https://api.github.com/users/facebook-github-bot/events{/privacy}', 'received_events_url': 'https://api.github.com/users/facebook-github-bot/received_events', 'type': 'User', 'site_admin': False}",referenced,ed47b85d3bd9c33ed723d2ae5309bebb4d619ac6,https://api.github.com/repos/pytorch/pytorch/commits/ed47b85d3bd9c33ed723d2ae5309bebb4d619ac6,2019-03-22T20:54:23Z,125,93,32
11157,1838477773,"{'login': 'facebook-github-bot', 'id': 6422482, 'node_id': 'MDQ6VXNlcjY0MjI0ODI=', 'avatar_url': 'https://avatars3.githubusercontent.com/u/6422482?v=4', 'gravatar_id': '', 'url': 'https://api.github.com/users/facebook-github-bot', 'html_url': 'https://github.com/facebook-github-bot', 'followers_url': 'https://api.github.com/users/facebook-github-bot/followers', 'following_url': 'https://api.github.com/users/facebook-github-bot/following{/other_user}', 'gists_url': 'https://api.github.com/users/facebook-github-bot/gists{/gist_id}', 'starred_url': 'https://api.github.com/users/facebook-github-bot/starred{/owner}{/repo}', 'subscriptions_url': 'https://api.github.com/users/facebook-github-bot/subscriptions', 'organizations_url': 'https://api.github.com/users/facebook-github-bot/orgs', 'repos_url': 'https://api.github.com/users/facebook-github-bot/repos', 'events_url': 'https://api.github.com/users/facebook-github-bot/events{/privacy}', 'received_events_url': 'https://api.github.com/users/facebook-github-bot/received_events', 'type': 'User', 'site_admin': False}",closed,120d7694327dafcfca5fa4447f438772c9b1c729,https://api.github.com/repos/pytorch/pytorch/commits/120d7694327dafcfca5fa4447f438772c9b1c729,2018-09-11T13:04:04Z,45,31,14
11118,1850801650,"{'login': 'facebook-github-bot', 'id': 6422482, 'node_id': 'MDQ6VXNlcjY0MjI0ODI=', 'avatar_url': 'https://avatars3.githubusercontent.com/u/6422482?v=4', 'gravatar_id': '', 'url': 'https://api.github.com/users/facebook-github-bot', 'html_url': 'https://github.com/facebook-github-bot', 'followers_url': 'https://api.github.com/users/facebook-github-bot/followers', 'following_url': 'https://api.github.com/users/facebook-github-bot/following{/other_user}', 'gists_url': 'https://api.github.com/users/facebook-github-bot/gists{/gist_id}', 'starred_url': 'https://api.github.com/users/facebook-github-bot/starred{/owner}{/repo}', 'subscriptions_url': 'https://api.github.com/users/facebook-github-bot/subscriptions', 'organizations_url': 'https://api.github.com/users/facebook-github-bot/orgs', 'repos_url': 'https://api.github.com/users/facebook-github-bot/repos', 'events_url': 'https://api.github.com/users/facebook-github-bot/events{/privacy}', 'received_events_url': 'https://api.github.com/users/facebook-github-bot/received_events', 'type': 'User', 'site_admin': False}",referenced,336323f53c21fb68c884fd071825ac31914300a0,https://api.github.com/repos/pytorch/pytorch/commits/336323f53c21fb68c884fd071825ac31914300a0,2018-09-17T20:42:37Z,34,33,1
11118,1858848165,"{'login': 'facebook-github-bot', 'id': 6422482, 'node_id': 'MDQ6VXNlcjY0MjI0ODI=', 'avatar_url': 'https://avatars3.githubusercontent.com/u/6422482?v=4', 'gravatar_id': '', 'url': 'https://api.github.com/users/facebook-github-bot', 'html_url': 'https://github.com/facebook-github-bot', 'followers_url': 'https://api.github.com/users/facebook-github-bot/followers', 'following_url': 'https://api.github.com/users/facebook-github-bot/following{/other_user}', 'gists_url': 'https://api.github.com/users/facebook-github-bot/gists{/gist_id}', 'starred_url': 'https://api.github.com/users/facebook-github-bot/starred{/owner}{/repo}', 'subscriptions_url': 'https://api.github.com/users/facebook-github-bot/subscriptions', 'organizations_url': 'https://api.github.com/users/facebook-github-bot/orgs', 'repos_url': 'https://api.github.com/users/facebook-github-bot/repos', 'events_url': 'https://api.github.com/users/facebook-github-bot/events{/privacy}', 'received_events_url': 'https://api.github.com/users/facebook-github-bot/received_events', 'type': 'User', 'site_admin': False}",referenced,068eac255b088c55cfdff55e73d7d24517c5e801,https://api.github.com/repos/pytorch/pytorch/commits/068eac255b088c55cfdff55e73d7d24517c5e801,2018-09-20T21:44:31Z,64,61,3
11108,1822403396,"{'login': 'facebook-github-bot', 'id': 6422482, 'node_id': 'MDQ6VXNlcjY0MjI0ODI=', 'avatar_url': 'https://avatars3.githubusercontent.com/u/6422482?v=4', 'gravatar_id': '', 'url': 'https://api.github.com/users/facebook-github-bot', 'html_url': 'https://github.com/facebook-github-bot', 'followers_url': 'https://api.github.com/users/facebook-github-bot/followers', 'following_url': 'https://api.github.com/users/facebook-github-bot/following{/other_user}', 'gists_url': 'https://api.github.com/users/facebook-github-bot/gists{/gist_id}', 'starred_url': 'https://api.github.com/users/facebook-github-bot/starred{/owner}{/repo}', 'subscriptions_url': 'https://api.github.com/users/facebook-github-bot/subscriptions', 'organizations_url': 'https://api.github.com/users/facebook-github-bot/orgs', 'repos_url': 'https://api.github.com/users/facebook-github-bot/repos', 'events_url': 'https://api.github.com/users/facebook-github-bot/events{/privacy}', 'received_events_url': 'https://api.github.com/users/facebook-github-bot/received_events', 'type': 'User', 'site_admin': False}",closed,e1a17d5a42485810dcc2e92f1424e7204287d780,https://api.github.com/repos/pytorch/pytorch/commits/e1a17d5a42485810dcc2e92f1424e7204287d780,2018-09-02T21:40:52Z,82,41,41
11093,2006018670,"{'login': 'facebook-github-bot', 'id': 6422482, 'node_id': 'MDQ6VXNlcjY0MjI0ODI=', 'avatar_url': 'https://avatars3.githubusercontent.com/u/6422482?v=4', 'gravatar_id': '', 'url': 'https://api.github.com/users/facebook-github-bot', 'html_url': 'https://github.com/facebook-github-bot', 'followers_url': 'https://api.github.com/users/facebook-github-bot/followers', 'following_url': 'https://api.github.com/users/facebook-github-bot/following{/other_user}', 'gists_url': 'https://api.github.com/users/facebook-github-bot/gists{/gist_id}', 'starred_url': 'https://api.github.com/users/facebook-github-bot/starred{/owner}{/repo}', 'subscriptions_url': 'https://api.github.com/users/facebook-github-bot/subscriptions', 'organizations_url': 'https://api.github.com/users/facebook-github-bot/orgs', 'repos_url': 'https://api.github.com/users/facebook-github-bot/repos', 'events_url': 'https://api.github.com/users/facebook-github-bot/events{/privacy}', 'received_events_url': 'https://api.github.com/users/facebook-github-bot/received_events', 'type': 'User', 'site_admin': False}",referenced,33ea7eafefb6a74d4d87b4e02f8d182640051ffc,https://api.github.com/repos/pytorch/pytorch/commits/33ea7eafefb6a74d4d87b4e02f8d182640051ffc,2018-12-05T02:49:14Z,147,96,51
11089,1863928058,"{'login': 'facebook-github-bot', 'id': 6422482, 'node_id': 'MDQ6VXNlcjY0MjI0ODI=', 'avatar_url': 'https://avatars3.githubusercontent.com/u/6422482?v=4', 'gravatar_id': '', 'url': 'https://api.github.com/users/facebook-github-bot', 'html_url': 'https://github.com/facebook-github-bot', 'followers_url': 'https://api.github.com/users/facebook-github-bot/followers', 'following_url': 'https://api.github.com/users/facebook-github-bot/following{/other_user}', 'gists_url': 'https://api.github.com/users/facebook-github-bot/gists{/gist_id}', 'starred_url': 'https://api.github.com/users/facebook-github-bot/starred{/owner}{/repo}', 'subscriptions_url': 'https://api.github.com/users/facebook-github-bot/subscriptions', 'organizations_url': 'https://api.github.com/users/facebook-github-bot/orgs', 'repos_url': 'https://api.github.com/users/facebook-github-bot/repos', 'events_url': 'https://api.github.com/users/facebook-github-bot/events{/privacy}', 'received_events_url': 'https://api.github.com/users/facebook-github-bot/received_events', 'type': 'User', 'site_admin': False}",referenced,ffbac7d0bb4e0772cab0054f79339478124ea9aa,https://api.github.com/repos/pytorch/pytorch/commits/ffbac7d0bb4e0772cab0054f79339478124ea9aa,2018-09-24T19:00:04Z,22,19,3
11084,1822127004,"{'login': 'facebook-github-bot', 'id': 6422482, 'node_id': 'MDQ6VXNlcjY0MjI0ODI=', 'avatar_url': 'https://avatars3.githubusercontent.com/u/6422482?v=4', 'gravatar_id': '', 'url': 'https://api.github.com/users/facebook-github-bot', 'html_url': 'https://github.com/facebook-github-bot', 'followers_url': 'https://api.github.com/users/facebook-github-bot/followers', 'following_url': 'https://api.github.com/users/facebook-github-bot/following{/other_user}', 'gists_url': 'https://api.github.com/users/facebook-github-bot/gists{/gist_id}', 'starred_url': 'https://api.github.com/users/facebook-github-bot/starred{/owner}{/repo}', 'subscriptions_url': 'https://api.github.com/users/facebook-github-bot/subscriptions', 'organizations_url': 'https://api.github.com/users/facebook-github-bot/orgs', 'repos_url': 'https://api.github.com/users/facebook-github-bot/repos', 'events_url': 'https://api.github.com/users/facebook-github-bot/events{/privacy}', 'received_events_url': 'https://api.github.com/users/facebook-github-bot/received_events', 'type': 'User', 'site_admin': False}",referenced,1350f76b628bd4630439223adbe21ee993873f44,https://api.github.com/repos/pytorch/pytorch/commits/1350f76b628bd4630439223adbe21ee993873f44,2018-09-02T06:10:31Z,99,85,14
11074,1839099945,"{'login': 'facebook-github-bot', 'id': 6422482, 'node_id': 'MDQ6VXNlcjY0MjI0ODI=', 'avatar_url': 'https://avatars3.githubusercontent.com/u/6422482?v=4', 'gravatar_id': '', 'url': 'https://api.github.com/users/facebook-github-bot', 'html_url': 'https://github.com/facebook-github-bot', 'followers_url': 'https://api.github.com/users/facebook-github-bot/followers', 'following_url': 'https://api.github.com/users/facebook-github-bot/following{/other_user}', 'gists_url': 'https://api.github.com/users/facebook-github-bot/gists{/gist_id}', 'starred_url': 'https://api.github.com/users/facebook-github-bot/starred{/owner}{/repo}', 'subscriptions_url': 'https://api.github.com/users/facebook-github-bot/subscriptions', 'organizations_url': 'https://api.github.com/users/facebook-github-bot/orgs', 'repos_url': 'https://api.github.com/users/facebook-github-bot/repos', 'events_url': 'https://api.github.com/users/facebook-github-bot/events{/privacy}', 'received_events_url': 'https://api.github.com/users/facebook-github-bot/received_events', 'type': 'User', 'site_admin': False}",referenced,d32b41003aa5d0ec10aa72be126ad9c136b50111,https://api.github.com/repos/pytorch/pytorch/commits/d32b41003aa5d0ec10aa72be126ad9c136b50111,2018-09-11T17:11:21Z,22,13,9
11057,1828523310,"{'login': 'facebook-github-bot', 'id': 6422482, 'node_id': 'MDQ6VXNlcjY0MjI0ODI=', 'avatar_url': 'https://avatars3.githubusercontent.com/u/6422482?v=4', 'gravatar_id': '', 'url': 'https://api.github.com/users/facebook-github-bot', 'html_url': 'https://github.com/facebook-github-bot', 'followers_url': 'https://api.github.com/users/facebook-github-bot/followers', 'following_url': 'https://api.github.com/users/facebook-github-bot/following{/other_user}', 'gists_url': 'https://api.github.com/users/facebook-github-bot/gists{/gist_id}', 'starred_url': 'https://api.github.com/users/facebook-github-bot/starred{/owner}{/repo}', 'subscriptions_url': 'https://api.github.com/users/facebook-github-bot/subscriptions', 'organizations_url': 'https://api.github.com/users/facebook-github-bot/orgs', 'repos_url': 'https://api.github.com/users/facebook-github-bot/repos', 'events_url': 'https://api.github.com/users/facebook-github-bot/events{/privacy}', 'received_events_url': 'https://api.github.com/users/facebook-github-bot/received_events', 'type': 'User', 'site_admin': False}",closed,55212507a24bc742c5e9c68f1b917e9cc6c32b0f,https://api.github.com/repos/pytorch/pytorch/commits/55212507a24bc742c5e9c68f1b917e9cc6c32b0f,2018-09-05T17:58:14Z,9,7,2
11033,1822386064,"{'login': 'facebook-github-bot', 'id': 6422482, 'node_id': 'MDQ6VXNlcjY0MjI0ODI=', 'avatar_url': 'https://avatars3.githubusercontent.com/u/6422482?v=4', 'gravatar_id': '', 'url': 'https://api.github.com/users/facebook-github-bot', 'html_url': 'https://github.com/facebook-github-bot', 'followers_url': 'https://api.github.com/users/facebook-github-bot/followers', 'following_url': 'https://api.github.com/users/facebook-github-bot/following{/other_user}', 'gists_url': 'https://api.github.com/users/facebook-github-bot/gists{/gist_id}', 'starred_url': 'https://api.github.com/users/facebook-github-bot/starred{/owner}{/repo}', 'subscriptions_url': 'https://api.github.com/users/facebook-github-bot/subscriptions', 'organizations_url': 'https://api.github.com/users/facebook-github-bot/orgs', 'repos_url': 'https://api.github.com/users/facebook-github-bot/repos', 'events_url': 'https://api.github.com/users/facebook-github-bot/events{/privacy}', 'received_events_url': 'https://api.github.com/users/facebook-github-bot/received_events', 'type': 'User', 'site_admin': False}",closed,cf10efb8d453e0cf69a64383d8ed4239f967860f,https://api.github.com/repos/pytorch/pytorch/commits/cf10efb8d453e0cf69a64383d8ed4239f967860f,2018-09-02T20:40:43Z,7,7,0
11030,2391256474,"{'login': 'facebook-github-bot', 'id': 6422482, 'node_id': 'MDQ6VXNlcjY0MjI0ODI=', 'avatar_url': 'https://avatars3.githubusercontent.com/u/6422482?v=4', 'gravatar_id': '', 'url': 'https://api.github.com/users/facebook-github-bot', 'html_url': 'https://github.com/facebook-github-bot', 'followers_url': 'https://api.github.com/users/facebook-github-bot/followers', 'following_url': 'https://api.github.com/users/facebook-github-bot/following{/other_user}', 'gists_url': 'https://api.github.com/users/facebook-github-bot/gists{/gist_id}', 'starred_url': 'https://api.github.com/users/facebook-github-bot/starred{/owner}{/repo}', 'subscriptions_url': 'https://api.github.com/users/facebook-github-bot/subscriptions', 'organizations_url': 'https://api.github.com/users/facebook-github-bot/orgs', 'repos_url': 'https://api.github.com/users/facebook-github-bot/repos', 'events_url': 'https://api.github.com/users/facebook-github-bot/events{/privacy}', 'received_events_url': 'https://api.github.com/users/facebook-github-bot/received_events', 'type': 'User', 'site_admin': False}",closed,6251c563eb1b02ea0ad76271e0f8a0e378348f00,https://api.github.com/repos/pytorch/pytorch/commits/6251c563eb1b02ea0ad76271e0f8a0e378348f00,2019-06-05T13:38:15Z,370,181,189
10882,2031472050,"{'login': 'facebook-github-bot', 'id': 6422482, 'node_id': 'MDQ6VXNlcjY0MjI0ODI=', 'avatar_url': 'https://avatars3.githubusercontent.com/u/6422482?v=4', 'gravatar_id': '', 'url': 'https://api.github.com/users/facebook-github-bot', 'html_url': 'https://github.com/facebook-github-bot', 'followers_url': 'https://api.github.com/users/facebook-github-bot/followers', 'following_url': 'https://api.github.com/users/facebook-github-bot/following{/other_user}', 'gists_url': 'https://api.github.com/users/facebook-github-bot/gists{/gist_id}', 'starred_url': 'https://api.github.com/users/facebook-github-bot/starred{/owner}{/repo}', 'subscriptions_url': 'https://api.github.com/users/facebook-github-bot/subscriptions', 'organizations_url': 'https://api.github.com/users/facebook-github-bot/orgs', 'repos_url': 'https://api.github.com/users/facebook-github-bot/repos', 'events_url': 'https://api.github.com/users/facebook-github-bot/events{/privacy}', 'received_events_url': 'https://api.github.com/users/facebook-github-bot/received_events', 'type': 'User', 'site_admin': False}",referenced,700271d0e92c33a4cce3fee34b39ad5baa179b00,https://api.github.com/repos/pytorch/pytorch/commits/700271d0e92c33a4cce3fee34b39ad5baa179b00,2018-12-17T21:49:43Z,187,160,27
10876,1851489486,"{'login': 'facebook-github-bot', 'id': 6422482, 'node_id': 'MDQ6VXNlcjY0MjI0ODI=', 'avatar_url': 'https://avatars3.githubusercontent.com/u/6422482?v=4', 'gravatar_id': '', 'url': 'https://api.github.com/users/facebook-github-bot', 'html_url': 'https://github.com/facebook-github-bot', 'followers_url': 'https://api.github.com/users/facebook-github-bot/followers', 'following_url': 'https://api.github.com/users/facebook-github-bot/following{/other_user}', 'gists_url': 'https://api.github.com/users/facebook-github-bot/gists{/gist_id}', 'starred_url': 'https://api.github.com/users/facebook-github-bot/starred{/owner}{/repo}', 'subscriptions_url': 'https://api.github.com/users/facebook-github-bot/subscriptions', 'organizations_url': 'https://api.github.com/users/facebook-github-bot/orgs', 'repos_url': 'https://api.github.com/users/facebook-github-bot/repos', 'events_url': 'https://api.github.com/users/facebook-github-bot/events{/privacy}', 'received_events_url': 'https://api.github.com/users/facebook-github-bot/received_events', 'type': 'User', 'site_admin': False}",closed,407a9fee0c8fb172459ac9b3556419305e47f8a7,https://api.github.com/repos/pytorch/pytorch/commits/407a9fee0c8fb172459ac9b3556419305e47f8a7,2018-09-18T06:30:26Z,48,45,3
10873,1853480314,"{'login': 'facebook-github-bot', 'id': 6422482, 'node_id': 'MDQ6VXNlcjY0MjI0ODI=', 'avatar_url': 'https://avatars3.githubusercontent.com/u/6422482?v=4', 'gravatar_id': '', 'url': 'https://api.github.com/users/facebook-github-bot', 'html_url': 'https://github.com/facebook-github-bot', 'followers_url': 'https://api.github.com/users/facebook-github-bot/followers', 'following_url': 'https://api.github.com/users/facebook-github-bot/following{/other_user}', 'gists_url': 'https://api.github.com/users/facebook-github-bot/gists{/gist_id}', 'starred_url': 'https://api.github.com/users/facebook-github-bot/starred{/owner}{/repo}', 'subscriptions_url': 'https://api.github.com/users/facebook-github-bot/subscriptions', 'organizations_url': 'https://api.github.com/users/facebook-github-bot/orgs', 'repos_url': 'https://api.github.com/users/facebook-github-bot/repos', 'events_url': 'https://api.github.com/users/facebook-github-bot/events{/privacy}', 'received_events_url': 'https://api.github.com/users/facebook-github-bot/received_events', 'type': 'User', 'site_admin': False}",closed,d4e1fa45d055a1b00e8b7cfefa5c9f5db9ae6160,https://api.github.com/repos/pytorch/pytorch/commits/d4e1fa45d055a1b00e8b7cfefa5c9f5db9ae6160,2018-09-18T20:56:55Z,59,47,12
10858,1839928729,"{'login': 'facebook-github-bot', 'id': 6422482, 'node_id': 'MDQ6VXNlcjY0MjI0ODI=', 'avatar_url': 'https://avatars3.githubusercontent.com/u/6422482?v=4', 'gravatar_id': '', 'url': 'https://api.github.com/users/facebook-github-bot', 'html_url': 'https://github.com/facebook-github-bot', 'followers_url': 'https://api.github.com/users/facebook-github-bot/followers', 'following_url': 'https://api.github.com/users/facebook-github-bot/following{/other_user}', 'gists_url': 'https://api.github.com/users/facebook-github-bot/gists{/gist_id}', 'starred_url': 'https://api.github.com/users/facebook-github-bot/starred{/owner}{/repo}', 'subscriptions_url': 'https://api.github.com/users/facebook-github-bot/subscriptions', 'organizations_url': 'https://api.github.com/users/facebook-github-bot/orgs', 'repos_url': 'https://api.github.com/users/facebook-github-bot/repos', 'events_url': 'https://api.github.com/users/facebook-github-bot/events{/privacy}', 'received_events_url': 'https://api.github.com/users/facebook-github-bot/received_events', 'type': 'User', 'site_admin': False}",closed,cda74ac476471e753ca06bd3491c84dc0bcaa813,https://api.github.com/repos/pytorch/pytorch/commits/cda74ac476471e753ca06bd3491c84dc0bcaa813,2018-09-12T00:58:01Z,16,8,8
10851,1816514405,"{'login': 'facebook-github-bot', 'id': 6422482, 'node_id': 'MDQ6VXNlcjY0MjI0ODI=', 'avatar_url': 'https://avatars3.githubusercontent.com/u/6422482?v=4', 'gravatar_id': '', 'url': 'https://api.github.com/users/facebook-github-bot', 'html_url': 'https://github.com/facebook-github-bot', 'followers_url': 'https://api.github.com/users/facebook-github-bot/followers', 'following_url': 'https://api.github.com/users/facebook-github-bot/following{/other_user}', 'gists_url': 'https://api.github.com/users/facebook-github-bot/gists{/gist_id}', 'starred_url': 'https://api.github.com/users/facebook-github-bot/starred{/owner}{/repo}', 'subscriptions_url': 'https://api.github.com/users/facebook-github-bot/subscriptions', 'organizations_url': 'https://api.github.com/users/facebook-github-bot/orgs', 'repos_url': 'https://api.github.com/users/facebook-github-bot/repos', 'events_url': 'https://api.github.com/users/facebook-github-bot/events{/privacy}', 'received_events_url': 'https://api.github.com/users/facebook-github-bot/received_events', 'type': 'User', 'site_admin': False}",closed,4e446b85fb5e0b5db0951cc068e423d9caf5beef,https://api.github.com/repos/pytorch/pytorch/commits/4e446b85fb5e0b5db0951cc068e423d9caf5beef,2018-08-29T19:27:05Z,8,4,4
10850,1936565452,"{'login': 'facebook-github-bot', 'id': 6422482, 'node_id': 'MDQ6VXNlcjY0MjI0ODI=', 'avatar_url': 'https://avatars3.githubusercontent.com/u/6422482?v=4', 'gravatar_id': '', 'url': 'https://api.github.com/users/facebook-github-bot', 'html_url': 'https://github.com/facebook-github-bot', 'followers_url': 'https://api.github.com/users/facebook-github-bot/followers', 'following_url': 'https://api.github.com/users/facebook-github-bot/following{/other_user}', 'gists_url': 'https://api.github.com/users/facebook-github-bot/gists{/gist_id}', 'starred_url': 'https://api.github.com/users/facebook-github-bot/starred{/owner}{/repo}', 'subscriptions_url': 'https://api.github.com/users/facebook-github-bot/subscriptions', 'organizations_url': 'https://api.github.com/users/facebook-github-bot/orgs', 'repos_url': 'https://api.github.com/users/facebook-github-bot/repos', 'events_url': 'https://api.github.com/users/facebook-github-bot/events{/privacy}', 'received_events_url': 'https://api.github.com/users/facebook-github-bot/received_events', 'type': 'User', 'site_admin': False}",closed,11a16961a543a44ad7fc36d144888f5ddf070791,https://api.github.com/repos/pytorch/pytorch/commits/11a16961a543a44ad7fc36d144888f5ddf070791,2018-10-30T23:30:45Z,52,51,1
10839,1820724865,"{'login': 'facebook-github-bot', 'id': 6422482, 'node_id': 'MDQ6VXNlcjY0MjI0ODI=', 'avatar_url': 'https://avatars3.githubusercontent.com/u/6422482?v=4', 'gravatar_id': '', 'url': 'https://api.github.com/users/facebook-github-bot', 'html_url': 'https://github.com/facebook-github-bot', 'followers_url': 'https://api.github.com/users/facebook-github-bot/followers', 'following_url': 'https://api.github.com/users/facebook-github-bot/following{/other_user}', 'gists_url': 'https://api.github.com/users/facebook-github-bot/gists{/gist_id}', 'starred_url': 'https://api.github.com/users/facebook-github-bot/starred{/owner}{/repo}', 'subscriptions_url': 'https://api.github.com/users/facebook-github-bot/subscriptions', 'organizations_url': 'https://api.github.com/users/facebook-github-bot/orgs', 'repos_url': 'https://api.github.com/users/facebook-github-bot/repos', 'events_url': 'https://api.github.com/users/facebook-github-bot/events{/privacy}', 'received_events_url': 'https://api.github.com/users/facebook-github-bot/received_events', 'type': 'User', 'site_admin': False}",closed,82aeebb3d972bb20fc7deac410d9705954bbd37f,https://api.github.com/repos/pytorch/pytorch/commits/82aeebb3d972bb20fc7deac410d9705954bbd37f,2018-08-31T14:26:06Z,38,38,0
10838,1834395960,"{'login': 'facebook-github-bot', 'id': 6422482, 'node_id': 'MDQ6VXNlcjY0MjI0ODI=', 'avatar_url': 'https://avatars3.githubusercontent.com/u/6422482?v=4', 'gravatar_id': '', 'url': 'https://api.github.com/users/facebook-github-bot', 'html_url': 'https://github.com/facebook-github-bot', 'followers_url': 'https://api.github.com/users/facebook-github-bot/followers', 'following_url': 'https://api.github.com/users/facebook-github-bot/following{/other_user}', 'gists_url': 'https://api.github.com/users/facebook-github-bot/gists{/gist_id}', 'starred_url': 'https://api.github.com/users/facebook-github-bot/starred{/owner}{/repo}', 'subscriptions_url': 'https://api.github.com/users/facebook-github-bot/subscriptions', 'organizations_url': 'https://api.github.com/users/facebook-github-bot/orgs', 'repos_url': 'https://api.github.com/users/facebook-github-bot/repos', 'events_url': 'https://api.github.com/users/facebook-github-bot/events{/privacy}', 'received_events_url': 'https://api.github.com/users/facebook-github-bot/received_events', 'type': 'User', 'site_admin': False}",closed,02114e877f3b1acc4966968af73ff453ee1f9ad1,https://api.github.com/repos/pytorch/pytorch/commits/02114e877f3b1acc4966968af73ff453ee1f9ad1,2018-09-09T00:11:15Z,8,4,4
10832,1844900741,"{'login': 'facebook-github-bot', 'id': 6422482, 'node_id': 'MDQ6VXNlcjY0MjI0ODI=', 'avatar_url': 'https://avatars3.githubusercontent.com/u/6422482?v=4', 'gravatar_id': '', 'url': 'https://api.github.com/users/facebook-github-bot', 'html_url': 'https://github.com/facebook-github-bot', 'followers_url': 'https://api.github.com/users/facebook-github-bot/followers', 'following_url': 'https://api.github.com/users/facebook-github-bot/following{/other_user}', 'gists_url': 'https://api.github.com/users/facebook-github-bot/gists{/gist_id}', 'starred_url': 'https://api.github.com/users/facebook-github-bot/starred{/owner}{/repo}', 'subscriptions_url': 'https://api.github.com/users/facebook-github-bot/subscriptions', 'organizations_url': 'https://api.github.com/users/facebook-github-bot/orgs', 'repos_url': 'https://api.github.com/users/facebook-github-bot/repos', 'events_url': 'https://api.github.com/users/facebook-github-bot/events{/privacy}', 'received_events_url': 'https://api.github.com/users/facebook-github-bot/received_events', 'type': 'User', 'site_admin': False}",closed,85ff72348d92c9e4b38dd00bbe42f0ca3e66667f,https://api.github.com/repos/pytorch/pytorch/commits/85ff72348d92c9e4b38dd00bbe42f0ca3e66667f,2018-09-13T23:34:08Z,70,70,0
10823,1852602496,"{'login': 'facebook-github-bot', 'id': 6422482, 'node_id': 'MDQ6VXNlcjY0MjI0ODI=', 'avatar_url': 'https://avatars3.githubusercontent.com/u/6422482?v=4', 'gravatar_id': '', 'url': 'https://api.github.com/users/facebook-github-bot', 'html_url': 'https://github.com/facebook-github-bot', 'followers_url': 'https://api.github.com/users/facebook-github-bot/followers', 'following_url': 'https://api.github.com/users/facebook-github-bot/following{/other_user}', 'gists_url': 'https://api.github.com/users/facebook-github-bot/gists{/gist_id}', 'starred_url': 'https://api.github.com/users/facebook-github-bot/starred{/owner}{/repo}', 'subscriptions_url': 'https://api.github.com/users/facebook-github-bot/subscriptions', 'organizations_url': 'https://api.github.com/users/facebook-github-bot/orgs', 'repos_url': 'https://api.github.com/users/facebook-github-bot/repos', 'events_url': 'https://api.github.com/users/facebook-github-bot/events{/privacy}', 'received_events_url': 'https://api.github.com/users/facebook-github-bot/received_events', 'type': 'User', 'site_admin': False}",referenced,4ee0a78ee6452b7c1584b6020aef791b9d3e8ab6,https://api.github.com/repos/pytorch/pytorch/commits/4ee0a78ee6452b7c1584b6020aef791b9d3e8ab6,2018-09-18T14:42:50Z,82,49,33
10774,1807901444,"{'login': 'facebook-github-bot', 'id': 6422482, 'node_id': 'MDQ6VXNlcjY0MjI0ODI=', 'avatar_url': 'https://avatars3.githubusercontent.com/u/6422482?v=4', 'gravatar_id': '', 'url': 'https://api.github.com/users/facebook-github-bot', 'html_url': 'https://github.com/facebook-github-bot', 'followers_url': 'https://api.github.com/users/facebook-github-bot/followers', 'following_url': 'https://api.github.com/users/facebook-github-bot/following{/other_user}', 'gists_url': 'https://api.github.com/users/facebook-github-bot/gists{/gist_id}', 'starred_url': 'https://api.github.com/users/facebook-github-bot/starred{/owner}{/repo}', 'subscriptions_url': 'https://api.github.com/users/facebook-github-bot/subscriptions', 'organizations_url': 'https://api.github.com/users/facebook-github-bot/orgs', 'repos_url': 'https://api.github.com/users/facebook-github-bot/repos', 'events_url': 'https://api.github.com/users/facebook-github-bot/events{/privacy}', 'received_events_url': 'https://api.github.com/users/facebook-github-bot/received_events', 'type': 'User', 'site_admin': False}",referenced,ca567862b279b9006e73dedc003779329d935772,https://api.github.com/repos/pytorch/pytorch/commits/ca567862b279b9006e73dedc003779329d935772,2018-08-24T15:11:48Z,241,198,43
10774,1831698155,"{'login': 'facebook-github-bot', 'id': 6422482, 'node_id': 'MDQ6VXNlcjY0MjI0ODI=', 'avatar_url': 'https://avatars3.githubusercontent.com/u/6422482?v=4', 'gravatar_id': '', 'url': 'https://api.github.com/users/facebook-github-bot', 'html_url': 'https://github.com/facebook-github-bot', 'followers_url': 'https://api.github.com/users/facebook-github-bot/followers', 'following_url': 'https://api.github.com/users/facebook-github-bot/following{/other_user}', 'gists_url': 'https://api.github.com/users/facebook-github-bot/gists{/gist_id}', 'starred_url': 'https://api.github.com/users/facebook-github-bot/starred{/owner}{/repo}', 'subscriptions_url': 'https://api.github.com/users/facebook-github-bot/subscriptions', 'organizations_url': 'https://api.github.com/users/facebook-github-bot/orgs', 'repos_url': 'https://api.github.com/users/facebook-github-bot/repos', 'events_url': 'https://api.github.com/users/facebook-github-bot/events{/privacy}', 'received_events_url': 'https://api.github.com/users/facebook-github-bot/received_events', 'type': 'User', 'site_admin': False}",referenced,4d678790c56974108bcc2072380b850dcb0b74a8,https://api.github.com/repos/pytorch/pytorch/commits/4d678790c56974108bcc2072380b850dcb0b74a8,2018-09-06T23:42:54Z,232,186,46
10757,2382394534,"{'login': 'facebook-github-bot', 'id': 6422482, 'node_id': 'MDQ6VXNlcjY0MjI0ODI=', 'avatar_url': 'https://avatars3.githubusercontent.com/u/6422482?v=4', 'gravatar_id': '', 'url': 'https://api.github.com/users/facebook-github-bot', 'html_url': 'https://github.com/facebook-github-bot', 'followers_url': 'https://api.github.com/users/facebook-github-bot/followers', 'following_url': 'https://api.github.com/users/facebook-github-bot/following{/other_user}', 'gists_url': 'https://api.github.com/users/facebook-github-bot/gists{/gist_id}', 'starred_url': 'https://api.github.com/users/facebook-github-bot/starred{/owner}{/repo}', 'subscriptions_url': 'https://api.github.com/users/facebook-github-bot/subscriptions', 'organizations_url': 'https://api.github.com/users/facebook-github-bot/orgs', 'repos_url': 'https://api.github.com/users/facebook-github-bot/repos', 'events_url': 'https://api.github.com/users/facebook-github-bot/events{/privacy}', 'received_events_url': 'https://api.github.com/users/facebook-github-bot/received_events', 'type': 'User', 'site_admin': False}",referenced,678dc44d4c15fda55df129316a6e549942c55a43,https://api.github.com/repos/pytorch/pytorch/commits/678dc44d4c15fda55df129316a6e549942c55a43,2019-06-01T00:12:31Z,6,4,2
10751,1801489485,"{'login': 'SsnL', 'id': 5674597, 'node_id': 'MDQ6VXNlcjU2NzQ1OTc=', 'avatar_url': 'https://avatars2.githubusercontent.com/u/5674597?v=4', 'gravatar_id': '', 'url': 'https://api.github.com/users/SsnL', 'html_url': 'https://github.com/SsnL', 'followers_url': 'https://api.github.com/users/SsnL/followers', 'following_url': 'https://api.github.com/users/SsnL/following{/other_user}', 'gists_url': 'https://api.github.com/users/SsnL/gists{/gist_id}', 'starred_url': 'https://api.github.com/users/SsnL/starred{/owner}{/repo}', 'subscriptions_url': 'https://api.github.com/users/SsnL/subscriptions', 'organizations_url': 'https://api.github.com/users/SsnL/orgs', 'repos_url': 'https://api.github.com/users/SsnL/repos', 'events_url': 'https://api.github.com/users/SsnL/events{/privacy}', 'received_events_url': 'https://api.github.com/users/SsnL/received_events', 'type': 'User', 'site_admin': False}",referenced,c4787d1a445e62bbd95c7b576de99acb58157ff6,https://api.github.com/repos/pytorch/pytorch/commits/c4787d1a445e62bbd95c7b576de99acb58157ff6,2018-08-22T00:29:29Z,4,2,2
10751,1801713048,"{'login': 'facebook-github-bot', 'id': 6422482, 'node_id': 'MDQ6VXNlcjY0MjI0ODI=', 'avatar_url': 'https://avatars3.githubusercontent.com/u/6422482?v=4', 'gravatar_id': '', 'url': 'https://api.github.com/users/facebook-github-bot', 'html_url': 'https://github.com/facebook-github-bot', 'followers_url': 'https://api.github.com/users/facebook-github-bot/followers', 'following_url': 'https://api.github.com/users/facebook-github-bot/following{/other_user}', 'gists_url': 'https://api.github.com/users/facebook-github-bot/gists{/gist_id}', 'starred_url': 'https://api.github.com/users/facebook-github-bot/starred{/owner}{/repo}', 'subscriptions_url': 'https://api.github.com/users/facebook-github-bot/subscriptions', 'organizations_url': 'https://api.github.com/users/facebook-github-bot/orgs', 'repos_url': 'https://api.github.com/users/facebook-github-bot/repos', 'events_url': 'https://api.github.com/users/facebook-github-bot/events{/privacy}', 'received_events_url': 'https://api.github.com/users/facebook-github-bot/received_events', 'type': 'User', 'site_admin': False}",closed,abb209ef253f47db0880f4482766d38c2c59212b,https://api.github.com/repos/pytorch/pytorch/commits/abb209ef253f47db0880f4482766d38c2c59212b,2018-08-22T04:10:21Z,4,2,2
10726,1871185610,"{'login': 'facebook-github-bot', 'id': 6422482, 'node_id': 'MDQ6VXNlcjY0MjI0ODI=', 'avatar_url': 'https://avatars3.githubusercontent.com/u/6422482?v=4', 'gravatar_id': '', 'url': 'https://api.github.com/users/facebook-github-bot', 'html_url': 'https://github.com/facebook-github-bot', 'followers_url': 'https://api.github.com/users/facebook-github-bot/followers', 'following_url': 'https://api.github.com/users/facebook-github-bot/following{/other_user}', 'gists_url': 'https://api.github.com/users/facebook-github-bot/gists{/gist_id}', 'starred_url': 'https://api.github.com/users/facebook-github-bot/starred{/owner}{/repo}', 'subscriptions_url': 'https://api.github.com/users/facebook-github-bot/subscriptions', 'organizations_url': 'https://api.github.com/users/facebook-github-bot/orgs', 'repos_url': 'https://api.github.com/users/facebook-github-bot/repos', 'events_url': 'https://api.github.com/users/facebook-github-bot/events{/privacy}', 'received_events_url': 'https://api.github.com/users/facebook-github-bot/received_events', 'type': 'User', 'site_admin': False}",referenced,a72603f8f8ffdd77a826129b18e839df3fe3a109,https://api.github.com/repos/pytorch/pytorch/commits/a72603f8f8ffdd77a826129b18e839df3fe3a109,2018-09-27T14:10:54Z,29,16,13
10723,1861335751,"{'login': 'facebook-github-bot', 'id': 6422482, 'node_id': 'MDQ6VXNlcjY0MjI0ODI=', 'avatar_url': 'https://avatars3.githubusercontent.com/u/6422482?v=4', 'gravatar_id': '', 'url': 'https://api.github.com/users/facebook-github-bot', 'html_url': 'https://github.com/facebook-github-bot', 'followers_url': 'https://api.github.com/users/facebook-github-bot/followers', 'following_url': 'https://api.github.com/users/facebook-github-bot/following{/other_user}', 'gists_url': 'https://api.github.com/users/facebook-github-bot/gists{/gist_id}', 'starred_url': 'https://api.github.com/users/facebook-github-bot/starred{/owner}{/repo}', 'subscriptions_url': 'https://api.github.com/users/facebook-github-bot/subscriptions', 'organizations_url': 'https://api.github.com/users/facebook-github-bot/orgs', 'repos_url': 'https://api.github.com/users/facebook-github-bot/repos', 'events_url': 'https://api.github.com/users/facebook-github-bot/events{/privacy}', 'received_events_url': 'https://api.github.com/users/facebook-github-bot/received_events', 'type': 'User', 'site_admin': False}",closed,de11fe0c8381bc8fa4182f247226d1f606d79678,https://api.github.com/repos/pytorch/pytorch/commits/de11fe0c8381bc8fa4182f247226d1f606d79678,2018-09-21T23:27:14Z,1106,550,556
10715,1830640890,"{'login': 'facebook-github-bot', 'id': 6422482, 'node_id': 'MDQ6VXNlcjY0MjI0ODI=', 'avatar_url': 'https://avatars3.githubusercontent.com/u/6422482?v=4', 'gravatar_id': '', 'url': 'https://api.github.com/users/facebook-github-bot', 'html_url': 'https://github.com/facebook-github-bot', 'followers_url': 'https://api.github.com/users/facebook-github-bot/followers', 'following_url': 'https://api.github.com/users/facebook-github-bot/following{/other_user}', 'gists_url': 'https://api.github.com/users/facebook-github-bot/gists{/gist_id}', 'starred_url': 'https://api.github.com/users/facebook-github-bot/starred{/owner}{/repo}', 'subscriptions_url': 'https://api.github.com/users/facebook-github-bot/subscriptions', 'organizations_url': 'https://api.github.com/users/facebook-github-bot/orgs', 'repos_url': 'https://api.github.com/users/facebook-github-bot/repos', 'events_url': 'https://api.github.com/users/facebook-github-bot/events{/privacy}', 'received_events_url': 'https://api.github.com/users/facebook-github-bot/received_events', 'type': 'User', 'site_admin': False}",referenced,656e81db9372ea62f80155acded8b90b3445f0fd,https://api.github.com/repos/pytorch/pytorch/commits/656e81db9372ea62f80155acded8b90b3445f0fd,2018-09-06T14:56:19Z,36,34,2
10698,1798452723,"{'login': 'avmgithub', 'id': 9083746, 'node_id': 'MDQ6VXNlcjkwODM3NDY=', 'avatar_url': 'https://avatars1.githubusercontent.com/u/9083746?v=4', 'gravatar_id': '', 'url': 'https://api.github.com/users/avmgithub', 'html_url': 'https://github.com/avmgithub', 'followers_url': 'https://api.github.com/users/avmgithub/followers', 'following_url': 'https://api.github.com/users/avmgithub/following{/other_user}', 'gists_url': 'https://api.github.com/users/avmgithub/gists{/gist_id}', 'starred_url': 'https://api.github.com/users/avmgithub/starred{/owner}{/repo}', 'subscriptions_url': 'https://api.github.com/users/avmgithub/subscriptions', 'organizations_url': 'https://api.github.com/users/avmgithub/orgs', 'repos_url': 'https://api.github.com/users/avmgithub/repos', 'events_url': 'https://api.github.com/users/avmgithub/events{/privacy}', 'received_events_url': 'https://api.github.com/users/avmgithub/received_events', 'type': 'User', 'site_admin': False}",referenced,6bdbad93b96ecd943fe5091725ccd70fad9a6057,https://api.github.com/repos/pytorch/pytorch/commits/6bdbad93b96ecd943fe5091725ccd70fad9a6057,2018-08-20T19:00:48Z,492,290,202
10698,1798713470,"{'login': 'facebook-github-bot', 'id': 6422482, 'node_id': 'MDQ6VXNlcjY0MjI0ODI=', 'avatar_url': 'https://avatars3.githubusercontent.com/u/6422482?v=4', 'gravatar_id': '', 'url': 'https://api.github.com/users/facebook-github-bot', 'html_url': 'https://github.com/facebook-github-bot', 'followers_url': 'https://api.github.com/users/facebook-github-bot/followers', 'following_url': 'https://api.github.com/users/facebook-github-bot/following{/other_user}', 'gists_url': 'https://api.github.com/users/facebook-github-bot/gists{/gist_id}', 'starred_url': 'https://api.github.com/users/facebook-github-bot/starred{/owner}{/repo}', 'subscriptions_url': 'https://api.github.com/users/facebook-github-bot/subscriptions', 'organizations_url': 'https://api.github.com/users/facebook-github-bot/orgs', 'repos_url': 'https://api.github.com/users/facebook-github-bot/repos', 'events_url': 'https://api.github.com/users/facebook-github-bot/events{/privacy}', 'received_events_url': 'https://api.github.com/users/facebook-github-bot/received_events', 'type': 'User', 'site_admin': False}",closed,39a3dcc9999409a534331b3c3d905bfc298d51d2,https://api.github.com/repos/pytorch/pytorch/commits/39a3dcc9999409a534331b3c3d905bfc298d51d2,2018-08-20T21:11:30Z,4,2,2
10661,1841254986,"{'login': 'facebook-github-bot', 'id': 6422482, 'node_id': 'MDQ6VXNlcjY0MjI0ODI=', 'avatar_url': 'https://avatars3.githubusercontent.com/u/6422482?v=4', 'gravatar_id': '', 'url': 'https://api.github.com/users/facebook-github-bot', 'html_url': 'https://github.com/facebook-github-bot', 'followers_url': 'https://api.github.com/users/facebook-github-bot/followers', 'following_url': 'https://api.github.com/users/facebook-github-bot/following{/other_user}', 'gists_url': 'https://api.github.com/users/facebook-github-bot/gists{/gist_id}', 'starred_url': 'https://api.github.com/users/facebook-github-bot/starred{/owner}{/repo}', 'subscriptions_url': 'https://api.github.com/users/facebook-github-bot/subscriptions', 'organizations_url': 'https://api.github.com/users/facebook-github-bot/orgs', 'repos_url': 'https://api.github.com/users/facebook-github-bot/repos', 'events_url': 'https://api.github.com/users/facebook-github-bot/events{/privacy}', 'received_events_url': 'https://api.github.com/users/facebook-github-bot/received_events', 'type': 'User', 'site_admin': False}",referenced,efc0f6784aa94d75f2b68e2f42a54253c9729d72,https://api.github.com/repos/pytorch/pytorch/commits/efc0f6784aa94d75f2b68e2f42a54253c9729d72,2018-09-12T14:11:20Z,331,311,20
10654,2257198667,"{'login': 'facebook-github-bot', 'id': 6422482, 'node_id': 'MDQ6VXNlcjY0MjI0ODI=', 'avatar_url': 'https://avatars3.githubusercontent.com/u/6422482?v=4', 'gravatar_id': '', 'url': 'https://api.github.com/users/facebook-github-bot', 'html_url': 'https://github.com/facebook-github-bot', 'followers_url': 'https://api.github.com/users/facebook-github-bot/followers', 'following_url': 'https://api.github.com/users/facebook-github-bot/following{/other_user}', 'gists_url': 'https://api.github.com/users/facebook-github-bot/gists{/gist_id}', 'starred_url': 'https://api.github.com/users/facebook-github-bot/starred{/owner}{/repo}', 'subscriptions_url': 'https://api.github.com/users/facebook-github-bot/subscriptions', 'organizations_url': 'https://api.github.com/users/facebook-github-bot/orgs', 'repos_url': 'https://api.github.com/users/facebook-github-bot/repos', 'events_url': 'https://api.github.com/users/facebook-github-bot/events{/privacy}', 'received_events_url': 'https://api.github.com/users/facebook-github-bot/received_events', 'type': 'User', 'site_admin': False}",closed,e6bbbb017e1ad829316e7d7ea0f9ca9e78421da2,https://api.github.com/repos/pytorch/pytorch/commits/e6bbbb017e1ad829316e7d7ea0f9ca9e78421da2,2019-04-06T00:57:22Z,25,24,1
10648,1901378887,"{'login': 'facebook-github-bot', 'id': 6422482, 'node_id': 'MDQ6VXNlcjY0MjI0ODI=', 'avatar_url': 'https://avatars3.githubusercontent.com/u/6422482?v=4', 'gravatar_id': '', 'url': 'https://api.github.com/users/facebook-github-bot', 'html_url': 'https://github.com/facebook-github-bot', 'followers_url': 'https://api.github.com/users/facebook-github-bot/followers', 'following_url': 'https://api.github.com/users/facebook-github-bot/following{/other_user}', 'gists_url': 'https://api.github.com/users/facebook-github-bot/gists{/gist_id}', 'starred_url': 'https://api.github.com/users/facebook-github-bot/starred{/owner}{/repo}', 'subscriptions_url': 'https://api.github.com/users/facebook-github-bot/subscriptions', 'organizations_url': 'https://api.github.com/users/facebook-github-bot/orgs', 'repos_url': 'https://api.github.com/users/facebook-github-bot/repos', 'events_url': 'https://api.github.com/users/facebook-github-bot/events{/privacy}', 'received_events_url': 'https://api.github.com/users/facebook-github-bot/received_events', 'type': 'User', 'site_admin': False}",closed,5317429e826ad1049bdbdf40de79a25d3b957120,https://api.github.com/repos/pytorch/pytorch/commits/5317429e826ad1049bdbdf40de79a25d3b957120,2018-10-12T18:14:46Z,102,80,22
10642,1808274856,"{'login': 'facebook-github-bot', 'id': 6422482, 'node_id': 'MDQ6VXNlcjY0MjI0ODI=', 'avatar_url': 'https://avatars3.githubusercontent.com/u/6422482?v=4', 'gravatar_id': '', 'url': 'https://api.github.com/users/facebook-github-bot', 'html_url': 'https://github.com/facebook-github-bot', 'followers_url': 'https://api.github.com/users/facebook-github-bot/followers', 'following_url': 'https://api.github.com/users/facebook-github-bot/following{/other_user}', 'gists_url': 'https://api.github.com/users/facebook-github-bot/gists{/gist_id}', 'starred_url': 'https://api.github.com/users/facebook-github-bot/starred{/owner}{/repo}', 'subscriptions_url': 'https://api.github.com/users/facebook-github-bot/subscriptions', 'organizations_url': 'https://api.github.com/users/facebook-github-bot/orgs', 'repos_url': 'https://api.github.com/users/facebook-github-bot/repos', 'events_url': 'https://api.github.com/users/facebook-github-bot/events{/privacy}', 'received_events_url': 'https://api.github.com/users/facebook-github-bot/received_events', 'type': 'User', 'site_admin': False}",closed,f1df85d799ab737e78f8a06b317a1852acbb3ef2,https://api.github.com/repos/pytorch/pytorch/commits/f1df85d799ab737e78f8a06b317a1852acbb3ef2,2018-08-24T18:28:19Z,9,8,1
10632,1806469947,"{'login': 'facebook-github-bot', 'id': 6422482, 'node_id': 'MDQ6VXNlcjY0MjI0ODI=', 'avatar_url': 'https://avatars3.githubusercontent.com/u/6422482?v=4', 'gravatar_id': '', 'url': 'https://api.github.com/users/facebook-github-bot', 'html_url': 'https://github.com/facebook-github-bot', 'followers_url': 'https://api.github.com/users/facebook-github-bot/followers', 'following_url': 'https://api.github.com/users/facebook-github-bot/following{/other_user}', 'gists_url': 'https://api.github.com/users/facebook-github-bot/gists{/gist_id}', 'starred_url': 'https://api.github.com/users/facebook-github-bot/starred{/owner}{/repo}', 'subscriptions_url': 'https://api.github.com/users/facebook-github-bot/subscriptions', 'organizations_url': 'https://api.github.com/users/facebook-github-bot/orgs', 'repos_url': 'https://api.github.com/users/facebook-github-bot/repos', 'events_url': 'https://api.github.com/users/facebook-github-bot/events{/privacy}', 'received_events_url': 'https://api.github.com/users/facebook-github-bot/received_events', 'type': 'User', 'site_admin': False}",closed,3d43a8244091ff4ffa70404110263e202fd94a0c,https://api.github.com/repos/pytorch/pytorch/commits/3d43a8244091ff4ffa70404110263e202fd94a0c,2018-08-23T22:11:42Z,242,156,86
10631,1798713481,"{'login': 'facebook-github-bot', 'id': 6422482, 'node_id': 'MDQ6VXNlcjY0MjI0ODI=', 'avatar_url': 'https://avatars3.githubusercontent.com/u/6422482?v=4', 'gravatar_id': '', 'url': 'https://api.github.com/users/facebook-github-bot', 'html_url': 'https://github.com/facebook-github-bot', 'followers_url': 'https://api.github.com/users/facebook-github-bot/followers', 'following_url': 'https://api.github.com/users/facebook-github-bot/following{/other_user}', 'gists_url': 'https://api.github.com/users/facebook-github-bot/gists{/gist_id}', 'starred_url': 'https://api.github.com/users/facebook-github-bot/starred{/owner}{/repo}', 'subscriptions_url': 'https://api.github.com/users/facebook-github-bot/subscriptions', 'organizations_url': 'https://api.github.com/users/facebook-github-bot/orgs', 'repos_url': 'https://api.github.com/users/facebook-github-bot/repos', 'events_url': 'https://api.github.com/users/facebook-github-bot/events{/privacy}', 'received_events_url': 'https://api.github.com/users/facebook-github-bot/received_events', 'type': 'User', 'site_admin': False}",closed,585e6b581f15332da5424d3ebf58767f780cd8dd,https://api.github.com/repos/pytorch/pytorch/commits/585e6b581f15332da5424d3ebf58767f780cd8dd,2018-08-20T21:11:31Z,35,34,1
10584,1795632331,"{'login': 'facebook-github-bot', 'id': 6422482, 'node_id': 'MDQ6VXNlcjY0MjI0ODI=', 'avatar_url': 'https://avatars3.githubusercontent.com/u/6422482?v=4', 'gravatar_id': '', 'url': 'https://api.github.com/users/facebook-github-bot', 'html_url': 'https://github.com/facebook-github-bot', 'followers_url': 'https://api.github.com/users/facebook-github-bot/followers', 'following_url': 'https://api.github.com/users/facebook-github-bot/following{/other_user}', 'gists_url': 'https://api.github.com/users/facebook-github-bot/gists{/gist_id}', 'starred_url': 'https://api.github.com/users/facebook-github-bot/starred{/owner}{/repo}', 'subscriptions_url': 'https://api.github.com/users/facebook-github-bot/subscriptions', 'organizations_url': 'https://api.github.com/users/facebook-github-bot/orgs', 'repos_url': 'https://api.github.com/users/facebook-github-bot/repos', 'events_url': 'https://api.github.com/users/facebook-github-bot/events{/privacy}', 'received_events_url': 'https://api.github.com/users/facebook-github-bot/received_events', 'type': 'User', 'site_admin': False}",closed,c5c1c051cac7a120a1aeecaf3f6fb418d9a989d6,https://api.github.com/repos/pytorch/pytorch/commits/c5c1c051cac7a120a1aeecaf3f6fb418d9a989d6,2018-08-17T21:55:44Z,7,6,1
10570,1791683333,"{'login': 'facebook-github-bot', 'id': 6422482, 'node_id': 'MDQ6VXNlcjY0MjI0ODI=', 'avatar_url': 'https://avatars3.githubusercontent.com/u/6422482?v=4', 'gravatar_id': '', 'url': 'https://api.github.com/users/facebook-github-bot', 'html_url': 'https://github.com/facebook-github-bot', 'followers_url': 'https://api.github.com/users/facebook-github-bot/followers', 'following_url': 'https://api.github.com/users/facebook-github-bot/following{/other_user}', 'gists_url': 'https://api.github.com/users/facebook-github-bot/gists{/gist_id}', 'starred_url': 'https://api.github.com/users/facebook-github-bot/starred{/owner}{/repo}', 'subscriptions_url': 'https://api.github.com/users/facebook-github-bot/subscriptions', 'organizations_url': 'https://api.github.com/users/facebook-github-bot/orgs', 'repos_url': 'https://api.github.com/users/facebook-github-bot/repos', 'events_url': 'https://api.github.com/users/facebook-github-bot/events{/privacy}', 'received_events_url': 'https://api.github.com/users/facebook-github-bot/received_events', 'type': 'User', 'site_admin': False}",referenced,7487ee55f10e8702b83ad2b79395991851edef7e,https://api.github.com/repos/pytorch/pytorch/commits/7487ee55f10e8702b83ad2b79395991851edef7e,2018-08-16T07:27:03Z,9,4,5
10568,1791706401,"{'login': 'facebook-github-bot', 'id': 6422482, 'node_id': 'MDQ6VXNlcjY0MjI0ODI=', 'avatar_url': 'https://avatars3.githubusercontent.com/u/6422482?v=4', 'gravatar_id': '', 'url': 'https://api.github.com/users/facebook-github-bot', 'html_url': 'https://github.com/facebook-github-bot', 'followers_url': 'https://api.github.com/users/facebook-github-bot/followers', 'following_url': 'https://api.github.com/users/facebook-github-bot/following{/other_user}', 'gists_url': 'https://api.github.com/users/facebook-github-bot/gists{/gist_id}', 'starred_url': 'https://api.github.com/users/facebook-github-bot/starred{/owner}{/repo}', 'subscriptions_url': 'https://api.github.com/users/facebook-github-bot/subscriptions', 'organizations_url': 'https://api.github.com/users/facebook-github-bot/orgs', 'repos_url': 'https://api.github.com/users/facebook-github-bot/repos', 'events_url': 'https://api.github.com/users/facebook-github-bot/events{/privacy}', 'received_events_url': 'https://api.github.com/users/facebook-github-bot/received_events', 'type': 'User', 'site_admin': False}",referenced,238b4b9236c8f0b36667ff9a83ca9125e34e7713,https://api.github.com/repos/pytorch/pytorch/commits/238b4b9236c8f0b36667ff9a83ca9125e34e7713,2018-08-16T07:40:38Z,2,1,1
10540,1844791392,"{'login': 'facebook-github-bot', 'id': 6422482, 'node_id': 'MDQ6VXNlcjY0MjI0ODI=', 'avatar_url': 'https://avatars3.githubusercontent.com/u/6422482?v=4', 'gravatar_id': '', 'url': 'https://api.github.com/users/facebook-github-bot', 'html_url': 'https://github.com/facebook-github-bot', 'followers_url': 'https://api.github.com/users/facebook-github-bot/followers', 'following_url': 'https://api.github.com/users/facebook-github-bot/following{/other_user}', 'gists_url': 'https://api.github.com/users/facebook-github-bot/gists{/gist_id}', 'starred_url': 'https://api.github.com/users/facebook-github-bot/starred{/owner}{/repo}', 'subscriptions_url': 'https://api.github.com/users/facebook-github-bot/subscriptions', 'organizations_url': 'https://api.github.com/users/facebook-github-bot/orgs', 'repos_url': 'https://api.github.com/users/facebook-github-bot/repos', 'events_url': 'https://api.github.com/users/facebook-github-bot/events{/privacy}', 'received_events_url': 'https://api.github.com/users/facebook-github-bot/received_events', 'type': 'User', 'site_admin': False}",referenced,05e06f7de2c84b8dd770c2f5008f5b7620e97d39,https://api.github.com/repos/pytorch/pytorch/commits/05e06f7de2c84b8dd770c2f5008f5b7620e97d39,2018-09-13T22:10:41Z,82,50,32
10538,2373570633,"{'login': 'facebook-github-bot', 'id': 6422482, 'node_id': 'MDQ6VXNlcjY0MjI0ODI=', 'avatar_url': 'https://avatars3.githubusercontent.com/u/6422482?v=4', 'gravatar_id': '', 'url': 'https://api.github.com/users/facebook-github-bot', 'html_url': 'https://github.com/facebook-github-bot', 'followers_url': 'https://api.github.com/users/facebook-github-bot/followers', 'following_url': 'https://api.github.com/users/facebook-github-bot/following{/other_user}', 'gists_url': 'https://api.github.com/users/facebook-github-bot/gists{/gist_id}', 'starred_url': 'https://api.github.com/users/facebook-github-bot/starred{/owner}{/repo}', 'subscriptions_url': 'https://api.github.com/users/facebook-github-bot/subscriptions', 'organizations_url': 'https://api.github.com/users/facebook-github-bot/orgs', 'repos_url': 'https://api.github.com/users/facebook-github-bot/repos', 'events_url': 'https://api.github.com/users/facebook-github-bot/events{/privacy}', 'received_events_url': 'https://api.github.com/users/facebook-github-bot/received_events', 'type': 'User', 'site_admin': False}",referenced,f6ec46489065d0fa3cb584210a3a932229f2a0ce,https://api.github.com/repos/pytorch/pytorch/commits/f6ec46489065d0fa3cb584210a3a932229f2a0ce,2019-05-29T00:54:56Z,719,464,255
10532,2592065243,"{'login': 'facebook-github-bot', 'id': 6422482, 'node_id': 'MDQ6VXNlcjY0MjI0ODI=', 'avatar_url': 'https://avatars3.githubusercontent.com/u/6422482?v=4', 'gravatar_id': '', 'url': 'https://api.github.com/users/facebook-github-bot', 'html_url': 'https://github.com/facebook-github-bot', 'followers_url': 'https://api.github.com/users/facebook-github-bot/followers', 'following_url': 'https://api.github.com/users/facebook-github-bot/following{/other_user}', 'gists_url': 'https://api.github.com/users/facebook-github-bot/gists{/gist_id}', 'starred_url': 'https://api.github.com/users/facebook-github-bot/starred{/owner}{/repo}', 'subscriptions_url': 'https://api.github.com/users/facebook-github-bot/subscriptions', 'organizations_url': 'https://api.github.com/users/facebook-github-bot/orgs', 'repos_url': 'https://api.github.com/users/facebook-github-bot/repos', 'events_url': 'https://api.github.com/users/facebook-github-bot/events{/privacy}', 'received_events_url': 'https://api.github.com/users/facebook-github-bot/received_events', 'type': 'User', 'site_admin': False}",closed,5dd915cd1ac73d06b9c30134bacdac88aa24fae7,https://api.github.com/repos/pytorch/pytorch/commits/5dd915cd1ac73d06b9c30134bacdac88aa24fae7,2019-08-28T21:59:03Z,70,66,4
10523,1791024990,"{'login': 'facebook-github-bot', 'id': 6422482, 'node_id': 'MDQ6VXNlcjY0MjI0ODI=', 'avatar_url': 'https://avatars3.githubusercontent.com/u/6422482?v=4', 'gravatar_id': '', 'url': 'https://api.github.com/users/facebook-github-bot', 'html_url': 'https://github.com/facebook-github-bot', 'followers_url': 'https://api.github.com/users/facebook-github-bot/followers', 'following_url': 'https://api.github.com/users/facebook-github-bot/following{/other_user}', 'gists_url': 'https://api.github.com/users/facebook-github-bot/gists{/gist_id}', 'starred_url': 'https://api.github.com/users/facebook-github-bot/starred{/owner}{/repo}', 'subscriptions_url': 'https://api.github.com/users/facebook-github-bot/subscriptions', 'organizations_url': 'https://api.github.com/users/facebook-github-bot/orgs', 'repos_url': 'https://api.github.com/users/facebook-github-bot/repos', 'events_url': 'https://api.github.com/users/facebook-github-bot/events{/privacy}', 'received_events_url': 'https://api.github.com/users/facebook-github-bot/received_events', 'type': 'User', 'site_admin': False}",closed,26c764a1db1fecbab3870eb88c928da378ab0c5b,https://api.github.com/repos/pytorch/pytorch/commits/26c764a1db1fecbab3870eb88c928da378ab0c5b,2018-08-15T21:28:07Z,2,1,1
10501,1795572006,"{'login': 'facebook-github-bot', 'id': 6422482, 'node_id': 'MDQ6VXNlcjY0MjI0ODI=', 'avatar_url': 'https://avatars3.githubusercontent.com/u/6422482?v=4', 'gravatar_id': '', 'url': 'https://api.github.com/users/facebook-github-bot', 'html_url': 'https://github.com/facebook-github-bot', 'followers_url': 'https://api.github.com/users/facebook-github-bot/followers', 'following_url': 'https://api.github.com/users/facebook-github-bot/following{/other_user}', 'gists_url': 'https://api.github.com/users/facebook-github-bot/gists{/gist_id}', 'starred_url': 'https://api.github.com/users/facebook-github-bot/starred{/owner}{/repo}', 'subscriptions_url': 'https://api.github.com/users/facebook-github-bot/subscriptions', 'organizations_url': 'https://api.github.com/users/facebook-github-bot/orgs', 'repos_url': 'https://api.github.com/users/facebook-github-bot/repos', 'events_url': 'https://api.github.com/users/facebook-github-bot/events{/privacy}', 'received_events_url': 'https://api.github.com/users/facebook-github-bot/received_events', 'type': 'User', 'site_admin': False}",closed,86c9856d9c878631e611de0e138bc409228bbfef,https://api.github.com/repos/pytorch/pytorch/commits/86c9856d9c878631e611de0e138bc409228bbfef,2018-08-17T21:11:32Z,468,300,168
10456,1786868276,"{'login': 'facebook-github-bot', 'id': 6422482, 'node_id': 'MDQ6VXNlcjY0MjI0ODI=', 'avatar_url': 'https://avatars3.githubusercontent.com/u/6422482?v=4', 'gravatar_id': '', 'url': 'https://api.github.com/users/facebook-github-bot', 'html_url': 'https://github.com/facebook-github-bot', 'followers_url': 'https://api.github.com/users/facebook-github-bot/followers', 'following_url': 'https://api.github.com/users/facebook-github-bot/following{/other_user}', 'gists_url': 'https://api.github.com/users/facebook-github-bot/gists{/gist_id}', 'starred_url': 'https://api.github.com/users/facebook-github-bot/starred{/owner}{/repo}', 'subscriptions_url': 'https://api.github.com/users/facebook-github-bot/subscriptions', 'organizations_url': 'https://api.github.com/users/facebook-github-bot/orgs', 'repos_url': 'https://api.github.com/users/facebook-github-bot/repos', 'events_url': 'https://api.github.com/users/facebook-github-bot/events{/privacy}', 'received_events_url': 'https://api.github.com/users/facebook-github-bot/received_events', 'type': 'User', 'site_admin': False}",closed,fed05cf4cf1063df009fc2280a0b5040606fde89,https://api.github.com/repos/pytorch/pytorch/commits/fed05cf4cf1063df009fc2280a0b5040606fde89,2018-08-14T04:10:20Z,52,51,1
10435,1784366969,"{'login': 'facebook-github-bot', 'id': 6422482, 'node_id': 'MDQ6VXNlcjY0MjI0ODI=', 'avatar_url': 'https://avatars3.githubusercontent.com/u/6422482?v=4', 'gravatar_id': '', 'url': 'https://api.github.com/users/facebook-github-bot', 'html_url': 'https://github.com/facebook-github-bot', 'followers_url': 'https://api.github.com/users/facebook-github-bot/followers', 'following_url': 'https://api.github.com/users/facebook-github-bot/following{/other_user}', 'gists_url': 'https://api.github.com/users/facebook-github-bot/gists{/gist_id}', 'starred_url': 'https://api.github.com/users/facebook-github-bot/starred{/owner}{/repo}', 'subscriptions_url': 'https://api.github.com/users/facebook-github-bot/subscriptions', 'organizations_url': 'https://api.github.com/users/facebook-github-bot/orgs', 'repos_url': 'https://api.github.com/users/facebook-github-bot/repos', 'events_url': 'https://api.github.com/users/facebook-github-bot/events{/privacy}', 'received_events_url': 'https://api.github.com/users/facebook-github-bot/received_events', 'type': 'User', 'site_admin': False}",referenced,508de8109fe88d6e690c03bc2c5ecb863f889062,https://api.github.com/repos/pytorch/pytorch/commits/508de8109fe88d6e690c03bc2c5ecb863f889062,2018-08-13T01:10:15Z,2,1,1
10397,1785816291,"{'login': 'facebook-github-bot', 'id': 6422482, 'node_id': 'MDQ6VXNlcjY0MjI0ODI=', 'avatar_url': 'https://avatars3.githubusercontent.com/u/6422482?v=4', 'gravatar_id': '', 'url': 'https://api.github.com/users/facebook-github-bot', 'html_url': 'https://github.com/facebook-github-bot', 'followers_url': 'https://api.github.com/users/facebook-github-bot/followers', 'following_url': 'https://api.github.com/users/facebook-github-bot/following{/other_user}', 'gists_url': 'https://api.github.com/users/facebook-github-bot/gists{/gist_id}', 'starred_url': 'https://api.github.com/users/facebook-github-bot/starred{/owner}{/repo}', 'subscriptions_url': 'https://api.github.com/users/facebook-github-bot/subscriptions', 'organizations_url': 'https://api.github.com/users/facebook-github-bot/orgs', 'repos_url': 'https://api.github.com/users/facebook-github-bot/repos', 'events_url': 'https://api.github.com/users/facebook-github-bot/events{/privacy}', 'received_events_url': 'https://api.github.com/users/facebook-github-bot/received_events', 'type': 'User', 'site_admin': False}",closed,64a6f17177732f459725ff64c6ba7c2db2c94bba,https://api.github.com/repos/pytorch/pytorch/commits/64a6f17177732f459725ff64c6ba7c2db2c94bba,2018-08-13T16:27:31Z,5,2,3
10357,1856383111,"{'login': 'facebook-github-bot', 'id': 6422482, 'node_id': 'MDQ6VXNlcjY0MjI0ODI=', 'avatar_url': 'https://avatars3.githubusercontent.com/u/6422482?v=4', 'gravatar_id': '', 'url': 'https://api.github.com/users/facebook-github-bot', 'html_url': 'https://github.com/facebook-github-bot', 'followers_url': 'https://api.github.com/users/facebook-github-bot/followers', 'following_url': 'https://api.github.com/users/facebook-github-bot/following{/other_user}', 'gists_url': 'https://api.github.com/users/facebook-github-bot/gists{/gist_id}', 'starred_url': 'https://api.github.com/users/facebook-github-bot/starred{/owner}{/repo}', 'subscriptions_url': 'https://api.github.com/users/facebook-github-bot/subscriptions', 'organizations_url': 'https://api.github.com/users/facebook-github-bot/orgs', 'repos_url': 'https://api.github.com/users/facebook-github-bot/repos', 'events_url': 'https://api.github.com/users/facebook-github-bot/events{/privacy}', 'received_events_url': 'https://api.github.com/users/facebook-github-bot/received_events', 'type': 'User', 'site_admin': False}",referenced,24e958a0a779e3dcd7bda19ef3fa702ee654e9dc,https://api.github.com/repos/pytorch/pytorch/commits/24e958a0a779e3dcd7bda19ef3fa702ee654e9dc,2018-09-19T23:47:20Z,1721,1098,623
10355,1822308793,"{'login': 'facebook-github-bot', 'id': 6422482, 'node_id': 'MDQ6VXNlcjY0MjI0ODI=', 'avatar_url': 'https://avatars3.githubusercontent.com/u/6422482?v=4', 'gravatar_id': '', 'url': 'https://api.github.com/users/facebook-github-bot', 'html_url': 'https://github.com/facebook-github-bot', 'followers_url': 'https://api.github.com/users/facebook-github-bot/followers', 'following_url': 'https://api.github.com/users/facebook-github-bot/following{/other_user}', 'gists_url': 'https://api.github.com/users/facebook-github-bot/gists{/gist_id}', 'starred_url': 'https://api.github.com/users/facebook-github-bot/starred{/owner}{/repo}', 'subscriptions_url': 'https://api.github.com/users/facebook-github-bot/subscriptions', 'organizations_url': 'https://api.github.com/users/facebook-github-bot/orgs', 'repos_url': 'https://api.github.com/users/facebook-github-bot/repos', 'events_url': 'https://api.github.com/users/facebook-github-bot/events{/privacy}', 'received_events_url': 'https://api.github.com/users/facebook-github-bot/received_events', 'type': 'User', 'site_admin': False}",closed,593d74061fdd6468681b4b289814a2bd18003532,https://api.github.com/repos/pytorch/pytorch/commits/593d74061fdd6468681b4b289814a2bd18003532,2018-09-02T16:27:15Z,64,43,21
10353,1785816289,"{'login': 'facebook-github-bot', 'id': 6422482, 'node_id': 'MDQ6VXNlcjY0MjI0ODI=', 'avatar_url': 'https://avatars3.githubusercontent.com/u/6422482?v=4', 'gravatar_id': '', 'url': 'https://api.github.com/users/facebook-github-bot', 'html_url': 'https://github.com/facebook-github-bot', 'followers_url': 'https://api.github.com/users/facebook-github-bot/followers', 'following_url': 'https://api.github.com/users/facebook-github-bot/following{/other_user}', 'gists_url': 'https://api.github.com/users/facebook-github-bot/gists{/gist_id}', 'starred_url': 'https://api.github.com/users/facebook-github-bot/starred{/owner}{/repo}', 'subscriptions_url': 'https://api.github.com/users/facebook-github-bot/subscriptions', 'organizations_url': 'https://api.github.com/users/facebook-github-bot/orgs', 'repos_url': 'https://api.github.com/users/facebook-github-bot/repos', 'events_url': 'https://api.github.com/users/facebook-github-bot/events{/privacy}', 'received_events_url': 'https://api.github.com/users/facebook-github-bot/received_events', 'type': 'User', 'site_admin': False}",closed,64a6f17177732f459725ff64c6ba7c2db2c94bba,https://api.github.com/repos/pytorch/pytorch/commits/64a6f17177732f459725ff64c6ba7c2db2c94bba,2018-08-13T16:27:30Z,5,2,3
10345,1816321078,"{'login': 'facebook-github-bot', 'id': 6422482, 'node_id': 'MDQ6VXNlcjY0MjI0ODI=', 'avatar_url': 'https://avatars3.githubusercontent.com/u/6422482?v=4', 'gravatar_id': '', 'url': 'https://api.github.com/users/facebook-github-bot', 'html_url': 'https://github.com/facebook-github-bot', 'followers_url': 'https://api.github.com/users/facebook-github-bot/followers', 'following_url': 'https://api.github.com/users/facebook-github-bot/following{/other_user}', 'gists_url': 'https://api.github.com/users/facebook-github-bot/gists{/gist_id}', 'starred_url': 'https://api.github.com/users/facebook-github-bot/starred{/owner}{/repo}', 'subscriptions_url': 'https://api.github.com/users/facebook-github-bot/subscriptions', 'organizations_url': 'https://api.github.com/users/facebook-github-bot/orgs', 'repos_url': 'https://api.github.com/users/facebook-github-bot/repos', 'events_url': 'https://api.github.com/users/facebook-github-bot/events{/privacy}', 'received_events_url': 'https://api.github.com/users/facebook-github-bot/received_events', 'type': 'User', 'site_admin': False}",closed,a9469c9c8ab046a7961c1c357d84f60063507c4b,https://api.github.com/repos/pytorch/pytorch/commits/a9469c9c8ab046a7961c1c357d84f60063507c4b,2018-08-29T17:56:38Z,59,38,21
10307,1816165188,"{'login': 'facebook-github-bot', 'id': 6422482, 'node_id': 'MDQ6VXNlcjY0MjI0ODI=', 'avatar_url': 'https://avatars3.githubusercontent.com/u/6422482?v=4', 'gravatar_id': '', 'url': 'https://api.github.com/users/facebook-github-bot', 'html_url': 'https://github.com/facebook-github-bot', 'followers_url': 'https://api.github.com/users/facebook-github-bot/followers', 'following_url': 'https://api.github.com/users/facebook-github-bot/following{/other_user}', 'gists_url': 'https://api.github.com/users/facebook-github-bot/gists{/gist_id}', 'starred_url': 'https://api.github.com/users/facebook-github-bot/starred{/owner}{/repo}', 'subscriptions_url': 'https://api.github.com/users/facebook-github-bot/subscriptions', 'organizations_url': 'https://api.github.com/users/facebook-github-bot/orgs', 'repos_url': 'https://api.github.com/users/facebook-github-bot/repos', 'events_url': 'https://api.github.com/users/facebook-github-bot/events{/privacy}', 'received_events_url': 'https://api.github.com/users/facebook-github-bot/received_events', 'type': 'User', 'site_admin': False}",closed,7169906249fb57e0a9be00902abcb26457dcc14c,https://api.github.com/repos/pytorch/pytorch/commits/7169906249fb57e0a9be00902abcb26457dcc14c,2018-08-29T16:44:33Z,21,21,0
10276,1781032252,"{'login': 'facebook-github-bot', 'id': 6422482, 'node_id': 'MDQ6VXNlcjY0MjI0ODI=', 'avatar_url': 'https://avatars3.githubusercontent.com/u/6422482?v=4', 'gravatar_id': '', 'url': 'https://api.github.com/users/facebook-github-bot', 'html_url': 'https://github.com/facebook-github-bot', 'followers_url': 'https://api.github.com/users/facebook-github-bot/followers', 'following_url': 'https://api.github.com/users/facebook-github-bot/following{/other_user}', 'gists_url': 'https://api.github.com/users/facebook-github-bot/gists{/gist_id}', 'starred_url': 'https://api.github.com/users/facebook-github-bot/starred{/owner}{/repo}', 'subscriptions_url': 'https://api.github.com/users/facebook-github-bot/subscriptions', 'organizations_url': 'https://api.github.com/users/facebook-github-bot/orgs', 'repos_url': 'https://api.github.com/users/facebook-github-bot/repos', 'events_url': 'https://api.github.com/users/facebook-github-bot/events{/privacy}', 'received_events_url': 'https://api.github.com/users/facebook-github-bot/received_events', 'type': 'User', 'site_admin': False}",closed,64a60030a619ab656666be49aa332a96d8094845,https://api.github.com/repos/pytorch/pytorch/commits/64a60030a619ab656666be49aa332a96d8094845,2018-08-09T19:42:07Z,67,29,38
10270,1779269091,"{'login': 'facebook-github-bot', 'id': 6422482, 'node_id': 'MDQ6VXNlcjY0MjI0ODI=', 'avatar_url': 'https://avatars3.githubusercontent.com/u/6422482?v=4', 'gravatar_id': '', 'url': 'https://api.github.com/users/facebook-github-bot', 'html_url': 'https://github.com/facebook-github-bot', 'followers_url': 'https://api.github.com/users/facebook-github-bot/followers', 'following_url': 'https://api.github.com/users/facebook-github-bot/following{/other_user}', 'gists_url': 'https://api.github.com/users/facebook-github-bot/gists{/gist_id}', 'starred_url': 'https://api.github.com/users/facebook-github-bot/starred{/owner}{/repo}', 'subscriptions_url': 'https://api.github.com/users/facebook-github-bot/subscriptions', 'organizations_url': 'https://api.github.com/users/facebook-github-bot/orgs', 'repos_url': 'https://api.github.com/users/facebook-github-bot/repos', 'events_url': 'https://api.github.com/users/facebook-github-bot/events{/privacy}', 'received_events_url': 'https://api.github.com/users/facebook-github-bot/received_events', 'type': 'User', 'site_admin': False}",closed,6e49f933ad01ccd9064e5ef3d433c7aefcfe3d86,https://api.github.com/repos/pytorch/pytorch/commits/6e49f933ad01ccd9064e5ef3d433c7aefcfe3d86,2018-08-09T04:14:02Z,7,7,0
10258,2071088939,"{'login': 'facebook-github-bot', 'id': 6422482, 'node_id': 'MDQ6VXNlcjY0MjI0ODI=', 'avatar_url': 'https://avatars3.githubusercontent.com/u/6422482?v=4', 'gravatar_id': '', 'url': 'https://api.github.com/users/facebook-github-bot', 'html_url': 'https://github.com/facebook-github-bot', 'followers_url': 'https://api.github.com/users/facebook-github-bot/followers', 'following_url': 'https://api.github.com/users/facebook-github-bot/following{/other_user}', 'gists_url': 'https://api.github.com/users/facebook-github-bot/gists{/gist_id}', 'starred_url': 'https://api.github.com/users/facebook-github-bot/starred{/owner}{/repo}', 'subscriptions_url': 'https://api.github.com/users/facebook-github-bot/subscriptions', 'organizations_url': 'https://api.github.com/users/facebook-github-bot/orgs', 'repos_url': 'https://api.github.com/users/facebook-github-bot/repos', 'events_url': 'https://api.github.com/users/facebook-github-bot/events{/privacy}', 'received_events_url': 'https://api.github.com/users/facebook-github-bot/received_events', 'type': 'User', 'site_admin': False}",referenced,492b7d410b03fef9b0438f64fb5d4383402b973e,https://api.github.com/repos/pytorch/pytorch/commits/492b7d410b03fef9b0438f64fb5d4383402b973e,2019-01-14T07:40:00Z,10,5,5
10241,1783341952,"{'login': 'facebook-github-bot', 'id': 6422482, 'node_id': 'MDQ6VXNlcjY0MjI0ODI=', 'avatar_url': 'https://avatars3.githubusercontent.com/u/6422482?v=4', 'gravatar_id': '', 'url': 'https://api.github.com/users/facebook-github-bot', 'html_url': 'https://github.com/facebook-github-bot', 'followers_url': 'https://api.github.com/users/facebook-github-bot/followers', 'following_url': 'https://api.github.com/users/facebook-github-bot/following{/other_user}', 'gists_url': 'https://api.github.com/users/facebook-github-bot/gists{/gist_id}', 'starred_url': 'https://api.github.com/users/facebook-github-bot/starred{/owner}{/repo}', 'subscriptions_url': 'https://api.github.com/users/facebook-github-bot/subscriptions', 'organizations_url': 'https://api.github.com/users/facebook-github-bot/orgs', 'repos_url': 'https://api.github.com/users/facebook-github-bot/repos', 'events_url': 'https://api.github.com/users/facebook-github-bot/events{/privacy}', 'received_events_url': 'https://api.github.com/users/facebook-github-bot/received_events', 'type': 'User', 'site_admin': False}",closed,0b8a0125ab1c7af1d518c0018cf5596f24c1d55a,https://api.github.com/repos/pytorch/pytorch/commits/0b8a0125ab1c7af1d518c0018cf5596f24c1d55a,2018-08-10T20:40:41Z,22,19,3
10238,1790851859,"{'login': 'facebook-github-bot', 'id': 6422482, 'node_id': 'MDQ6VXNlcjY0MjI0ODI=', 'avatar_url': 'https://avatars3.githubusercontent.com/u/6422482?v=4', 'gravatar_id': '', 'url': 'https://api.github.com/users/facebook-github-bot', 'html_url': 'https://github.com/facebook-github-bot', 'followers_url': 'https://api.github.com/users/facebook-github-bot/followers', 'following_url': 'https://api.github.com/users/facebook-github-bot/following{/other_user}', 'gists_url': 'https://api.github.com/users/facebook-github-bot/gists{/gist_id}', 'starred_url': 'https://api.github.com/users/facebook-github-bot/starred{/owner}{/repo}', 'subscriptions_url': 'https://api.github.com/users/facebook-github-bot/subscriptions', 'organizations_url': 'https://api.github.com/users/facebook-github-bot/orgs', 'repos_url': 'https://api.github.com/users/facebook-github-bot/repos', 'events_url': 'https://api.github.com/users/facebook-github-bot/events{/privacy}', 'received_events_url': 'https://api.github.com/users/facebook-github-bot/received_events', 'type': 'User', 'site_admin': False}",closed,254dedf6043d5bea7dab6d1f663bcf9331628307,https://api.github.com/repos/pytorch/pytorch/commits/254dedf6043d5bea7dab6d1f663bcf9331628307,2018-08-15T20:00:54Z,18,10,8
10237,1822127002,"{'login': 'facebook-github-bot', 'id': 6422482, 'node_id': 'MDQ6VXNlcjY0MjI0ODI=', 'avatar_url': 'https://avatars3.githubusercontent.com/u/6422482?v=4', 'gravatar_id': '', 'url': 'https://api.github.com/users/facebook-github-bot', 'html_url': 'https://github.com/facebook-github-bot', 'followers_url': 'https://api.github.com/users/facebook-github-bot/followers', 'following_url': 'https://api.github.com/users/facebook-github-bot/following{/other_user}', 'gists_url': 'https://api.github.com/users/facebook-github-bot/gists{/gist_id}', 'starred_url': 'https://api.github.com/users/facebook-github-bot/starred{/owner}{/repo}', 'subscriptions_url': 'https://api.github.com/users/facebook-github-bot/subscriptions', 'organizations_url': 'https://api.github.com/users/facebook-github-bot/orgs', 'repos_url': 'https://api.github.com/users/facebook-github-bot/repos', 'events_url': 'https://api.github.com/users/facebook-github-bot/events{/privacy}', 'received_events_url': 'https://api.github.com/users/facebook-github-bot/received_events', 'type': 'User', 'site_admin': False}",closed,1350f76b628bd4630439223adbe21ee993873f44,https://api.github.com/repos/pytorch/pytorch/commits/1350f76b628bd4630439223adbe21ee993873f44,2018-09-02T06:10:30Z,99,85,14
10236,1856383108,"{'login': 'facebook-github-bot', 'id': 6422482, 'node_id': 'MDQ6VXNlcjY0MjI0ODI=', 'avatar_url': 'https://avatars3.githubusercontent.com/u/6422482?v=4', 'gravatar_id': '', 'url': 'https://api.github.com/users/facebook-github-bot', 'html_url': 'https://github.com/facebook-github-bot', 'followers_url': 'https://api.github.com/users/facebook-github-bot/followers', 'following_url': 'https://api.github.com/users/facebook-github-bot/following{/other_user}', 'gists_url': 'https://api.github.com/users/facebook-github-bot/gists{/gist_id}', 'starred_url': 'https://api.github.com/users/facebook-github-bot/starred{/owner}{/repo}', 'subscriptions_url': 'https://api.github.com/users/facebook-github-bot/subscriptions', 'organizations_url': 'https://api.github.com/users/facebook-github-bot/orgs', 'repos_url': 'https://api.github.com/users/facebook-github-bot/repos', 'events_url': 'https://api.github.com/users/facebook-github-bot/events{/privacy}', 'received_events_url': 'https://api.github.com/users/facebook-github-bot/received_events', 'type': 'User', 'site_admin': False}",referenced,24e958a0a779e3dcd7bda19ef3fa702ee654e9dc,https://api.github.com/repos/pytorch/pytorch/commits/24e958a0a779e3dcd7bda19ef3fa702ee654e9dc,2018-09-19T23:47:20Z,1721,1098,623
10206,1771783974,"{'login': 'facebook-github-bot', 'id': 6422482, 'node_id': 'MDQ6VXNlcjY0MjI0ODI=', 'avatar_url': 'https://avatars3.githubusercontent.com/u/6422482?v=4', 'gravatar_id': '', 'url': 'https://api.github.com/users/facebook-github-bot', 'html_url': 'https://github.com/facebook-github-bot', 'followers_url': 'https://api.github.com/users/facebook-github-bot/followers', 'following_url': 'https://api.github.com/users/facebook-github-bot/following{/other_user}', 'gists_url': 'https://api.github.com/users/facebook-github-bot/gists{/gist_id}', 'starred_url': 'https://api.github.com/users/facebook-github-bot/starred{/owner}{/repo}', 'subscriptions_url': 'https://api.github.com/users/facebook-github-bot/subscriptions', 'organizations_url': 'https://api.github.com/users/facebook-github-bot/orgs', 'repos_url': 'https://api.github.com/users/facebook-github-bot/repos', 'events_url': 'https://api.github.com/users/facebook-github-bot/events{/privacy}', 'received_events_url': 'https://api.github.com/users/facebook-github-bot/received_events', 'type': 'User', 'site_admin': False}",referenced,df23bdc82da05f45037898d09662265876850698,https://api.github.com/repos/pytorch/pytorch/commits/df23bdc82da05f45037898d09662265876850698,2018-08-05T22:56:46Z,33,23,10
10160,1775805408,"{'login': 'facebook-github-bot', 'id': 6422482, 'node_id': 'MDQ6VXNlcjY0MjI0ODI=', 'avatar_url': 'https://avatars3.githubusercontent.com/u/6422482?v=4', 'gravatar_id': '', 'url': 'https://api.github.com/users/facebook-github-bot', 'html_url': 'https://github.com/facebook-github-bot', 'followers_url': 'https://api.github.com/users/facebook-github-bot/followers', 'following_url': 'https://api.github.com/users/facebook-github-bot/following{/other_user}', 'gists_url': 'https://api.github.com/users/facebook-github-bot/gists{/gist_id}', 'starred_url': 'https://api.github.com/users/facebook-github-bot/starred{/owner}{/repo}', 'subscriptions_url': 'https://api.github.com/users/facebook-github-bot/subscriptions', 'organizations_url': 'https://api.github.com/users/facebook-github-bot/orgs', 'repos_url': 'https://api.github.com/users/facebook-github-bot/repos', 'events_url': 'https://api.github.com/users/facebook-github-bot/events{/privacy}', 'received_events_url': 'https://api.github.com/users/facebook-github-bot/received_events', 'type': 'User', 'site_admin': False}",closed,fe68879832f1198c0e2edb24d6b7b415ab9c87ae,https://api.github.com/repos/pytorch/pytorch/commits/fe68879832f1198c0e2edb24d6b7b415ab9c87ae,2018-08-07T16:59:14Z,5,5,0
10127,2696508716,"{'login': 'facebook-github-bot', 'id': 6422482, 'node_id': 'MDQ6VXNlcjY0MjI0ODI=', 'avatar_url': 'https://avatars3.githubusercontent.com/u/6422482?v=4', 'gravatar_id': '', 'url': 'https://api.github.com/users/facebook-github-bot', 'html_url': 'https://github.com/facebook-github-bot', 'followers_url': 'https://api.github.com/users/facebook-github-bot/followers', 'following_url': 'https://api.github.com/users/facebook-github-bot/following{/other_user}', 'gists_url': 'https://api.github.com/users/facebook-github-bot/gists{/gist_id}', 'starred_url': 'https://api.github.com/users/facebook-github-bot/starred{/owner}{/repo}', 'subscriptions_url': 'https://api.github.com/users/facebook-github-bot/subscriptions', 'organizations_url': 'https://api.github.com/users/facebook-github-bot/orgs', 'repos_url': 'https://api.github.com/users/facebook-github-bot/repos', 'events_url': 'https://api.github.com/users/facebook-github-bot/events{/privacy}', 'received_events_url': 'https://api.github.com/users/facebook-github-bot/received_events', 'type': 'User', 'site_admin': False}",closed,d57124823bb97c0233c7e84b79eec019f497ee87,https://api.github.com/repos/pytorch/pytorch/commits/d57124823bb97c0233c7e84b79eec019f497ee87,2019-10-08T18:55:04Z,1,1,0
10120,1831664007,"{'login': 'facebook-github-bot', 'id': 6422482, 'node_id': 'MDQ6VXNlcjY0MjI0ODI=', 'avatar_url': 'https://avatars3.githubusercontent.com/u/6422482?v=4', 'gravatar_id': '', 'url': 'https://api.github.com/users/facebook-github-bot', 'html_url': 'https://github.com/facebook-github-bot', 'followers_url': 'https://api.github.com/users/facebook-github-bot/followers', 'following_url': 'https://api.github.com/users/facebook-github-bot/following{/other_user}', 'gists_url': 'https://api.github.com/users/facebook-github-bot/gists{/gist_id}', 'starred_url': 'https://api.github.com/users/facebook-github-bot/starred{/owner}{/repo}', 'subscriptions_url': 'https://api.github.com/users/facebook-github-bot/subscriptions', 'organizations_url': 'https://api.github.com/users/facebook-github-bot/orgs', 'repos_url': 'https://api.github.com/users/facebook-github-bot/repos', 'events_url': 'https://api.github.com/users/facebook-github-bot/events{/privacy}', 'received_events_url': 'https://api.github.com/users/facebook-github-bot/received_events', 'type': 'User', 'site_admin': False}",closed,49231ab0a8dc5381502d04a1ee3a32326fea93aa,https://api.github.com/repos/pytorch/pytorch/commits/49231ab0a8dc5381502d04a1ee3a32326fea93aa,2018-09-06T23:14:16Z,72,56,16
10114,1916955844,"{'login': 'facebook-github-bot', 'id': 6422482, 'node_id': 'MDQ6VXNlcjY0MjI0ODI=', 'avatar_url': 'https://avatars3.githubusercontent.com/u/6422482?v=4', 'gravatar_id': '', 'url': 'https://api.github.com/users/facebook-github-bot', 'html_url': 'https://github.com/facebook-github-bot', 'followers_url': 'https://api.github.com/users/facebook-github-bot/followers', 'following_url': 'https://api.github.com/users/facebook-github-bot/following{/other_user}', 'gists_url': 'https://api.github.com/users/facebook-github-bot/gists{/gist_id}', 'starred_url': 'https://api.github.com/users/facebook-github-bot/starred{/owner}{/repo}', 'subscriptions_url': 'https://api.github.com/users/facebook-github-bot/subscriptions', 'organizations_url': 'https://api.github.com/users/facebook-github-bot/orgs', 'repos_url': 'https://api.github.com/users/facebook-github-bot/repos', 'events_url': 'https://api.github.com/users/facebook-github-bot/events{/privacy}', 'received_events_url': 'https://api.github.com/users/facebook-github-bot/received_events', 'type': 'User', 'site_admin': False}",referenced,01227f3ba7f0bc261c574373d8780209bb07eedf,https://api.github.com/repos/pytorch/pytorch/commits/01227f3ba7f0bc261c574373d8780209bb07eedf,2018-10-22T03:21:59Z,2,2,0
10114,1933156766,"{'login': 'facebook-github-bot', 'id': 6422482, 'node_id': 'MDQ6VXNlcjY0MjI0ODI=', 'avatar_url': 'https://avatars3.githubusercontent.com/u/6422482?v=4', 'gravatar_id': '', 'url': 'https://api.github.com/users/facebook-github-bot', 'html_url': 'https://github.com/facebook-github-bot', 'followers_url': 'https://api.github.com/users/facebook-github-bot/followers', 'following_url': 'https://api.github.com/users/facebook-github-bot/following{/other_user}', 'gists_url': 'https://api.github.com/users/facebook-github-bot/gists{/gist_id}', 'starred_url': 'https://api.github.com/users/facebook-github-bot/starred{/owner}{/repo}', 'subscriptions_url': 'https://api.github.com/users/facebook-github-bot/subscriptions', 'organizations_url': 'https://api.github.com/users/facebook-github-bot/orgs', 'repos_url': 'https://api.github.com/users/facebook-github-bot/repos', 'events_url': 'https://api.github.com/users/facebook-github-bot/events{/privacy}', 'received_events_url': 'https://api.github.com/users/facebook-github-bot/received_events', 'type': 'User', 'site_admin': False}",closed,1c8a823b3b3b67e4e1bcf5d1102b6cfbda7cef15,https://api.github.com/repos/pytorch/pytorch/commits/1c8a823b3b3b67e4e1bcf5d1102b6cfbda7cef15,2018-10-29T18:57:34Z,95,66,29
10096,1795707102,"{'login': 'facebook-github-bot', 'id': 6422482, 'node_id': 'MDQ6VXNlcjY0MjI0ODI=', 'avatar_url': 'https://avatars3.githubusercontent.com/u/6422482?v=4', 'gravatar_id': '', 'url': 'https://api.github.com/users/facebook-github-bot', 'html_url': 'https://github.com/facebook-github-bot', 'followers_url': 'https://api.github.com/users/facebook-github-bot/followers', 'following_url': 'https://api.github.com/users/facebook-github-bot/following{/other_user}', 'gists_url': 'https://api.github.com/users/facebook-github-bot/gists{/gist_id}', 'starred_url': 'https://api.github.com/users/facebook-github-bot/starred{/owner}{/repo}', 'subscriptions_url': 'https://api.github.com/users/facebook-github-bot/subscriptions', 'organizations_url': 'https://api.github.com/users/facebook-github-bot/orgs', 'repos_url': 'https://api.github.com/users/facebook-github-bot/repos', 'events_url': 'https://api.github.com/users/facebook-github-bot/events{/privacy}', 'received_events_url': 'https://api.github.com/users/facebook-github-bot/received_events', 'type': 'User', 'site_admin': False}",closed,e29b5a1ea8a8564550537f5db2ea0d4c8c45476d,https://api.github.com/repos/pytorch/pytorch/commits/e29b5a1ea8a8564550537f5db2ea0d4c8c45476d,2018-08-17T23:05:14Z,389,306,83
10041,1766632726,"{'login': 'facebook-github-bot', 'id': 6422482, 'node_id': 'MDQ6VXNlcjY0MjI0ODI=', 'avatar_url': 'https://avatars3.githubusercontent.com/u/6422482?v=4', 'gravatar_id': '', 'url': 'https://api.github.com/users/facebook-github-bot', 'html_url': 'https://github.com/facebook-github-bot', 'followers_url': 'https://api.github.com/users/facebook-github-bot/followers', 'following_url': 'https://api.github.com/users/facebook-github-bot/following{/other_user}', 'gists_url': 'https://api.github.com/users/facebook-github-bot/gists{/gist_id}', 'starred_url': 'https://api.github.com/users/facebook-github-bot/starred{/owner}{/repo}', 'subscriptions_url': 'https://api.github.com/users/facebook-github-bot/subscriptions', 'organizations_url': 'https://api.github.com/users/facebook-github-bot/orgs', 'repos_url': 'https://api.github.com/users/facebook-github-bot/repos', 'events_url': 'https://api.github.com/users/facebook-github-bot/events{/privacy}', 'received_events_url': 'https://api.github.com/users/facebook-github-bot/received_events', 'type': 'User', 'site_admin': False}",closed,6b338c80264280b1c983ba49d0ffa43a499cd2fe,https://api.github.com/repos/pytorch/pytorch/commits/6b338c80264280b1c983ba49d0ffa43a499cd2fe,2018-08-02T02:19:30Z,96,65,31
10032,1771347724,"{'login': 'facebook-github-bot', 'id': 6422482, 'node_id': 'MDQ6VXNlcjY0MjI0ODI=', 'avatar_url': 'https://avatars3.githubusercontent.com/u/6422482?v=4', 'gravatar_id': '', 'url': 'https://api.github.com/users/facebook-github-bot', 'html_url': 'https://github.com/facebook-github-bot', 'followers_url': 'https://api.github.com/users/facebook-github-bot/followers', 'following_url': 'https://api.github.com/users/facebook-github-bot/following{/other_user}', 'gists_url': 'https://api.github.com/users/facebook-github-bot/gists{/gist_id}', 'starred_url': 'https://api.github.com/users/facebook-github-bot/starred{/owner}{/repo}', 'subscriptions_url': 'https://api.github.com/users/facebook-github-bot/subscriptions', 'organizations_url': 'https://api.github.com/users/facebook-github-bot/orgs', 'repos_url': 'https://api.github.com/users/facebook-github-bot/repos', 'events_url': 'https://api.github.com/users/facebook-github-bot/events{/privacy}', 'received_events_url': 'https://api.github.com/users/facebook-github-bot/received_events', 'type': 'User', 'site_admin': False}",closed,29406a2c4c36d3c155abed16cf75f26af44426d4,https://api.github.com/repos/pytorch/pytorch/commits/29406a2c4c36d3c155abed16cf75f26af44426d4,2018-08-04T18:40:07Z,10,6,4
10013,1803535495,"{'login': 'facebook-github-bot', 'id': 6422482, 'node_id': 'MDQ6VXNlcjY0MjI0ODI=', 'avatar_url': 'https://avatars3.githubusercontent.com/u/6422482?v=4', 'gravatar_id': '', 'url': 'https://api.github.com/users/facebook-github-bot', 'html_url': 'https://github.com/facebook-github-bot', 'followers_url': 'https://api.github.com/users/facebook-github-bot/followers', 'following_url': 'https://api.github.com/users/facebook-github-bot/following{/other_user}', 'gists_url': 'https://api.github.com/users/facebook-github-bot/gists{/gist_id}', 'starred_url': 'https://api.github.com/users/facebook-github-bot/starred{/owner}{/repo}', 'subscriptions_url': 'https://api.github.com/users/facebook-github-bot/subscriptions', 'organizations_url': 'https://api.github.com/users/facebook-github-bot/orgs', 'repos_url': 'https://api.github.com/users/facebook-github-bot/repos', 'events_url': 'https://api.github.com/users/facebook-github-bot/events{/privacy}', 'received_events_url': 'https://api.github.com/users/facebook-github-bot/received_events', 'type': 'User', 'site_admin': False}",closed,9767951ca8a0af26d3caf2e84a52b10f81b9c2cb,https://api.github.com/repos/pytorch/pytorch/commits/9767951ca8a0af26d3caf2e84a52b10f81b9c2cb,2018-08-22T19:41:10Z,34,17,17
10009,1763724226,"{'login': 'facebook-github-bot', 'id': 6422482, 'node_id': 'MDQ6VXNlcjY0MjI0ODI=', 'avatar_url': 'https://avatars3.githubusercontent.com/u/6422482?v=4', 'gravatar_id': '', 'url': 'https://api.github.com/users/facebook-github-bot', 'html_url': 'https://github.com/facebook-github-bot', 'followers_url': 'https://api.github.com/users/facebook-github-bot/followers', 'following_url': 'https://api.github.com/users/facebook-github-bot/following{/other_user}', 'gists_url': 'https://api.github.com/users/facebook-github-bot/gists{/gist_id}', 'starred_url': 'https://api.github.com/users/facebook-github-bot/starred{/owner}{/repo}', 'subscriptions_url': 'https://api.github.com/users/facebook-github-bot/subscriptions', 'organizations_url': 'https://api.github.com/users/facebook-github-bot/orgs', 'repos_url': 'https://api.github.com/users/facebook-github-bot/repos', 'events_url': 'https://api.github.com/users/facebook-github-bot/events{/privacy}', 'received_events_url': 'https://api.github.com/users/facebook-github-bot/received_events', 'type': 'User', 'site_admin': False}",closed,242280162546797b32d6911b781d2dc74bed7fbf,https://api.github.com/repos/pytorch/pytorch/commits/242280162546797b32d6911b781d2dc74bed7fbf,2018-07-31T20:41:01Z,16,9,7
9998,1775990620,"{'login': 'facebook-github-bot', 'id': 6422482, 'node_id': 'MDQ6VXNlcjY0MjI0ODI=', 'avatar_url': 'https://avatars3.githubusercontent.com/u/6422482?v=4', 'gravatar_id': '', 'url': 'https://api.github.com/users/facebook-github-bot', 'html_url': 'https://github.com/facebook-github-bot', 'followers_url': 'https://api.github.com/users/facebook-github-bot/followers', 'following_url': 'https://api.github.com/users/facebook-github-bot/following{/other_user}', 'gists_url': 'https://api.github.com/users/facebook-github-bot/gists{/gist_id}', 'starred_url': 'https://api.github.com/users/facebook-github-bot/starred{/owner}{/repo}', 'subscriptions_url': 'https://api.github.com/users/facebook-github-bot/subscriptions', 'organizations_url': 'https://api.github.com/users/facebook-github-bot/orgs', 'repos_url': 'https://api.github.com/users/facebook-github-bot/repos', 'events_url': 'https://api.github.com/users/facebook-github-bot/events{/privacy}', 'received_events_url': 'https://api.github.com/users/facebook-github-bot/received_events', 'type': 'User', 'site_admin': False}",closed,dcaafdd04b4c728d874402fa909d5dfdd47b7f0c,https://api.github.com/repos/pytorch/pytorch/commits/dcaafdd04b4c728d874402fa909d5dfdd47b7f0c,2018-08-07T18:25:52Z,8,6,2
9997,1816930402,"{'login': 'facebook-github-bot', 'id': 6422482, 'node_id': 'MDQ6VXNlcjY0MjI0ODI=', 'avatar_url': 'https://avatars3.githubusercontent.com/u/6422482?v=4', 'gravatar_id': '', 'url': 'https://api.github.com/users/facebook-github-bot', 'html_url': 'https://github.com/facebook-github-bot', 'followers_url': 'https://api.github.com/users/facebook-github-bot/followers', 'following_url': 'https://api.github.com/users/facebook-github-bot/following{/other_user}', 'gists_url': 'https://api.github.com/users/facebook-github-bot/gists{/gist_id}', 'starred_url': 'https://api.github.com/users/facebook-github-bot/starred{/owner}{/repo}', 'subscriptions_url': 'https://api.github.com/users/facebook-github-bot/subscriptions', 'organizations_url': 'https://api.github.com/users/facebook-github-bot/orgs', 'repos_url': 'https://api.github.com/users/facebook-github-bot/repos', 'events_url': 'https://api.github.com/users/facebook-github-bot/events{/privacy}', 'received_events_url': 'https://api.github.com/users/facebook-github-bot/received_events', 'type': 'User', 'site_admin': False}",referenced,2cc98d8df7365aa26eca555028035aef20da3088,https://api.github.com/repos/pytorch/pytorch/commits/2cc98d8df7365aa26eca555028035aef20da3088,2018-08-29T23:27:18Z,282,273,9
9996,1783367087,"{'login': 'facebook-github-bot', 'id': 6422482, 'node_id': 'MDQ6VXNlcjY0MjI0ODI=', 'avatar_url': 'https://avatars3.githubusercontent.com/u/6422482?v=4', 'gravatar_id': '', 'url': 'https://api.github.com/users/facebook-github-bot', 'html_url': 'https://github.com/facebook-github-bot', 'followers_url': 'https://api.github.com/users/facebook-github-bot/followers', 'following_url': 'https://api.github.com/users/facebook-github-bot/following{/other_user}', 'gists_url': 'https://api.github.com/users/facebook-github-bot/gists{/gist_id}', 'starred_url': 'https://api.github.com/users/facebook-github-bot/starred{/owner}{/repo}', 'subscriptions_url': 'https://api.github.com/users/facebook-github-bot/subscriptions', 'organizations_url': 'https://api.github.com/users/facebook-github-bot/orgs', 'repos_url': 'https://api.github.com/users/facebook-github-bot/repos', 'events_url': 'https://api.github.com/users/facebook-github-bot/events{/privacy}', 'received_events_url': 'https://api.github.com/users/facebook-github-bot/received_events', 'type': 'User', 'site_admin': False}",closed,674f7a977802776c58add622255134df4f38569b,https://api.github.com/repos/pytorch/pytorch/commits/674f7a977802776c58add622255134df4f38569b,2018-08-10T20:56:11Z,124,102,22
9984,1840076624,"{'login': 'facebook-github-bot', 'id': 6422482, 'node_id': 'MDQ6VXNlcjY0MjI0ODI=', 'avatar_url': 'https://avatars3.githubusercontent.com/u/6422482?v=4', 'gravatar_id': '', 'url': 'https://api.github.com/users/facebook-github-bot', 'html_url': 'https://github.com/facebook-github-bot', 'followers_url': 'https://api.github.com/users/facebook-github-bot/followers', 'following_url': 'https://api.github.com/users/facebook-github-bot/following{/other_user}', 'gists_url': 'https://api.github.com/users/facebook-github-bot/gists{/gist_id}', 'starred_url': 'https://api.github.com/users/facebook-github-bot/starred{/owner}{/repo}', 'subscriptions_url': 'https://api.github.com/users/facebook-github-bot/subscriptions', 'organizations_url': 'https://api.github.com/users/facebook-github-bot/orgs', 'repos_url': 'https://api.github.com/users/facebook-github-bot/repos', 'events_url': 'https://api.github.com/users/facebook-github-bot/events{/privacy}', 'received_events_url': 'https://api.github.com/users/facebook-github-bot/received_events', 'type': 'User', 'site_admin': False}",closed,54107ae8cf476b4ebe7c631f75273e0b014e748c,https://api.github.com/repos/pytorch/pytorch/commits/54107ae8cf476b4ebe7c631f75273e0b014e748c,2018-09-12T03:29:27Z,106,74,32
9981,1822135865,"{'login': 'facebook-github-bot', 'id': 6422482, 'node_id': 'MDQ6VXNlcjY0MjI0ODI=', 'avatar_url': 'https://avatars3.githubusercontent.com/u/6422482?v=4', 'gravatar_id': '', 'url': 'https://api.github.com/users/facebook-github-bot', 'html_url': 'https://github.com/facebook-github-bot', 'followers_url': 'https://api.github.com/users/facebook-github-bot/followers', 'following_url': 'https://api.github.com/users/facebook-github-bot/following{/other_user}', 'gists_url': 'https://api.github.com/users/facebook-github-bot/gists{/gist_id}', 'starred_url': 'https://api.github.com/users/facebook-github-bot/starred{/owner}{/repo}', 'subscriptions_url': 'https://api.github.com/users/facebook-github-bot/subscriptions', 'organizations_url': 'https://api.github.com/users/facebook-github-bot/orgs', 'repos_url': 'https://api.github.com/users/facebook-github-bot/repos', 'events_url': 'https://api.github.com/users/facebook-github-bot/events{/privacy}', 'received_events_url': 'https://api.github.com/users/facebook-github-bot/received_events', 'type': 'User', 'site_admin': False}",closed,4d28b65fb8978f1c34765d56f18c07042e70a43a,https://api.github.com/repos/pytorch/pytorch/commits/4d28b65fb8978f1c34765d56f18c07042e70a43a,2018-09-02T06:56:48Z,13,12,1
9977,1780571707,"{'login': 'facebook-github-bot', 'id': 6422482, 'node_id': 'MDQ6VXNlcjY0MjI0ODI=', 'avatar_url': 'https://avatars3.githubusercontent.com/u/6422482?v=4', 'gravatar_id': '', 'url': 'https://api.github.com/users/facebook-github-bot', 'html_url': 'https://github.com/facebook-github-bot', 'followers_url': 'https://api.github.com/users/facebook-github-bot/followers', 'following_url': 'https://api.github.com/users/facebook-github-bot/following{/other_user}', 'gists_url': 'https://api.github.com/users/facebook-github-bot/gists{/gist_id}', 'starred_url': 'https://api.github.com/users/facebook-github-bot/starred{/owner}{/repo}', 'subscriptions_url': 'https://api.github.com/users/facebook-github-bot/subscriptions', 'organizations_url': 'https://api.github.com/users/facebook-github-bot/orgs', 'repos_url': 'https://api.github.com/users/facebook-github-bot/repos', 'events_url': 'https://api.github.com/users/facebook-github-bot/events{/privacy}', 'received_events_url': 'https://api.github.com/users/facebook-github-bot/received_events', 'type': 'User', 'site_admin': False}",closed,52d85bedb7e5ea7ce4d81339060994b52765be46,https://api.github.com/repos/pytorch/pytorch/commits/52d85bedb7e5ea7ce4d81339060994b52765be46,2018-08-09T15:55:44Z,30,25,5
9963,1833640106,"{'login': 'facebook-github-bot', 'id': 6422482, 'node_id': 'MDQ6VXNlcjY0MjI0ODI=', 'avatar_url': 'https://avatars3.githubusercontent.com/u/6422482?v=4', 'gravatar_id': '', 'url': 'https://api.github.com/users/facebook-github-bot', 'html_url': 'https://github.com/facebook-github-bot', 'followers_url': 'https://api.github.com/users/facebook-github-bot/followers', 'following_url': 'https://api.github.com/users/facebook-github-bot/following{/other_user}', 'gists_url': 'https://api.github.com/users/facebook-github-bot/gists{/gist_id}', 'starred_url': 'https://api.github.com/users/facebook-github-bot/starred{/owner}{/repo}', 'subscriptions_url': 'https://api.github.com/users/facebook-github-bot/subscriptions', 'organizations_url': 'https://api.github.com/users/facebook-github-bot/orgs', 'repos_url': 'https://api.github.com/users/facebook-github-bot/repos', 'events_url': 'https://api.github.com/users/facebook-github-bot/events{/privacy}', 'received_events_url': 'https://api.github.com/users/facebook-github-bot/received_events', 'type': 'User', 'site_admin': False}",closed,733402bef4a470ec58086ac254da64920c385da2,https://api.github.com/repos/pytorch/pytorch/commits/733402bef4a470ec58086ac254da64920c385da2,2018-09-07T19:57:55Z,25,24,1
9941,2037507959,"{'login': 'facebook-github-bot', 'id': 6422482, 'node_id': 'MDQ6VXNlcjY0MjI0ODI=', 'avatar_url': 'https://avatars3.githubusercontent.com/u/6422482?v=4', 'gravatar_id': '', 'url': 'https://api.github.com/users/facebook-github-bot', 'html_url': 'https://github.com/facebook-github-bot', 'followers_url': 'https://api.github.com/users/facebook-github-bot/followers', 'following_url': 'https://api.github.com/users/facebook-github-bot/following{/other_user}', 'gists_url': 'https://api.github.com/users/facebook-github-bot/gists{/gist_id}', 'starred_url': 'https://api.github.com/users/facebook-github-bot/starred{/owner}{/repo}', 'subscriptions_url': 'https://api.github.com/users/facebook-github-bot/subscriptions', 'organizations_url': 'https://api.github.com/users/facebook-github-bot/orgs', 'repos_url': 'https://api.github.com/users/facebook-github-bot/repos', 'events_url': 'https://api.github.com/users/facebook-github-bot/events{/privacy}', 'received_events_url': 'https://api.github.com/users/facebook-github-bot/received_events', 'type': 'User', 'site_admin': False}",closed,b89b46abfb20fb726cd1bc921ebdf6586e80f262,https://api.github.com/repos/pytorch/pytorch/commits/b89b46abfb20fb726cd1bc921ebdf6586e80f262,2018-12-20T05:40:03Z,165,69,96
9940,1795571999,"{'login': 'facebook-github-bot', 'id': 6422482, 'node_id': 'MDQ6VXNlcjY0MjI0ODI=', 'avatar_url': 'https://avatars3.githubusercontent.com/u/6422482?v=4', 'gravatar_id': '', 'url': 'https://api.github.com/users/facebook-github-bot', 'html_url': 'https://github.com/facebook-github-bot', 'followers_url': 'https://api.github.com/users/facebook-github-bot/followers', 'following_url': 'https://api.github.com/users/facebook-github-bot/following{/other_user}', 'gists_url': 'https://api.github.com/users/facebook-github-bot/gists{/gist_id}', 'starred_url': 'https://api.github.com/users/facebook-github-bot/starred{/owner}{/repo}', 'subscriptions_url': 'https://api.github.com/users/facebook-github-bot/subscriptions', 'organizations_url': 'https://api.github.com/users/facebook-github-bot/orgs', 'repos_url': 'https://api.github.com/users/facebook-github-bot/repos', 'events_url': 'https://api.github.com/users/facebook-github-bot/events{/privacy}', 'received_events_url': 'https://api.github.com/users/facebook-github-bot/received_events', 'type': 'User', 'site_admin': False}",referenced,86c9856d9c878631e611de0e138bc409228bbfef,https://api.github.com/repos/pytorch/pytorch/commits/86c9856d9c878631e611de0e138bc409228bbfef,2018-08-17T21:11:31Z,468,300,168
9940,2223797857,"{'login': 'facebook-github-bot', 'id': 6422482, 'node_id': 'MDQ6VXNlcjY0MjI0ODI=', 'avatar_url': 'https://avatars3.githubusercontent.com/u/6422482?v=4', 'gravatar_id': '', 'url': 'https://api.github.com/users/facebook-github-bot', 'html_url': 'https://github.com/facebook-github-bot', 'followers_url': 'https://api.github.com/users/facebook-github-bot/followers', 'following_url': 'https://api.github.com/users/facebook-github-bot/following{/other_user}', 'gists_url': 'https://api.github.com/users/facebook-github-bot/gists{/gist_id}', 'starred_url': 'https://api.github.com/users/facebook-github-bot/starred{/owner}{/repo}', 'subscriptions_url': 'https://api.github.com/users/facebook-github-bot/subscriptions', 'organizations_url': 'https://api.github.com/users/facebook-github-bot/orgs', 'repos_url': 'https://api.github.com/users/facebook-github-bot/repos', 'events_url': 'https://api.github.com/users/facebook-github-bot/events{/privacy}', 'received_events_url': 'https://api.github.com/users/facebook-github-bot/received_events', 'type': 'User', 'site_admin': False}",closed,ed47b85d3bd9c33ed723d2ae5309bebb4d619ac6,https://api.github.com/repos/pytorch/pytorch/commits/ed47b85d3bd9c33ed723d2ae5309bebb4d619ac6,2019-03-22T20:54:23Z,125,93,32
9935,1846528352,"{'login': 'facebook-github-bot', 'id': 6422482, 'node_id': 'MDQ6VXNlcjY0MjI0ODI=', 'avatar_url': 'https://avatars3.githubusercontent.com/u/6422482?v=4', 'gravatar_id': '', 'url': 'https://api.github.com/users/facebook-github-bot', 'html_url': 'https://github.com/facebook-github-bot', 'followers_url': 'https://api.github.com/users/facebook-github-bot/followers', 'following_url': 'https://api.github.com/users/facebook-github-bot/following{/other_user}', 'gists_url': 'https://api.github.com/users/facebook-github-bot/gists{/gist_id}', 'starred_url': 'https://api.github.com/users/facebook-github-bot/starred{/owner}{/repo}', 'subscriptions_url': 'https://api.github.com/users/facebook-github-bot/subscriptions', 'organizations_url': 'https://api.github.com/users/facebook-github-bot/orgs', 'repos_url': 'https://api.github.com/users/facebook-github-bot/repos', 'events_url': 'https://api.github.com/users/facebook-github-bot/events{/privacy}', 'received_events_url': 'https://api.github.com/users/facebook-github-bot/received_events', 'type': 'User', 'site_admin': False}",referenced,0d9b9100f977f677a0734af9096e9121ed85b337,https://api.github.com/repos/pytorch/pytorch/commits/0d9b9100f977f677a0734af9096e9121ed85b337,2018-09-14T16:26:06Z,8,4,4
9934,1790786023,"{'login': 'facebook-github-bot', 'id': 6422482, 'node_id': 'MDQ6VXNlcjY0MjI0ODI=', 'avatar_url': 'https://avatars3.githubusercontent.com/u/6422482?v=4', 'gravatar_id': '', 'url': 'https://api.github.com/users/facebook-github-bot', 'html_url': 'https://github.com/facebook-github-bot', 'followers_url': 'https://api.github.com/users/facebook-github-bot/followers', 'following_url': 'https://api.github.com/users/facebook-github-bot/following{/other_user}', 'gists_url': 'https://api.github.com/users/facebook-github-bot/gists{/gist_id}', 'starred_url': 'https://api.github.com/users/facebook-github-bot/starred{/owner}{/repo}', 'subscriptions_url': 'https://api.github.com/users/facebook-github-bot/subscriptions', 'organizations_url': 'https://api.github.com/users/facebook-github-bot/orgs', 'repos_url': 'https://api.github.com/users/facebook-github-bot/repos', 'events_url': 'https://api.github.com/users/facebook-github-bot/events{/privacy}', 'received_events_url': 'https://api.github.com/users/facebook-github-bot/received_events', 'type': 'User', 'site_admin': False}",closed,5d27d687793f3d62a397b65f6f6218ee871e3dd9,https://api.github.com/repos/pytorch/pytorch/commits/5d27d687793f3d62a397b65f6f6218ee871e3dd9,2018-08-15T19:26:55Z,10,5,5
9930,1761101596,"{'login': 'facebook-github-bot', 'id': 6422482, 'node_id': 'MDQ6VXNlcjY0MjI0ODI=', 'avatar_url': 'https://avatars3.githubusercontent.com/u/6422482?v=4', 'gravatar_id': '', 'url': 'https://api.github.com/users/facebook-github-bot', 'html_url': 'https://github.com/facebook-github-bot', 'followers_url': 'https://api.github.com/users/facebook-github-bot/followers', 'following_url': 'https://api.github.com/users/facebook-github-bot/following{/other_user}', 'gists_url': 'https://api.github.com/users/facebook-github-bot/gists{/gist_id}', 'starred_url': 'https://api.github.com/users/facebook-github-bot/starred{/owner}{/repo}', 'subscriptions_url': 'https://api.github.com/users/facebook-github-bot/subscriptions', 'organizations_url': 'https://api.github.com/users/facebook-github-bot/orgs', 'repos_url': 'https://api.github.com/users/facebook-github-bot/repos', 'events_url': 'https://api.github.com/users/facebook-github-bot/events{/privacy}', 'received_events_url': 'https://api.github.com/users/facebook-github-bot/received_events', 'type': 'User', 'site_admin': False}",closed,faa96c1c47740823c79bd50832be41df52872ecd,https://api.github.com/repos/pytorch/pytorch/commits/faa96c1c47740823c79bd50832be41df52872ecd,2018-07-30T19:59:32Z,6,5,1
9929,1791104982,"{'login': 'facebook-github-bot', 'id': 6422482, 'node_id': 'MDQ6VXNlcjY0MjI0ODI=', 'avatar_url': 'https://avatars3.githubusercontent.com/u/6422482?v=4', 'gravatar_id': '', 'url': 'https://api.github.com/users/facebook-github-bot', 'html_url': 'https://github.com/facebook-github-bot', 'followers_url': 'https://api.github.com/users/facebook-github-bot/followers', 'following_url': 'https://api.github.com/users/facebook-github-bot/following{/other_user}', 'gists_url': 'https://api.github.com/users/facebook-github-bot/gists{/gist_id}', 'starred_url': 'https://api.github.com/users/facebook-github-bot/starred{/owner}{/repo}', 'subscriptions_url': 'https://api.github.com/users/facebook-github-bot/subscriptions', 'organizations_url': 'https://api.github.com/users/facebook-github-bot/orgs', 'repos_url': 'https://api.github.com/users/facebook-github-bot/repos', 'events_url': 'https://api.github.com/users/facebook-github-bot/events{/privacy}', 'received_events_url': 'https://api.github.com/users/facebook-github-bot/received_events', 'type': 'User', 'site_admin': False}",closed,151e7de893c00e11fb1de6b02b386087c1c21721,https://api.github.com/repos/pytorch/pytorch/commits/151e7de893c00e11fb1de6b02b386087c1c21721,2018-08-15T22:14:26Z,149,79,70
9917,1856383110,"{'login': 'facebook-github-bot', 'id': 6422482, 'node_id': 'MDQ6VXNlcjY0MjI0ODI=', 'avatar_url': 'https://avatars3.githubusercontent.com/u/6422482?v=4', 'gravatar_id': '', 'url': 'https://api.github.com/users/facebook-github-bot', 'html_url': 'https://github.com/facebook-github-bot', 'followers_url': 'https://api.github.com/users/facebook-github-bot/followers', 'following_url': 'https://api.github.com/users/facebook-github-bot/following{/other_user}', 'gists_url': 'https://api.github.com/users/facebook-github-bot/gists{/gist_id}', 'starred_url': 'https://api.github.com/users/facebook-github-bot/starred{/owner}{/repo}', 'subscriptions_url': 'https://api.github.com/users/facebook-github-bot/subscriptions', 'organizations_url': 'https://api.github.com/users/facebook-github-bot/orgs', 'repos_url': 'https://api.github.com/users/facebook-github-bot/repos', 'events_url': 'https://api.github.com/users/facebook-github-bot/events{/privacy}', 'received_events_url': 'https://api.github.com/users/facebook-github-bot/received_events', 'type': 'User', 'site_admin': False}",referenced,24e958a0a779e3dcd7bda19ef3fa702ee654e9dc,https://api.github.com/repos/pytorch/pytorch/commits/24e958a0a779e3dcd7bda19ef3fa702ee654e9dc,2018-09-19T23:47:20Z,1721,1098,623
9914,1775990641,"{'login': 'facebook-github-bot', 'id': 6422482, 'node_id': 'MDQ6VXNlcjY0MjI0ODI=', 'avatar_url': 'https://avatars3.githubusercontent.com/u/6422482?v=4', 'gravatar_id': '', 'url': 'https://api.github.com/users/facebook-github-bot', 'html_url': 'https://github.com/facebook-github-bot', 'followers_url': 'https://api.github.com/users/facebook-github-bot/followers', 'following_url': 'https://api.github.com/users/facebook-github-bot/following{/other_user}', 'gists_url': 'https://api.github.com/users/facebook-github-bot/gists{/gist_id}', 'starred_url': 'https://api.github.com/users/facebook-github-bot/starred{/owner}{/repo}', 'subscriptions_url': 'https://api.github.com/users/facebook-github-bot/subscriptions', 'organizations_url': 'https://api.github.com/users/facebook-github-bot/orgs', 'repos_url': 'https://api.github.com/users/facebook-github-bot/repos', 'events_url': 'https://api.github.com/users/facebook-github-bot/events{/privacy}', 'received_events_url': 'https://api.github.com/users/facebook-github-bot/received_events', 'type': 'User', 'site_admin': False}",closed,db7a2b1f0dade4d70e381cfd6a6f9887fd7ce067,https://api.github.com/repos/pytorch/pytorch/commits/db7a2b1f0dade4d70e381cfd6a6f9887fd7ce067,2018-08-07T18:25:53Z,15,9,6
9876,1756445511,"{'login': 'facebook-github-bot', 'id': 6422482, 'node_id': 'MDQ6VXNlcjY0MjI0ODI=', 'avatar_url': 'https://avatars3.githubusercontent.com/u/6422482?v=4', 'gravatar_id': '', 'url': 'https://api.github.com/users/facebook-github-bot', 'html_url': 'https://github.com/facebook-github-bot', 'followers_url': 'https://api.github.com/users/facebook-github-bot/followers', 'following_url': 'https://api.github.com/users/facebook-github-bot/following{/other_user}', 'gists_url': 'https://api.github.com/users/facebook-github-bot/gists{/gist_id}', 'starred_url': 'https://api.github.com/users/facebook-github-bot/starred{/owner}{/repo}', 'subscriptions_url': 'https://api.github.com/users/facebook-github-bot/subscriptions', 'organizations_url': 'https://api.github.com/users/facebook-github-bot/orgs', 'repos_url': 'https://api.github.com/users/facebook-github-bot/repos', 'events_url': 'https://api.github.com/users/facebook-github-bot/events{/privacy}', 'received_events_url': 'https://api.github.com/users/facebook-github-bot/received_events', 'type': 'User', 'site_admin': False}",closed,e41eb4332783ce32d26fdf3418688a583a5cc478,https://api.github.com/repos/pytorch/pytorch/commits/e41eb4332783ce32d26fdf3418688a583a5cc478,2018-07-27T03:56:16Z,10,2,8
9818,1758926665,"{'login': 'facebook-github-bot', 'id': 6422482, 'node_id': 'MDQ6VXNlcjY0MjI0ODI=', 'avatar_url': 'https://avatars3.githubusercontent.com/u/6422482?v=4', 'gravatar_id': '', 'url': 'https://api.github.com/users/facebook-github-bot', 'html_url': 'https://github.com/facebook-github-bot', 'followers_url': 'https://api.github.com/users/facebook-github-bot/followers', 'following_url': 'https://api.github.com/users/facebook-github-bot/following{/other_user}', 'gists_url': 'https://api.github.com/users/facebook-github-bot/gists{/gist_id}', 'starred_url': 'https://api.github.com/users/facebook-github-bot/starred{/owner}{/repo}', 'subscriptions_url': 'https://api.github.com/users/facebook-github-bot/subscriptions', 'organizations_url': 'https://api.github.com/users/facebook-github-bot/orgs', 'repos_url': 'https://api.github.com/users/facebook-github-bot/repos', 'events_url': 'https://api.github.com/users/facebook-github-bot/events{/privacy}', 'received_events_url': 'https://api.github.com/users/facebook-github-bot/received_events', 'type': 'User', 'site_admin': False}",closed,3d6015db0e7a43f21a6c7ef56454466ef149897d,https://api.github.com/repos/pytorch/pytorch/commits/3d6015db0e7a43f21a6c7ef56454466ef149897d,2018-07-29T15:25:02Z,8,6,2
9817,1756445510,"{'login': 'facebook-github-bot', 'id': 6422482, 'node_id': 'MDQ6VXNlcjY0MjI0ODI=', 'avatar_url': 'https://avatars3.githubusercontent.com/u/6422482?v=4', 'gravatar_id': '', 'url': 'https://api.github.com/users/facebook-github-bot', 'html_url': 'https://github.com/facebook-github-bot', 'followers_url': 'https://api.github.com/users/facebook-github-bot/followers', 'following_url': 'https://api.github.com/users/facebook-github-bot/following{/other_user}', 'gists_url': 'https://api.github.com/users/facebook-github-bot/gists{/gist_id}', 'starred_url': 'https://api.github.com/users/facebook-github-bot/starred{/owner}{/repo}', 'subscriptions_url': 'https://api.github.com/users/facebook-github-bot/subscriptions', 'organizations_url': 'https://api.github.com/users/facebook-github-bot/orgs', 'repos_url': 'https://api.github.com/users/facebook-github-bot/repos', 'events_url': 'https://api.github.com/users/facebook-github-bot/events{/privacy}', 'received_events_url': 'https://api.github.com/users/facebook-github-bot/received_events', 'type': 'User', 'site_admin': False}",closed,e41eb4332783ce32d26fdf3418688a583a5cc478,https://api.github.com/repos/pytorch/pytorch/commits/e41eb4332783ce32d26fdf3418688a583a5cc478,2018-07-27T03:56:16Z,10,2,8
9784,1766405390,"{'login': 'facebook-github-bot', 'id': 6422482, 'node_id': 'MDQ6VXNlcjY0MjI0ODI=', 'avatar_url': 'https://avatars3.githubusercontent.com/u/6422482?v=4', 'gravatar_id': '', 'url': 'https://api.github.com/users/facebook-github-bot', 'html_url': 'https://github.com/facebook-github-bot', 'followers_url': 'https://api.github.com/users/facebook-github-bot/followers', 'following_url': 'https://api.github.com/users/facebook-github-bot/following{/other_user}', 'gists_url': 'https://api.github.com/users/facebook-github-bot/gists{/gist_id}', 'starred_url': 'https://api.github.com/users/facebook-github-bot/starred{/owner}{/repo}', 'subscriptions_url': 'https://api.github.com/users/facebook-github-bot/subscriptions', 'organizations_url': 'https://api.github.com/users/facebook-github-bot/orgs', 'repos_url': 'https://api.github.com/users/facebook-github-bot/repos', 'events_url': 'https://api.github.com/users/facebook-github-bot/events{/privacy}', 'received_events_url': 'https://api.github.com/users/facebook-github-bot/received_events', 'type': 'User', 'site_admin': False}",referenced,1d427fd6f66b0822db62f30e7654cae95abfd207,https://api.github.com/repos/pytorch/pytorch/commits/1d427fd6f66b0822db62f30e7654cae95abfd207,2018-08-01T22:36:07Z,79,57,22
9784,1771068893,"{'login': 'facebook-github-bot', 'id': 6422482, 'node_id': 'MDQ6VXNlcjY0MjI0ODI=', 'avatar_url': 'https://avatars3.githubusercontent.com/u/6422482?v=4', 'gravatar_id': '', 'url': 'https://api.github.com/users/facebook-github-bot', 'html_url': 'https://github.com/facebook-github-bot', 'followers_url': 'https://api.github.com/users/facebook-github-bot/followers', 'following_url': 'https://api.github.com/users/facebook-github-bot/following{/other_user}', 'gists_url': 'https://api.github.com/users/facebook-github-bot/gists{/gist_id}', 'starred_url': 'https://api.github.com/users/facebook-github-bot/starred{/owner}{/repo}', 'subscriptions_url': 'https://api.github.com/users/facebook-github-bot/subscriptions', 'organizations_url': 'https://api.github.com/users/facebook-github-bot/orgs', 'repos_url': 'https://api.github.com/users/facebook-github-bot/repos', 'events_url': 'https://api.github.com/users/facebook-github-bot/events{/privacy}', 'received_events_url': 'https://api.github.com/users/facebook-github-bot/received_events', 'type': 'User', 'site_admin': False}",closed,41dce17e223a19ad0fba571ab8bc7ea599698fd0,https://api.github.com/repos/pytorch/pytorch/commits/41dce17e223a19ad0fba571ab8bc7ea599698fd0,2018-08-04T01:26:35Z,136,91,45
9776,1757656774,"{'login': 'facebook-github-bot', 'id': 6422482, 'node_id': 'MDQ6VXNlcjY0MjI0ODI=', 'avatar_url': 'https://avatars3.githubusercontent.com/u/6422482?v=4', 'gravatar_id': '', 'url': 'https://api.github.com/users/facebook-github-bot', 'html_url': 'https://github.com/facebook-github-bot', 'followers_url': 'https://api.github.com/users/facebook-github-bot/followers', 'following_url': 'https://api.github.com/users/facebook-github-bot/following{/other_user}', 'gists_url': 'https://api.github.com/users/facebook-github-bot/gists{/gist_id}', 'starred_url': 'https://api.github.com/users/facebook-github-bot/starred{/owner}{/repo}', 'subscriptions_url': 'https://api.github.com/users/facebook-github-bot/subscriptions', 'organizations_url': 'https://api.github.com/users/facebook-github-bot/orgs', 'repos_url': 'https://api.github.com/users/facebook-github-bot/repos', 'events_url': 'https://api.github.com/users/facebook-github-bot/events{/privacy}', 'received_events_url': 'https://api.github.com/users/facebook-github-bot/received_events', 'type': 'User', 'site_admin': False}",closed,bf32ea80942ce720b105efcd517fd11182edeb08,https://api.github.com/repos/pytorch/pytorch/commits/bf32ea80942ce720b105efcd517fd11182edeb08,2018-07-27T16:25:09Z,4,2,2
9756,1781032240,"{'login': 'facebook-github-bot', 'id': 6422482, 'node_id': 'MDQ6VXNlcjY0MjI0ODI=', 'avatar_url': 'https://avatars3.githubusercontent.com/u/6422482?v=4', 'gravatar_id': '', 'url': 'https://api.github.com/users/facebook-github-bot', 'html_url': 'https://github.com/facebook-github-bot', 'followers_url': 'https://api.github.com/users/facebook-github-bot/followers', 'following_url': 'https://api.github.com/users/facebook-github-bot/following{/other_user}', 'gists_url': 'https://api.github.com/users/facebook-github-bot/gists{/gist_id}', 'starred_url': 'https://api.github.com/users/facebook-github-bot/starred{/owner}{/repo}', 'subscriptions_url': 'https://api.github.com/users/facebook-github-bot/subscriptions', 'organizations_url': 'https://api.github.com/users/facebook-github-bot/orgs', 'repos_url': 'https://api.github.com/users/facebook-github-bot/repos', 'events_url': 'https://api.github.com/users/facebook-github-bot/events{/privacy}', 'received_events_url': 'https://api.github.com/users/facebook-github-bot/received_events', 'type': 'User', 'site_admin': False}",closed,b43beec07079f64d7407b93e610eab5c0755d766,https://api.github.com/repos/pytorch/pytorch/commits/b43beec07079f64d7407b93e610eab5c0755d766,2018-08-09T19:42:06Z,17,13,4
9756,1791459990,"{'login': 'facebook-github-bot', 'id': 6422482, 'node_id': 'MDQ6VXNlcjY0MjI0ODI=', 'avatar_url': 'https://avatars3.githubusercontent.com/u/6422482?v=4', 'gravatar_id': '', 'url': 'https://api.github.com/users/facebook-github-bot', 'html_url': 'https://github.com/facebook-github-bot', 'followers_url': 'https://api.github.com/users/facebook-github-bot/followers', 'following_url': 'https://api.github.com/users/facebook-github-bot/following{/other_user}', 'gists_url': 'https://api.github.com/users/facebook-github-bot/gists{/gist_id}', 'starred_url': 'https://api.github.com/users/facebook-github-bot/starred{/owner}{/repo}', 'subscriptions_url': 'https://api.github.com/users/facebook-github-bot/subscriptions', 'organizations_url': 'https://api.github.com/users/facebook-github-bot/orgs', 'repos_url': 'https://api.github.com/users/facebook-github-bot/repos', 'events_url': 'https://api.github.com/users/facebook-github-bot/events{/privacy}', 'received_events_url': 'https://api.github.com/users/facebook-github-bot/received_events', 'type': 'User', 'site_admin': False}",referenced,8013dac43d2acb592cab75317f17d4f9c5b9eb6a,https://api.github.com/repos/pytorch/pytorch/commits/8013dac43d2acb592cab75317f17d4f9c5b9eb6a,2018-08-16T03:57:09Z,27,21,6
9754,1751027212,"{'login': 'facebook-github-bot', 'id': 6422482, 'node_id': 'MDQ6VXNlcjY0MjI0ODI=', 'avatar_url': 'https://avatars3.githubusercontent.com/u/6422482?v=4', 'gravatar_id': '', 'url': 'https://api.github.com/users/facebook-github-bot', 'html_url': 'https://github.com/facebook-github-bot', 'followers_url': 'https://api.github.com/users/facebook-github-bot/followers', 'following_url': 'https://api.github.com/users/facebook-github-bot/following{/other_user}', 'gists_url': 'https://api.github.com/users/facebook-github-bot/gists{/gist_id}', 'starred_url': 'https://api.github.com/users/facebook-github-bot/starred{/owner}{/repo}', 'subscriptions_url': 'https://api.github.com/users/facebook-github-bot/subscriptions', 'organizations_url': 'https://api.github.com/users/facebook-github-bot/orgs', 'repos_url': 'https://api.github.com/users/facebook-github-bot/repos', 'events_url': 'https://api.github.com/users/facebook-github-bot/events{/privacy}', 'received_events_url': 'https://api.github.com/users/facebook-github-bot/received_events', 'type': 'User', 'site_admin': False}",closed,7050d83dd728858cb1095788285316d1c3297b86,https://api.github.com/repos/pytorch/pytorch/commits/7050d83dd728858cb1095788285316d1c3297b86,2018-07-24T19:42:01Z,23,12,11
9743,1756255490,"{'login': 'facebook-github-bot', 'id': 6422482, 'node_id': 'MDQ6VXNlcjY0MjI0ODI=', 'avatar_url': 'https://avatars3.githubusercontent.com/u/6422482?v=4', 'gravatar_id': '', 'url': 'https://api.github.com/users/facebook-github-bot', 'html_url': 'https://github.com/facebook-github-bot', 'followers_url': 'https://api.github.com/users/facebook-github-bot/followers', 'following_url': 'https://api.github.com/users/facebook-github-bot/following{/other_user}', 'gists_url': 'https://api.github.com/users/facebook-github-bot/gists{/gist_id}', 'starred_url': 'https://api.github.com/users/facebook-github-bot/starred{/owner}{/repo}', 'subscriptions_url': 'https://api.github.com/users/facebook-github-bot/subscriptions', 'organizations_url': 'https://api.github.com/users/facebook-github-bot/orgs', 'repos_url': 'https://api.github.com/users/facebook-github-bot/repos', 'events_url': 'https://api.github.com/users/facebook-github-bot/events{/privacy}', 'received_events_url': 'https://api.github.com/users/facebook-github-bot/received_events', 'type': 'User', 'site_admin': False}",closed,9df9c46992d596cdbc74ef94ead6d628c8e54c08,https://api.github.com/repos/pytorch/pytorch/commits/9df9c46992d596cdbc74ef94ead6d628c8e54c08,2018-07-27T00:10:43Z,4,4,0
9702,1765450261,"{'login': 'facebook-github-bot', 'id': 6422482, 'node_id': 'MDQ6VXNlcjY0MjI0ODI=', 'avatar_url': 'https://avatars3.githubusercontent.com/u/6422482?v=4', 'gravatar_id': '', 'url': 'https://api.github.com/users/facebook-github-bot', 'html_url': 'https://github.com/facebook-github-bot', 'followers_url': 'https://api.github.com/users/facebook-github-bot/followers', 'following_url': 'https://api.github.com/users/facebook-github-bot/following{/other_user}', 'gists_url': 'https://api.github.com/users/facebook-github-bot/gists{/gist_id}', 'starred_url': 'https://api.github.com/users/facebook-github-bot/starred{/owner}{/repo}', 'subscriptions_url': 'https://api.github.com/users/facebook-github-bot/subscriptions', 'organizations_url': 'https://api.github.com/users/facebook-github-bot/orgs', 'repos_url': 'https://api.github.com/users/facebook-github-bot/repos', 'events_url': 'https://api.github.com/users/facebook-github-bot/events{/privacy}', 'received_events_url': 'https://api.github.com/users/facebook-github-bot/received_events', 'type': 'User', 'site_admin': False}",referenced,43b151224e5487eea00c7ce4e0efd442ee623715,https://api.github.com/repos/pytorch/pytorch/commits/43b151224e5487eea00c7ce4e0efd442ee623715,2018-08-01T14:55:49Z,3371,1688,1683
9702,1783248319,"{'login': 'facebook-github-bot', 'id': 6422482, 'node_id': 'MDQ6VXNlcjY0MjI0ODI=', 'avatar_url': 'https://avatars3.githubusercontent.com/u/6422482?v=4', 'gravatar_id': '', 'url': 'https://api.github.com/users/facebook-github-bot', 'html_url': 'https://github.com/facebook-github-bot', 'followers_url': 'https://api.github.com/users/facebook-github-bot/followers', 'following_url': 'https://api.github.com/users/facebook-github-bot/following{/other_user}', 'gists_url': 'https://api.github.com/users/facebook-github-bot/gists{/gist_id}', 'starred_url': 'https://api.github.com/users/facebook-github-bot/starred{/owner}{/repo}', 'subscriptions_url': 'https://api.github.com/users/facebook-github-bot/subscriptions', 'organizations_url': 'https://api.github.com/users/facebook-github-bot/orgs', 'repos_url': 'https://api.github.com/users/facebook-github-bot/repos', 'events_url': 'https://api.github.com/users/facebook-github-bot/events{/privacy}', 'received_events_url': 'https://api.github.com/users/facebook-github-bot/received_events', 'type': 'User', 'site_admin': False}",closed,6a55238a3ff4ae3dfdfe5d87cf35d92fcd10bf2a,https://api.github.com/repos/pytorch/pytorch/commits/6a55238a3ff4ae3dfdfe5d87cf35d92fcd10bf2a,2018-08-10T19:44:34Z,2446,1404,1042
9692,1845013949,"{'login': 'facebook-github-bot', 'id': 6422482, 'node_id': 'MDQ6VXNlcjY0MjI0ODI=', 'avatar_url': 'https://avatars3.githubusercontent.com/u/6422482?v=4', 'gravatar_id': '', 'url': 'https://api.github.com/users/facebook-github-bot', 'html_url': 'https://github.com/facebook-github-bot', 'followers_url': 'https://api.github.com/users/facebook-github-bot/followers', 'following_url': 'https://api.github.com/users/facebook-github-bot/following{/other_user}', 'gists_url': 'https://api.github.com/users/facebook-github-bot/gists{/gist_id}', 'starred_url': 'https://api.github.com/users/facebook-github-bot/starred{/owner}{/repo}', 'subscriptions_url': 'https://api.github.com/users/facebook-github-bot/subscriptions', 'organizations_url': 'https://api.github.com/users/facebook-github-bot/orgs', 'repos_url': 'https://api.github.com/users/facebook-github-bot/repos', 'events_url': 'https://api.github.com/users/facebook-github-bot/events{/privacy}', 'received_events_url': 'https://api.github.com/users/facebook-github-bot/received_events', 'type': 'User', 'site_admin': False}",referenced,760679352e8a6fda08b55c7e0cf2c916c7ed6d53,https://api.github.com/repos/pytorch/pytorch/commits/760679352e8a6fda08b55c7e0cf2c916c7ed6d53,2018-09-14T01:27:04Z,91,57,34
9687,2166346611,"{'login': 'facebook-github-bot', 'id': 6422482, 'node_id': 'MDQ6VXNlcjY0MjI0ODI=', 'avatar_url': 'https://avatars3.githubusercontent.com/u/6422482?v=4', 'gravatar_id': '', 'url': 'https://api.github.com/users/facebook-github-bot', 'html_url': 'https://github.com/facebook-github-bot', 'followers_url': 'https://api.github.com/users/facebook-github-bot/followers', 'following_url': 'https://api.github.com/users/facebook-github-bot/following{/other_user}', 'gists_url': 'https://api.github.com/users/facebook-github-bot/gists{/gist_id}', 'starred_url': 'https://api.github.com/users/facebook-github-bot/starred{/owner}{/repo}', 'subscriptions_url': 'https://api.github.com/users/facebook-github-bot/subscriptions', 'organizations_url': 'https://api.github.com/users/facebook-github-bot/orgs', 'repos_url': 'https://api.github.com/users/facebook-github-bot/repos', 'events_url': 'https://api.github.com/users/facebook-github-bot/events{/privacy}', 'received_events_url': 'https://api.github.com/users/facebook-github-bot/received_events', 'type': 'User', 'site_admin': False}",closed,4ca1a54526c3bb4583ffee1a0e75075750fabfbd,https://api.github.com/repos/pytorch/pytorch/commits/4ca1a54526c3bb4583ffee1a0e75075750fabfbd,2019-02-26T22:24:55Z,26,18,8
9677,1764126259,"{'login': 'facebook-github-bot', 'id': 6422482, 'node_id': 'MDQ6VXNlcjY0MjI0ODI=', 'avatar_url': 'https://avatars3.githubusercontent.com/u/6422482?v=4', 'gravatar_id': '', 'url': 'https://api.github.com/users/facebook-github-bot', 'html_url': 'https://github.com/facebook-github-bot', 'followers_url': 'https://api.github.com/users/facebook-github-bot/followers', 'following_url': 'https://api.github.com/users/facebook-github-bot/following{/other_user}', 'gists_url': 'https://api.github.com/users/facebook-github-bot/gists{/gist_id}', 'starred_url': 'https://api.github.com/users/facebook-github-bot/starred{/owner}{/repo}', 'subscriptions_url': 'https://api.github.com/users/facebook-github-bot/subscriptions', 'organizations_url': 'https://api.github.com/users/facebook-github-bot/orgs', 'repos_url': 'https://api.github.com/users/facebook-github-bot/repos', 'events_url': 'https://api.github.com/users/facebook-github-bot/events{/privacy}', 'received_events_url': 'https://api.github.com/users/facebook-github-bot/received_events', 'type': 'User', 'site_admin': False}",referenced,799c947cf3fc6edd50a78af65fa1342a2be0a5f6,https://api.github.com/repos/pytorch/pytorch/commits/799c947cf3fc6edd50a78af65fa1342a2be0a5f6,2018-08-01T01:39:40Z,1,1,0
9646,1819079644,"{'login': 'facebook-github-bot', 'id': 6422482, 'node_id': 'MDQ6VXNlcjY0MjI0ODI=', 'avatar_url': 'https://avatars3.githubusercontent.com/u/6422482?v=4', 'gravatar_id': '', 'url': 'https://api.github.com/users/facebook-github-bot', 'html_url': 'https://github.com/facebook-github-bot', 'followers_url': 'https://api.github.com/users/facebook-github-bot/followers', 'following_url': 'https://api.github.com/users/facebook-github-bot/following{/other_user}', 'gists_url': 'https://api.github.com/users/facebook-github-bot/gists{/gist_id}', 'starred_url': 'https://api.github.com/users/facebook-github-bot/starred{/owner}{/repo}', 'subscriptions_url': 'https://api.github.com/users/facebook-github-bot/subscriptions', 'organizations_url': 'https://api.github.com/users/facebook-github-bot/orgs', 'repos_url': 'https://api.github.com/users/facebook-github-bot/repos', 'events_url': 'https://api.github.com/users/facebook-github-bot/events{/privacy}', 'received_events_url': 'https://api.github.com/users/facebook-github-bot/received_events', 'type': 'User', 'site_admin': False}",referenced,9d4360c06090dfc68c91bc10ba1261469190ebec,https://api.github.com/repos/pytorch/pytorch/commits/9d4360c06090dfc68c91bc10ba1261469190ebec,2018-08-30T19:41:37Z,665,333,332
9642,1755470801,"{'login': 'facebook-github-bot', 'id': 6422482, 'node_id': 'MDQ6VXNlcjY0MjI0ODI=', 'avatar_url': 'https://avatars3.githubusercontent.com/u/6422482?v=4', 'gravatar_id': '', 'url': 'https://api.github.com/users/facebook-github-bot', 'html_url': 'https://github.com/facebook-github-bot', 'followers_url': 'https://api.github.com/users/facebook-github-bot/followers', 'following_url': 'https://api.github.com/users/facebook-github-bot/following{/other_user}', 'gists_url': 'https://api.github.com/users/facebook-github-bot/gists{/gist_id}', 'starred_url': 'https://api.github.com/users/facebook-github-bot/starred{/owner}{/repo}', 'subscriptions_url': 'https://api.github.com/users/facebook-github-bot/subscriptions', 'organizations_url': 'https://api.github.com/users/facebook-github-bot/orgs', 'repos_url': 'https://api.github.com/users/facebook-github-bot/repos', 'events_url': 'https://api.github.com/users/facebook-github-bot/events{/privacy}', 'received_events_url': 'https://api.github.com/users/facebook-github-bot/received_events', 'type': 'User', 'site_admin': False}",closed,2c7e7e37a60a294e1a0583b7d92bff6b1e61cf55,https://api.github.com/repos/pytorch/pytorch/commits/2c7e7e37a60a294e1a0583b7d92bff6b1e61cf55,2018-07-26T16:28:16Z,2,1,1
9589,1745001313,"{'login': 'facebook-github-bot', 'id': 6422482, 'node_id': 'MDQ6VXNlcjY0MjI0ODI=', 'avatar_url': 'https://avatars3.githubusercontent.com/u/6422482?v=4', 'gravatar_id': '', 'url': 'https://api.github.com/users/facebook-github-bot', 'html_url': 'https://github.com/facebook-github-bot', 'followers_url': 'https://api.github.com/users/facebook-github-bot/followers', 'following_url': 'https://api.github.com/users/facebook-github-bot/following{/other_user}', 'gists_url': 'https://api.github.com/users/facebook-github-bot/gists{/gist_id}', 'starred_url': 'https://api.github.com/users/facebook-github-bot/starred{/owner}{/repo}', 'subscriptions_url': 'https://api.github.com/users/facebook-github-bot/subscriptions', 'organizations_url': 'https://api.github.com/users/facebook-github-bot/orgs', 'repos_url': 'https://api.github.com/users/facebook-github-bot/repos', 'events_url': 'https://api.github.com/users/facebook-github-bot/events{/privacy}', 'received_events_url': 'https://api.github.com/users/facebook-github-bot/received_events', 'type': 'User', 'site_admin': False}",closed,bfe2aa093e17c84db863672ad446de064e47dc7e,https://api.github.com/repos/pytorch/pytorch/commits/bfe2aa093e17c84db863672ad446de064e47dc7e,2018-07-20T14:56:25Z,9,8,1
9554,1742933220,"{'login': 'facebook-github-bot', 'id': 6422482, 'node_id': 'MDQ6VXNlcjY0MjI0ODI=', 'avatar_url': 'https://avatars3.githubusercontent.com/u/6422482?v=4', 'gravatar_id': '', 'url': 'https://api.github.com/users/facebook-github-bot', 'html_url': 'https://github.com/facebook-github-bot', 'followers_url': 'https://api.github.com/users/facebook-github-bot/followers', 'following_url': 'https://api.github.com/users/facebook-github-bot/following{/other_user}', 'gists_url': 'https://api.github.com/users/facebook-github-bot/gists{/gist_id}', 'starred_url': 'https://api.github.com/users/facebook-github-bot/starred{/owner}{/repo}', 'subscriptions_url': 'https://api.github.com/users/facebook-github-bot/subscriptions', 'organizations_url': 'https://api.github.com/users/facebook-github-bot/orgs', 'repos_url': 'https://api.github.com/users/facebook-github-bot/repos', 'events_url': 'https://api.github.com/users/facebook-github-bot/events{/privacy}', 'received_events_url': 'https://api.github.com/users/facebook-github-bot/received_events', 'type': 'User', 'site_admin': False}",closed,e0446fcfa9d1129e66978d685056a7122e687bd6,https://api.github.com/repos/pytorch/pytorch/commits/e0446fcfa9d1129e66978d685056a7122e687bd6,2018-07-19T15:55:55Z,10,5,5
9546,1753052918,"{'login': 'facebook-github-bot', 'id': 6422482, 'node_id': 'MDQ6VXNlcjY0MjI0ODI=', 'avatar_url': 'https://avatars3.githubusercontent.com/u/6422482?v=4', 'gravatar_id': '', 'url': 'https://api.github.com/users/facebook-github-bot', 'html_url': 'https://github.com/facebook-github-bot', 'followers_url': 'https://api.github.com/users/facebook-github-bot/followers', 'following_url': 'https://api.github.com/users/facebook-github-bot/following{/other_user}', 'gists_url': 'https://api.github.com/users/facebook-github-bot/gists{/gist_id}', 'starred_url': 'https://api.github.com/users/facebook-github-bot/starred{/owner}{/repo}', 'subscriptions_url': 'https://api.github.com/users/facebook-github-bot/subscriptions', 'organizations_url': 'https://api.github.com/users/facebook-github-bot/orgs', 'repos_url': 'https://api.github.com/users/facebook-github-bot/repos', 'events_url': 'https://api.github.com/users/facebook-github-bot/events{/privacy}', 'received_events_url': 'https://api.github.com/users/facebook-github-bot/received_events', 'type': 'User', 'site_admin': False}",closed,ea67a2bd1160666ae238cdae294b74b56a2d7c73,https://api.github.com/repos/pytorch/pytorch/commits/ea67a2bd1160666ae238cdae294b74b56a2d7c73,2018-07-25T16:27:01Z,16,13,3
9534,1853973116,"{'login': 'facebook-github-bot', 'id': 6422482, 'node_id': 'MDQ6VXNlcjY0MjI0ODI=', 'avatar_url': 'https://avatars3.githubusercontent.com/u/6422482?v=4', 'gravatar_id': '', 'url': 'https://api.github.com/users/facebook-github-bot', 'html_url': 'https://github.com/facebook-github-bot', 'followers_url': 'https://api.github.com/users/facebook-github-bot/followers', 'following_url': 'https://api.github.com/users/facebook-github-bot/following{/other_user}', 'gists_url': 'https://api.github.com/users/facebook-github-bot/gists{/gist_id}', 'starred_url': 'https://api.github.com/users/facebook-github-bot/starred{/owner}{/repo}', 'subscriptions_url': 'https://api.github.com/users/facebook-github-bot/subscriptions', 'organizations_url': 'https://api.github.com/users/facebook-github-bot/orgs', 'repos_url': 'https://api.github.com/users/facebook-github-bot/repos', 'events_url': 'https://api.github.com/users/facebook-github-bot/events{/privacy}', 'received_events_url': 'https://api.github.com/users/facebook-github-bot/received_events', 'type': 'User', 'site_admin': False}",closed,8aedc27a6368c6a08038522c72b225f401e64e88,https://api.github.com/repos/pytorch/pytorch/commits/8aedc27a6368c6a08038522c72b225f401e64e88,2018-09-19T03:27:15Z,55,54,1
9513,1927571833,"{'login': 'facebook-github-bot', 'id': 6422482, 'node_id': 'MDQ6VXNlcjY0MjI0ODI=', 'avatar_url': 'https://avatars3.githubusercontent.com/u/6422482?v=4', 'gravatar_id': '', 'url': 'https://api.github.com/users/facebook-github-bot', 'html_url': 'https://github.com/facebook-github-bot', 'followers_url': 'https://api.github.com/users/facebook-github-bot/followers', 'following_url': 'https://api.github.com/users/facebook-github-bot/following{/other_user}', 'gists_url': 'https://api.github.com/users/facebook-github-bot/gists{/gist_id}', 'starred_url': 'https://api.github.com/users/facebook-github-bot/starred{/owner}{/repo}', 'subscriptions_url': 'https://api.github.com/users/facebook-github-bot/subscriptions', 'organizations_url': 'https://api.github.com/users/facebook-github-bot/orgs', 'repos_url': 'https://api.github.com/users/facebook-github-bot/repos', 'events_url': 'https://api.github.com/users/facebook-github-bot/events{/privacy}', 'received_events_url': 'https://api.github.com/users/facebook-github-bot/received_events', 'type': 'User', 'site_admin': False}",closed,4e1c64caee5037917f603c3683973667238c0163,https://api.github.com/repos/pytorch/pytorch/commits/4e1c64caee5037917f603c3683973667238c0163,2018-10-25T23:09:48Z,578,353,225
9507,1745001318,"{'login': 'facebook-github-bot', 'id': 6422482, 'node_id': 'MDQ6VXNlcjY0MjI0ODI=', 'avatar_url': 'https://avatars3.githubusercontent.com/u/6422482?v=4', 'gravatar_id': '', 'url': 'https://api.github.com/users/facebook-github-bot', 'html_url': 'https://github.com/facebook-github-bot', 'followers_url': 'https://api.github.com/users/facebook-github-bot/followers', 'following_url': 'https://api.github.com/users/facebook-github-bot/following{/other_user}', 'gists_url': 'https://api.github.com/users/facebook-github-bot/gists{/gist_id}', 'starred_url': 'https://api.github.com/users/facebook-github-bot/starred{/owner}{/repo}', 'subscriptions_url': 'https://api.github.com/users/facebook-github-bot/subscriptions', 'organizations_url': 'https://api.github.com/users/facebook-github-bot/orgs', 'repos_url': 'https://api.github.com/users/facebook-github-bot/repos', 'events_url': 'https://api.github.com/users/facebook-github-bot/events{/privacy}', 'received_events_url': 'https://api.github.com/users/facebook-github-bot/received_events', 'type': 'User', 'site_admin': False}",referenced,bfe2aa093e17c84db863672ad446de064e47dc7e,https://api.github.com/repos/pytorch/pytorch/commits/bfe2aa093e17c84db863672ad446de064e47dc7e,2018-07-20T14:56:25Z,9,8,1
9502,1745001321,"{'login': 'facebook-github-bot', 'id': 6422482, 'node_id': 'MDQ6VXNlcjY0MjI0ODI=', 'avatar_url': 'https://avatars3.githubusercontent.com/u/6422482?v=4', 'gravatar_id': '', 'url': 'https://api.github.com/users/facebook-github-bot', 'html_url': 'https://github.com/facebook-github-bot', 'followers_url': 'https://api.github.com/users/facebook-github-bot/followers', 'following_url': 'https://api.github.com/users/facebook-github-bot/following{/other_user}', 'gists_url': 'https://api.github.com/users/facebook-github-bot/gists{/gist_id}', 'starred_url': 'https://api.github.com/users/facebook-github-bot/starred{/owner}{/repo}', 'subscriptions_url': 'https://api.github.com/users/facebook-github-bot/subscriptions', 'organizations_url': 'https://api.github.com/users/facebook-github-bot/orgs', 'repos_url': 'https://api.github.com/users/facebook-github-bot/repos', 'events_url': 'https://api.github.com/users/facebook-github-bot/events{/privacy}', 'received_events_url': 'https://api.github.com/users/facebook-github-bot/received_events', 'type': 'User', 'site_admin': False}",referenced,bfe2aa093e17c84db863672ad446de064e47dc7e,https://api.github.com/repos/pytorch/pytorch/commits/bfe2aa093e17c84db863672ad446de064e47dc7e,2018-07-20T14:56:25Z,9,8,1
9479,1742970419,"{'login': 'facebook-github-bot', 'id': 6422482, 'node_id': 'MDQ6VXNlcjY0MjI0ODI=', 'avatar_url': 'https://avatars3.githubusercontent.com/u/6422482?v=4', 'gravatar_id': '', 'url': 'https://api.github.com/users/facebook-github-bot', 'html_url': 'https://github.com/facebook-github-bot', 'followers_url': 'https://api.github.com/users/facebook-github-bot/followers', 'following_url': 'https://api.github.com/users/facebook-github-bot/following{/other_user}', 'gists_url': 'https://api.github.com/users/facebook-github-bot/gists{/gist_id}', 'starred_url': 'https://api.github.com/users/facebook-github-bot/starred{/owner}{/repo}', 'subscriptions_url': 'https://api.github.com/users/facebook-github-bot/subscriptions', 'organizations_url': 'https://api.github.com/users/facebook-github-bot/orgs', 'repos_url': 'https://api.github.com/users/facebook-github-bot/repos', 'events_url': 'https://api.github.com/users/facebook-github-bot/events{/privacy}', 'received_events_url': 'https://api.github.com/users/facebook-github-bot/received_events', 'type': 'User', 'site_admin': False}",closed,aee9e90abd8e952253d61961db6dec1e229905fb,https://api.github.com/repos/pytorch/pytorch/commits/aee9e90abd8e952253d61961db6dec1e229905fb,2018-07-19T16:12:13Z,86,39,47
9447,1736415397,"{'login': 'facebook-github-bot', 'id': 6422482, 'node_id': 'MDQ6VXNlcjY0MjI0ODI=', 'avatar_url': 'https://avatars3.githubusercontent.com/u/6422482?v=4', 'gravatar_id': '', 'url': 'https://api.github.com/users/facebook-github-bot', 'html_url': 'https://github.com/facebook-github-bot', 'followers_url': 'https://api.github.com/users/facebook-github-bot/followers', 'following_url': 'https://api.github.com/users/facebook-github-bot/following{/other_user}', 'gists_url': 'https://api.github.com/users/facebook-github-bot/gists{/gist_id}', 'starred_url': 'https://api.github.com/users/facebook-github-bot/starred{/owner}{/repo}', 'subscriptions_url': 'https://api.github.com/users/facebook-github-bot/subscriptions', 'organizations_url': 'https://api.github.com/users/facebook-github-bot/orgs', 'repos_url': 'https://api.github.com/users/facebook-github-bot/repos', 'events_url': 'https://api.github.com/users/facebook-github-bot/events{/privacy}', 'received_events_url': 'https://api.github.com/users/facebook-github-bot/received_events', 'type': 'User', 'site_admin': False}",closed,976f9253a5425918eda7cf865b097cf42b5da8d7,https://api.github.com/repos/pytorch/pytorch/commits/976f9253a5425918eda7cf865b097cf42b5da8d7,2018-07-16T22:41:29Z,332,139,193
9421,1733973626,"{'login': 'facebook-github-bot', 'id': 6422482, 'node_id': 'MDQ6VXNlcjY0MjI0ODI=', 'avatar_url': 'https://avatars3.githubusercontent.com/u/6422482?v=4', 'gravatar_id': '', 'url': 'https://api.github.com/users/facebook-github-bot', 'html_url': 'https://github.com/facebook-github-bot', 'followers_url': 'https://api.github.com/users/facebook-github-bot/followers', 'following_url': 'https://api.github.com/users/facebook-github-bot/following{/other_user}', 'gists_url': 'https://api.github.com/users/facebook-github-bot/gists{/gist_id}', 'starred_url': 'https://api.github.com/users/facebook-github-bot/starred{/owner}{/repo}', 'subscriptions_url': 'https://api.github.com/users/facebook-github-bot/subscriptions', 'organizations_url': 'https://api.github.com/users/facebook-github-bot/orgs', 'repos_url': 'https://api.github.com/users/facebook-github-bot/repos', 'events_url': 'https://api.github.com/users/facebook-github-bot/events{/privacy}', 'received_events_url': 'https://api.github.com/users/facebook-github-bot/received_events', 'type': 'User', 'site_admin': False}",closed,8444e1660b66082e0ee399d95691921ed504252b,https://api.github.com/repos/pytorch/pytorch/commits/8444e1660b66082e0ee399d95691921ed504252b,2018-07-14T19:26:08Z,22,17,5
9419,1733973632,"{'login': 'facebook-github-bot', 'id': 6422482, 'node_id': 'MDQ6VXNlcjY0MjI0ODI=', 'avatar_url': 'https://avatars3.githubusercontent.com/u/6422482?v=4', 'gravatar_id': '', 'url': 'https://api.github.com/users/facebook-github-bot', 'html_url': 'https://github.com/facebook-github-bot', 'followers_url': 'https://api.github.com/users/facebook-github-bot/followers', 'following_url': 'https://api.github.com/users/facebook-github-bot/following{/other_user}', 'gists_url': 'https://api.github.com/users/facebook-github-bot/gists{/gist_id}', 'starred_url': 'https://api.github.com/users/facebook-github-bot/starred{/owner}{/repo}', 'subscriptions_url': 'https://api.github.com/users/facebook-github-bot/subscriptions', 'organizations_url': 'https://api.github.com/users/facebook-github-bot/orgs', 'repos_url': 'https://api.github.com/users/facebook-github-bot/repos', 'events_url': 'https://api.github.com/users/facebook-github-bot/events{/privacy}', 'received_events_url': 'https://api.github.com/users/facebook-github-bot/received_events', 'type': 'User', 'site_admin': False}",closed,a4f63576b6915a74cba5659d6699ca70e141fe70,https://api.github.com/repos/pytorch/pytorch/commits/a4f63576b6915a74cba5659d6699ca70e141fe70,2018-07-14T19:26:08Z,4,2,2
9418,1763570477,"{'login': 'facebook-github-bot', 'id': 6422482, 'node_id': 'MDQ6VXNlcjY0MjI0ODI=', 'avatar_url': 'https://avatars3.githubusercontent.com/u/6422482?v=4', 'gravatar_id': '', 'url': 'https://api.github.com/users/facebook-github-bot', 'html_url': 'https://github.com/facebook-github-bot', 'followers_url': 'https://api.github.com/users/facebook-github-bot/followers', 'following_url': 'https://api.github.com/users/facebook-github-bot/following{/other_user}', 'gists_url': 'https://api.github.com/users/facebook-github-bot/gists{/gist_id}', 'starred_url': 'https://api.github.com/users/facebook-github-bot/starred{/owner}{/repo}', 'subscriptions_url': 'https://api.github.com/users/facebook-github-bot/subscriptions', 'organizations_url': 'https://api.github.com/users/facebook-github-bot/orgs', 'repos_url': 'https://api.github.com/users/facebook-github-bot/repos', 'events_url': 'https://api.github.com/users/facebook-github-bot/events{/privacy}', 'received_events_url': 'https://api.github.com/users/facebook-github-bot/received_events', 'type': 'User', 'site_admin': False}",closed,371a786b18f9b39ac03fa4be6b59f5871c1f947a,https://api.github.com/repos/pytorch/pytorch/commits/371a786b18f9b39ac03fa4be6b59f5871c1f947a,2018-07-31T19:25:46Z,11,10,1
9416,1738086124,"{'login': 'facebook-github-bot', 'id': 6422482, 'node_id': 'MDQ6VXNlcjY0MjI0ODI=', 'avatar_url': 'https://avatars3.githubusercontent.com/u/6422482?v=4', 'gravatar_id': '', 'url': 'https://api.github.com/users/facebook-github-bot', 'html_url': 'https://github.com/facebook-github-bot', 'followers_url': 'https://api.github.com/users/facebook-github-bot/followers', 'following_url': 'https://api.github.com/users/facebook-github-bot/following{/other_user}', 'gists_url': 'https://api.github.com/users/facebook-github-bot/gists{/gist_id}', 'starred_url': 'https://api.github.com/users/facebook-github-bot/starred{/owner}{/repo}', 'subscriptions_url': 'https://api.github.com/users/facebook-github-bot/subscriptions', 'organizations_url': 'https://api.github.com/users/facebook-github-bot/orgs', 'repos_url': 'https://api.github.com/users/facebook-github-bot/repos', 'events_url': 'https://api.github.com/users/facebook-github-bot/events{/privacy}', 'received_events_url': 'https://api.github.com/users/facebook-github-bot/received_events', 'type': 'User', 'site_admin': False}",closed,52cc073212845419af788a97a3ae17a4f401e6fd,https://api.github.com/repos/pytorch/pytorch/commits/52cc073212845419af788a97a3ae17a4f401e6fd,2018-07-17T15:55:44Z,72,59,13
9412,1829339479,"{'login': 'facebook-github-bot', 'id': 6422482, 'node_id': 'MDQ6VXNlcjY0MjI0ODI=', 'avatar_url': 'https://avatars3.githubusercontent.com/u/6422482?v=4', 'gravatar_id': '', 'url': 'https://api.github.com/users/facebook-github-bot', 'html_url': 'https://github.com/facebook-github-bot', 'followers_url': 'https://api.github.com/users/facebook-github-bot/followers', 'following_url': 'https://api.github.com/users/facebook-github-bot/following{/other_user}', 'gists_url': 'https://api.github.com/users/facebook-github-bot/gists{/gist_id}', 'starred_url': 'https://api.github.com/users/facebook-github-bot/starred{/owner}{/repo}', 'subscriptions_url': 'https://api.github.com/users/facebook-github-bot/subscriptions', 'organizations_url': 'https://api.github.com/users/facebook-github-bot/orgs', 'repos_url': 'https://api.github.com/users/facebook-github-bot/repos', 'events_url': 'https://api.github.com/users/facebook-github-bot/events{/privacy}', 'received_events_url': 'https://api.github.com/users/facebook-github-bot/received_events', 'type': 'User', 'site_admin': False}",closed,83a1ab213652ffab27bd68569d6d28fead86e7bd,https://api.github.com/repos/pytorch/pytorch/commits/83a1ab213652ffab27bd68569d6d28fead86e7bd,2018-09-06T02:42:20Z,1346,1286,60
9409,1736415418,"{'login': 'facebook-github-bot', 'id': 6422482, 'node_id': 'MDQ6VXNlcjY0MjI0ODI=', 'avatar_url': 'https://avatars3.githubusercontent.com/u/6422482?v=4', 'gravatar_id': '', 'url': 'https://api.github.com/users/facebook-github-bot', 'html_url': 'https://github.com/facebook-github-bot', 'followers_url': 'https://api.github.com/users/facebook-github-bot/followers', 'following_url': 'https://api.github.com/users/facebook-github-bot/following{/other_user}', 'gists_url': 'https://api.github.com/users/facebook-github-bot/gists{/gist_id}', 'starred_url': 'https://api.github.com/users/facebook-github-bot/starred{/owner}{/repo}', 'subscriptions_url': 'https://api.github.com/users/facebook-github-bot/subscriptions', 'organizations_url': 'https://api.github.com/users/facebook-github-bot/orgs', 'repos_url': 'https://api.github.com/users/facebook-github-bot/repos', 'events_url': 'https://api.github.com/users/facebook-github-bot/events{/privacy}', 'received_events_url': 'https://api.github.com/users/facebook-github-bot/received_events', 'type': 'User', 'site_admin': False}",closed,5ff686651fecad791e845bf066d730a8b283e8d9,https://api.github.com/repos/pytorch/pytorch/commits/5ff686651fecad791e845bf066d730a8b283e8d9,2018-07-16T22:41:30Z,2,1,1
9404,1743248306,"{'login': 'facebook-github-bot', 'id': 6422482, 'node_id': 'MDQ6VXNlcjY0MjI0ODI=', 'avatar_url': 'https://avatars3.githubusercontent.com/u/6422482?v=4', 'gravatar_id': '', 'url': 'https://api.github.com/users/facebook-github-bot', 'html_url': 'https://github.com/facebook-github-bot', 'followers_url': 'https://api.github.com/users/facebook-github-bot/followers', 'following_url': 'https://api.github.com/users/facebook-github-bot/following{/other_user}', 'gists_url': 'https://api.github.com/users/facebook-github-bot/gists{/gist_id}', 'starred_url': 'https://api.github.com/users/facebook-github-bot/starred{/owner}{/repo}', 'subscriptions_url': 'https://api.github.com/users/facebook-github-bot/subscriptions', 'organizations_url': 'https://api.github.com/users/facebook-github-bot/orgs', 'repos_url': 'https://api.github.com/users/facebook-github-bot/repos', 'events_url': 'https://api.github.com/users/facebook-github-bot/events{/privacy}', 'received_events_url': 'https://api.github.com/users/facebook-github-bot/received_events', 'type': 'User', 'site_admin': False}",closed,f33cd36c9bb6d3eecd42cb185f22cf76e304fc1b,https://api.github.com/repos/pytorch/pytorch/commits/f33cd36c9bb6d3eecd42cb185f22cf76e304fc1b,2018-07-19T18:30:31Z,446,223,223
9395,1924981869,"{'login': 'facebook-github-bot', 'id': 6422482, 'node_id': 'MDQ6VXNlcjY0MjI0ODI=', 'avatar_url': 'https://avatars3.githubusercontent.com/u/6422482?v=4', 'gravatar_id': '', 'url': 'https://api.github.com/users/facebook-github-bot', 'html_url': 'https://github.com/facebook-github-bot', 'followers_url': 'https://api.github.com/users/facebook-github-bot/followers', 'following_url': 'https://api.github.com/users/facebook-github-bot/following{/other_user}', 'gists_url': 'https://api.github.com/users/facebook-github-bot/gists{/gist_id}', 'starred_url': 'https://api.github.com/users/facebook-github-bot/starred{/owner}{/repo}', 'subscriptions_url': 'https://api.github.com/users/facebook-github-bot/subscriptions', 'organizations_url': 'https://api.github.com/users/facebook-github-bot/orgs', 'repos_url': 'https://api.github.com/users/facebook-github-bot/repos', 'events_url': 'https://api.github.com/users/facebook-github-bot/events{/privacy}', 'received_events_url': 'https://api.github.com/users/facebook-github-bot/received_events', 'type': 'User', 'site_admin': False}",referenced,478886be308c5c14f5898bfe4d9833f4debba20a,https://api.github.com/repos/pytorch/pytorch/commits/478886be308c5c14f5898bfe4d9833f4debba20a,2018-10-25T01:14:13Z,194,120,74
9390,1745001332,"{'login': 'facebook-github-bot', 'id': 6422482, 'node_id': 'MDQ6VXNlcjY0MjI0ODI=', 'avatar_url': 'https://avatars3.githubusercontent.com/u/6422482?v=4', 'gravatar_id': '', 'url': 'https://api.github.com/users/facebook-github-bot', 'html_url': 'https://github.com/facebook-github-bot', 'followers_url': 'https://api.github.com/users/facebook-github-bot/followers', 'following_url': 'https://api.github.com/users/facebook-github-bot/following{/other_user}', 'gists_url': 'https://api.github.com/users/facebook-github-bot/gists{/gist_id}', 'starred_url': 'https://api.github.com/users/facebook-github-bot/starred{/owner}{/repo}', 'subscriptions_url': 'https://api.github.com/users/facebook-github-bot/subscriptions', 'organizations_url': 'https://api.github.com/users/facebook-github-bot/orgs', 'repos_url': 'https://api.github.com/users/facebook-github-bot/repos', 'events_url': 'https://api.github.com/users/facebook-github-bot/events{/privacy}', 'received_events_url': 'https://api.github.com/users/facebook-github-bot/received_events', 'type': 'User', 'site_admin': False}",referenced,bfe2aa093e17c84db863672ad446de064e47dc7e,https://api.github.com/repos/pytorch/pytorch/commits/bfe2aa093e17c84db863672ad446de064e47dc7e,2018-07-20T14:56:25Z,9,8,1
9383,1777789599,"{'login': 'facebook-github-bot', 'id': 6422482, 'node_id': 'MDQ6VXNlcjY0MjI0ODI=', 'avatar_url': 'https://avatars3.githubusercontent.com/u/6422482?v=4', 'gravatar_id': '', 'url': 'https://api.github.com/users/facebook-github-bot', 'html_url': 'https://github.com/facebook-github-bot', 'followers_url': 'https://api.github.com/users/facebook-github-bot/followers', 'following_url': 'https://api.github.com/users/facebook-github-bot/following{/other_user}', 'gists_url': 'https://api.github.com/users/facebook-github-bot/gists{/gist_id}', 'starred_url': 'https://api.github.com/users/facebook-github-bot/starred{/owner}{/repo}', 'subscriptions_url': 'https://api.github.com/users/facebook-github-bot/subscriptions', 'organizations_url': 'https://api.github.com/users/facebook-github-bot/orgs', 'repos_url': 'https://api.github.com/users/facebook-github-bot/repos', 'events_url': 'https://api.github.com/users/facebook-github-bot/events{/privacy}', 'received_events_url': 'https://api.github.com/users/facebook-github-bot/received_events', 'type': 'User', 'site_admin': False}",closed,69760e2840f1143ff16a7071e822716f55c59c23,https://api.github.com/repos/pytorch/pytorch/commits/69760e2840f1143ff16a7071e822716f55c59c23,2018-08-08T13:45:00Z,16,13,3
9378,1750968546,"{'login': 'facebook-github-bot', 'id': 6422482, 'node_id': 'MDQ6VXNlcjY0MjI0ODI=', 'avatar_url': 'https://avatars3.githubusercontent.com/u/6422482?v=4', 'gravatar_id': '', 'url': 'https://api.github.com/users/facebook-github-bot', 'html_url': 'https://github.com/facebook-github-bot', 'followers_url': 'https://api.github.com/users/facebook-github-bot/followers', 'following_url': 'https://api.github.com/users/facebook-github-bot/following{/other_user}', 'gists_url': 'https://api.github.com/users/facebook-github-bot/gists{/gist_id}', 'starred_url': 'https://api.github.com/users/facebook-github-bot/starred{/owner}{/repo}', 'subscriptions_url': 'https://api.github.com/users/facebook-github-bot/subscriptions', 'organizations_url': 'https://api.github.com/users/facebook-github-bot/orgs', 'repos_url': 'https://api.github.com/users/facebook-github-bot/repos', 'events_url': 'https://api.github.com/users/facebook-github-bot/events{/privacy}', 'received_events_url': 'https://api.github.com/users/facebook-github-bot/received_events', 'type': 'User', 'site_admin': False}",closed,360c1bbd5b36fd84670292b2ea93170c31cbd5cf,https://api.github.com/repos/pytorch/pytorch/commits/360c1bbd5b36fd84670292b2ea93170c31cbd5cf,2018-07-24T19:11:14Z,107,107,0
9348,1729374533,"{'login': 'SsnL', 'id': 5674597, 'node_id': 'MDQ6VXNlcjU2NzQ1OTc=', 'avatar_url': 'https://avatars2.githubusercontent.com/u/5674597?v=4', 'gravatar_id': '', 'url': 'https://api.github.com/users/SsnL', 'html_url': 'https://github.com/SsnL', 'followers_url': 'https://api.github.com/users/SsnL/followers', 'following_url': 'https://api.github.com/users/SsnL/following{/other_user}', 'gists_url': 'https://api.github.com/users/SsnL/gists{/gist_id}', 'starred_url': 'https://api.github.com/users/SsnL/starred{/owner}{/repo}', 'subscriptions_url': 'https://api.github.com/users/SsnL/subscriptions', 'organizations_url': 'https://api.github.com/users/SsnL/orgs', 'repos_url': 'https://api.github.com/users/SsnL/repos', 'events_url': 'https://api.github.com/users/SsnL/events{/privacy}', 'received_events_url': 'https://api.github.com/users/SsnL/received_events', 'type': 'User', 'site_admin': False}",referenced,1812639c782813b938ff3091173b799f44208c21,https://api.github.com/repos/pytorch/pytorch/commits/1812639c782813b938ff3091173b799f44208c21,2018-07-12T03:48:26Z,6,3,3
9348,1729405010,"{'login': 'facebook-github-bot', 'id': 6422482, 'node_id': 'MDQ6VXNlcjY0MjI0ODI=', 'avatar_url': 'https://avatars3.githubusercontent.com/u/6422482?v=4', 'gravatar_id': '', 'url': 'https://api.github.com/users/facebook-github-bot', 'html_url': 'https://github.com/facebook-github-bot', 'followers_url': 'https://api.github.com/users/facebook-github-bot/followers', 'following_url': 'https://api.github.com/users/facebook-github-bot/following{/other_user}', 'gists_url': 'https://api.github.com/users/facebook-github-bot/gists{/gist_id}', 'starred_url': 'https://api.github.com/users/facebook-github-bot/starred{/owner}{/repo}', 'subscriptions_url': 'https://api.github.com/users/facebook-github-bot/subscriptions', 'organizations_url': 'https://api.github.com/users/facebook-github-bot/orgs', 'repos_url': 'https://api.github.com/users/facebook-github-bot/repos', 'events_url': 'https://api.github.com/users/facebook-github-bot/events{/privacy}', 'received_events_url': 'https://api.github.com/users/facebook-github-bot/received_events', 'type': 'User', 'site_admin': False}",closed,00b4b4703e27b4f531db5e8a88fb2348c77b4ee4,https://api.github.com/repos/pytorch/pytorch/commits/00b4b4703e27b4f531db5e8a88fb2348c77b4ee4,2018-07-12T04:26:35Z,6,3,3
9301,1771055467,"{'login': 'facebook-github-bot', 'id': 6422482, 'node_id': 'MDQ6VXNlcjY0MjI0ODI=', 'avatar_url': 'https://avatars3.githubusercontent.com/u/6422482?v=4', 'gravatar_id': '', 'url': 'https://api.github.com/users/facebook-github-bot', 'html_url': 'https://github.com/facebook-github-bot', 'followers_url': 'https://api.github.com/users/facebook-github-bot/followers', 'following_url': 'https://api.github.com/users/facebook-github-bot/following{/other_user}', 'gists_url': 'https://api.github.com/users/facebook-github-bot/gists{/gist_id}', 'starred_url': 'https://api.github.com/users/facebook-github-bot/starred{/owner}{/repo}', 'subscriptions_url': 'https://api.github.com/users/facebook-github-bot/subscriptions', 'organizations_url': 'https://api.github.com/users/facebook-github-bot/orgs', 'repos_url': 'https://api.github.com/users/facebook-github-bot/repos', 'events_url': 'https://api.github.com/users/facebook-github-bot/events{/privacy}', 'received_events_url': 'https://api.github.com/users/facebook-github-bot/received_events', 'type': 'User', 'site_admin': False}",referenced,149d4f776b4a896945bdec81b89a150f5c9ee66d,https://api.github.com/repos/pytorch/pytorch/commits/149d4f776b4a896945bdec81b89a150f5c9ee66d,2018-08-04T00:55:34Z,28,22,6
9264,1725549939,"{'login': 'facebook-github-bot', 'id': 6422482, 'node_id': 'MDQ6VXNlcjY0MjI0ODI=', 'avatar_url': 'https://avatars3.githubusercontent.com/u/6422482?v=4', 'gravatar_id': '', 'url': 'https://api.github.com/users/facebook-github-bot', 'html_url': 'https://github.com/facebook-github-bot', 'followers_url': 'https://api.github.com/users/facebook-github-bot/followers', 'following_url': 'https://api.github.com/users/facebook-github-bot/following{/other_user}', 'gists_url': 'https://api.github.com/users/facebook-github-bot/gists{/gist_id}', 'starred_url': 'https://api.github.com/users/facebook-github-bot/starred{/owner}{/repo}', 'subscriptions_url': 'https://api.github.com/users/facebook-github-bot/subscriptions', 'organizations_url': 'https://api.github.com/users/facebook-github-bot/orgs', 'repos_url': 'https://api.github.com/users/facebook-github-bot/repos', 'events_url': 'https://api.github.com/users/facebook-github-bot/events{/privacy}', 'received_events_url': 'https://api.github.com/users/facebook-github-bot/received_events', 'type': 'User', 'site_admin': False}",closed,1597fc594d36a18d1d4aee16d09ea49ae7065610,https://api.github.com/repos/pytorch/pytorch/commits/1597fc594d36a18d1d4aee16d09ea49ae7065610,2018-07-10T13:40:45Z,246,122,124
9247,1722117257,"{'login': 'facebook-github-bot', 'id': 6422482, 'node_id': 'MDQ6VXNlcjY0MjI0ODI=', 'avatar_url': 'https://avatars3.githubusercontent.com/u/6422482?v=4', 'gravatar_id': '', 'url': 'https://api.github.com/users/facebook-github-bot', 'html_url': 'https://github.com/facebook-github-bot', 'followers_url': 'https://api.github.com/users/facebook-github-bot/followers', 'following_url': 'https://api.github.com/users/facebook-github-bot/following{/other_user}', 'gists_url': 'https://api.github.com/users/facebook-github-bot/gists{/gist_id}', 'starred_url': 'https://api.github.com/users/facebook-github-bot/starred{/owner}{/repo}', 'subscriptions_url': 'https://api.github.com/users/facebook-github-bot/subscriptions', 'organizations_url': 'https://api.github.com/users/facebook-github-bot/orgs', 'repos_url': 'https://api.github.com/users/facebook-github-bot/repos', 'events_url': 'https://api.github.com/users/facebook-github-bot/events{/privacy}', 'received_events_url': 'https://api.github.com/users/facebook-github-bot/received_events', 'type': 'User', 'site_admin': False}",referenced,e8536c08a16b533fe0a9d645dd4255513f9f4fdd,https://api.github.com/repos/pytorch/pytorch/commits/e8536c08a16b533fe0a9d645dd4255513f9f4fdd,2018-07-09T02:10:44Z,479,322,157
9232,1771975581,"{'login': 'facebook-github-bot', 'id': 6422482, 'node_id': 'MDQ6VXNlcjY0MjI0ODI=', 'avatar_url': 'https://avatars3.githubusercontent.com/u/6422482?v=4', 'gravatar_id': '', 'url': 'https://api.github.com/users/facebook-github-bot', 'html_url': 'https://github.com/facebook-github-bot', 'followers_url': 'https://api.github.com/users/facebook-github-bot/followers', 'following_url': 'https://api.github.com/users/facebook-github-bot/following{/other_user}', 'gists_url': 'https://api.github.com/users/facebook-github-bot/gists{/gist_id}', 'starred_url': 'https://api.github.com/users/facebook-github-bot/starred{/owner}{/repo}', 'subscriptions_url': 'https://api.github.com/users/facebook-github-bot/subscriptions', 'organizations_url': 'https://api.github.com/users/facebook-github-bot/orgs', 'repos_url': 'https://api.github.com/users/facebook-github-bot/repos', 'events_url': 'https://api.github.com/users/facebook-github-bot/events{/privacy}', 'received_events_url': 'https://api.github.com/users/facebook-github-bot/received_events', 'type': 'User', 'site_admin': False}",closed,506142ac8aebe0b3794ba66d6d6c4019fc2182c8,https://api.github.com/repos/pytorch/pytorch/commits/506142ac8aebe0b3794ba66d6d6c4019fc2182c8,2018-08-06T04:25:02Z,13,10,3
9200,1724464306,"{'login': 'facebook-github-bot', 'id': 6422482, 'node_id': 'MDQ6VXNlcjY0MjI0ODI=', 'avatar_url': 'https://avatars3.githubusercontent.com/u/6422482?v=4', 'gravatar_id': '', 'url': 'https://api.github.com/users/facebook-github-bot', 'html_url': 'https://github.com/facebook-github-bot', 'followers_url': 'https://api.github.com/users/facebook-github-bot/followers', 'following_url': 'https://api.github.com/users/facebook-github-bot/following{/other_user}', 'gists_url': 'https://api.github.com/users/facebook-github-bot/gists{/gist_id}', 'starred_url': 'https://api.github.com/users/facebook-github-bot/starred{/owner}{/repo}', 'subscriptions_url': 'https://api.github.com/users/facebook-github-bot/subscriptions', 'organizations_url': 'https://api.github.com/users/facebook-github-bot/orgs', 'repos_url': 'https://api.github.com/users/facebook-github-bot/repos', 'events_url': 'https://api.github.com/users/facebook-github-bot/events{/privacy}', 'received_events_url': 'https://api.github.com/users/facebook-github-bot/received_events', 'type': 'User', 'site_admin': False}",closed,19ecb5f8adf863ccb1825f8f984b8512245d4c13,https://api.github.com/repos/pytorch/pytorch/commits/19ecb5f8adf863ccb1825f8f984b8512245d4c13,2018-07-10T01:56:09Z,3,3,0
9168,1720400413,"{'login': 'facebook-github-bot', 'id': 6422482, 'node_id': 'MDQ6VXNlcjY0MjI0ODI=', 'avatar_url': 'https://avatars3.githubusercontent.com/u/6422482?v=4', 'gravatar_id': '', 'url': 'https://api.github.com/users/facebook-github-bot', 'html_url': 'https://github.com/facebook-github-bot', 'followers_url': 'https://api.github.com/users/facebook-github-bot/followers', 'following_url': 'https://api.github.com/users/facebook-github-bot/following{/other_user}', 'gists_url': 'https://api.github.com/users/facebook-github-bot/gists{/gist_id}', 'starred_url': 'https://api.github.com/users/facebook-github-bot/starred{/owner}{/repo}', 'subscriptions_url': 'https://api.github.com/users/facebook-github-bot/subscriptions', 'organizations_url': 'https://api.github.com/users/facebook-github-bot/orgs', 'repos_url': 'https://api.github.com/users/facebook-github-bot/repos', 'events_url': 'https://api.github.com/users/facebook-github-bot/events{/privacy}', 'received_events_url': 'https://api.github.com/users/facebook-github-bot/received_events', 'type': 'User', 'site_admin': False}",referenced,eadc5071e8a6aa71a24348a959a2f3ae7d0220a1,https://api.github.com/repos/pytorch/pytorch/commits/eadc5071e8a6aa71a24348a959a2f3ae7d0220a1,2018-07-06T14:26:10Z,10,9,1
9167,1724354054,"{'login': 'facebook-github-bot', 'id': 6422482, 'node_id': 'MDQ6VXNlcjY0MjI0ODI=', 'avatar_url': 'https://avatars3.githubusercontent.com/u/6422482?v=4', 'gravatar_id': '', 'url': 'https://api.github.com/users/facebook-github-bot', 'html_url': 'https://github.com/facebook-github-bot', 'followers_url': 'https://api.github.com/users/facebook-github-bot/followers', 'following_url': 'https://api.github.com/users/facebook-github-bot/following{/other_user}', 'gists_url': 'https://api.github.com/users/facebook-github-bot/gists{/gist_id}', 'starred_url': 'https://api.github.com/users/facebook-github-bot/starred{/owner}{/repo}', 'subscriptions_url': 'https://api.github.com/users/facebook-github-bot/subscriptions', 'organizations_url': 'https://api.github.com/users/facebook-github-bot/orgs', 'repos_url': 'https://api.github.com/users/facebook-github-bot/repos', 'events_url': 'https://api.github.com/users/facebook-github-bot/events{/privacy}', 'received_events_url': 'https://api.github.com/users/facebook-github-bot/received_events', 'type': 'User', 'site_admin': False}",closed,342dbcc35a5118b0fa8cccbbd2c45542d234871a,https://api.github.com/repos/pytorch/pytorch/commits/342dbcc35a5118b0fa8cccbbd2c45542d234871a,2018-07-09T23:56:25Z,12,3,9
9160,2288643401,"{'login': 'facebook-github-bot', 'id': 6422482, 'node_id': 'MDQ6VXNlcjY0MjI0ODI=', 'avatar_url': 'https://avatars3.githubusercontent.com/u/6422482?v=4', 'gravatar_id': '', 'url': 'https://api.github.com/users/facebook-github-bot', 'html_url': 'https://github.com/facebook-github-bot', 'followers_url': 'https://api.github.com/users/facebook-github-bot/followers', 'following_url': 'https://api.github.com/users/facebook-github-bot/following{/other_user}', 'gists_url': 'https://api.github.com/users/facebook-github-bot/gists{/gist_id}', 'starred_url': 'https://api.github.com/users/facebook-github-bot/starred{/owner}{/repo}', 'subscriptions_url': 'https://api.github.com/users/facebook-github-bot/subscriptions', 'organizations_url': 'https://api.github.com/users/facebook-github-bot/orgs', 'repos_url': 'https://api.github.com/users/facebook-github-bot/repos', 'events_url': 'https://api.github.com/users/facebook-github-bot/events{/privacy}', 'received_events_url': 'https://api.github.com/users/facebook-github-bot/received_events', 'type': 'User', 'site_admin': False}",referenced,30292d994fabf24146fe0dbcfe9621d4f87325e2,https://api.github.com/repos/pytorch/pytorch/commits/30292d994fabf24146fe0dbcfe9621d4f87325e2,2019-04-19T17:14:28Z,35,33,2
9147,1716456530,"{'login': 'facebook-github-bot', 'id': 6422482, 'node_id': 'MDQ6VXNlcjY0MjI0ODI=', 'avatar_url': 'https://avatars3.githubusercontent.com/u/6422482?v=4', 'gravatar_id': '', 'url': 'https://api.github.com/users/facebook-github-bot', 'html_url': 'https://github.com/facebook-github-bot', 'followers_url': 'https://api.github.com/users/facebook-github-bot/followers', 'following_url': 'https://api.github.com/users/facebook-github-bot/following{/other_user}', 'gists_url': 'https://api.github.com/users/facebook-github-bot/gists{/gist_id}', 'starred_url': 'https://api.github.com/users/facebook-github-bot/starred{/owner}{/repo}', 'subscriptions_url': 'https://api.github.com/users/facebook-github-bot/subscriptions', 'organizations_url': 'https://api.github.com/users/facebook-github-bot/orgs', 'repos_url': 'https://api.github.com/users/facebook-github-bot/repos', 'events_url': 'https://api.github.com/users/facebook-github-bot/events{/privacy}', 'received_events_url': 'https://api.github.com/users/facebook-github-bot/received_events', 'type': 'User', 'site_admin': False}",closed,08daed40f729a7813b30a5d9ac3b015f642a2b14,https://api.github.com/repos/pytorch/pytorch/commits/08daed40f729a7813b30a5d9ac3b015f642a2b14,2018-07-04T14:25:19Z,15,14,1
9142,1715045959,"{'login': 'facebook-github-bot', 'id': 6422482, 'node_id': 'MDQ6VXNlcjY0MjI0ODI=', 'avatar_url': 'https://avatars3.githubusercontent.com/u/6422482?v=4', 'gravatar_id': '', 'url': 'https://api.github.com/users/facebook-github-bot', 'html_url': 'https://github.com/facebook-github-bot', 'followers_url': 'https://api.github.com/users/facebook-github-bot/followers', 'following_url': 'https://api.github.com/users/facebook-github-bot/following{/other_user}', 'gists_url': 'https://api.github.com/users/facebook-github-bot/gists{/gist_id}', 'starred_url': 'https://api.github.com/users/facebook-github-bot/starred{/owner}{/repo}', 'subscriptions_url': 'https://api.github.com/users/facebook-github-bot/subscriptions', 'organizations_url': 'https://api.github.com/users/facebook-github-bot/orgs', 'repos_url': 'https://api.github.com/users/facebook-github-bot/repos', 'events_url': 'https://api.github.com/users/facebook-github-bot/events{/privacy}', 'received_events_url': 'https://api.github.com/users/facebook-github-bot/received_events', 'type': 'User', 'site_admin': False}",closed,b479494ed4e2821e47722331fd11c5f26f36671c,https://api.github.com/repos/pytorch/pytorch/commits/b479494ed4e2821e47722331fd11c5f26f36671c,2018-07-03T21:26:43Z,2,1,1
9141,1771055465,"{'login': 'facebook-github-bot', 'id': 6422482, 'node_id': 'MDQ6VXNlcjY0MjI0ODI=', 'avatar_url': 'https://avatars3.githubusercontent.com/u/6422482?v=4', 'gravatar_id': '', 'url': 'https://api.github.com/users/facebook-github-bot', 'html_url': 'https://github.com/facebook-github-bot', 'followers_url': 'https://api.github.com/users/facebook-github-bot/followers', 'following_url': 'https://api.github.com/users/facebook-github-bot/following{/other_user}', 'gists_url': 'https://api.github.com/users/facebook-github-bot/gists{/gist_id}', 'starred_url': 'https://api.github.com/users/facebook-github-bot/starred{/owner}{/repo}', 'subscriptions_url': 'https://api.github.com/users/facebook-github-bot/subscriptions', 'organizations_url': 'https://api.github.com/users/facebook-github-bot/orgs', 'repos_url': 'https://api.github.com/users/facebook-github-bot/repos', 'events_url': 'https://api.github.com/users/facebook-github-bot/events{/privacy}', 'received_events_url': 'https://api.github.com/users/facebook-github-bot/received_events', 'type': 'User', 'site_admin': False}",closed,149d4f776b4a896945bdec81b89a150f5c9ee66d,https://api.github.com/repos/pytorch/pytorch/commits/149d4f776b4a896945bdec81b89a150f5c9ee66d,2018-08-04T00:55:34Z,28,22,6
9132,1734239651,"{'login': 'facebook-github-bot', 'id': 6422482, 'node_id': 'MDQ6VXNlcjY0MjI0ODI=', 'avatar_url': 'https://avatars3.githubusercontent.com/u/6422482?v=4', 'gravatar_id': '', 'url': 'https://api.github.com/users/facebook-github-bot', 'html_url': 'https://github.com/facebook-github-bot', 'followers_url': 'https://api.github.com/users/facebook-github-bot/followers', 'following_url': 'https://api.github.com/users/facebook-github-bot/following{/other_user}', 'gists_url': 'https://api.github.com/users/facebook-github-bot/gists{/gist_id}', 'starred_url': 'https://api.github.com/users/facebook-github-bot/starred{/owner}{/repo}', 'subscriptions_url': 'https://api.github.com/users/facebook-github-bot/subscriptions', 'organizations_url': 'https://api.github.com/users/facebook-github-bot/orgs', 'repos_url': 'https://api.github.com/users/facebook-github-bot/repos', 'events_url': 'https://api.github.com/users/facebook-github-bot/events{/privacy}', 'received_events_url': 'https://api.github.com/users/facebook-github-bot/received_events', 'type': 'User', 'site_admin': False}",referenced,5eb9d40cc6b5f248db203b9b76de9b30f1c56d65,https://api.github.com/repos/pytorch/pytorch/commits/5eb9d40cc6b5f248db203b9b76de9b30f1c56d65,2018-07-15T14:56:07Z,27,26,1
9132,1740443465,"{'login': 'facebook-github-bot', 'id': 6422482, 'node_id': 'MDQ6VXNlcjY0MjI0ODI=', 'avatar_url': 'https://avatars3.githubusercontent.com/u/6422482?v=4', 'gravatar_id': '', 'url': 'https://api.github.com/users/facebook-github-bot', 'html_url': 'https://github.com/facebook-github-bot', 'followers_url': 'https://api.github.com/users/facebook-github-bot/followers', 'following_url': 'https://api.github.com/users/facebook-github-bot/following{/other_user}', 'gists_url': 'https://api.github.com/users/facebook-github-bot/gists{/gist_id}', 'starred_url': 'https://api.github.com/users/facebook-github-bot/starred{/owner}{/repo}', 'subscriptions_url': 'https://api.github.com/users/facebook-github-bot/subscriptions', 'organizations_url': 'https://api.github.com/users/facebook-github-bot/orgs', 'repos_url': 'https://api.github.com/users/facebook-github-bot/repos', 'events_url': 'https://api.github.com/users/facebook-github-bot/events{/privacy}', 'received_events_url': 'https://api.github.com/users/facebook-github-bot/received_events', 'type': 'User', 'site_admin': False}",closed,5eaed750c237ca633b4666fecaa440291329de81,https://api.github.com/repos/pytorch/pytorch/commits/5eaed750c237ca633b4666fecaa440291329de81,2018-07-18T15:26:12Z,31,28,3
9130,1715336131,"{'login': 'facebook-github-bot', 'id': 6422482, 'node_id': 'MDQ6VXNlcjY0MjI0ODI=', 'avatar_url': 'https://avatars3.githubusercontent.com/u/6422482?v=4', 'gravatar_id': '', 'url': 'https://api.github.com/users/facebook-github-bot', 'html_url': 'https://github.com/facebook-github-bot', 'followers_url': 'https://api.github.com/users/facebook-github-bot/followers', 'following_url': 'https://api.github.com/users/facebook-github-bot/following{/other_user}', 'gists_url': 'https://api.github.com/users/facebook-github-bot/gists{/gist_id}', 'starred_url': 'https://api.github.com/users/facebook-github-bot/starred{/owner}{/repo}', 'subscriptions_url': 'https://api.github.com/users/facebook-github-bot/subscriptions', 'organizations_url': 'https://api.github.com/users/facebook-github-bot/orgs', 'repos_url': 'https://api.github.com/users/facebook-github-bot/repos', 'events_url': 'https://api.github.com/users/facebook-github-bot/events{/privacy}', 'received_events_url': 'https://api.github.com/users/facebook-github-bot/received_events', 'type': 'User', 'site_admin': False}",closed,49f88ac9561c289e41d04dfa0f5b55f92a9c1b78,https://api.github.com/repos/pytorch/pytorch/commits/49f88ac9561c289e41d04dfa0f5b55f92a9c1b78,2018-07-04T02:11:18Z,9,1,8
9110,1714923277,"{'login': 'facebook-github-bot', 'id': 6422482, 'node_id': 'MDQ6VXNlcjY0MjI0ODI=', 'avatar_url': 'https://avatars3.githubusercontent.com/u/6422482?v=4', 'gravatar_id': '', 'url': 'https://api.github.com/users/facebook-github-bot', 'html_url': 'https://github.com/facebook-github-bot', 'followers_url': 'https://api.github.com/users/facebook-github-bot/followers', 'following_url': 'https://api.github.com/users/facebook-github-bot/following{/other_user}', 'gists_url': 'https://api.github.com/users/facebook-github-bot/gists{/gist_id}', 'starred_url': 'https://api.github.com/users/facebook-github-bot/starred{/owner}{/repo}', 'subscriptions_url': 'https://api.github.com/users/facebook-github-bot/subscriptions', 'organizations_url': 'https://api.github.com/users/facebook-github-bot/orgs', 'repos_url': 'https://api.github.com/users/facebook-github-bot/repos', 'events_url': 'https://api.github.com/users/facebook-github-bot/events{/privacy}', 'received_events_url': 'https://api.github.com/users/facebook-github-bot/received_events', 'type': 'User', 'site_admin': False}",closed,b432837a9d57023add43e267eacbf0b4969b2316,https://api.github.com/repos/pytorch/pytorch/commits/b432837a9d57023add43e267eacbf0b4969b2316,2018-07-03T20:12:11Z,232,171,61
9109,1806569662,"{'login': 'facebook-github-bot', 'id': 6422482, 'node_id': 'MDQ6VXNlcjY0MjI0ODI=', 'avatar_url': 'https://avatars3.githubusercontent.com/u/6422482?v=4', 'gravatar_id': '', 'url': 'https://api.github.com/users/facebook-github-bot', 'html_url': 'https://github.com/facebook-github-bot', 'followers_url': 'https://api.github.com/users/facebook-github-bot/followers', 'following_url': 'https://api.github.com/users/facebook-github-bot/following{/other_user}', 'gists_url': 'https://api.github.com/users/facebook-github-bot/gists{/gist_id}', 'starred_url': 'https://api.github.com/users/facebook-github-bot/starred{/owner}{/repo}', 'subscriptions_url': 'https://api.github.com/users/facebook-github-bot/subscriptions', 'organizations_url': 'https://api.github.com/users/facebook-github-bot/orgs', 'repos_url': 'https://api.github.com/users/facebook-github-bot/repos', 'events_url': 'https://api.github.com/users/facebook-github-bot/events{/privacy}', 'received_events_url': 'https://api.github.com/users/facebook-github-bot/received_events', 'type': 'User', 'site_admin': False}",referenced,ee022a476a2747abed4a950ed88a27f620f1d1f7,https://api.github.com/repos/pytorch/pytorch/commits/ee022a476a2747abed4a950ed88a27f620f1d1f7,2018-08-23T23:26:35Z,16,10,6
9103,1712925184,"{'login': 'facebook-github-bot', 'id': 6422482, 'node_id': 'MDQ6VXNlcjY0MjI0ODI=', 'avatar_url': 'https://avatars3.githubusercontent.com/u/6422482?v=4', 'gravatar_id': '', 'url': 'https://api.github.com/users/facebook-github-bot', 'html_url': 'https://github.com/facebook-github-bot', 'followers_url': 'https://api.github.com/users/facebook-github-bot/followers', 'following_url': 'https://api.github.com/users/facebook-github-bot/following{/other_user}', 'gists_url': 'https://api.github.com/users/facebook-github-bot/gists{/gist_id}', 'starred_url': 'https://api.github.com/users/facebook-github-bot/starred{/owner}{/repo}', 'subscriptions_url': 'https://api.github.com/users/facebook-github-bot/subscriptions', 'organizations_url': 'https://api.github.com/users/facebook-github-bot/orgs', 'repos_url': 'https://api.github.com/users/facebook-github-bot/repos', 'events_url': 'https://api.github.com/users/facebook-github-bot/events{/privacy}', 'received_events_url': 'https://api.github.com/users/facebook-github-bot/received_events', 'type': 'User', 'site_admin': False}",closed,21c786071b8919222daef7128f9218c825182db3,https://api.github.com/repos/pytorch/pytorch/commits/21c786071b8919222daef7128f9218c825182db3,2018-07-03T02:43:13Z,487,233,254
9079,1710710912,"{'login': 'facebook-github-bot', 'id': 6422482, 'node_id': 'MDQ6VXNlcjY0MjI0ODI=', 'avatar_url': 'https://avatars3.githubusercontent.com/u/6422482?v=4', 'gravatar_id': '', 'url': 'https://api.github.com/users/facebook-github-bot', 'html_url': 'https://github.com/facebook-github-bot', 'followers_url': 'https://api.github.com/users/facebook-github-bot/followers', 'following_url': 'https://api.github.com/users/facebook-github-bot/following{/other_user}', 'gists_url': 'https://api.github.com/users/facebook-github-bot/gists{/gist_id}', 'starred_url': 'https://api.github.com/users/facebook-github-bot/starred{/owner}{/repo}', 'subscriptions_url': 'https://api.github.com/users/facebook-github-bot/subscriptions', 'organizations_url': 'https://api.github.com/users/facebook-github-bot/orgs', 'repos_url': 'https://api.github.com/users/facebook-github-bot/repos', 'events_url': 'https://api.github.com/users/facebook-github-bot/events{/privacy}', 'received_events_url': 'https://api.github.com/users/facebook-github-bot/received_events', 'type': 'User', 'site_admin': False}",closed,179807a8c7c27b71db832ace68f22c2d5846cdde,https://api.github.com/repos/pytorch/pytorch/commits/179807a8c7c27b71db832ace68f22c2d5846cdde,2018-07-02T05:25:22Z,19,18,1
9062,1860833468,"{'login': 'facebook-github-bot', 'id': 6422482, 'node_id': 'MDQ6VXNlcjY0MjI0ODI=', 'avatar_url': 'https://avatars3.githubusercontent.com/u/6422482?v=4', 'gravatar_id': '', 'url': 'https://api.github.com/users/facebook-github-bot', 'html_url': 'https://github.com/facebook-github-bot', 'followers_url': 'https://api.github.com/users/facebook-github-bot/followers', 'following_url': 'https://api.github.com/users/facebook-github-bot/following{/other_user}', 'gists_url': 'https://api.github.com/users/facebook-github-bot/gists{/gist_id}', 'starred_url': 'https://api.github.com/users/facebook-github-bot/starred{/owner}{/repo}', 'subscriptions_url': 'https://api.github.com/users/facebook-github-bot/subscriptions', 'organizations_url': 'https://api.github.com/users/facebook-github-bot/orgs', 'repos_url': 'https://api.github.com/users/facebook-github-bot/repos', 'events_url': 'https://api.github.com/users/facebook-github-bot/events{/privacy}', 'received_events_url': 'https://api.github.com/users/facebook-github-bot/received_events', 'type': 'User', 'site_admin': False}",closed,6834dcab1c87e1f2aac3e189ec7ccb20bab8028e,https://api.github.com/repos/pytorch/pytorch/commits/6834dcab1c87e1f2aac3e189ec7ccb20bab8028e,2018-09-21T18:05:43Z,15,13,2
9054,1736641559,"{'login': 'facebook-github-bot', 'id': 6422482, 'node_id': 'MDQ6VXNlcjY0MjI0ODI=', 'avatar_url': 'https://avatars3.githubusercontent.com/u/6422482?v=4', 'gravatar_id': '', 'url': 'https://api.github.com/users/facebook-github-bot', 'html_url': 'https://github.com/facebook-github-bot', 'followers_url': 'https://api.github.com/users/facebook-github-bot/followers', 'following_url': 'https://api.github.com/users/facebook-github-bot/following{/other_user}', 'gists_url': 'https://api.github.com/users/facebook-github-bot/gists{/gist_id}', 'starred_url': 'https://api.github.com/users/facebook-github-bot/starred{/owner}{/repo}', 'subscriptions_url': 'https://api.github.com/users/facebook-github-bot/subscriptions', 'organizations_url': 'https://api.github.com/users/facebook-github-bot/orgs', 'repos_url': 'https://api.github.com/users/facebook-github-bot/repos', 'events_url': 'https://api.github.com/users/facebook-github-bot/events{/privacy}', 'received_events_url': 'https://api.github.com/users/facebook-github-bot/received_events', 'type': 'User', 'site_admin': False}",closed,ad74006ffa22c79285e21c7777e9d386607ebbea,https://api.github.com/repos/pytorch/pytorch/commits/ad74006ffa22c79285e21c7777e9d386607ebbea,2018-07-17T02:26:11Z,11,4,7
9049,1710023421,"{'login': 'facebook-github-bot', 'id': 6422482, 'node_id': 'MDQ6VXNlcjY0MjI0ODI=', 'avatar_url': 'https://avatars3.githubusercontent.com/u/6422482?v=4', 'gravatar_id': '', 'url': 'https://api.github.com/users/facebook-github-bot', 'html_url': 'https://github.com/facebook-github-bot', 'followers_url': 'https://api.github.com/users/facebook-github-bot/followers', 'following_url': 'https://api.github.com/users/facebook-github-bot/following{/other_user}', 'gists_url': 'https://api.github.com/users/facebook-github-bot/gists{/gist_id}', 'starred_url': 'https://api.github.com/users/facebook-github-bot/starred{/owner}{/repo}', 'subscriptions_url': 'https://api.github.com/users/facebook-github-bot/subscriptions', 'organizations_url': 'https://api.github.com/users/facebook-github-bot/orgs', 'repos_url': 'https://api.github.com/users/facebook-github-bot/repos', 'events_url': 'https://api.github.com/users/facebook-github-bot/events{/privacy}', 'received_events_url': 'https://api.github.com/users/facebook-github-bot/received_events', 'type': 'User', 'site_admin': False}",closed,2c6c53f5ceb48503ac5d1a5e7f81bba69e32f31f,https://api.github.com/repos/pytorch/pytorch/commits/2c6c53f5ceb48503ac5d1a5e7f81bba69e32f31f,2018-06-30T17:40:34Z,6,6,0
8988,1826829869,"{'login': 'facebook-github-bot', 'id': 6422482, 'node_id': 'MDQ6VXNlcjY0MjI0ODI=', 'avatar_url': 'https://avatars3.githubusercontent.com/u/6422482?v=4', 'gravatar_id': '', 'url': 'https://api.github.com/users/facebook-github-bot', 'html_url': 'https://github.com/facebook-github-bot', 'followers_url': 'https://api.github.com/users/facebook-github-bot/followers', 'following_url': 'https://api.github.com/users/facebook-github-bot/following{/other_user}', 'gists_url': 'https://api.github.com/users/facebook-github-bot/gists{/gist_id}', 'starred_url': 'https://api.github.com/users/facebook-github-bot/starred{/owner}{/repo}', 'subscriptions_url': 'https://api.github.com/users/facebook-github-bot/subscriptions', 'organizations_url': 'https://api.github.com/users/facebook-github-bot/orgs', 'repos_url': 'https://api.github.com/users/facebook-github-bot/repos', 'events_url': 'https://api.github.com/users/facebook-github-bot/events{/privacy}', 'received_events_url': 'https://api.github.com/users/facebook-github-bot/received_events', 'type': 'User', 'site_admin': False}",closed,d4060d2d0e0e4ce54186a618a4794c1e0a2b7d25,https://api.github.com/repos/pytorch/pytorch/commits/d4060d2d0e0e4ce54186a618a4794c1e0a2b7d25,2018-09-05T04:11:28Z,138,138,0
8981,1707066748,"{'login': 'facebook-github-bot', 'id': 6422482, 'node_id': 'MDQ6VXNlcjY0MjI0ODI=', 'avatar_url': 'https://avatars3.githubusercontent.com/u/6422482?v=4', 'gravatar_id': '', 'url': 'https://api.github.com/users/facebook-github-bot', 'html_url': 'https://github.com/facebook-github-bot', 'followers_url': 'https://api.github.com/users/facebook-github-bot/followers', 'following_url': 'https://api.github.com/users/facebook-github-bot/following{/other_user}', 'gists_url': 'https://api.github.com/users/facebook-github-bot/gists{/gist_id}', 'starred_url': 'https://api.github.com/users/facebook-github-bot/starred{/owner}{/repo}', 'subscriptions_url': 'https://api.github.com/users/facebook-github-bot/subscriptions', 'organizations_url': 'https://api.github.com/users/facebook-github-bot/orgs', 'repos_url': 'https://api.github.com/users/facebook-github-bot/repos', 'events_url': 'https://api.github.com/users/facebook-github-bot/events{/privacy}', 'received_events_url': 'https://api.github.com/users/facebook-github-bot/received_events', 'type': 'User', 'site_admin': False}",closed,73102294265b21fb63c9411180cd6a0e4d99bb5e,https://api.github.com/repos/pytorch/pytorch/commits/73102294265b21fb63c9411180cd6a0e4d99bb5e,2018-06-28T18:46:40Z,2,1,1
8957,1705106784,"{'login': 'facebook-github-bot', 'id': 6422482, 'node_id': 'MDQ6VXNlcjY0MjI0ODI=', 'avatar_url': 'https://avatars3.githubusercontent.com/u/6422482?v=4', 'gravatar_id': '', 'url': 'https://api.github.com/users/facebook-github-bot', 'html_url': 'https://github.com/facebook-github-bot', 'followers_url': 'https://api.github.com/users/facebook-github-bot/followers', 'following_url': 'https://api.github.com/users/facebook-github-bot/following{/other_user}', 'gists_url': 'https://api.github.com/users/facebook-github-bot/gists{/gist_id}', 'starred_url': 'https://api.github.com/users/facebook-github-bot/starred{/owner}{/repo}', 'subscriptions_url': 'https://api.github.com/users/facebook-github-bot/subscriptions', 'organizations_url': 'https://api.github.com/users/facebook-github-bot/orgs', 'repos_url': 'https://api.github.com/users/facebook-github-bot/repos', 'events_url': 'https://api.github.com/users/facebook-github-bot/events{/privacy}', 'received_events_url': 'https://api.github.com/users/facebook-github-bot/received_events', 'type': 'User', 'site_admin': False}",closed,ba8e13384474c31caf685993985c5f0c1cdc9f96,https://api.github.com/repos/pytorch/pytorch/commits/ba8e13384474c31caf685993985c5f0c1cdc9f96,2018-06-27T23:07:34Z,6,3,3
8949,1707563454,"{'login': 'facebook-github-bot', 'id': 6422482, 'node_id': 'MDQ6VXNlcjY0MjI0ODI=', 'avatar_url': 'https://avatars3.githubusercontent.com/u/6422482?v=4', 'gravatar_id': '', 'url': 'https://api.github.com/users/facebook-github-bot', 'html_url': 'https://github.com/facebook-github-bot', 'followers_url': 'https://api.github.com/users/facebook-github-bot/followers', 'following_url': 'https://api.github.com/users/facebook-github-bot/following{/other_user}', 'gists_url': 'https://api.github.com/users/facebook-github-bot/gists{/gist_id}', 'starred_url': 'https://api.github.com/users/facebook-github-bot/starred{/owner}{/repo}', 'subscriptions_url': 'https://api.github.com/users/facebook-github-bot/subscriptions', 'organizations_url': 'https://api.github.com/users/facebook-github-bot/orgs', 'repos_url': 'https://api.github.com/users/facebook-github-bot/repos', 'events_url': 'https://api.github.com/users/facebook-github-bot/events{/privacy}', 'received_events_url': 'https://api.github.com/users/facebook-github-bot/received_events', 'type': 'User', 'site_admin': False}",closed,30549a129324a0ddbf2fc826a2a414eece6eb347,https://api.github.com/repos/pytorch/pytorch/commits/30549a129324a0ddbf2fc826a2a414eece6eb347,2018-06-28T23:45:24Z,3,2,1
8940,1708709920,"{'login': 'facebook-github-bot', 'id': 6422482, 'node_id': 'MDQ6VXNlcjY0MjI0ODI=', 'avatar_url': 'https://avatars3.githubusercontent.com/u/6422482?v=4', 'gravatar_id': '', 'url': 'https://api.github.com/users/facebook-github-bot', 'html_url': 'https://github.com/facebook-github-bot', 'followers_url': 'https://api.github.com/users/facebook-github-bot/followers', 'following_url': 'https://api.github.com/users/facebook-github-bot/following{/other_user}', 'gists_url': 'https://api.github.com/users/facebook-github-bot/gists{/gist_id}', 'starred_url': 'https://api.github.com/users/facebook-github-bot/starred{/owner}{/repo}', 'subscriptions_url': 'https://api.github.com/users/facebook-github-bot/subscriptions', 'organizations_url': 'https://api.github.com/users/facebook-github-bot/orgs', 'repos_url': 'https://api.github.com/users/facebook-github-bot/repos', 'events_url': 'https://api.github.com/users/facebook-github-bot/events{/privacy}', 'received_events_url': 'https://api.github.com/users/facebook-github-bot/received_events', 'type': 'User', 'site_admin': False}",closed,b7956204429ba7717780fff463dabea5bf92b8be,https://api.github.com/repos/pytorch/pytorch/commits/b7956204429ba7717780fff463dabea5bf92b8be,2018-06-29T13:54:47Z,33,30,3
8928,1726657110,"{'login': 'facebook-github-bot', 'id': 6422482, 'node_id': 'MDQ6VXNlcjY0MjI0ODI=', 'avatar_url': 'https://avatars3.githubusercontent.com/u/6422482?v=4', 'gravatar_id': '', 'url': 'https://api.github.com/users/facebook-github-bot', 'html_url': 'https://github.com/facebook-github-bot', 'followers_url': 'https://api.github.com/users/facebook-github-bot/followers', 'following_url': 'https://api.github.com/users/facebook-github-bot/following{/other_user}', 'gists_url': 'https://api.github.com/users/facebook-github-bot/gists{/gist_id}', 'starred_url': 'https://api.github.com/users/facebook-github-bot/starred{/owner}{/repo}', 'subscriptions_url': 'https://api.github.com/users/facebook-github-bot/subscriptions', 'organizations_url': 'https://api.github.com/users/facebook-github-bot/orgs', 'repos_url': 'https://api.github.com/users/facebook-github-bot/repos', 'events_url': 'https://api.github.com/users/facebook-github-bot/events{/privacy}', 'received_events_url': 'https://api.github.com/users/facebook-github-bot/received_events', 'type': 'User', 'site_admin': False}",referenced,a47a30b9ce4e515358bb2a53c540a45b04108ad6,https://api.github.com/repos/pytorch/pytorch/commits/a47a30b9ce4e515358bb2a53c540a45b04108ad6,2018-07-10T22:12:06Z,131,64,67
8900,1708915998,"{'login': 'facebook-github-bot', 'id': 6422482, 'node_id': 'MDQ6VXNlcjY0MjI0ODI=', 'avatar_url': 'https://avatars3.githubusercontent.com/u/6422482?v=4', 'gravatar_id': '', 'url': 'https://api.github.com/users/facebook-github-bot', 'html_url': 'https://github.com/facebook-github-bot', 'followers_url': 'https://api.github.com/users/facebook-github-bot/followers', 'following_url': 'https://api.github.com/users/facebook-github-bot/following{/other_user}', 'gists_url': 'https://api.github.com/users/facebook-github-bot/gists{/gist_id}', 'starred_url': 'https://api.github.com/users/facebook-github-bot/starred{/owner}{/repo}', 'subscriptions_url': 'https://api.github.com/users/facebook-github-bot/subscriptions', 'organizations_url': 'https://api.github.com/users/facebook-github-bot/orgs', 'repos_url': 'https://api.github.com/users/facebook-github-bot/repos', 'events_url': 'https://api.github.com/users/facebook-github-bot/events{/privacy}', 'received_events_url': 'https://api.github.com/users/facebook-github-bot/received_events', 'type': 'User', 'site_admin': False}",closed,37e526e1a8cfedb9112c161b01a7f7a143d0998b,https://api.github.com/repos/pytorch/pytorch/commits/37e526e1a8cfedb9112c161b01a7f7a143d0998b,2018-06-29T15:25:10Z,5,3,2
8867,1707563446,"{'login': 'facebook-github-bot', 'id': 6422482, 'node_id': 'MDQ6VXNlcjY0MjI0ODI=', 'avatar_url': 'https://avatars3.githubusercontent.com/u/6422482?v=4', 'gravatar_id': '', 'url': 'https://api.github.com/users/facebook-github-bot', 'html_url': 'https://github.com/facebook-github-bot', 'followers_url': 'https://api.github.com/users/facebook-github-bot/followers', 'following_url': 'https://api.github.com/users/facebook-github-bot/following{/other_user}', 'gists_url': 'https://api.github.com/users/facebook-github-bot/gists{/gist_id}', 'starred_url': 'https://api.github.com/users/facebook-github-bot/starred{/owner}{/repo}', 'subscriptions_url': 'https://api.github.com/users/facebook-github-bot/subscriptions', 'organizations_url': 'https://api.github.com/users/facebook-github-bot/orgs', 'repos_url': 'https://api.github.com/users/facebook-github-bot/repos', 'events_url': 'https://api.github.com/users/facebook-github-bot/events{/privacy}', 'received_events_url': 'https://api.github.com/users/facebook-github-bot/received_events', 'type': 'User', 'site_admin': False}",closed,2e23bc1a20304dd51ed8fc6190d3e920f8c15b39,https://api.github.com/repos/pytorch/pytorch/commits/2e23bc1a20304dd51ed8fc6190d3e920f8c15b39,2018-06-28T23:45:24Z,262,166,96
8857,1707852557,"{'login': 'facebook-github-bot', 'id': 6422482, 'node_id': 'MDQ6VXNlcjY0MjI0ODI=', 'avatar_url': 'https://avatars3.githubusercontent.com/u/6422482?v=4', 'gravatar_id': '', 'url': 'https://api.github.com/users/facebook-github-bot', 'html_url': 'https://github.com/facebook-github-bot', 'followers_url': 'https://api.github.com/users/facebook-github-bot/followers', 'following_url': 'https://api.github.com/users/facebook-github-bot/following{/other_user}', 'gists_url': 'https://api.github.com/users/facebook-github-bot/gists{/gist_id}', 'starred_url': 'https://api.github.com/users/facebook-github-bot/starred{/owner}{/repo}', 'subscriptions_url': 'https://api.github.com/users/facebook-github-bot/subscriptions', 'organizations_url': 'https://api.github.com/users/facebook-github-bot/orgs', 'repos_url': 'https://api.github.com/users/facebook-github-bot/repos', 'events_url': 'https://api.github.com/users/facebook-github-bot/events{/privacy}', 'received_events_url': 'https://api.github.com/users/facebook-github-bot/received_events', 'type': 'User', 'site_admin': False}",closed,4643269eb5e0df7ff591ed013fd6ede1d26a5440,https://api.github.com/repos/pytorch/pytorch/commits/4643269eb5e0df7ff591ed013fd6ede1d26a5440,2018-06-29T05:12:03Z,16,16,0
8840,1698065713,"{'login': 'soumith', 'id': 1310570, 'node_id': 'MDQ6VXNlcjEzMTA1NzA=', 'avatar_url': 'https://avatars0.githubusercontent.com/u/1310570?v=4', 'gravatar_id': '', 'url': 'https://api.github.com/users/soumith', 'html_url': 'https://github.com/soumith', 'followers_url': 'https://api.github.com/users/soumith/followers', 'following_url': 'https://api.github.com/users/soumith/following{/other_user}', 'gists_url': 'https://api.github.com/users/soumith/gists{/gist_id}', 'starred_url': 'https://api.github.com/users/soumith/starred{/owner}{/repo}', 'subscriptions_url': 'https://api.github.com/users/soumith/subscriptions', 'organizations_url': 'https://api.github.com/users/soumith/orgs', 'repos_url': 'https://api.github.com/users/soumith/repos', 'events_url': 'https://api.github.com/users/soumith/events{/privacy}', 'received_events_url': 'https://api.github.com/users/soumith/received_events', 'type': 'User', 'site_admin': False}",referenced,50410c95725da83572171dca8b9600df6bc708ba,https://api.github.com/repos/pytorch/pytorch/commits/50410c95725da83572171dca8b9600df6bc708ba,2018-06-25T06:01:44Z,2,1,1
8786,1696735546,"{'login': 'SsnL', 'id': 5674597, 'node_id': 'MDQ6VXNlcjU2NzQ1OTc=', 'avatar_url': 'https://avatars2.githubusercontent.com/u/5674597?v=4', 'gravatar_id': '', 'url': 'https://api.github.com/users/SsnL', 'html_url': 'https://github.com/SsnL', 'followers_url': 'https://api.github.com/users/SsnL/followers', 'following_url': 'https://api.github.com/users/SsnL/following{/other_user}', 'gists_url': 'https://api.github.com/users/SsnL/gists{/gist_id}', 'starred_url': 'https://api.github.com/users/SsnL/starred{/owner}{/repo}', 'subscriptions_url': 'https://api.github.com/users/SsnL/subscriptions', 'organizations_url': 'https://api.github.com/users/SsnL/orgs', 'repos_url': 'https://api.github.com/users/SsnL/repos', 'events_url': 'https://api.github.com/users/SsnL/events{/privacy}', 'received_events_url': 'https://api.github.com/users/SsnL/received_events', 'type': 'User', 'site_admin': False}",referenced,1d4cf095b808f66867dae79d289d315bef974a7f,https://api.github.com/repos/pytorch/pytorch/commits/1d4cf095b808f66867dae79d289d315bef974a7f,2018-06-22T20:15:03Z,12,12,0
8774,1733516260,"{'login': 'facebook-github-bot', 'id': 6422482, 'node_id': 'MDQ6VXNlcjY0MjI0ODI=', 'avatar_url': 'https://avatars3.githubusercontent.com/u/6422482?v=4', 'gravatar_id': '', 'url': 'https://api.github.com/users/facebook-github-bot', 'html_url': 'https://github.com/facebook-github-bot', 'followers_url': 'https://api.github.com/users/facebook-github-bot/followers', 'following_url': 'https://api.github.com/users/facebook-github-bot/following{/other_user}', 'gists_url': 'https://api.github.com/users/facebook-github-bot/gists{/gist_id}', 'starred_url': 'https://api.github.com/users/facebook-github-bot/starred{/owner}{/repo}', 'subscriptions_url': 'https://api.github.com/users/facebook-github-bot/subscriptions', 'organizations_url': 'https://api.github.com/users/facebook-github-bot/orgs', 'repos_url': 'https://api.github.com/users/facebook-github-bot/repos', 'events_url': 'https://api.github.com/users/facebook-github-bot/events{/privacy}', 'received_events_url': 'https://api.github.com/users/facebook-github-bot/received_events', 'type': 'User', 'site_admin': False}",closed,86eeeab7587ec5ae4f77c57daf681eef26ed5209,https://api.github.com/repos/pytorch/pytorch/commits/86eeeab7587ec5ae4f77c57daf681eef26ed5209,2018-07-13T21:47:27Z,26,18,8
8716,1707563444,"{'login': 'facebook-github-bot', 'id': 6422482, 'node_id': 'MDQ6VXNlcjY0MjI0ODI=', 'avatar_url': 'https://avatars3.githubusercontent.com/u/6422482?v=4', 'gravatar_id': '', 'url': 'https://api.github.com/users/facebook-github-bot', 'html_url': 'https://github.com/facebook-github-bot', 'followers_url': 'https://api.github.com/users/facebook-github-bot/followers', 'following_url': 'https://api.github.com/users/facebook-github-bot/following{/other_user}', 'gists_url': 'https://api.github.com/users/facebook-github-bot/gists{/gist_id}', 'starred_url': 'https://api.github.com/users/facebook-github-bot/starred{/owner}{/repo}', 'subscriptions_url': 'https://api.github.com/users/facebook-github-bot/subscriptions', 'organizations_url': 'https://api.github.com/users/facebook-github-bot/orgs', 'repos_url': 'https://api.github.com/users/facebook-github-bot/repos', 'events_url': 'https://api.github.com/users/facebook-github-bot/events{/privacy}', 'received_events_url': 'https://api.github.com/users/facebook-github-bot/received_events', 'type': 'User', 'site_admin': False}",referenced,2e23bc1a20304dd51ed8fc6190d3e920f8c15b39,https://api.github.com/repos/pytorch/pytorch/commits/2e23bc1a20304dd51ed8fc6190d3e920f8c15b39,2018-06-28T23:45:23Z,262,166,96
8715,1707893714,"{'login': 'facebook-github-bot', 'id': 6422482, 'node_id': 'MDQ6VXNlcjY0MjI0ODI=', 'avatar_url': 'https://avatars3.githubusercontent.com/u/6422482?v=4', 'gravatar_id': '', 'url': 'https://api.github.com/users/facebook-github-bot', 'html_url': 'https://github.com/facebook-github-bot', 'followers_url': 'https://api.github.com/users/facebook-github-bot/followers', 'following_url': 'https://api.github.com/users/facebook-github-bot/following{/other_user}', 'gists_url': 'https://api.github.com/users/facebook-github-bot/gists{/gist_id}', 'starred_url': 'https://api.github.com/users/facebook-github-bot/starred{/owner}{/repo}', 'subscriptions_url': 'https://api.github.com/users/facebook-github-bot/subscriptions', 'organizations_url': 'https://api.github.com/users/facebook-github-bot/orgs', 'repos_url': 'https://api.github.com/users/facebook-github-bot/repos', 'events_url': 'https://api.github.com/users/facebook-github-bot/events{/privacy}', 'received_events_url': 'https://api.github.com/users/facebook-github-bot/received_events', 'type': 'User', 'site_admin': False}",closed,00b5d397aef410f5926cb50e7d6e4e676aef71a8,https://api.github.com/repos/pytorch/pytorch/commits/00b5d397aef410f5926cb50e7d6e4e676aef71a8,2018-06-29T05:57:06Z,70,42,28
8714,1722039626,"{'login': 'facebook-github-bot', 'id': 6422482, 'node_id': 'MDQ6VXNlcjY0MjI0ODI=', 'avatar_url': 'https://avatars3.githubusercontent.com/u/6422482?v=4', 'gravatar_id': '', 'url': 'https://api.github.com/users/facebook-github-bot', 'html_url': 'https://github.com/facebook-github-bot', 'followers_url': 'https://api.github.com/users/facebook-github-bot/followers', 'following_url': 'https://api.github.com/users/facebook-github-bot/following{/other_user}', 'gists_url': 'https://api.github.com/users/facebook-github-bot/gists{/gist_id}', 'starred_url': 'https://api.github.com/users/facebook-github-bot/starred{/owner}{/repo}', 'subscriptions_url': 'https://api.github.com/users/facebook-github-bot/subscriptions', 'organizations_url': 'https://api.github.com/users/facebook-github-bot/orgs', 'repos_url': 'https://api.github.com/users/facebook-github-bot/repos', 'events_url': 'https://api.github.com/users/facebook-github-bot/events{/privacy}', 'received_events_url': 'https://api.github.com/users/facebook-github-bot/received_events', 'type': 'User', 'site_admin': False}",referenced,66dc97e51ca872e01d6430363770256c76f94361,https://api.github.com/repos/pytorch/pytorch/commits/66dc97e51ca872e01d6430363770256c76f94361,2018-07-08T23:47:47Z,16,8,8
8710,1728506062,"{'login': 'facebook-github-bot', 'id': 6422482, 'node_id': 'MDQ6VXNlcjY0MjI0ODI=', 'avatar_url': 'https://avatars3.githubusercontent.com/u/6422482?v=4', 'gravatar_id': '', 'url': 'https://api.github.com/users/facebook-github-bot', 'html_url': 'https://github.com/facebook-github-bot', 'followers_url': 'https://api.github.com/users/facebook-github-bot/followers', 'following_url': 'https://api.github.com/users/facebook-github-bot/following{/other_user}', 'gists_url': 'https://api.github.com/users/facebook-github-bot/gists{/gist_id}', 'starred_url': 'https://api.github.com/users/facebook-github-bot/starred{/owner}{/repo}', 'subscriptions_url': 'https://api.github.com/users/facebook-github-bot/subscriptions', 'organizations_url': 'https://api.github.com/users/facebook-github-bot/orgs', 'repos_url': 'https://api.github.com/users/facebook-github-bot/repos', 'events_url': 'https://api.github.com/users/facebook-github-bot/events{/privacy}', 'received_events_url': 'https://api.github.com/users/facebook-github-bot/received_events', 'type': 'User', 'site_admin': False}",closed,05559b40716d4161fadabff6130805f07172ef83,https://api.github.com/repos/pytorch/pytorch/commits/05559b40716d4161fadabff6130805f07172ef83,2018-07-11T17:26:36Z,19,16,3
8698,2507232028,"{'login': 'facebook-github-bot', 'id': 6422482, 'node_id': 'MDQ6VXNlcjY0MjI0ODI=', 'avatar_url': 'https://avatars3.githubusercontent.com/u/6422482?v=4', 'gravatar_id': '', 'url': 'https://api.github.com/users/facebook-github-bot', 'html_url': 'https://github.com/facebook-github-bot', 'followers_url': 'https://api.github.com/users/facebook-github-bot/followers', 'following_url': 'https://api.github.com/users/facebook-github-bot/following{/other_user}', 'gists_url': 'https://api.github.com/users/facebook-github-bot/gists{/gist_id}', 'starred_url': 'https://api.github.com/users/facebook-github-bot/starred{/owner}{/repo}', 'subscriptions_url': 'https://api.github.com/users/facebook-github-bot/subscriptions', 'organizations_url': 'https://api.github.com/users/facebook-github-bot/orgs', 'repos_url': 'https://api.github.com/users/facebook-github-bot/repos', 'events_url': 'https://api.github.com/users/facebook-github-bot/events{/privacy}', 'received_events_url': 'https://api.github.com/users/facebook-github-bot/received_events', 'type': 'User', 'site_admin': False}",closed,3ed79f4b6c937c99058845cc3f4b0a3b179256cf,https://api.github.com/repos/pytorch/pytorch/commits/3ed79f4b6c937c99058845cc3f4b0a3b179256cf,2019-07-24T18:25:34Z,443,213,230
8692,1692010362,"{'login': 'soumith', 'id': 1310570, 'node_id': 'MDQ6VXNlcjEzMTA1NzA=', 'avatar_url': 'https://avatars0.githubusercontent.com/u/1310570?v=4', 'gravatar_id': '', 'url': 'https://api.github.com/users/soumith', 'html_url': 'https://github.com/soumith', 'followers_url': 'https://api.github.com/users/soumith/followers', 'following_url': 'https://api.github.com/users/soumith/following{/other_user}', 'gists_url': 'https://api.github.com/users/soumith/gists{/gist_id}', 'starred_url': 'https://api.github.com/users/soumith/starred{/owner}{/repo}', 'subscriptions_url': 'https://api.github.com/users/soumith/subscriptions', 'organizations_url': 'https://api.github.com/users/soumith/orgs', 'repos_url': 'https://api.github.com/users/soumith/repos', 'events_url': 'https://api.github.com/users/soumith/events{/privacy}', 'received_events_url': 'https://api.github.com/users/soumith/received_events', 'type': 'User', 'site_admin': False}",referenced,3e25b4af6d3878f4f2b68106c00e0422d48efd35,https://api.github.com/repos/pytorch/pytorch/commits/3e25b4af6d3878f4f2b68106c00e0422d48efd35,2018-06-20T19:18:30Z,2,1,1
8690,1708915982,"{'login': 'facebook-github-bot', 'id': 6422482, 'node_id': 'MDQ6VXNlcjY0MjI0ODI=', 'avatar_url': 'https://avatars3.githubusercontent.com/u/6422482?v=4', 'gravatar_id': '', 'url': 'https://api.github.com/users/facebook-github-bot', 'html_url': 'https://github.com/facebook-github-bot', 'followers_url': 'https://api.github.com/users/facebook-github-bot/followers', 'following_url': 'https://api.github.com/users/facebook-github-bot/following{/other_user}', 'gists_url': 'https://api.github.com/users/facebook-github-bot/gists{/gist_id}', 'starred_url': 'https://api.github.com/users/facebook-github-bot/starred{/owner}{/repo}', 'subscriptions_url': 'https://api.github.com/users/facebook-github-bot/subscriptions', 'organizations_url': 'https://api.github.com/users/facebook-github-bot/orgs', 'repos_url': 'https://api.github.com/users/facebook-github-bot/repos', 'events_url': 'https://api.github.com/users/facebook-github-bot/events{/privacy}', 'received_events_url': 'https://api.github.com/users/facebook-github-bot/received_events', 'type': 'User', 'site_admin': False}",closed,6a1e8010713794f940739841297e177a865900c9,https://api.github.com/repos/pytorch/pytorch/commits/6a1e8010713794f940739841297e177a865900c9,2018-06-29T15:25:09Z,2,2,0
8659,1691628141,"{'login': 'ezyang', 'id': 13564, 'node_id': 'MDQ6VXNlcjEzNTY0', 'avatar_url': 'https://avatars0.githubusercontent.com/u/13564?v=4', 'gravatar_id': '', 'url': 'https://api.github.com/users/ezyang', 'html_url': 'https://github.com/ezyang', 'followers_url': 'https://api.github.com/users/ezyang/followers', 'following_url': 'https://api.github.com/users/ezyang/following{/other_user}', 'gists_url': 'https://api.github.com/users/ezyang/gists{/gist_id}', 'starred_url': 'https://api.github.com/users/ezyang/starred{/owner}{/repo}', 'subscriptions_url': 'https://api.github.com/users/ezyang/subscriptions', 'organizations_url': 'https://api.github.com/users/ezyang/orgs', 'repos_url': 'https://api.github.com/users/ezyang/repos', 'events_url': 'https://api.github.com/users/ezyang/events{/privacy}', 'received_events_url': 'https://api.github.com/users/ezyang/received_events', 'type': 'User', 'site_admin': False}",referenced,d97c9dd01904ff423554345cd877ebc1e520c21e,https://api.github.com/repos/pytorch/pytorch/commits/d97c9dd01904ff423554345cd877ebc1e520c21e,2018-06-20T16:24:01Z,7,7,0
8652,1705106781,"{'login': 'facebook-github-bot', 'id': 6422482, 'node_id': 'MDQ6VXNlcjY0MjI0ODI=', 'avatar_url': 'https://avatars3.githubusercontent.com/u/6422482?v=4', 'gravatar_id': '', 'url': 'https://api.github.com/users/facebook-github-bot', 'html_url': 'https://github.com/facebook-github-bot', 'followers_url': 'https://api.github.com/users/facebook-github-bot/followers', 'following_url': 'https://api.github.com/users/facebook-github-bot/following{/other_user}', 'gists_url': 'https://api.github.com/users/facebook-github-bot/gists{/gist_id}', 'starred_url': 'https://api.github.com/users/facebook-github-bot/starred{/owner}{/repo}', 'subscriptions_url': 'https://api.github.com/users/facebook-github-bot/subscriptions', 'organizations_url': 'https://api.github.com/users/facebook-github-bot/orgs', 'repos_url': 'https://api.github.com/users/facebook-github-bot/repos', 'events_url': 'https://api.github.com/users/facebook-github-bot/events{/privacy}', 'received_events_url': 'https://api.github.com/users/facebook-github-bot/received_events', 'type': 'User', 'site_admin': False}",closed,ba8e13384474c31caf685993985c5f0c1cdc9f96,https://api.github.com/repos/pytorch/pytorch/commits/ba8e13384474c31caf685993985c5f0c1cdc9f96,2018-06-27T23:07:33Z,6,3,3
8611,2110446695,"{'login': 'facebook-github-bot', 'id': 6422482, 'node_id': 'MDQ6VXNlcjY0MjI0ODI=', 'avatar_url': 'https://avatars3.githubusercontent.com/u/6422482?v=4', 'gravatar_id': '', 'url': 'https://api.github.com/users/facebook-github-bot', 'html_url': 'https://github.com/facebook-github-bot', 'followers_url': 'https://api.github.com/users/facebook-github-bot/followers', 'following_url': 'https://api.github.com/users/facebook-github-bot/following{/other_user}', 'gists_url': 'https://api.github.com/users/facebook-github-bot/gists{/gist_id}', 'starred_url': 'https://api.github.com/users/facebook-github-bot/starred{/owner}{/repo}', 'subscriptions_url': 'https://api.github.com/users/facebook-github-bot/subscriptions', 'organizations_url': 'https://api.github.com/users/facebook-github-bot/orgs', 'repos_url': 'https://api.github.com/users/facebook-github-bot/repos', 'events_url': 'https://api.github.com/users/facebook-github-bot/events{/privacy}', 'received_events_url': 'https://api.github.com/users/facebook-github-bot/received_events', 'type': 'User', 'site_admin': False}",referenced,b109549bf374202809dfab1a043a8e76fe9a7075,https://api.github.com/repos/pytorch/pytorch/commits/b109549bf374202809dfab1a043a8e76fe9a7075,2019-01-31T19:52:59Z,2,1,1
8599,1689028829,"{'login': 'soumith', 'id': 1310570, 'node_id': 'MDQ6VXNlcjEzMTA1NzA=', 'avatar_url': 'https://avatars0.githubusercontent.com/u/1310570?v=4', 'gravatar_id': '', 'url': 'https://api.github.com/users/soumith', 'html_url': 'https://github.com/soumith', 'followers_url': 'https://api.github.com/users/soumith/followers', 'following_url': 'https://api.github.com/users/soumith/following{/other_user}', 'gists_url': 'https://api.github.com/users/soumith/gists{/gist_id}', 'starred_url': 'https://api.github.com/users/soumith/starred{/owner}{/repo}', 'subscriptions_url': 'https://api.github.com/users/soumith/subscriptions', 'organizations_url': 'https://api.github.com/users/soumith/orgs', 'repos_url': 'https://api.github.com/users/soumith/repos', 'events_url': 'https://api.github.com/users/soumith/events{/privacy}', 'received_events_url': 'https://api.github.com/users/soumith/received_events', 'type': 'User', 'site_admin': False}",closed,9a9eadacc6ac3b734a6d607ae6f63ec1a0d1438d,https://api.github.com/repos/pytorch/pytorch/commits/9a9eadacc6ac3b734a6d607ae6f63ec1a0d1438d,2018-06-19T15:54:30Z,3,3,0
8560,1830640883,"{'login': 'facebook-github-bot', 'id': 6422482, 'node_id': 'MDQ6VXNlcjY0MjI0ODI=', 'avatar_url': 'https://avatars3.githubusercontent.com/u/6422482?v=4', 'gravatar_id': '', 'url': 'https://api.github.com/users/facebook-github-bot', 'html_url': 'https://github.com/facebook-github-bot', 'followers_url': 'https://api.github.com/users/facebook-github-bot/followers', 'following_url': 'https://api.github.com/users/facebook-github-bot/following{/other_user}', 'gists_url': 'https://api.github.com/users/facebook-github-bot/gists{/gist_id}', 'starred_url': 'https://api.github.com/users/facebook-github-bot/starred{/owner}{/repo}', 'subscriptions_url': 'https://api.github.com/users/facebook-github-bot/subscriptions', 'organizations_url': 'https://api.github.com/users/facebook-github-bot/orgs', 'repos_url': 'https://api.github.com/users/facebook-github-bot/repos', 'events_url': 'https://api.github.com/users/facebook-github-bot/events{/privacy}', 'received_events_url': 'https://api.github.com/users/facebook-github-bot/received_events', 'type': 'User', 'site_admin': False}",closed,656e81db9372ea62f80155acded8b90b3445f0fd,https://api.github.com/repos/pytorch/pytorch/commits/656e81db9372ea62f80155acded8b90b3445f0fd,2018-09-06T14:56:19Z,36,34,2
8529,1768479877,"{'login': 'facebook-github-bot', 'id': 6422482, 'node_id': 'MDQ6VXNlcjY0MjI0ODI=', 'avatar_url': 'https://avatars3.githubusercontent.com/u/6422482?v=4', 'gravatar_id': '', 'url': 'https://api.github.com/users/facebook-github-bot', 'html_url': 'https://github.com/facebook-github-bot', 'followers_url': 'https://api.github.com/users/facebook-github-bot/followers', 'following_url': 'https://api.github.com/users/facebook-github-bot/following{/other_user}', 'gists_url': 'https://api.github.com/users/facebook-github-bot/gists{/gist_id}', 'starred_url': 'https://api.github.com/users/facebook-github-bot/starred{/owner}{/repo}', 'subscriptions_url': 'https://api.github.com/users/facebook-github-bot/subscriptions', 'organizations_url': 'https://api.github.com/users/facebook-github-bot/orgs', 'repos_url': 'https://api.github.com/users/facebook-github-bot/repos', 'events_url': 'https://api.github.com/users/facebook-github-bot/events{/privacy}', 'received_events_url': 'https://api.github.com/users/facebook-github-bot/received_events', 'type': 'User', 'site_admin': False}",referenced,6e85112f12cce9731ae09237769f15f675f3da7b,https://api.github.com/repos/pytorch/pytorch/commits/6e85112f12cce9731ae09237769f15f675f3da7b,2018-08-02T19:26:20Z,914,476,438
8525,1833882293,"{'login': 'facebook-github-bot', 'id': 6422482, 'node_id': 'MDQ6VXNlcjY0MjI0ODI=', 'avatar_url': 'https://avatars3.githubusercontent.com/u/6422482?v=4', 'gravatar_id': '', 'url': 'https://api.github.com/users/facebook-github-bot', 'html_url': 'https://github.com/facebook-github-bot', 'followers_url': 'https://api.github.com/users/facebook-github-bot/followers', 'following_url': 'https://api.github.com/users/facebook-github-bot/following{/other_user}', 'gists_url': 'https://api.github.com/users/facebook-github-bot/gists{/gist_id}', 'starred_url': 'https://api.github.com/users/facebook-github-bot/starred{/owner}{/repo}', 'subscriptions_url': 'https://api.github.com/users/facebook-github-bot/subscriptions', 'organizations_url': 'https://api.github.com/users/facebook-github-bot/orgs', 'repos_url': 'https://api.github.com/users/facebook-github-bot/repos', 'events_url': 'https://api.github.com/users/facebook-github-bot/events{/privacy}', 'received_events_url': 'https://api.github.com/users/facebook-github-bot/received_events', 'type': 'User', 'site_admin': False}",closed,4bf5fc44c86d835f4812e7b3baffae9c65de0677,https://api.github.com/repos/pytorch/pytorch/commits/4bf5fc44c86d835f4812e7b3baffae9c65de0677,2018-09-07T22:40:33Z,38,31,7
8520,1833882300,"{'login': 'facebook-github-bot', 'id': 6422482, 'node_id': 'MDQ6VXNlcjY0MjI0ODI=', 'avatar_url': 'https://avatars3.githubusercontent.com/u/6422482?v=4', 'gravatar_id': '', 'url': 'https://api.github.com/users/facebook-github-bot', 'html_url': 'https://github.com/facebook-github-bot', 'followers_url': 'https://api.github.com/users/facebook-github-bot/followers', 'following_url': 'https://api.github.com/users/facebook-github-bot/following{/other_user}', 'gists_url': 'https://api.github.com/users/facebook-github-bot/gists{/gist_id}', 'starred_url': 'https://api.github.com/users/facebook-github-bot/starred{/owner}{/repo}', 'subscriptions_url': 'https://api.github.com/users/facebook-github-bot/subscriptions', 'organizations_url': 'https://api.github.com/users/facebook-github-bot/orgs', 'repos_url': 'https://api.github.com/users/facebook-github-bot/repos', 'events_url': 'https://api.github.com/users/facebook-github-bot/events{/privacy}', 'received_events_url': 'https://api.github.com/users/facebook-github-bot/received_events', 'type': 'User', 'site_admin': False}",closed,4bf5fc44c86d835f4812e7b3baffae9c65de0677,https://api.github.com/repos/pytorch/pytorch/commits/4bf5fc44c86d835f4812e7b3baffae9c65de0677,2018-09-07T22:40:33Z,38,31,7
8518,1766450520,"{'login': 'facebook-github-bot', 'id': 6422482, 'node_id': 'MDQ6VXNlcjY0MjI0ODI=', 'avatar_url': 'https://avatars3.githubusercontent.com/u/6422482?v=4', 'gravatar_id': '', 'url': 'https://api.github.com/users/facebook-github-bot', 'html_url': 'https://github.com/facebook-github-bot', 'followers_url': 'https://api.github.com/users/facebook-github-bot/followers', 'following_url': 'https://api.github.com/users/facebook-github-bot/following{/other_user}', 'gists_url': 'https://api.github.com/users/facebook-github-bot/gists{/gist_id}', 'starred_url': 'https://api.github.com/users/facebook-github-bot/starred{/owner}{/repo}', 'subscriptions_url': 'https://api.github.com/users/facebook-github-bot/subscriptions', 'organizations_url': 'https://api.github.com/users/facebook-github-bot/orgs', 'repos_url': 'https://api.github.com/users/facebook-github-bot/repos', 'events_url': 'https://api.github.com/users/facebook-github-bot/events{/privacy}', 'received_events_url': 'https://api.github.com/users/facebook-github-bot/received_events', 'type': 'User', 'site_admin': False}",referenced,4ed5b9267cf3953b89b2247081b77b0e1c1a7985,https://api.github.com/repos/pytorch/pytorch/commits/4ed5b9267cf3953b89b2247081b77b0e1c1a7985,2018-08-01T23:11:12Z,13,8,5
8516,1806469953,"{'login': 'facebook-github-bot', 'id': 6422482, 'node_id': 'MDQ6VXNlcjY0MjI0ODI=', 'avatar_url': 'https://avatars3.githubusercontent.com/u/6422482?v=4', 'gravatar_id': '', 'url': 'https://api.github.com/users/facebook-github-bot', 'html_url': 'https://github.com/facebook-github-bot', 'followers_url': 'https://api.github.com/users/facebook-github-bot/followers', 'following_url': 'https://api.github.com/users/facebook-github-bot/following{/other_user}', 'gists_url': 'https://api.github.com/users/facebook-github-bot/gists{/gist_id}', 'starred_url': 'https://api.github.com/users/facebook-github-bot/starred{/owner}{/repo}', 'subscriptions_url': 'https://api.github.com/users/facebook-github-bot/subscriptions', 'organizations_url': 'https://api.github.com/users/facebook-github-bot/orgs', 'repos_url': 'https://api.github.com/users/facebook-github-bot/repos', 'events_url': 'https://api.github.com/users/facebook-github-bot/events{/privacy}', 'received_events_url': 'https://api.github.com/users/facebook-github-bot/received_events', 'type': 'User', 'site_admin': False}",closed,3d43a8244091ff4ffa70404110263e202fd94a0c,https://api.github.com/repos/pytorch/pytorch/commits/3d43a8244091ff4ffa70404110263e202fd94a0c,2018-08-23T22:11:42Z,242,156,86
8515,1850860703,"{'login': 'facebook-github-bot', 'id': 6422482, 'node_id': 'MDQ6VXNlcjY0MjI0ODI=', 'avatar_url': 'https://avatars3.githubusercontent.com/u/6422482?v=4', 'gravatar_id': '', 'url': 'https://api.github.com/users/facebook-github-bot', 'html_url': 'https://github.com/facebook-github-bot', 'followers_url': 'https://api.github.com/users/facebook-github-bot/followers', 'following_url': 'https://api.github.com/users/facebook-github-bot/following{/other_user}', 'gists_url': 'https://api.github.com/users/facebook-github-bot/gists{/gist_id}', 'starred_url': 'https://api.github.com/users/facebook-github-bot/starred{/owner}{/repo}', 'subscriptions_url': 'https://api.github.com/users/facebook-github-bot/subscriptions', 'organizations_url': 'https://api.github.com/users/facebook-github-bot/orgs', 'repos_url': 'https://api.github.com/users/facebook-github-bot/repos', 'events_url': 'https://api.github.com/users/facebook-github-bot/events{/privacy}', 'received_events_url': 'https://api.github.com/users/facebook-github-bot/received_events', 'type': 'User', 'site_admin': False}",closed,7671f4ab1c921888554bef92d1cee55785bcf232,https://api.github.com/repos/pytorch/pytorch/commits/7671f4ab1c921888554bef92d1cee55785bcf232,2018-09-17T21:09:43Z,53,49,4
8508,1700040235,"{'login': 'soumith', 'id': 1310570, 'node_id': 'MDQ6VXNlcjEzMTA1NzA=', 'avatar_url': 'https://avatars0.githubusercontent.com/u/1310570?v=4', 'gravatar_id': '', 'url': 'https://api.github.com/users/soumith', 'html_url': 'https://github.com/soumith', 'followers_url': 'https://api.github.com/users/soumith/followers', 'following_url': 'https://api.github.com/users/soumith/following{/other_user}', 'gists_url': 'https://api.github.com/users/soumith/gists{/gist_id}', 'starred_url': 'https://api.github.com/users/soumith/starred{/owner}{/repo}', 'subscriptions_url': 'https://api.github.com/users/soumith/subscriptions', 'organizations_url': 'https://api.github.com/users/soumith/orgs', 'repos_url': 'https://api.github.com/users/soumith/repos', 'events_url': 'https://api.github.com/users/soumith/events{/privacy}', 'received_events_url': 'https://api.github.com/users/soumith/received_events', 'type': 'User', 'site_admin': False}",closed,49a3e49627c71a4abe551c832e4720e8b21704fe,https://api.github.com/repos/pytorch/pytorch/commits/49a3e49627c71a4abe551c832e4720e8b21704fe,2018-06-25T22:07:28Z,2,2,0
8502,1758422970,"{'login': 'facebook-github-bot', 'id': 6422482, 'node_id': 'MDQ6VXNlcjY0MjI0ODI=', 'avatar_url': 'https://avatars3.githubusercontent.com/u/6422482?v=4', 'gravatar_id': '', 'url': 'https://api.github.com/users/facebook-github-bot', 'html_url': 'https://github.com/facebook-github-bot', 'followers_url': 'https://api.github.com/users/facebook-github-bot/followers', 'following_url': 'https://api.github.com/users/facebook-github-bot/following{/other_user}', 'gists_url': 'https://api.github.com/users/facebook-github-bot/gists{/gist_id}', 'starred_url': 'https://api.github.com/users/facebook-github-bot/starred{/owner}{/repo}', 'subscriptions_url': 'https://api.github.com/users/facebook-github-bot/subscriptions', 'organizations_url': 'https://api.github.com/users/facebook-github-bot/orgs', 'repos_url': 'https://api.github.com/users/facebook-github-bot/repos', 'events_url': 'https://api.github.com/users/facebook-github-bot/events{/privacy}', 'received_events_url': 'https://api.github.com/users/facebook-github-bot/received_events', 'type': 'User', 'site_admin': False}",closed,47c1badf9003afd7f6959ba3e91f325085947f32,https://api.github.com/repos/pytorch/pytorch/commits/47c1badf9003afd7f6959ba3e91f325085947f32,2018-07-28T05:55:36Z,336,172,164
8481,1710710923,"{'login': 'facebook-github-bot', 'id': 6422482, 'node_id': 'MDQ6VXNlcjY0MjI0ODI=', 'avatar_url': 'https://avatars3.githubusercontent.com/u/6422482?v=4', 'gravatar_id': '', 'url': 'https://api.github.com/users/facebook-github-bot', 'html_url': 'https://github.com/facebook-github-bot', 'followers_url': 'https://api.github.com/users/facebook-github-bot/followers', 'following_url': 'https://api.github.com/users/facebook-github-bot/following{/other_user}', 'gists_url': 'https://api.github.com/users/facebook-github-bot/gists{/gist_id}', 'starred_url': 'https://api.github.com/users/facebook-github-bot/starred{/owner}{/repo}', 'subscriptions_url': 'https://api.github.com/users/facebook-github-bot/subscriptions', 'organizations_url': 'https://api.github.com/users/facebook-github-bot/orgs', 'repos_url': 'https://api.github.com/users/facebook-github-bot/repos', 'events_url': 'https://api.github.com/users/facebook-github-bot/events{/privacy}', 'received_events_url': 'https://api.github.com/users/facebook-github-bot/received_events', 'type': 'User', 'site_admin': False}",closed,623ae0c07c83d217b7ba2efabfddd4ce59cdd934,https://api.github.com/repos/pytorch/pytorch/commits/623ae0c07c83d217b7ba2efabfddd4ce59cdd934,2018-07-02T05:25:23Z,55,36,19
8452,1707527181,"{'login': 'facebook-github-bot', 'id': 6422482, 'node_id': 'MDQ6VXNlcjY0MjI0ODI=', 'avatar_url': 'https://avatars3.githubusercontent.com/u/6422482?v=4', 'gravatar_id': '', 'url': 'https://api.github.com/users/facebook-github-bot', 'html_url': 'https://github.com/facebook-github-bot', 'followers_url': 'https://api.github.com/users/facebook-github-bot/followers', 'following_url': 'https://api.github.com/users/facebook-github-bot/following{/other_user}', 'gists_url': 'https://api.github.com/users/facebook-github-bot/gists{/gist_id}', 'starred_url': 'https://api.github.com/users/facebook-github-bot/starred{/owner}{/repo}', 'subscriptions_url': 'https://api.github.com/users/facebook-github-bot/subscriptions', 'organizations_url': 'https://api.github.com/users/facebook-github-bot/orgs', 'repos_url': 'https://api.github.com/users/facebook-github-bot/repos', 'events_url': 'https://api.github.com/users/facebook-github-bot/events{/privacy}', 'received_events_url': 'https://api.github.com/users/facebook-github-bot/received_events', 'type': 'User', 'site_admin': False}",referenced,0bd9e96b0860a521307d38b54e164d0cdd80e48b,https://api.github.com/repos/pytorch/pytorch/commits/0bd9e96b0860a521307d38b54e164d0cdd80e48b,2018-06-28T23:11:10Z,57,40,17
8439,1844477182,"{'login': 'facebook-github-bot', 'id': 6422482, 'node_id': 'MDQ6VXNlcjY0MjI0ODI=', 'avatar_url': 'https://avatars3.githubusercontent.com/u/6422482?v=4', 'gravatar_id': '', 'url': 'https://api.github.com/users/facebook-github-bot', 'html_url': 'https://github.com/facebook-github-bot', 'followers_url': 'https://api.github.com/users/facebook-github-bot/followers', 'following_url': 'https://api.github.com/users/facebook-github-bot/following{/other_user}', 'gists_url': 'https://api.github.com/users/facebook-github-bot/gists{/gist_id}', 'starred_url': 'https://api.github.com/users/facebook-github-bot/starred{/owner}{/repo}', 'subscriptions_url': 'https://api.github.com/users/facebook-github-bot/subscriptions', 'organizations_url': 'https://api.github.com/users/facebook-github-bot/orgs', 'repos_url': 'https://api.github.com/users/facebook-github-bot/repos', 'events_url': 'https://api.github.com/users/facebook-github-bot/events{/privacy}', 'received_events_url': 'https://api.github.com/users/facebook-github-bot/received_events', 'type': 'User', 'site_admin': False}",closed,75f49befeb922a577a1e0e38f26e963b57c1f8ea,https://api.github.com/repos/pytorch/pytorch/commits/75f49befeb922a577a1e0e38f26e963b57c1f8ea,2018-09-13T19:27:46Z,133,73,60
8420,1679432480,"{'login': 'ezyang', 'id': 13564, 'node_id': 'MDQ6VXNlcjEzNTY0', 'avatar_url': 'https://avatars0.githubusercontent.com/u/13564?v=4', 'gravatar_id': '', 'url': 'https://api.github.com/users/ezyang', 'html_url': 'https://github.com/ezyang', 'followers_url': 'https://api.github.com/users/ezyang/followers', 'following_url': 'https://api.github.com/users/ezyang/following{/other_user}', 'gists_url': 'https://api.github.com/users/ezyang/gists{/gist_id}', 'starred_url': 'https://api.github.com/users/ezyang/starred{/owner}{/repo}', 'subscriptions_url': 'https://api.github.com/users/ezyang/subscriptions', 'organizations_url': 'https://api.github.com/users/ezyang/orgs', 'repos_url': 'https://api.github.com/users/ezyang/repos', 'events_url': 'https://api.github.com/users/ezyang/events{/privacy}', 'received_events_url': 'https://api.github.com/users/ezyang/received_events', 'type': 'User', 'site_admin': False}",referenced,f1b512430619e3b747f63117d2406f070fba2b65,https://api.github.com/repos/pytorch/pytorch/commits/f1b512430619e3b747f63117d2406f070fba2b65,2018-06-13T18:27:09Z,13,10,3
8410,1700280732,"{'login': 'zdevito', 'id': 370202, 'node_id': 'MDQ6VXNlcjM3MDIwMg==', 'avatar_url': 'https://avatars0.githubusercontent.com/u/370202?v=4', 'gravatar_id': '', 'url': 'https://api.github.com/users/zdevito', 'html_url': 'https://github.com/zdevito', 'followers_url': 'https://api.github.com/users/zdevito/followers', 'following_url': 'https://api.github.com/users/zdevito/following{/other_user}', 'gists_url': 'https://api.github.com/users/zdevito/gists{/gist_id}', 'starred_url': 'https://api.github.com/users/zdevito/starred{/owner}{/repo}', 'subscriptions_url': 'https://api.github.com/users/zdevito/subscriptions', 'organizations_url': 'https://api.github.com/users/zdevito/orgs', 'repos_url': 'https://api.github.com/users/zdevito/repos', 'events_url': 'https://api.github.com/users/zdevito/events{/privacy}', 'received_events_url': 'https://api.github.com/users/zdevito/received_events', 'type': 'User', 'site_admin': False}",referenced,f74207c99fea86e8a613a037f3c15c31dfff2887,https://api.github.com/repos/pytorch/pytorch/commits/f74207c99fea86e8a613a037f3c15c31dfff2887,2018-06-26T01:40:40Z,576,368,208
8385,1766405354,"{'login': 'facebook-github-bot', 'id': 6422482, 'node_id': 'MDQ6VXNlcjY0MjI0ODI=', 'avatar_url': 'https://avatars3.githubusercontent.com/u/6422482?v=4', 'gravatar_id': '', 'url': 'https://api.github.com/users/facebook-github-bot', 'html_url': 'https://github.com/facebook-github-bot', 'followers_url': 'https://api.github.com/users/facebook-github-bot/followers', 'following_url': 'https://api.github.com/users/facebook-github-bot/following{/other_user}', 'gists_url': 'https://api.github.com/users/facebook-github-bot/gists{/gist_id}', 'starred_url': 'https://api.github.com/users/facebook-github-bot/starred{/owner}{/repo}', 'subscriptions_url': 'https://api.github.com/users/facebook-github-bot/subscriptions', 'organizations_url': 'https://api.github.com/users/facebook-github-bot/orgs', 'repos_url': 'https://api.github.com/users/facebook-github-bot/repos', 'events_url': 'https://api.github.com/users/facebook-github-bot/events{/privacy}', 'received_events_url': 'https://api.github.com/users/facebook-github-bot/received_events', 'type': 'User', 'site_admin': False}",closed,ad6d62250ae4be3face0a75ce98470dde249cf5a,https://api.github.com/repos/pytorch/pytorch/commits/ad6d62250ae4be3face0a75ce98470dde249cf5a,2018-08-01T22:36:06Z,16,16,0
8366,1839493814,"{'login': 'facebook-github-bot', 'id': 6422482, 'node_id': 'MDQ6VXNlcjY0MjI0ODI=', 'avatar_url': 'https://avatars3.githubusercontent.com/u/6422482?v=4', 'gravatar_id': '', 'url': 'https://api.github.com/users/facebook-github-bot', 'html_url': 'https://github.com/facebook-github-bot', 'followers_url': 'https://api.github.com/users/facebook-github-bot/followers', 'following_url': 'https://api.github.com/users/facebook-github-bot/following{/other_user}', 'gists_url': 'https://api.github.com/users/facebook-github-bot/gists{/gist_id}', 'starred_url': 'https://api.github.com/users/facebook-github-bot/starred{/owner}{/repo}', 'subscriptions_url': 'https://api.github.com/users/facebook-github-bot/subscriptions', 'organizations_url': 'https://api.github.com/users/facebook-github-bot/orgs', 'repos_url': 'https://api.github.com/users/facebook-github-bot/repos', 'events_url': 'https://api.github.com/users/facebook-github-bot/events{/privacy}', 'received_events_url': 'https://api.github.com/users/facebook-github-bot/received_events', 'type': 'User', 'site_admin': False}",referenced,c1dce21fd5505085ef148aa9d70a312d8d14257f,https://api.github.com/repos/pytorch/pytorch/commits/c1dce21fd5505085ef148aa9d70a312d8d14257f,2018-09-11T20:10:50Z,196,179,17
8351,1844416169,"{'login': 'facebook-github-bot', 'id': 6422482, 'node_id': 'MDQ6VXNlcjY0MjI0ODI=', 'avatar_url': 'https://avatars3.githubusercontent.com/u/6422482?v=4', 'gravatar_id': '', 'url': 'https://api.github.com/users/facebook-github-bot', 'html_url': 'https://github.com/facebook-github-bot', 'followers_url': 'https://api.github.com/users/facebook-github-bot/followers', 'following_url': 'https://api.github.com/users/facebook-github-bot/following{/other_user}', 'gists_url': 'https://api.github.com/users/facebook-github-bot/gists{/gist_id}', 'starred_url': 'https://api.github.com/users/facebook-github-bot/starred{/owner}{/repo}', 'subscriptions_url': 'https://api.github.com/users/facebook-github-bot/subscriptions', 'organizations_url': 'https://api.github.com/users/facebook-github-bot/orgs', 'repos_url': 'https://api.github.com/users/facebook-github-bot/repos', 'events_url': 'https://api.github.com/users/facebook-github-bot/events{/privacy}', 'received_events_url': 'https://api.github.com/users/facebook-github-bot/received_events', 'type': 'User', 'site_admin': False}",closed,9abc66674559ac214dad31ca42bc0d981d5260db,https://api.github.com/repos/pytorch/pytorch/commits/9abc66674559ac214dad31ca42bc0d981d5260db,2018-09-13T18:57:49Z,15,15,0
8335,1675190083,"{'login': 'ezyang', 'id': 13564, 'node_id': 'MDQ6VXNlcjEzNTY0', 'avatar_url': 'https://avatars0.githubusercontent.com/u/13564?v=4', 'gravatar_id': '', 'url': 'https://api.github.com/users/ezyang', 'html_url': 'https://github.com/ezyang', 'followers_url': 'https://api.github.com/users/ezyang/followers', 'following_url': 'https://api.github.com/users/ezyang/following{/other_user}', 'gists_url': 'https://api.github.com/users/ezyang/gists{/gist_id}', 'starred_url': 'https://api.github.com/users/ezyang/starred{/owner}{/repo}', 'subscriptions_url': 'https://api.github.com/users/ezyang/subscriptions', 'organizations_url': 'https://api.github.com/users/ezyang/orgs', 'repos_url': 'https://api.github.com/users/ezyang/repos', 'events_url': 'https://api.github.com/users/ezyang/events{/privacy}', 'received_events_url': 'https://api.github.com/users/ezyang/received_events', 'type': 'User', 'site_admin': False}",closed,0cced57cb8ff14ac04ddf624f4a51c33c864f170,https://api.github.com/repos/pytorch/pytorch/commits/0cced57cb8ff14ac04ddf624f4a51c33c864f170,2018-06-12T01:05:54Z,4,2,2
8333,1674303545,"{'login': 'ezyang', 'id': 13564, 'node_id': 'MDQ6VXNlcjEzNTY0', 'avatar_url': 'https://avatars0.githubusercontent.com/u/13564?v=4', 'gravatar_id': '', 'url': 'https://api.github.com/users/ezyang', 'html_url': 'https://github.com/ezyang', 'followers_url': 'https://api.github.com/users/ezyang/followers', 'following_url': 'https://api.github.com/users/ezyang/following{/other_user}', 'gists_url': 'https://api.github.com/users/ezyang/gists{/gist_id}', 'starred_url': 'https://api.github.com/users/ezyang/starred{/owner}{/repo}', 'subscriptions_url': 'https://api.github.com/users/ezyang/subscriptions', 'organizations_url': 'https://api.github.com/users/ezyang/orgs', 'repos_url': 'https://api.github.com/users/ezyang/repos', 'events_url': 'https://api.github.com/users/ezyang/events{/privacy}', 'received_events_url': 'https://api.github.com/users/ezyang/received_events', 'type': 'User', 'site_admin': False}",closed,77660a9cbb0498d7951a8e3e53409ac944479d6c,https://api.github.com/repos/pytorch/pytorch/commits/77660a9cbb0498d7951a8e3e53409ac944479d6c,2018-06-11T16:16:22Z,6,6,0
8333,1684480417,"{'login': 'soumith', 'id': 1310570, 'node_id': 'MDQ6VXNlcjEzMTA1NzA=', 'avatar_url': 'https://avatars0.githubusercontent.com/u/1310570?v=4', 'gravatar_id': '', 'url': 'https://api.github.com/users/soumith', 'html_url': 'https://github.com/soumith', 'followers_url': 'https://api.github.com/users/soumith/followers', 'following_url': 'https://api.github.com/users/soumith/following{/other_user}', 'gists_url': 'https://api.github.com/users/soumith/gists{/gist_id}', 'starred_url': 'https://api.github.com/users/soumith/starred{/owner}{/repo}', 'subscriptions_url': 'https://api.github.com/users/soumith/subscriptions', 'organizations_url': 'https://api.github.com/users/soumith/orgs', 'repos_url': 'https://api.github.com/users/soumith/repos', 'events_url': 'https://api.github.com/users/soumith/events{/privacy}', 'received_events_url': 'https://api.github.com/users/soumith/received_events', 'type': 'User', 'site_admin': False}",referenced,c9b8d8566d550e46f03c922a95429bd6d31ed271,https://api.github.com/repos/pytorch/pytorch/commits/c9b8d8566d550e46f03c922a95429bd6d31ed271,2018-06-16T01:21:43Z,300,300,0
8330,1875478555,"{'login': 'facebook-github-bot', 'id': 6422482, 'node_id': 'MDQ6VXNlcjY0MjI0ODI=', 'avatar_url': 'https://avatars3.githubusercontent.com/u/6422482?v=4', 'gravatar_id': '', 'url': 'https://api.github.com/users/facebook-github-bot', 'html_url': 'https://github.com/facebook-github-bot', 'followers_url': 'https://api.github.com/users/facebook-github-bot/followers', 'following_url': 'https://api.github.com/users/facebook-github-bot/following{/other_user}', 'gists_url': 'https://api.github.com/users/facebook-github-bot/gists{/gist_id}', 'starred_url': 'https://api.github.com/users/facebook-github-bot/starred{/owner}{/repo}', 'subscriptions_url': 'https://api.github.com/users/facebook-github-bot/subscriptions', 'organizations_url': 'https://api.github.com/users/facebook-github-bot/orgs', 'repos_url': 'https://api.github.com/users/facebook-github-bot/repos', 'events_url': 'https://api.github.com/users/facebook-github-bot/events{/privacy}', 'received_events_url': 'https://api.github.com/users/facebook-github-bot/received_events', 'type': 'User', 'site_admin': False}",closed,572132fb1701e3c9a16dea50547355773a66a9a2,https://api.github.com/repos/pytorch/pytorch/commits/572132fb1701e3c9a16dea50547355773a66a9a2,2018-09-30T18:56:26Z,116,90,26
8212,2567814894,"{'login': 'facebook-github-bot', 'id': 6422482, 'node_id': 'MDQ6VXNlcjY0MjI0ODI=', 'avatar_url': 'https://avatars3.githubusercontent.com/u/6422482?v=4', 'gravatar_id': '', 'url': 'https://api.github.com/users/facebook-github-bot', 'html_url': 'https://github.com/facebook-github-bot', 'followers_url': 'https://api.github.com/users/facebook-github-bot/followers', 'following_url': 'https://api.github.com/users/facebook-github-bot/following{/other_user}', 'gists_url': 'https://api.github.com/users/facebook-github-bot/gists{/gist_id}', 'starred_url': 'https://api.github.com/users/facebook-github-bot/starred{/owner}{/repo}', 'subscriptions_url': 'https://api.github.com/users/facebook-github-bot/subscriptions', 'organizations_url': 'https://api.github.com/users/facebook-github-bot/orgs', 'repos_url': 'https://api.github.com/users/facebook-github-bot/repos', 'events_url': 'https://api.github.com/users/facebook-github-bot/events{/privacy}', 'received_events_url': 'https://api.github.com/users/facebook-github-bot/received_events', 'type': 'User', 'site_admin': False}",closed,6100205eb8a88090581a905e595e7d1d2a8c232d,https://api.github.com/repos/pytorch/pytorch/commits/6100205eb8a88090581a905e595e7d1d2a8c232d,2019-08-19T22:06:14Z,404,290,114
8208,1697752497,"{'login': 'SsnL', 'id': 5674597, 'node_id': 'MDQ6VXNlcjU2NzQ1OTc=', 'avatar_url': 'https://avatars2.githubusercontent.com/u/5674597?v=4', 'gravatar_id': '', 'url': 'https://api.github.com/users/SsnL', 'html_url': 'https://github.com/SsnL', 'followers_url': 'https://api.github.com/users/SsnL/followers', 'following_url': 'https://api.github.com/users/SsnL/following{/other_user}', 'gists_url': 'https://api.github.com/users/SsnL/gists{/gist_id}', 'starred_url': 'https://api.github.com/users/SsnL/starred{/owner}{/repo}', 'subscriptions_url': 'https://api.github.com/users/SsnL/subscriptions', 'organizations_url': 'https://api.github.com/users/SsnL/orgs', 'repos_url': 'https://api.github.com/users/SsnL/repos', 'events_url': 'https://api.github.com/users/SsnL/events{/privacy}', 'received_events_url': 'https://api.github.com/users/SsnL/received_events', 'type': 'User', 'site_admin': False}",referenced,fc22bf3e82723178015708ae1265ec14710c2dec,https://api.github.com/repos/pytorch/pytorch/commits/fc22bf3e82723178015708ae1265ec14710c2dec,2018-06-24T21:15:47Z,91,72,19
8110,1661707609,"{'login': 'ezyang', 'id': 13564, 'node_id': 'MDQ6VXNlcjEzNTY0', 'avatar_url': 'https://avatars0.githubusercontent.com/u/13564?v=4', 'gravatar_id': '', 'url': 'https://api.github.com/users/ezyang', 'html_url': 'https://github.com/ezyang', 'followers_url': 'https://api.github.com/users/ezyang/followers', 'following_url': 'https://api.github.com/users/ezyang/following{/other_user}', 'gists_url': 'https://api.github.com/users/ezyang/gists{/gist_id}', 'starred_url': 'https://api.github.com/users/ezyang/starred{/owner}{/repo}', 'subscriptions_url': 'https://api.github.com/users/ezyang/subscriptions', 'organizations_url': 'https://api.github.com/users/ezyang/orgs', 'repos_url': 'https://api.github.com/users/ezyang/repos', 'events_url': 'https://api.github.com/users/ezyang/events{/privacy}', 'received_events_url': 'https://api.github.com/users/ezyang/received_events', 'type': 'User', 'site_admin': False}",referenced,96a77b5aa80a3d7512e7916c28af469eae353962,https://api.github.com/repos/pytorch/pytorch/commits/96a77b5aa80a3d7512e7916c28af469eae353962,2018-06-04T16:13:30Z,47,38,9
8110,1684480251,"{'login': 'soumith', 'id': 1310570, 'node_id': 'MDQ6VXNlcjEzMTA1NzA=', 'avatar_url': 'https://avatars0.githubusercontent.com/u/1310570?v=4', 'gravatar_id': '', 'url': 'https://api.github.com/users/soumith', 'html_url': 'https://github.com/soumith', 'followers_url': 'https://api.github.com/users/soumith/followers', 'following_url': 'https://api.github.com/users/soumith/following{/other_user}', 'gists_url': 'https://api.github.com/users/soumith/gists{/gist_id}', 'starred_url': 'https://api.github.com/users/soumith/starred{/owner}{/repo}', 'subscriptions_url': 'https://api.github.com/users/soumith/subscriptions', 'organizations_url': 'https://api.github.com/users/soumith/orgs', 'repos_url': 'https://api.github.com/users/soumith/repos', 'events_url': 'https://api.github.com/users/soumith/events{/privacy}', 'received_events_url': 'https://api.github.com/users/soumith/received_events', 'type': 'User', 'site_admin': False}",referenced,c9b8d8566d550e46f03c922a95429bd6d31ed271,https://api.github.com/repos/pytorch/pytorch/commits/c9b8d8566d550e46f03c922a95429bd6d31ed271,2018-06-16T01:21:39Z,300,300,0
8084,1677566209,"{'login': 'ezyang', 'id': 13564, 'node_id': 'MDQ6VXNlcjEzNTY0', 'avatar_url': 'https://avatars0.githubusercontent.com/u/13564?v=4', 'gravatar_id': '', 'url': 'https://api.github.com/users/ezyang', 'html_url': 'https://github.com/ezyang', 'followers_url': 'https://api.github.com/users/ezyang/followers', 'following_url': 'https://api.github.com/users/ezyang/following{/other_user}', 'gists_url': 'https://api.github.com/users/ezyang/gists{/gist_id}', 'starred_url': 'https://api.github.com/users/ezyang/starred{/owner}{/repo}', 'subscriptions_url': 'https://api.github.com/users/ezyang/subscriptions', 'organizations_url': 'https://api.github.com/users/ezyang/orgs', 'repos_url': 'https://api.github.com/users/ezyang/repos', 'events_url': 'https://api.github.com/users/ezyang/events{/privacy}', 'received_events_url': 'https://api.github.com/users/ezyang/received_events', 'type': 'User', 'site_admin': False}",closed,4485ce66c293935d36745b9b11d8927aba16d64d,https://api.github.com/repos/pytorch/pytorch/commits/4485ce66c293935d36745b9b11d8927aba16d64d,2018-06-13T00:06:57Z,2,1,1
8076,1766632725,"{'login': 'facebook-github-bot', 'id': 6422482, 'node_id': 'MDQ6VXNlcjY0MjI0ODI=', 'avatar_url': 'https://avatars3.githubusercontent.com/u/6422482?v=4', 'gravatar_id': '', 'url': 'https://api.github.com/users/facebook-github-bot', 'html_url': 'https://github.com/facebook-github-bot', 'followers_url': 'https://api.github.com/users/facebook-github-bot/followers', 'following_url': 'https://api.github.com/users/facebook-github-bot/following{/other_user}', 'gists_url': 'https://api.github.com/users/facebook-github-bot/gists{/gist_id}', 'starred_url': 'https://api.github.com/users/facebook-github-bot/starred{/owner}{/repo}', 'subscriptions_url': 'https://api.github.com/users/facebook-github-bot/subscriptions', 'organizations_url': 'https://api.github.com/users/facebook-github-bot/orgs', 'repos_url': 'https://api.github.com/users/facebook-github-bot/repos', 'events_url': 'https://api.github.com/users/facebook-github-bot/events{/privacy}', 'received_events_url': 'https://api.github.com/users/facebook-github-bot/received_events', 'type': 'User', 'site_admin': False}",closed,6b338c80264280b1c983ba49d0ffa43a499cd2fe,https://api.github.com/repos/pytorch/pytorch/commits/6b338c80264280b1c983ba49d0ffa43a499cd2fe,2018-08-02T02:19:30Z,96,65,31
7993,1663821332,"{'login': 'soumith', 'id': 1310570, 'node_id': 'MDQ6VXNlcjEzMTA1NzA=', 'avatar_url': 'https://avatars0.githubusercontent.com/u/1310570?v=4', 'gravatar_id': '', 'url': 'https://api.github.com/users/soumith', 'html_url': 'https://github.com/soumith', 'followers_url': 'https://api.github.com/users/soumith/followers', 'following_url': 'https://api.github.com/users/soumith/following{/other_user}', 'gists_url': 'https://api.github.com/users/soumith/gists{/gist_id}', 'starred_url': 'https://api.github.com/users/soumith/starred{/owner}{/repo}', 'subscriptions_url': 'https://api.github.com/users/soumith/subscriptions', 'organizations_url': 'https://api.github.com/users/soumith/orgs', 'repos_url': 'https://api.github.com/users/soumith/repos', 'events_url': 'https://api.github.com/users/soumith/events{/privacy}', 'received_events_url': 'https://api.github.com/users/soumith/received_events', 'type': 'User', 'site_admin': False}",referenced,ee0b75a3d2b60cf82ccc0acb0fb2b1e581e1bfee,https://api.github.com/repos/pytorch/pytorch/commits/ee0b75a3d2b60cf82ccc0acb0fb2b1e581e1bfee,2018-06-05T14:16:12Z,7,7,0
7993,1684480277,"{'login': 'soumith', 'id': 1310570, 'node_id': 'MDQ6VXNlcjEzMTA1NzA=', 'avatar_url': 'https://avatars0.githubusercontent.com/u/1310570?v=4', 'gravatar_id': '', 'url': 'https://api.github.com/users/soumith', 'html_url': 'https://github.com/soumith', 'followers_url': 'https://api.github.com/users/soumith/followers', 'following_url': 'https://api.github.com/users/soumith/following{/other_user}', 'gists_url': 'https://api.github.com/users/soumith/gists{/gist_id}', 'starred_url': 'https://api.github.com/users/soumith/starred{/owner}{/repo}', 'subscriptions_url': 'https://api.github.com/users/soumith/subscriptions', 'organizations_url': 'https://api.github.com/users/soumith/orgs', 'repos_url': 'https://api.github.com/users/soumith/repos', 'events_url': 'https://api.github.com/users/soumith/events{/privacy}', 'received_events_url': 'https://api.github.com/users/soumith/received_events', 'type': 'User', 'site_admin': False}",referenced,c9b8d8566d550e46f03c922a95429bd6d31ed271,https://api.github.com/repos/pytorch/pytorch/commits/c9b8d8566d550e46f03c922a95429bd6d31ed271,2018-06-16T01:21:40Z,300,300,0
7929,1710277586,"{'login': 'facebook-github-bot', 'id': 6422482, 'node_id': 'MDQ6VXNlcjY0MjI0ODI=', 'avatar_url': 'https://avatars3.githubusercontent.com/u/6422482?v=4', 'gravatar_id': '', 'url': 'https://api.github.com/users/facebook-github-bot', 'html_url': 'https://github.com/facebook-github-bot', 'followers_url': 'https://api.github.com/users/facebook-github-bot/followers', 'following_url': 'https://api.github.com/users/facebook-github-bot/following{/other_user}', 'gists_url': 'https://api.github.com/users/facebook-github-bot/gists{/gist_id}', 'starred_url': 'https://api.github.com/users/facebook-github-bot/starred{/owner}{/repo}', 'subscriptions_url': 'https://api.github.com/users/facebook-github-bot/subscriptions', 'organizations_url': 'https://api.github.com/users/facebook-github-bot/orgs', 'repos_url': 'https://api.github.com/users/facebook-github-bot/repos', 'events_url': 'https://api.github.com/users/facebook-github-bot/events{/privacy}', 'received_events_url': 'https://api.github.com/users/facebook-github-bot/received_events', 'type': 'User', 'site_admin': False}",closed,c61f0217a536d19c9ff3290067ddcbb9ce3a5c6a,https://api.github.com/repos/pytorch/pytorch/commits/c61f0217a536d19c9ff3290067ddcbb9ce3a5c6a,2018-07-01T12:40:07Z,1787,998,789
7908,1813751433,"{'login': 'facebook-github-bot', 'id': 6422482, 'node_id': 'MDQ6VXNlcjY0MjI0ODI=', 'avatar_url': 'https://avatars3.githubusercontent.com/u/6422482?v=4', 'gravatar_id': '', 'url': 'https://api.github.com/users/facebook-github-bot', 'html_url': 'https://github.com/facebook-github-bot', 'followers_url': 'https://api.github.com/users/facebook-github-bot/followers', 'following_url': 'https://api.github.com/users/facebook-github-bot/following{/other_user}', 'gists_url': 'https://api.github.com/users/facebook-github-bot/gists{/gist_id}', 'starred_url': 'https://api.github.com/users/facebook-github-bot/starred{/owner}{/repo}', 'subscriptions_url': 'https://api.github.com/users/facebook-github-bot/subscriptions', 'organizations_url': 'https://api.github.com/users/facebook-github-bot/orgs', 'repos_url': 'https://api.github.com/users/facebook-github-bot/repos', 'events_url': 'https://api.github.com/users/facebook-github-bot/events{/privacy}', 'received_events_url': 'https://api.github.com/users/facebook-github-bot/received_events', 'type': 'User', 'site_admin': False}",closed,7f9fd1cc264729c1b9f48e5ac398119999b0cd31,https://api.github.com/repos/pytorch/pytorch/commits/7f9fd1cc264729c1b9f48e5ac398119999b0cd31,2018-08-28T17:54:54Z,58,55,3
7883,1738345829,"{'login': 'facebook-github-bot', 'id': 6422482, 'node_id': 'MDQ6VXNlcjY0MjI0ODI=', 'avatar_url': 'https://avatars3.githubusercontent.com/u/6422482?v=4', 'gravatar_id': '', 'url': 'https://api.github.com/users/facebook-github-bot', 'html_url': 'https://github.com/facebook-github-bot', 'followers_url': 'https://api.github.com/users/facebook-github-bot/followers', 'following_url': 'https://api.github.com/users/facebook-github-bot/following{/other_user}', 'gists_url': 'https://api.github.com/users/facebook-github-bot/gists{/gist_id}', 'starred_url': 'https://api.github.com/users/facebook-github-bot/starred{/owner}{/repo}', 'subscriptions_url': 'https://api.github.com/users/facebook-github-bot/subscriptions', 'organizations_url': 'https://api.github.com/users/facebook-github-bot/orgs', 'repos_url': 'https://api.github.com/users/facebook-github-bot/repos', 'events_url': 'https://api.github.com/users/facebook-github-bot/events{/privacy}', 'received_events_url': 'https://api.github.com/users/facebook-github-bot/received_events', 'type': 'User', 'site_admin': False}",closed,050a2588b567439ac0aea370649722cf4757f3a3,https://api.github.com/repos/pytorch/pytorch/commits/050a2588b567439ac0aea370649722cf4757f3a3,2018-07-17T17:56:33Z,479,248,231
7881,1819467739,"{'login': 'facebook-github-bot', 'id': 6422482, 'node_id': 'MDQ6VXNlcjY0MjI0ODI=', 'avatar_url': 'https://avatars3.githubusercontent.com/u/6422482?v=4', 'gravatar_id': '', 'url': 'https://api.github.com/users/facebook-github-bot', 'html_url': 'https://github.com/facebook-github-bot', 'followers_url': 'https://api.github.com/users/facebook-github-bot/followers', 'following_url': 'https://api.github.com/users/facebook-github-bot/following{/other_user}', 'gists_url': 'https://api.github.com/users/facebook-github-bot/gists{/gist_id}', 'starred_url': 'https://api.github.com/users/facebook-github-bot/starred{/owner}{/repo}', 'subscriptions_url': 'https://api.github.com/users/facebook-github-bot/subscriptions', 'organizations_url': 'https://api.github.com/users/facebook-github-bot/orgs', 'repos_url': 'https://api.github.com/users/facebook-github-bot/repos', 'events_url': 'https://api.github.com/users/facebook-github-bot/events{/privacy}', 'received_events_url': 'https://api.github.com/users/facebook-github-bot/received_events', 'type': 'User', 'site_admin': False}",closed,15314c7b8e18ca9c8317491286cfa1b2270895c0,https://api.github.com/repos/pytorch/pytorch/commits/15314c7b8e18ca9c8317491286cfa1b2270895c0,2018-08-30T23:42:21Z,2,1,1
7851,1918989139,"{'login': 'facebook-github-bot', 'id': 6422482, 'node_id': 'MDQ6VXNlcjY0MjI0ODI=', 'avatar_url': 'https://avatars3.githubusercontent.com/u/6422482?v=4', 'gravatar_id': '', 'url': 'https://api.github.com/users/facebook-github-bot', 'html_url': 'https://github.com/facebook-github-bot', 'followers_url': 'https://api.github.com/users/facebook-github-bot/followers', 'following_url': 'https://api.github.com/users/facebook-github-bot/following{/other_user}', 'gists_url': 'https://api.github.com/users/facebook-github-bot/gists{/gist_id}', 'starred_url': 'https://api.github.com/users/facebook-github-bot/starred{/owner}{/repo}', 'subscriptions_url': 'https://api.github.com/users/facebook-github-bot/subscriptions', 'organizations_url': 'https://api.github.com/users/facebook-github-bot/orgs', 'repos_url': 'https://api.github.com/users/facebook-github-bot/repos', 'events_url': 'https://api.github.com/users/facebook-github-bot/events{/privacy}', 'received_events_url': 'https://api.github.com/users/facebook-github-bot/received_events', 'type': 'User', 'site_admin': False}",referenced,952df2ba8f3cf0117b20cd3505756568ef8b9ddf,https://api.github.com/repos/pytorch/pytorch/commits/952df2ba8f3cf0117b20cd3505756568ef8b9ddf,2018-10-23T01:18:08Z,5,3,2
7849,1654573440,"{'login': 'zou3519', 'id': 5652049, 'node_id': 'MDQ6VXNlcjU2NTIwNDk=', 'avatar_url': 'https://avatars3.githubusercontent.com/u/5652049?v=4', 'gravatar_id': '', 'url': 'https://api.github.com/users/zou3519', 'html_url': 'https://github.com/zou3519', 'followers_url': 'https://api.github.com/users/zou3519/followers', 'following_url': 'https://api.github.com/users/zou3519/following{/other_user}', 'gists_url': 'https://api.github.com/users/zou3519/gists{/gist_id}', 'starred_url': 'https://api.github.com/users/zou3519/starred{/owner}{/repo}', 'subscriptions_url': 'https://api.github.com/users/zou3519/subscriptions', 'organizations_url': 'https://api.github.com/users/zou3519/orgs', 'repos_url': 'https://api.github.com/users/zou3519/repos', 'events_url': 'https://api.github.com/users/zou3519/events{/privacy}', 'received_events_url': 'https://api.github.com/users/zou3519/received_events', 'type': 'User', 'site_admin': False}",referenced,8e6cd43291ce29654afcb65cc91c74333a89ded4,https://api.github.com/repos/pytorch/pytorch/commits/8e6cd43291ce29654afcb65cc91c74333a89ded4,2018-05-30T20:51:57Z,2,1,1
7849,1684480108,"{'login': 'soumith', 'id': 1310570, 'node_id': 'MDQ6VXNlcjEzMTA1NzA=', 'avatar_url': 'https://avatars0.githubusercontent.com/u/1310570?v=4', 'gravatar_id': '', 'url': 'https://api.github.com/users/soumith', 'html_url': 'https://github.com/soumith', 'followers_url': 'https://api.github.com/users/soumith/followers', 'following_url': 'https://api.github.com/users/soumith/following{/other_user}', 'gists_url': 'https://api.github.com/users/soumith/gists{/gist_id}', 'starred_url': 'https://api.github.com/users/soumith/starred{/owner}{/repo}', 'subscriptions_url': 'https://api.github.com/users/soumith/subscriptions', 'organizations_url': 'https://api.github.com/users/soumith/orgs', 'repos_url': 'https://api.github.com/users/soumith/repos', 'events_url': 'https://api.github.com/users/soumith/events{/privacy}', 'received_events_url': 'https://api.github.com/users/soumith/received_events', 'type': 'User', 'site_admin': False}",referenced,c9b8d8566d550e46f03c922a95429bd6d31ed271,https://api.github.com/repos/pytorch/pytorch/commits/c9b8d8566d550e46f03c922a95429bd6d31ed271,2018-06-16T01:21:37Z,300,300,0
7817,1647379671,"{'login': 'anderspapitto', 'id': 1388690, 'node_id': 'MDQ6VXNlcjEzODg2OTA=', 'avatar_url': 'https://avatars3.githubusercontent.com/u/1388690?v=4', 'gravatar_id': '', 'url': 'https://api.github.com/users/anderspapitto', 'html_url': 'https://github.com/anderspapitto', 'followers_url': 'https://api.github.com/users/anderspapitto/followers', 'following_url': 'https://api.github.com/users/anderspapitto/following{/other_user}', 'gists_url': 'https://api.github.com/users/anderspapitto/gists{/gist_id}', 'starred_url': 'https://api.github.com/users/anderspapitto/starred{/owner}{/repo}', 'subscriptions_url': 'https://api.github.com/users/anderspapitto/subscriptions', 'organizations_url': 'https://api.github.com/users/anderspapitto/orgs', 'repos_url': 'https://api.github.com/users/anderspapitto/repos', 'events_url': 'https://api.github.com/users/anderspapitto/events{/privacy}', 'received_events_url': 'https://api.github.com/users/anderspapitto/received_events', 'type': 'User', 'site_admin': False}",referenced,d5c466e5ce93115a8ce4ab18bf4fa661d7ecc102,https://api.github.com/repos/pytorch/pytorch/commits/d5c466e5ce93115a8ce4ab18bf4fa661d7ecc102,2018-05-25T19:57:30Z,38,24,14
7800,1741214697,"{'login': 'facebook-github-bot', 'id': 6422482, 'node_id': 'MDQ6VXNlcjY0MjI0ODI=', 'avatar_url': 'https://avatars3.githubusercontent.com/u/6422482?v=4', 'gravatar_id': '', 'url': 'https://api.github.com/users/facebook-github-bot', 'html_url': 'https://github.com/facebook-github-bot', 'followers_url': 'https://api.github.com/users/facebook-github-bot/followers', 'following_url': 'https://api.github.com/users/facebook-github-bot/following{/other_user}', 'gists_url': 'https://api.github.com/users/facebook-github-bot/gists{/gist_id}', 'starred_url': 'https://api.github.com/users/facebook-github-bot/starred{/owner}{/repo}', 'subscriptions_url': 'https://api.github.com/users/facebook-github-bot/subscriptions', 'organizations_url': 'https://api.github.com/users/facebook-github-bot/orgs', 'repos_url': 'https://api.github.com/users/facebook-github-bot/repos', 'events_url': 'https://api.github.com/users/facebook-github-bot/events{/privacy}', 'received_events_url': 'https://api.github.com/users/facebook-github-bot/received_events', 'type': 'User', 'site_admin': False}",closed,3b886500a0481401267887c21c378c7752e06236,https://api.github.com/repos/pytorch/pytorch/commits/3b886500a0481401267887c21c378c7752e06236,2018-07-18T21:41:34Z,458,365,93
7793,1905484218,"{'login': 'facebook-github-bot', 'id': 6422482, 'node_id': 'MDQ6VXNlcjY0MjI0ODI=', 'avatar_url': 'https://avatars3.githubusercontent.com/u/6422482?v=4', 'gravatar_id': '', 'url': 'https://api.github.com/users/facebook-github-bot', 'html_url': 'https://github.com/facebook-github-bot', 'followers_url': 'https://api.github.com/users/facebook-github-bot/followers', 'following_url': 'https://api.github.com/users/facebook-github-bot/following{/other_user}', 'gists_url': 'https://api.github.com/users/facebook-github-bot/gists{/gist_id}', 'starred_url': 'https://api.github.com/users/facebook-github-bot/starred{/owner}{/repo}', 'subscriptions_url': 'https://api.github.com/users/facebook-github-bot/subscriptions', 'organizations_url': 'https://api.github.com/users/facebook-github-bot/orgs', 'repos_url': 'https://api.github.com/users/facebook-github-bot/repos', 'events_url': 'https://api.github.com/users/facebook-github-bot/events{/privacy}', 'received_events_url': 'https://api.github.com/users/facebook-github-bot/received_events', 'type': 'User', 'site_admin': False}",referenced,52cbf4b7749a94dad280f96388dd358c96d36cbd,https://api.github.com/repos/pytorch/pytorch/commits/52cbf4b7749a94dad280f96388dd358c96d36cbd,2018-10-16T00:03:33Z,2,1,1
7763,1650735613,"{'login': 'ezyang', 'id': 13564, 'node_id': 'MDQ6VXNlcjEzNTY0', 'avatar_url': 'https://avatars0.githubusercontent.com/u/13564?v=4', 'gravatar_id': '', 'url': 'https://api.github.com/users/ezyang', 'html_url': 'https://github.com/ezyang', 'followers_url': 'https://api.github.com/users/ezyang/followers', 'following_url': 'https://api.github.com/users/ezyang/following{/other_user}', 'gists_url': 'https://api.github.com/users/ezyang/gists{/gist_id}', 'starred_url': 'https://api.github.com/users/ezyang/starred{/owner}{/repo}', 'subscriptions_url': 'https://api.github.com/users/ezyang/subscriptions', 'organizations_url': 'https://api.github.com/users/ezyang/orgs', 'repos_url': 'https://api.github.com/users/ezyang/repos', 'events_url': 'https://api.github.com/users/ezyang/events{/privacy}', 'received_events_url': 'https://api.github.com/users/ezyang/received_events', 'type': 'User', 'site_admin': False}",closed,42a68749bf3efda9d27bb3b594cf154f602c5b3a,https://api.github.com/repos/pytorch/pytorch/commits/42a68749bf3efda9d27bb3b594cf154f602c5b3a,2018-05-29T10:27:20Z,3,2,1
7763,1650762793,"{'login': 'ezyang', 'id': 13564, 'node_id': 'MDQ6VXNlcjEzNTY0', 'avatar_url': 'https://avatars0.githubusercontent.com/u/13564?v=4', 'gravatar_id': '', 'url': 'https://api.github.com/users/ezyang', 'html_url': 'https://github.com/ezyang', 'followers_url': 'https://api.github.com/users/ezyang/followers', 'following_url': 'https://api.github.com/users/ezyang/following{/other_user}', 'gists_url': 'https://api.github.com/users/ezyang/gists{/gist_id}', 'starred_url': 'https://api.github.com/users/ezyang/starred{/owner}{/repo}', 'subscriptions_url': 'https://api.github.com/users/ezyang/subscriptions', 'organizations_url': 'https://api.github.com/users/ezyang/orgs', 'repos_url': 'https://api.github.com/users/ezyang/repos', 'events_url': 'https://api.github.com/users/ezyang/events{/privacy}', 'received_events_url': 'https://api.github.com/users/ezyang/received_events', 'type': 'User', 'site_admin': False}",referenced,f7439710b29f01142572dce6fa4bd253561f2a69,https://api.github.com/repos/pytorch/pytorch/commits/f7439710b29f01142572dce6fa4bd253561f2a69,2018-05-29T10:42:27Z,0,0,0
7722,1667537054,"{'login': 'ezyang', 'id': 13564, 'node_id': 'MDQ6VXNlcjEzNTY0', 'avatar_url': 'https://avatars0.githubusercontent.com/u/13564?v=4', 'gravatar_id': '', 'url': 'https://api.github.com/users/ezyang', 'html_url': 'https://github.com/ezyang', 'followers_url': 'https://api.github.com/users/ezyang/followers', 'following_url': 'https://api.github.com/users/ezyang/following{/other_user}', 'gists_url': 'https://api.github.com/users/ezyang/gists{/gist_id}', 'starred_url': 'https://api.github.com/users/ezyang/starred{/owner}{/repo}', 'subscriptions_url': 'https://api.github.com/users/ezyang/subscriptions', 'organizations_url': 'https://api.github.com/users/ezyang/orgs', 'repos_url': 'https://api.github.com/users/ezyang/repos', 'events_url': 'https://api.github.com/users/ezyang/events{/privacy}', 'received_events_url': 'https://api.github.com/users/ezyang/received_events', 'type': 'User', 'site_admin': False}",referenced,d0ca8896d54ef93e0b2ba6c78b674c782c9b6499,https://api.github.com/repos/pytorch/pytorch/commits/d0ca8896d54ef93e0b2ba6c78b674c782c9b6499,2018-06-07T02:54:56Z,21,20,1
7722,1684480356,"{'login': 'soumith', 'id': 1310570, 'node_id': 'MDQ6VXNlcjEzMTA1NzA=', 'avatar_url': 'https://avatars0.githubusercontent.com/u/1310570?v=4', 'gravatar_id': '', 'url': 'https://api.github.com/users/soumith', 'html_url': 'https://github.com/soumith', 'followers_url': 'https://api.github.com/users/soumith/followers', 'following_url': 'https://api.github.com/users/soumith/following{/other_user}', 'gists_url': 'https://api.github.com/users/soumith/gists{/gist_id}', 'starred_url': 'https://api.github.com/users/soumith/starred{/owner}{/repo}', 'subscriptions_url': 'https://api.github.com/users/soumith/subscriptions', 'organizations_url': 'https://api.github.com/users/soumith/orgs', 'repos_url': 'https://api.github.com/users/soumith/repos', 'events_url': 'https://api.github.com/users/soumith/events{/privacy}', 'received_events_url': 'https://api.github.com/users/soumith/received_events', 'type': 'User', 'site_admin': False}",referenced,c9b8d8566d550e46f03c922a95429bd6d31ed271,https://api.github.com/repos/pytorch/pytorch/commits/c9b8d8566d550e46f03c922a95429bd6d31ed271,2018-06-16T01:21:41Z,300,300,0
7689,1642870312,"{'login': 'soumith', 'id': 1310570, 'node_id': 'MDQ6VXNlcjEzMTA1NzA=', 'avatar_url': 'https://avatars0.githubusercontent.com/u/1310570?v=4', 'gravatar_id': '', 'url': 'https://api.github.com/users/soumith', 'html_url': 'https://github.com/soumith', 'followers_url': 'https://api.github.com/users/soumith/followers', 'following_url': 'https://api.github.com/users/soumith/following{/other_user}', 'gists_url': 'https://api.github.com/users/soumith/gists{/gist_id}', 'starred_url': 'https://api.github.com/users/soumith/starred{/owner}{/repo}', 'subscriptions_url': 'https://api.github.com/users/soumith/subscriptions', 'organizations_url': 'https://api.github.com/users/soumith/orgs', 'repos_url': 'https://api.github.com/users/soumith/repos', 'events_url': 'https://api.github.com/users/soumith/events{/privacy}', 'received_events_url': 'https://api.github.com/users/soumith/received_events', 'type': 'User', 'site_admin': False}",closed,aa214a8b8cc8bb7fa0a655499a709fc580e417db,https://api.github.com/repos/pytorch/pytorch/commits/aa214a8b8cc8bb7fa0a655499a709fc580e417db,2018-05-23T21:29:09Z,12,12,0
7651,1634427830,"{'login': 'soumith', 'id': 1310570, 'node_id': 'MDQ6VXNlcjEzMTA1NzA=', 'avatar_url': 'https://avatars0.githubusercontent.com/u/1310570?v=4', 'gravatar_id': '', 'url': 'https://api.github.com/users/soumith', 'html_url': 'https://github.com/soumith', 'followers_url': 'https://api.github.com/users/soumith/followers', 'following_url': 'https://api.github.com/users/soumith/following{/other_user}', 'gists_url': 'https://api.github.com/users/soumith/gists{/gist_id}', 'starred_url': 'https://api.github.com/users/soumith/starred{/owner}{/repo}', 'subscriptions_url': 'https://api.github.com/users/soumith/subscriptions', 'organizations_url': 'https://api.github.com/users/soumith/orgs', 'repos_url': 'https://api.github.com/users/soumith/repos', 'events_url': 'https://api.github.com/users/soumith/events{/privacy}', 'received_events_url': 'https://api.github.com/users/soumith/received_events', 'type': 'User', 'site_admin': False}",referenced,bf95dff85bccc212cfe83c42f98fa6e998d257b3,https://api.github.com/repos/pytorch/pytorch/commits/bf95dff85bccc212cfe83c42f98fa6e998d257b3,2018-05-18T14:35:33Z,16,15,1
7645,1634438560,"{'login': 'soumith', 'id': 1310570, 'node_id': 'MDQ6VXNlcjEzMTA1NzA=', 'avatar_url': 'https://avatars0.githubusercontent.com/u/1310570?v=4', 'gravatar_id': '', 'url': 'https://api.github.com/users/soumith', 'html_url': 'https://github.com/soumith', 'followers_url': 'https://api.github.com/users/soumith/followers', 'following_url': 'https://api.github.com/users/soumith/following{/other_user}', 'gists_url': 'https://api.github.com/users/soumith/gists{/gist_id}', 'starred_url': 'https://api.github.com/users/soumith/starred{/owner}{/repo}', 'subscriptions_url': 'https://api.github.com/users/soumith/subscriptions', 'organizations_url': 'https://api.github.com/users/soumith/orgs', 'repos_url': 'https://api.github.com/users/soumith/repos', 'events_url': 'https://api.github.com/users/soumith/events{/privacy}', 'received_events_url': 'https://api.github.com/users/soumith/received_events', 'type': 'User', 'site_admin': False}",referenced,f7bc7007d48433ef9ad6e8add86a62c772c6c04d,https://api.github.com/repos/pytorch/pytorch/commits/f7bc7007d48433ef9ad6e8add86a62c772c6c04d,2018-05-18T14:40:12Z,38,29,9
7640,1634522624,"{'login': 'soumith', 'id': 1310570, 'node_id': 'MDQ6VXNlcjEzMTA1NzA=', 'avatar_url': 'https://avatars0.githubusercontent.com/u/1310570?v=4', 'gravatar_id': '', 'url': 'https://api.github.com/users/soumith', 'html_url': 'https://github.com/soumith', 'followers_url': 'https://api.github.com/users/soumith/followers', 'following_url': 'https://api.github.com/users/soumith/following{/other_user}', 'gists_url': 'https://api.github.com/users/soumith/gists{/gist_id}', 'starred_url': 'https://api.github.com/users/soumith/starred{/owner}{/repo}', 'subscriptions_url': 'https://api.github.com/users/soumith/subscriptions', 'organizations_url': 'https://api.github.com/users/soumith/orgs', 'repos_url': 'https://api.github.com/users/soumith/repos', 'events_url': 'https://api.github.com/users/soumith/events{/privacy}', 'received_events_url': 'https://api.github.com/users/soumith/received_events', 'type': 'User', 'site_admin': False}",referenced,e37da05bd5b0c0b30aa021f8ddc906b282a42fdf,https://api.github.com/repos/pytorch/pytorch/commits/e37da05bd5b0c0b30aa021f8ddc906b282a42fdf,2018-05-18T15:16:54Z,1,1,0
7639,1635637486,"{'login': 'apaszke', 'id': 4583066, 'node_id': 'MDQ6VXNlcjQ1ODMwNjY=', 'avatar_url': 'https://avatars3.githubusercontent.com/u/4583066?v=4', 'gravatar_id': '', 'url': 'https://api.github.com/users/apaszke', 'html_url': 'https://github.com/apaszke', 'followers_url': 'https://api.github.com/users/apaszke/followers', 'following_url': 'https://api.github.com/users/apaszke/following{/other_user}', 'gists_url': 'https://api.github.com/users/apaszke/gists{/gist_id}', 'starred_url': 'https://api.github.com/users/apaszke/starred{/owner}{/repo}', 'subscriptions_url': 'https://api.github.com/users/apaszke/subscriptions', 'organizations_url': 'https://api.github.com/users/apaszke/orgs', 'repos_url': 'https://api.github.com/users/apaszke/repos', 'events_url': 'https://api.github.com/users/apaszke/events{/privacy}', 'received_events_url': 'https://api.github.com/users/apaszke/received_events', 'type': 'User', 'site_admin': False}",referenced,8f97cbcf4ed5e29c08d38fcc086bb53e6cc7097b,https://api.github.com/repos/pytorch/pytorch/commits/8f97cbcf4ed5e29c08d38fcc086bb53e6cc7097b,2018-05-19T18:04:39Z,12,1,11
7601,2624591932,"{'login': 'facebook-github-bot', 'id': 6422482, 'node_id': 'MDQ6VXNlcjY0MjI0ODI=', 'avatar_url': 'https://avatars3.githubusercontent.com/u/6422482?v=4', 'gravatar_id': '', 'url': 'https://api.github.com/users/facebook-github-bot', 'html_url': 'https://github.com/facebook-github-bot', 'followers_url': 'https://api.github.com/users/facebook-github-bot/followers', 'following_url': 'https://api.github.com/users/facebook-github-bot/following{/other_user}', 'gists_url': 'https://api.github.com/users/facebook-github-bot/gists{/gist_id}', 'starred_url': 'https://api.github.com/users/facebook-github-bot/starred{/owner}{/repo}', 'subscriptions_url': 'https://api.github.com/users/facebook-github-bot/subscriptions', 'organizations_url': 'https://api.github.com/users/facebook-github-bot/orgs', 'repos_url': 'https://api.github.com/users/facebook-github-bot/repos', 'events_url': 'https://api.github.com/users/facebook-github-bot/events{/privacy}', 'received_events_url': 'https://api.github.com/users/facebook-github-bot/received_events', 'type': 'User', 'site_admin': False}",referenced,87a2c926150688f8d64462bf55abd13615005e1a,https://api.github.com/repos/pytorch/pytorch/commits/87a2c926150688f8d64462bf55abd13615005e1a,2019-09-11T06:47:02Z,273,237,36
7580,1718730941,"{'login': 'facebook-github-bot', 'id': 6422482, 'node_id': 'MDQ6VXNlcjY0MjI0ODI=', 'avatar_url': 'https://avatars3.githubusercontent.com/u/6422482?v=4', 'gravatar_id': '', 'url': 'https://api.github.com/users/facebook-github-bot', 'html_url': 'https://github.com/facebook-github-bot', 'followers_url': 'https://api.github.com/users/facebook-github-bot/followers', 'following_url': 'https://api.github.com/users/facebook-github-bot/following{/other_user}', 'gists_url': 'https://api.github.com/users/facebook-github-bot/gists{/gist_id}', 'starred_url': 'https://api.github.com/users/facebook-github-bot/starred{/owner}{/repo}', 'subscriptions_url': 'https://api.github.com/users/facebook-github-bot/subscriptions', 'organizations_url': 'https://api.github.com/users/facebook-github-bot/orgs', 'repos_url': 'https://api.github.com/users/facebook-github-bot/repos', 'events_url': 'https://api.github.com/users/facebook-github-bot/events{/privacy}', 'received_events_url': 'https://api.github.com/users/facebook-github-bot/received_events', 'type': 'User', 'site_admin': False}",referenced,213540cd8557d5bb3624cbdf53b0aceeedf436c9,https://api.github.com/repos/pytorch/pytorch/commits/213540cd8557d5bb3624cbdf53b0aceeedf436c9,2018-07-05T18:26:35Z,81,81,0
7580,2075103665,"{'login': 'facebook-github-bot', 'id': 6422482, 'node_id': 'MDQ6VXNlcjY0MjI0ODI=', 'avatar_url': 'https://avatars3.githubusercontent.com/u/6422482?v=4', 'gravatar_id': '', 'url': 'https://api.github.com/users/facebook-github-bot', 'html_url': 'https://github.com/facebook-github-bot', 'followers_url': 'https://api.github.com/users/facebook-github-bot/followers', 'following_url': 'https://api.github.com/users/facebook-github-bot/following{/other_user}', 'gists_url': 'https://api.github.com/users/facebook-github-bot/gists{/gist_id}', 'starred_url': 'https://api.github.com/users/facebook-github-bot/starred{/owner}{/repo}', 'subscriptions_url': 'https://api.github.com/users/facebook-github-bot/subscriptions', 'organizations_url': 'https://api.github.com/users/facebook-github-bot/orgs', 'repos_url': 'https://api.github.com/users/facebook-github-bot/repos', 'events_url': 'https://api.github.com/users/facebook-github-bot/events{/privacy}', 'received_events_url': 'https://api.github.com/users/facebook-github-bot/received_events', 'type': 'User', 'site_admin': False}",closed,1065e7cd247e9e3a6b9133eae67daf2f76e54c18,https://api.github.com/repos/pytorch/pytorch/commits/1065e7cd247e9e3a6b9133eae67daf2f76e54c18,2019-01-15T16:33:04Z,203,202,1
7532,1625635935,"{'login': 'ezyang', 'id': 13564, 'node_id': 'MDQ6VXNlcjEzNTY0', 'avatar_url': 'https://avatars0.githubusercontent.com/u/13564?v=4', 'gravatar_id': '', 'url': 'https://api.github.com/users/ezyang', 'html_url': 'https://github.com/ezyang', 'followers_url': 'https://api.github.com/users/ezyang/followers', 'following_url': 'https://api.github.com/users/ezyang/following{/other_user}', 'gists_url': 'https://api.github.com/users/ezyang/gists{/gist_id}', 'starred_url': 'https://api.github.com/users/ezyang/starred{/owner}{/repo}', 'subscriptions_url': 'https://api.github.com/users/ezyang/subscriptions', 'organizations_url': 'https://api.github.com/users/ezyang/orgs', 'repos_url': 'https://api.github.com/users/ezyang/repos', 'events_url': 'https://api.github.com/users/ezyang/events{/privacy}', 'received_events_url': 'https://api.github.com/users/ezyang/received_events', 'type': 'User', 'site_admin': False}",referenced,61afbbbd185a153211fc2280b76453b656d51bde,https://api.github.com/repos/pytorch/pytorch/commits/61afbbbd185a153211fc2280b76453b656d51bde,2018-05-14T19:36:26Z,6,5,1
7518,1623677008,"{'login': 'ezyang', 'id': 13564, 'node_id': 'MDQ6VXNlcjEzNTY0', 'avatar_url': 'https://avatars0.githubusercontent.com/u/13564?v=4', 'gravatar_id': '', 'url': 'https://api.github.com/users/ezyang', 'html_url': 'https://github.com/ezyang', 'followers_url': 'https://api.github.com/users/ezyang/followers', 'following_url': 'https://api.github.com/users/ezyang/following{/other_user}', 'gists_url': 'https://api.github.com/users/ezyang/gists{/gist_id}', 'starred_url': 'https://api.github.com/users/ezyang/starred{/owner}{/repo}', 'subscriptions_url': 'https://api.github.com/users/ezyang/subscriptions', 'organizations_url': 'https://api.github.com/users/ezyang/orgs', 'repos_url': 'https://api.github.com/users/ezyang/repos', 'events_url': 'https://api.github.com/users/ezyang/events{/privacy}', 'received_events_url': 'https://api.github.com/users/ezyang/received_events', 'type': 'User', 'site_admin': False}",referenced,1ce5431aaf5318e3f707961337e17924515d02e3,https://api.github.com/repos/pytorch/pytorch/commits/1ce5431aaf5318e3f707961337e17924515d02e3,2018-05-13T19:44:52Z,34,18,16
7502,1628668484,"{'login': 'soumith', 'id': 1310570, 'node_id': 'MDQ6VXNlcjEzMTA1NzA=', 'avatar_url': 'https://avatars0.githubusercontent.com/u/1310570?v=4', 'gravatar_id': '', 'url': 'https://api.github.com/users/soumith', 'html_url': 'https://github.com/soumith', 'followers_url': 'https://api.github.com/users/soumith/followers', 'following_url': 'https://api.github.com/users/soumith/following{/other_user}', 'gists_url': 'https://api.github.com/users/soumith/gists{/gist_id}', 'starred_url': 'https://api.github.com/users/soumith/starred{/owner}{/repo}', 'subscriptions_url': 'https://api.github.com/users/soumith/subscriptions', 'organizations_url': 'https://api.github.com/users/soumith/orgs', 'repos_url': 'https://api.github.com/users/soumith/repos', 'events_url': 'https://api.github.com/users/soumith/events{/privacy}', 'received_events_url': 'https://api.github.com/users/soumith/received_events', 'type': 'User', 'site_admin': False}",referenced,c76da6494bad35a44a9b44631b0747ca7f60c807,https://api.github.com/repos/pytorch/pytorch/commits/c76da6494bad35a44a9b44631b0747ca7f60c807,2018-05-16T03:57:41Z,31,9,22
7464,1623677009,"{'login': 'ezyang', 'id': 13564, 'node_id': 'MDQ6VXNlcjEzNTY0', 'avatar_url': 'https://avatars0.githubusercontent.com/u/13564?v=4', 'gravatar_id': '', 'url': 'https://api.github.com/users/ezyang', 'html_url': 'https://github.com/ezyang', 'followers_url': 'https://api.github.com/users/ezyang/followers', 'following_url': 'https://api.github.com/users/ezyang/following{/other_user}', 'gists_url': 'https://api.github.com/users/ezyang/gists{/gist_id}', 'starred_url': 'https://api.github.com/users/ezyang/starred{/owner}{/repo}', 'subscriptions_url': 'https://api.github.com/users/ezyang/subscriptions', 'organizations_url': 'https://api.github.com/users/ezyang/orgs', 'repos_url': 'https://api.github.com/users/ezyang/repos', 'events_url': 'https://api.github.com/users/ezyang/events{/privacy}', 'received_events_url': 'https://api.github.com/users/ezyang/received_events', 'type': 'User', 'site_admin': False}",referenced,1ce5431aaf5318e3f707961337e17924515d02e3,https://api.github.com/repos/pytorch/pytorch/commits/1ce5431aaf5318e3f707961337e17924515d02e3,2018-05-13T19:44:52Z,34,18,16
7441,1620835934,"{'login': 'colesbury', 'id': 655866, 'node_id': 'MDQ6VXNlcjY1NTg2Ng==', 'avatar_url': 'https://avatars1.githubusercontent.com/u/655866?v=4', 'gravatar_id': '', 'url': 'https://api.github.com/users/colesbury', 'html_url': 'https://github.com/colesbury', 'followers_url': 'https://api.github.com/users/colesbury/followers', 'following_url': 'https://api.github.com/users/colesbury/following{/other_user}', 'gists_url': 'https://api.github.com/users/colesbury/gists{/gist_id}', 'starred_url': 'https://api.github.com/users/colesbury/starred{/owner}{/repo}', 'subscriptions_url': 'https://api.github.com/users/colesbury/subscriptions', 'organizations_url': 'https://api.github.com/users/colesbury/orgs', 'repos_url': 'https://api.github.com/users/colesbury/repos', 'events_url': 'https://api.github.com/users/colesbury/events{/privacy}', 'received_events_url': 'https://api.github.com/users/colesbury/received_events', 'type': 'User', 'site_admin': False}",referenced,6c7a8318c40412e5d9b52b299e424bce5aca2365,https://api.github.com/repos/pytorch/pytorch/commits/6c7a8318c40412e5d9b52b299e424bce5aca2365,2018-05-10T22:22:38Z,42,30,12
7434,1620888909,"{'login': 'pietern', 'id': 9845, 'node_id': 'MDQ6VXNlcjk4NDU=', 'avatar_url': 'https://avatars3.githubusercontent.com/u/9845?v=4', 'gravatar_id': '', 'url': 'https://api.github.com/users/pietern', 'html_url': 'https://github.com/pietern', 'followers_url': 'https://api.github.com/users/pietern/followers', 'following_url': 'https://api.github.com/users/pietern/following{/other_user}', 'gists_url': 'https://api.github.com/users/pietern/gists{/gist_id}', 'starred_url': 'https://api.github.com/users/pietern/starred{/owner}{/repo}', 'subscriptions_url': 'https://api.github.com/users/pietern/subscriptions', 'organizations_url': 'https://api.github.com/users/pietern/orgs', 'repos_url': 'https://api.github.com/users/pietern/repos', 'events_url': 'https://api.github.com/users/pietern/events{/privacy}', 'received_events_url': 'https://api.github.com/users/pietern/received_events', 'type': 'User', 'site_admin': False}",referenced,d5e77fb058f20470fe08d5ffee6446534da5516f,https://api.github.com/repos/pytorch/pytorch/commits/d5e77fb058f20470fe08d5ffee6446534da5516f,2018-05-10T23:04:43Z,536,536,0
7434,1632912500,"{'login': 'teng-li', 'id': 8120856, 'node_id': 'MDQ6VXNlcjgxMjA4NTY=', 'avatar_url': 'https://avatars2.githubusercontent.com/u/8120856?v=4', 'gravatar_id': '', 'url': 'https://api.github.com/users/teng-li', 'html_url': 'https://github.com/teng-li', 'followers_url': 'https://api.github.com/users/teng-li/followers', 'following_url': 'https://api.github.com/users/teng-li/following{/other_user}', 'gists_url': 'https://api.github.com/users/teng-li/gists{/gist_id}', 'starred_url': 'https://api.github.com/users/teng-li/starred{/owner}{/repo}', 'subscriptions_url': 'https://api.github.com/users/teng-li/subscriptions', 'organizations_url': 'https://api.github.com/users/teng-li/orgs', 'repos_url': 'https://api.github.com/users/teng-li/repos', 'events_url': 'https://api.github.com/users/teng-li/events{/privacy}', 'received_events_url': 'https://api.github.com/users/teng-li/received_events', 'type': 'User', 'site_admin': False}",referenced,0d27d2686c036757baa068ec36da5e846a93b703,https://api.github.com/repos/pytorch/pytorch/commits/0d27d2686c036757baa068ec36da5e846a93b703,2018-05-17T20:38:35Z,1153,1094,59
7434,1652141883,"{'login': 'ezyang', 'id': 13564, 'node_id': 'MDQ6VXNlcjEzNTY0', 'avatar_url': 'https://avatars0.githubusercontent.com/u/13564?v=4', 'gravatar_id': '', 'url': 'https://api.github.com/users/ezyang', 'html_url': 'https://github.com/ezyang', 'followers_url': 'https://api.github.com/users/ezyang/followers', 'following_url': 'https://api.github.com/users/ezyang/following{/other_user}', 'gists_url': 'https://api.github.com/users/ezyang/gists{/gist_id}', 'starred_url': 'https://api.github.com/users/ezyang/starred{/owner}{/repo}', 'subscriptions_url': 'https://api.github.com/users/ezyang/subscriptions', 'organizations_url': 'https://api.github.com/users/ezyang/orgs', 'repos_url': 'https://api.github.com/users/ezyang/repos', 'events_url': 'https://api.github.com/users/ezyang/events{/privacy}', 'received_events_url': 'https://api.github.com/users/ezyang/received_events', 'type': 'User', 'site_admin': False}",referenced,c2fa1f363bed12484f4ab5e692c4f110e28b23a5,https://api.github.com/repos/pytorch/pytorch/commits/c2fa1f363bed12484f4ab5e692c4f110e28b23a5,2018-05-29T21:07:23Z,573,573,0
7420,1790758769,"{'login': 'facebook-github-bot', 'id': 6422482, 'node_id': 'MDQ6VXNlcjY0MjI0ODI=', 'avatar_url': 'https://avatars3.githubusercontent.com/u/6422482?v=4', 'gravatar_id': '', 'url': 'https://api.github.com/users/facebook-github-bot', 'html_url': 'https://github.com/facebook-github-bot', 'followers_url': 'https://api.github.com/users/facebook-github-bot/followers', 'following_url': 'https://api.github.com/users/facebook-github-bot/following{/other_user}', 'gists_url': 'https://api.github.com/users/facebook-github-bot/gists{/gist_id}', 'starred_url': 'https://api.github.com/users/facebook-github-bot/starred{/owner}{/repo}', 'subscriptions_url': 'https://api.github.com/users/facebook-github-bot/subscriptions', 'organizations_url': 'https://api.github.com/users/facebook-github-bot/orgs', 'repos_url': 'https://api.github.com/users/facebook-github-bot/repos', 'events_url': 'https://api.github.com/users/facebook-github-bot/events{/privacy}', 'received_events_url': 'https://api.github.com/users/facebook-github-bot/received_events', 'type': 'User', 'site_admin': False}",referenced,9cffe783f16c107d7a26781b5735644faec5a92c,https://api.github.com/repos/pytorch/pytorch/commits/9cffe783f16c107d7a26781b5735644faec5a92c,2018-08-15T19:12:31Z,4,2,2
7415,1709719546,"{'login': 'facebook-github-bot', 'id': 6422482, 'node_id': 'MDQ6VXNlcjY0MjI0ODI=', 'avatar_url': 'https://avatars3.githubusercontent.com/u/6422482?v=4', 'gravatar_id': '', 'url': 'https://api.github.com/users/facebook-github-bot', 'html_url': 'https://github.com/facebook-github-bot', 'followers_url': 'https://api.github.com/users/facebook-github-bot/followers', 'following_url': 'https://api.github.com/users/facebook-github-bot/following{/other_user}', 'gists_url': 'https://api.github.com/users/facebook-github-bot/gists{/gist_id}', 'starred_url': 'https://api.github.com/users/facebook-github-bot/starred{/owner}{/repo}', 'subscriptions_url': 'https://api.github.com/users/facebook-github-bot/subscriptions', 'organizations_url': 'https://api.github.com/users/facebook-github-bot/orgs', 'repos_url': 'https://api.github.com/users/facebook-github-bot/repos', 'events_url': 'https://api.github.com/users/facebook-github-bot/events{/privacy}', 'received_events_url': 'https://api.github.com/users/facebook-github-bot/received_events', 'type': 'User', 'site_admin': False}",referenced,d793473e6040f7db398537a9d3225b02122aad30,https://api.github.com/repos/pytorch/pytorch/commits/d793473e6040f7db398537a9d3225b02122aad30,2018-06-29T23:56:06Z,5,5,0
7354,2036463072,"{'login': 'facebook-github-bot', 'id': 6422482, 'node_id': 'MDQ6VXNlcjY0MjI0ODI=', 'avatar_url': 'https://avatars3.githubusercontent.com/u/6422482?v=4', 'gravatar_id': '', 'url': 'https://api.github.com/users/facebook-github-bot', 'html_url': 'https://github.com/facebook-github-bot', 'followers_url': 'https://api.github.com/users/facebook-github-bot/followers', 'following_url': 'https://api.github.com/users/facebook-github-bot/following{/other_user}', 'gists_url': 'https://api.github.com/users/facebook-github-bot/gists{/gist_id}', 'starred_url': 'https://api.github.com/users/facebook-github-bot/starred{/owner}{/repo}', 'subscriptions_url': 'https://api.github.com/users/facebook-github-bot/subscriptions', 'organizations_url': 'https://api.github.com/users/facebook-github-bot/orgs', 'repos_url': 'https://api.github.com/users/facebook-github-bot/repos', 'events_url': 'https://api.github.com/users/facebook-github-bot/events{/privacy}', 'received_events_url': 'https://api.github.com/users/facebook-github-bot/received_events', 'type': 'User', 'site_admin': False}",referenced,54d4fe3f49d781030cb4c3b7ec3944fb2cf7aae3,https://api.github.com/repos/pytorch/pytorch/commits/54d4fe3f49d781030cb4c3b7ec3944fb2cf7aae3,2018-12-19T18:42:47Z,7,6,1
7327,1651901247,"{'login': 'zou3519', 'id': 5652049, 'node_id': 'MDQ6VXNlcjU2NTIwNDk=', 'avatar_url': 'https://avatars3.githubusercontent.com/u/5652049?v=4', 'gravatar_id': '', 'url': 'https://api.github.com/users/zou3519', 'html_url': 'https://github.com/zou3519', 'followers_url': 'https://api.github.com/users/zou3519/followers', 'following_url': 'https://api.github.com/users/zou3519/following{/other_user}', 'gists_url': 'https://api.github.com/users/zou3519/gists{/gist_id}', 'starred_url': 'https://api.github.com/users/zou3519/starred{/owner}{/repo}', 'subscriptions_url': 'https://api.github.com/users/zou3519/subscriptions', 'organizations_url': 'https://api.github.com/users/zou3519/orgs', 'repos_url': 'https://api.github.com/users/zou3519/repos', 'events_url': 'https://api.github.com/users/zou3519/events{/privacy}', 'received_events_url': 'https://api.github.com/users/zou3519/received_events', 'type': 'User', 'site_admin': False}",closed,215fe057ea0c178d5cbfe2e815a251351c7d3263,https://api.github.com/repos/pytorch/pytorch/commits/215fe057ea0c178d5cbfe2e815a251351c7d3263,2018-05-29T19:02:59Z,19,16,3
7320,1623400186,"{'login': 'ezyang', 'id': 13564, 'node_id': 'MDQ6VXNlcjEzNTY0', 'avatar_url': 'https://avatars0.githubusercontent.com/u/13564?v=4', 'gravatar_id': '', 'url': 'https://api.github.com/users/ezyang', 'html_url': 'https://github.com/ezyang', 'followers_url': 'https://api.github.com/users/ezyang/followers', 'following_url': 'https://api.github.com/users/ezyang/following{/other_user}', 'gists_url': 'https://api.github.com/users/ezyang/gists{/gist_id}', 'starred_url': 'https://api.github.com/users/ezyang/starred{/owner}{/repo}', 'subscriptions_url': 'https://api.github.com/users/ezyang/subscriptions', 'organizations_url': 'https://api.github.com/users/ezyang/orgs', 'repos_url': 'https://api.github.com/users/ezyang/repos', 'events_url': 'https://api.github.com/users/ezyang/events{/privacy}', 'received_events_url': 'https://api.github.com/users/ezyang/received_events', 'type': 'User', 'site_admin': False}",referenced,976b1d5ec1e2c38a1de36d9d36d0840a4aea7377,https://api.github.com/repos/pytorch/pytorch/commits/976b1d5ec1e2c38a1de36d9d36d0840a4aea7377,2018-05-13T02:57:29Z,12,5,7
7302,1610793390,"{'login': 'zou3519', 'id': 5652049, 'node_id': 'MDQ6VXNlcjU2NTIwNDk=', 'avatar_url': 'https://avatars3.githubusercontent.com/u/5652049?v=4', 'gravatar_id': '', 'url': 'https://api.github.com/users/zou3519', 'html_url': 'https://github.com/zou3519', 'followers_url': 'https://api.github.com/users/zou3519/followers', 'following_url': 'https://api.github.com/users/zou3519/following{/other_user}', 'gists_url': 'https://api.github.com/users/zou3519/gists{/gist_id}', 'starred_url': 'https://api.github.com/users/zou3519/starred{/owner}{/repo}', 'subscriptions_url': 'https://api.github.com/users/zou3519/subscriptions', 'organizations_url': 'https://api.github.com/users/zou3519/orgs', 'repos_url': 'https://api.github.com/users/zou3519/repos', 'events_url': 'https://api.github.com/users/zou3519/events{/privacy}', 'received_events_url': 'https://api.github.com/users/zou3519/received_events', 'type': 'User', 'site_admin': False}",referenced,24681a8e4914b46257682891d803e6b09503b7c6,https://api.github.com/repos/pytorch/pytorch/commits/24681a8e4914b46257682891d803e6b09503b7c6,2018-05-04T20:45:26Z,0,0,0
7289,1705340507,"{'login': 'facebook-github-bot', 'id': 6422482, 'node_id': 'MDQ6VXNlcjY0MjI0ODI=', 'avatar_url': 'https://avatars3.githubusercontent.com/u/6422482?v=4', 'gravatar_id': '', 'url': 'https://api.github.com/users/facebook-github-bot', 'html_url': 'https://github.com/facebook-github-bot', 'followers_url': 'https://api.github.com/users/facebook-github-bot/followers', 'following_url': 'https://api.github.com/users/facebook-github-bot/following{/other_user}', 'gists_url': 'https://api.github.com/users/facebook-github-bot/gists{/gist_id}', 'starred_url': 'https://api.github.com/users/facebook-github-bot/starred{/owner}{/repo}', 'subscriptions_url': 'https://api.github.com/users/facebook-github-bot/subscriptions', 'organizations_url': 'https://api.github.com/users/facebook-github-bot/orgs', 'repos_url': 'https://api.github.com/users/facebook-github-bot/repos', 'events_url': 'https://api.github.com/users/facebook-github-bot/events{/privacy}', 'received_events_url': 'https://api.github.com/users/facebook-github-bot/received_events', 'type': 'User', 'site_admin': False}",referenced,03d0a70a4da8351fb6d8274eb09104f737a7c430,https://api.github.com/repos/pytorch/pytorch/commits/03d0a70a4da8351fb6d8274eb09104f737a7c430,2018-06-28T03:10:46Z,405,195,210
7288,1705340505,"{'login': 'facebook-github-bot', 'id': 6422482, 'node_id': 'MDQ6VXNlcjY0MjI0ODI=', 'avatar_url': 'https://avatars3.githubusercontent.com/u/6422482?v=4', 'gravatar_id': '', 'url': 'https://api.github.com/users/facebook-github-bot', 'html_url': 'https://github.com/facebook-github-bot', 'followers_url': 'https://api.github.com/users/facebook-github-bot/followers', 'following_url': 'https://api.github.com/users/facebook-github-bot/following{/other_user}', 'gists_url': 'https://api.github.com/users/facebook-github-bot/gists{/gist_id}', 'starred_url': 'https://api.github.com/users/facebook-github-bot/starred{/owner}{/repo}', 'subscriptions_url': 'https://api.github.com/users/facebook-github-bot/subscriptions', 'organizations_url': 'https://api.github.com/users/facebook-github-bot/orgs', 'repos_url': 'https://api.github.com/users/facebook-github-bot/repos', 'events_url': 'https://api.github.com/users/facebook-github-bot/events{/privacy}', 'received_events_url': 'https://api.github.com/users/facebook-github-bot/received_events', 'type': 'User', 'site_admin': False}",closed,03d0a70a4da8351fb6d8274eb09104f737a7c430,https://api.github.com/repos/pytorch/pytorch/commits/03d0a70a4da8351fb6d8274eb09104f737a7c430,2018-06-28T03:10:46Z,405,195,210
7286,1705340506,"{'login': 'facebook-github-bot', 'id': 6422482, 'node_id': 'MDQ6VXNlcjY0MjI0ODI=', 'avatar_url': 'https://avatars3.githubusercontent.com/u/6422482?v=4', 'gravatar_id': '', 'url': 'https://api.github.com/users/facebook-github-bot', 'html_url': 'https://github.com/facebook-github-bot', 'followers_url': 'https://api.github.com/users/facebook-github-bot/followers', 'following_url': 'https://api.github.com/users/facebook-github-bot/following{/other_user}', 'gists_url': 'https://api.github.com/users/facebook-github-bot/gists{/gist_id}', 'starred_url': 'https://api.github.com/users/facebook-github-bot/starred{/owner}{/repo}', 'subscriptions_url': 'https://api.github.com/users/facebook-github-bot/subscriptions', 'organizations_url': 'https://api.github.com/users/facebook-github-bot/orgs', 'repos_url': 'https://api.github.com/users/facebook-github-bot/repos', 'events_url': 'https://api.github.com/users/facebook-github-bot/events{/privacy}', 'received_events_url': 'https://api.github.com/users/facebook-github-bot/received_events', 'type': 'User', 'site_admin': False}",referenced,03d0a70a4da8351fb6d8274eb09104f737a7c430,https://api.github.com/repos/pytorch/pytorch/commits/03d0a70a4da8351fb6d8274eb09104f737a7c430,2018-06-28T03:10:46Z,405,195,210
7266,1616421650,"{'login': 'ezyang', 'id': 13564, 'node_id': 'MDQ6VXNlcjEzNTY0', 'avatar_url': 'https://avatars0.githubusercontent.com/u/13564?v=4', 'gravatar_id': '', 'url': 'https://api.github.com/users/ezyang', 'html_url': 'https://github.com/ezyang', 'followers_url': 'https://api.github.com/users/ezyang/followers', 'following_url': 'https://api.github.com/users/ezyang/following{/other_user}', 'gists_url': 'https://api.github.com/users/ezyang/gists{/gist_id}', 'starred_url': 'https://api.github.com/users/ezyang/starred{/owner}{/repo}', 'subscriptions_url': 'https://api.github.com/users/ezyang/subscriptions', 'organizations_url': 'https://api.github.com/users/ezyang/orgs', 'repos_url': 'https://api.github.com/users/ezyang/repos', 'events_url': 'https://api.github.com/users/ezyang/events{/privacy}', 'received_events_url': 'https://api.github.com/users/ezyang/received_events', 'type': 'User', 'site_admin': False}",referenced,3185d8342ec4766ff9a30f3b821374836400b23c,https://api.github.com/repos/pytorch/pytorch/commits/3185d8342ec4766ff9a30f3b821374836400b23c,2018-05-08T22:32:14Z,4,2,2
7261,1623408639,"{'login': 'ezyang', 'id': 13564, 'node_id': 'MDQ6VXNlcjEzNTY0', 'avatar_url': 'https://avatars0.githubusercontent.com/u/13564?v=4', 'gravatar_id': '', 'url': 'https://api.github.com/users/ezyang', 'html_url': 'https://github.com/ezyang', 'followers_url': 'https://api.github.com/users/ezyang/followers', 'following_url': 'https://api.github.com/users/ezyang/following{/other_user}', 'gists_url': 'https://api.github.com/users/ezyang/gists{/gist_id}', 'starred_url': 'https://api.github.com/users/ezyang/starred{/owner}{/repo}', 'subscriptions_url': 'https://api.github.com/users/ezyang/subscriptions', 'organizations_url': 'https://api.github.com/users/ezyang/orgs', 'repos_url': 'https://api.github.com/users/ezyang/repos', 'events_url': 'https://api.github.com/users/ezyang/events{/privacy}', 'received_events_url': 'https://api.github.com/users/ezyang/received_events', 'type': 'User', 'site_admin': False}",closed,7edd451a4e81080562d8e2daa1e962bf7fbe4a9b,https://api.github.com/repos/pytorch/pytorch/commits/7edd451a4e81080562d8e2daa1e962bf7fbe4a9b,2018-05-13T03:31:59Z,34,19,15
7249,1623408532,"{'login': 'ezyang', 'id': 13564, 'node_id': 'MDQ6VXNlcjEzNTY0', 'avatar_url': 'https://avatars0.githubusercontent.com/u/13564?v=4', 'gravatar_id': '', 'url': 'https://api.github.com/users/ezyang', 'html_url': 'https://github.com/ezyang', 'followers_url': 'https://api.github.com/users/ezyang/followers', 'following_url': 'https://api.github.com/users/ezyang/following{/other_user}', 'gists_url': 'https://api.github.com/users/ezyang/gists{/gist_id}', 'starred_url': 'https://api.github.com/users/ezyang/starred{/owner}{/repo}', 'subscriptions_url': 'https://api.github.com/users/ezyang/subscriptions', 'organizations_url': 'https://api.github.com/users/ezyang/orgs', 'repos_url': 'https://api.github.com/users/ezyang/repos', 'events_url': 'https://api.github.com/users/ezyang/events{/privacy}', 'received_events_url': 'https://api.github.com/users/ezyang/received_events', 'type': 'User', 'site_admin': False}",referenced,cf9751207e8b97f5e844aacdaea494a2ba997caf,https://api.github.com/repos/pytorch/pytorch/commits/cf9751207e8b97f5e844aacdaea494a2ba997caf,2018-05-13T03:31:09Z,2,1,1
7237,1616420243,"{'login': 'ezyang', 'id': 13564, 'node_id': 'MDQ6VXNlcjEzNTY0', 'avatar_url': 'https://avatars0.githubusercontent.com/u/13564?v=4', 'gravatar_id': '', 'url': 'https://api.github.com/users/ezyang', 'html_url': 'https://github.com/ezyang', 'followers_url': 'https://api.github.com/users/ezyang/followers', 'following_url': 'https://api.github.com/users/ezyang/following{/other_user}', 'gists_url': 'https://api.github.com/users/ezyang/gists{/gist_id}', 'starred_url': 'https://api.github.com/users/ezyang/starred{/owner}{/repo}', 'subscriptions_url': 'https://api.github.com/users/ezyang/subscriptions', 'organizations_url': 'https://api.github.com/users/ezyang/orgs', 'repos_url': 'https://api.github.com/users/ezyang/repos', 'events_url': 'https://api.github.com/users/ezyang/events{/privacy}', 'received_events_url': 'https://api.github.com/users/ezyang/received_events', 'type': 'User', 'site_admin': False}",referenced,755d3105b6f61bf3834461fc3bc5bb77bd76a813,https://api.github.com/repos/pytorch/pytorch/commits/755d3105b6f61bf3834461fc3bc5bb77bd76a813,2018-05-08T22:31:12Z,2,1,1
7228,1738974077,"{'login': 'facebook-github-bot', 'id': 6422482, 'node_id': 'MDQ6VXNlcjY0MjI0ODI=', 'avatar_url': 'https://avatars3.githubusercontent.com/u/6422482?v=4', 'gravatar_id': '', 'url': 'https://api.github.com/users/facebook-github-bot', 'html_url': 'https://github.com/facebook-github-bot', 'followers_url': 'https://api.github.com/users/facebook-github-bot/followers', 'following_url': 'https://api.github.com/users/facebook-github-bot/following{/other_user}', 'gists_url': 'https://api.github.com/users/facebook-github-bot/gists{/gist_id}', 'starred_url': 'https://api.github.com/users/facebook-github-bot/starred{/owner}{/repo}', 'subscriptions_url': 'https://api.github.com/users/facebook-github-bot/subscriptions', 'organizations_url': 'https://api.github.com/users/facebook-github-bot/orgs', 'repos_url': 'https://api.github.com/users/facebook-github-bot/repos', 'events_url': 'https://api.github.com/users/facebook-github-bot/events{/privacy}', 'received_events_url': 'https://api.github.com/users/facebook-github-bot/received_events', 'type': 'User', 'site_admin': False}",closed,1c3580b6fef05a11666e98c51c97b83429a9223a,https://api.github.com/repos/pytorch/pytorch/commits/1c3580b6fef05a11666e98c51c97b83429a9223a,2018-07-18T00:11:18Z,31,30,1
7222,1663862167,"{'login': 'soumith', 'id': 1310570, 'node_id': 'MDQ6VXNlcjEzMTA1NzA=', 'avatar_url': 'https://avatars0.githubusercontent.com/u/1310570?v=4', 'gravatar_id': '', 'url': 'https://api.github.com/users/soumith', 'html_url': 'https://github.com/soumith', 'followers_url': 'https://api.github.com/users/soumith/followers', 'following_url': 'https://api.github.com/users/soumith/following{/other_user}', 'gists_url': 'https://api.github.com/users/soumith/gists{/gist_id}', 'starred_url': 'https://api.github.com/users/soumith/starred{/owner}{/repo}', 'subscriptions_url': 'https://api.github.com/users/soumith/subscriptions', 'organizations_url': 'https://api.github.com/users/soumith/orgs', 'repos_url': 'https://api.github.com/users/soumith/repos', 'events_url': 'https://api.github.com/users/soumith/events{/privacy}', 'received_events_url': 'https://api.github.com/users/soumith/received_events', 'type': 'User', 'site_admin': False}",referenced,c719c8032c3585b8f7c3e612fa781a1753dbb7c1,https://api.github.com/repos/pytorch/pytorch/commits/c719c8032c3585b8f7c3e612fa781a1753dbb7c1,2018-06-05T14:30:41Z,4,3,1
7222,1684480284,"{'login': 'soumith', 'id': 1310570, 'node_id': 'MDQ6VXNlcjEzMTA1NzA=', 'avatar_url': 'https://avatars0.githubusercontent.com/u/1310570?v=4', 'gravatar_id': '', 'url': 'https://api.github.com/users/soumith', 'html_url': 'https://github.com/soumith', 'followers_url': 'https://api.github.com/users/soumith/followers', 'following_url': 'https://api.github.com/users/soumith/following{/other_user}', 'gists_url': 'https://api.github.com/users/soumith/gists{/gist_id}', 'starred_url': 'https://api.github.com/users/soumith/starred{/owner}{/repo}', 'subscriptions_url': 'https://api.github.com/users/soumith/subscriptions', 'organizations_url': 'https://api.github.com/users/soumith/orgs', 'repos_url': 'https://api.github.com/users/soumith/repos', 'events_url': 'https://api.github.com/users/soumith/events{/privacy}', 'received_events_url': 'https://api.github.com/users/soumith/received_events', 'type': 'User', 'site_admin': False}",referenced,c9b8d8566d550e46f03c922a95429bd6d31ed271,https://api.github.com/repos/pytorch/pytorch/commits/c9b8d8566d550e46f03c922a95429bd6d31ed271,2018-06-16T01:21:40Z,300,300,0
7209,1609369818,"{'login': 'apaszke', 'id': 4583066, 'node_id': 'MDQ6VXNlcjQ1ODMwNjY=', 'avatar_url': 'https://avatars3.githubusercontent.com/u/4583066?v=4', 'gravatar_id': '', 'url': 'https://api.github.com/users/apaszke', 'html_url': 'https://github.com/apaszke', 'followers_url': 'https://api.github.com/users/apaszke/followers', 'following_url': 'https://api.github.com/users/apaszke/following{/other_user}', 'gists_url': 'https://api.github.com/users/apaszke/gists{/gist_id}', 'starred_url': 'https://api.github.com/users/apaszke/starred{/owner}{/repo}', 'subscriptions_url': 'https://api.github.com/users/apaszke/subscriptions', 'organizations_url': 'https://api.github.com/users/apaszke/orgs', 'repos_url': 'https://api.github.com/users/apaszke/repos', 'events_url': 'https://api.github.com/users/apaszke/events{/privacy}', 'received_events_url': 'https://api.github.com/users/apaszke/received_events', 'type': 'User', 'site_admin': False}",referenced,6363faf1847993c58931b381f6ef84d16af683ae,https://api.github.com/repos/pytorch/pytorch/commits/6363faf1847993c58931b381f6ef84d16af683ae,2018-05-04T08:52:13Z,3,2,1
7156,1623406454,"{'login': 'ezyang', 'id': 13564, 'node_id': 'MDQ6VXNlcjEzNTY0', 'avatar_url': 'https://avatars0.githubusercontent.com/u/13564?v=4', 'gravatar_id': '', 'url': 'https://api.github.com/users/ezyang', 'html_url': 'https://github.com/ezyang', 'followers_url': 'https://api.github.com/users/ezyang/followers', 'following_url': 'https://api.github.com/users/ezyang/following{/other_user}', 'gists_url': 'https://api.github.com/users/ezyang/gists{/gist_id}', 'starred_url': 'https://api.github.com/users/ezyang/starred{/owner}{/repo}', 'subscriptions_url': 'https://api.github.com/users/ezyang/subscriptions', 'organizations_url': 'https://api.github.com/users/ezyang/orgs', 'repos_url': 'https://api.github.com/users/ezyang/repos', 'events_url': 'https://api.github.com/users/ezyang/events{/privacy}', 'received_events_url': 'https://api.github.com/users/ezyang/received_events', 'type': 'User', 'site_admin': False}",referenced,eaa3f2e6139119bd4dcb7e9539ff1cb804854613,https://api.github.com/repos/pytorch/pytorch/commits/eaa3f2e6139119bd4dcb7e9539ff1cb804854613,2018-05-13T03:25:08Z,22,20,2
7150,1607020972,"{'login': 'soumith', 'id': 1310570, 'node_id': 'MDQ6VXNlcjEzMTA1NzA=', 'avatar_url': 'https://avatars0.githubusercontent.com/u/1310570?v=4', 'gravatar_id': '', 'url': 'https://api.github.com/users/soumith', 'html_url': 'https://github.com/soumith', 'followers_url': 'https://api.github.com/users/soumith/followers', 'following_url': 'https://api.github.com/users/soumith/following{/other_user}', 'gists_url': 'https://api.github.com/users/soumith/gists{/gist_id}', 'starred_url': 'https://api.github.com/users/soumith/starred{/owner}{/repo}', 'subscriptions_url': 'https://api.github.com/users/soumith/subscriptions', 'organizations_url': 'https://api.github.com/users/soumith/orgs', 'repos_url': 'https://api.github.com/users/soumith/repos', 'events_url': 'https://api.github.com/users/soumith/events{/privacy}', 'received_events_url': 'https://api.github.com/users/soumith/received_events', 'type': 'User', 'site_admin': False}",referenced,f9393ffc903c8694dda20bceaaf75fb835b04c65,https://api.github.com/repos/pytorch/pytorch/commits/f9393ffc903c8694dda20bceaaf75fb835b04c65,2018-05-03T07:08:23Z,3,0,3
7126,1963752604,"{'login': 'facebook-github-bot', 'id': 6422482, 'node_id': 'MDQ6VXNlcjY0MjI0ODI=', 'avatar_url': 'https://avatars3.githubusercontent.com/u/6422482?v=4', 'gravatar_id': '', 'url': 'https://api.github.com/users/facebook-github-bot', 'html_url': 'https://github.com/facebook-github-bot', 'followers_url': 'https://api.github.com/users/facebook-github-bot/followers', 'following_url': 'https://api.github.com/users/facebook-github-bot/following{/other_user}', 'gists_url': 'https://api.github.com/users/facebook-github-bot/gists{/gist_id}', 'starred_url': 'https://api.github.com/users/facebook-github-bot/starred{/owner}{/repo}', 'subscriptions_url': 'https://api.github.com/users/facebook-github-bot/subscriptions', 'organizations_url': 'https://api.github.com/users/facebook-github-bot/orgs', 'repos_url': 'https://api.github.com/users/facebook-github-bot/repos', 'events_url': 'https://api.github.com/users/facebook-github-bot/events{/privacy}', 'received_events_url': 'https://api.github.com/users/facebook-github-bot/received_events', 'type': 'User', 'site_admin': False}",referenced,f6e4fc071a63b8ffe89bbea892e97c598f008120,https://api.github.com/repos/pytorch/pytorch/commits/f6e4fc071a63b8ffe89bbea892e97c598f008120,2018-11-13T17:43:18Z,2,1,1
7095,1607009080,"{'login': 'soumith', 'id': 1310570, 'node_id': 'MDQ6VXNlcjEzMTA1NzA=', 'avatar_url': 'https://avatars0.githubusercontent.com/u/1310570?v=4', 'gravatar_id': '', 'url': 'https://api.github.com/users/soumith', 'html_url': 'https://github.com/soumith', 'followers_url': 'https://api.github.com/users/soumith/followers', 'following_url': 'https://api.github.com/users/soumith/following{/other_user}', 'gists_url': 'https://api.github.com/users/soumith/gists{/gist_id}', 'starred_url': 'https://api.github.com/users/soumith/starred{/owner}{/repo}', 'subscriptions_url': 'https://api.github.com/users/soumith/subscriptions', 'organizations_url': 'https://api.github.com/users/soumith/orgs', 'repos_url': 'https://api.github.com/users/soumith/repos', 'events_url': 'https://api.github.com/users/soumith/events{/privacy}', 'received_events_url': 'https://api.github.com/users/soumith/received_events', 'type': 'User', 'site_admin': False}",referenced,c4078b42b48d8a6dff07658e0f1a40afa7b33f87,https://api.github.com/repos/pytorch/pytorch/commits/c4078b42b48d8a6dff07658e0f1a40afa7b33f87,2018-05-03T06:58:54Z,22,21,1
7088,1602863432,"{'login': 'soumith', 'id': 1310570, 'node_id': 'MDQ6VXNlcjEzMTA1NzA=', 'avatar_url': 'https://avatars0.githubusercontent.com/u/1310570?v=4', 'gravatar_id': '', 'url': 'https://api.github.com/users/soumith', 'html_url': 'https://github.com/soumith', 'followers_url': 'https://api.github.com/users/soumith/followers', 'following_url': 'https://api.github.com/users/soumith/following{/other_user}', 'gists_url': 'https://api.github.com/users/soumith/gists{/gist_id}', 'starred_url': 'https://api.github.com/users/soumith/starred{/owner}{/repo}', 'subscriptions_url': 'https://api.github.com/users/soumith/subscriptions', 'organizations_url': 'https://api.github.com/users/soumith/orgs', 'repos_url': 'https://api.github.com/users/soumith/repos', 'events_url': 'https://api.github.com/users/soumith/events{/privacy}', 'received_events_url': 'https://api.github.com/users/soumith/received_events', 'type': 'User', 'site_admin': False}",referenced,0b0279981dcc0c600a85b94c73b50c04ba05ec71,https://api.github.com/repos/pytorch/pytorch/commits/0b0279981dcc0c600a85b94c73b50c04ba05ec71,2018-05-01T04:29:34Z,6,3,3
7039,1634417952,"{'login': 'zou3519', 'id': 5652049, 'node_id': 'MDQ6VXNlcjU2NTIwNDk=', 'avatar_url': 'https://avatars3.githubusercontent.com/u/5652049?v=4', 'gravatar_id': '', 'url': 'https://api.github.com/users/zou3519', 'html_url': 'https://github.com/zou3519', 'followers_url': 'https://api.github.com/users/zou3519/followers', 'following_url': 'https://api.github.com/users/zou3519/following{/other_user}', 'gists_url': 'https://api.github.com/users/zou3519/gists{/gist_id}', 'starred_url': 'https://api.github.com/users/zou3519/starred{/owner}{/repo}', 'subscriptions_url': 'https://api.github.com/users/zou3519/subscriptions', 'organizations_url': 'https://api.github.com/users/zou3519/orgs', 'repos_url': 'https://api.github.com/users/zou3519/repos', 'events_url': 'https://api.github.com/users/zou3519/events{/privacy}', 'received_events_url': 'https://api.github.com/users/zou3519/received_events', 'type': 'User', 'site_admin': False}",referenced,50d8473ccc55437af53c0344304eb522323cdb0e,https://api.github.com/repos/pytorch/pytorch/commits/50d8473ccc55437af53c0344304eb522323cdb0e,2018-05-18T14:31:08Z,42,25,17
7021,1601050384,"{'login': 'apaszke', 'id': 4583066, 'node_id': 'MDQ6VXNlcjQ1ODMwNjY=', 'avatar_url': 'https://avatars3.githubusercontent.com/u/4583066?v=4', 'gravatar_id': '', 'url': 'https://api.github.com/users/apaszke', 'html_url': 'https://github.com/apaszke', 'followers_url': 'https://api.github.com/users/apaszke/followers', 'following_url': 'https://api.github.com/users/apaszke/following{/other_user}', 'gists_url': 'https://api.github.com/users/apaszke/gists{/gist_id}', 'starred_url': 'https://api.github.com/users/apaszke/starred{/owner}{/repo}', 'subscriptions_url': 'https://api.github.com/users/apaszke/subscriptions', 'organizations_url': 'https://api.github.com/users/apaszke/orgs', 'repos_url': 'https://api.github.com/users/apaszke/repos', 'events_url': 'https://api.github.com/users/apaszke/events{/privacy}', 'received_events_url': 'https://api.github.com/users/apaszke/received_events', 'type': 'User', 'site_admin': False}",referenced,8fbab83c2a036b3ba00944d6c95504b430734db3,https://api.github.com/repos/pytorch/pytorch/commits/8fbab83c2a036b3ba00944d6c95504b430734db3,2018-04-30T08:20:24Z,61,55,6
7012,1601810392,"{'login': 'ezyang', 'id': 13564, 'node_id': 'MDQ6VXNlcjEzNTY0', 'avatar_url': 'https://avatars0.githubusercontent.com/u/13564?v=4', 'gravatar_id': '', 'url': 'https://api.github.com/users/ezyang', 'html_url': 'https://github.com/ezyang', 'followers_url': 'https://api.github.com/users/ezyang/followers', 'following_url': 'https://api.github.com/users/ezyang/following{/other_user}', 'gists_url': 'https://api.github.com/users/ezyang/gists{/gist_id}', 'starred_url': 'https://api.github.com/users/ezyang/starred{/owner}{/repo}', 'subscriptions_url': 'https://api.github.com/users/ezyang/subscriptions', 'organizations_url': 'https://api.github.com/users/ezyang/orgs', 'repos_url': 'https://api.github.com/users/ezyang/repos', 'events_url': 'https://api.github.com/users/ezyang/events{/privacy}', 'received_events_url': 'https://api.github.com/users/ezyang/received_events', 'type': 'User', 'site_admin': False}",referenced,b70b7a80d45f03a80c02035adfc8ea0375cdacec,https://api.github.com/repos/pytorch/pytorch/commits/b70b7a80d45f03a80c02035adfc8ea0375cdacec,2018-04-30T15:49:07Z,235,220,15
7002,2547611018,"{'login': 'facebook-github-bot', 'id': 6422482, 'node_id': 'MDQ6VXNlcjY0MjI0ODI=', 'avatar_url': 'https://avatars3.githubusercontent.com/u/6422482?v=4', 'gravatar_id': '', 'url': 'https://api.github.com/users/facebook-github-bot', 'html_url': 'https://github.com/facebook-github-bot', 'followers_url': 'https://api.github.com/users/facebook-github-bot/followers', 'following_url': 'https://api.github.com/users/facebook-github-bot/following{/other_user}', 'gists_url': 'https://api.github.com/users/facebook-github-bot/gists{/gist_id}', 'starred_url': 'https://api.github.com/users/facebook-github-bot/starred{/owner}{/repo}', 'subscriptions_url': 'https://api.github.com/users/facebook-github-bot/subscriptions', 'organizations_url': 'https://api.github.com/users/facebook-github-bot/orgs', 'repos_url': 'https://api.github.com/users/facebook-github-bot/repos', 'events_url': 'https://api.github.com/users/facebook-github-bot/events{/privacy}', 'received_events_url': 'https://api.github.com/users/facebook-github-bot/received_events', 'type': 'User', 'site_admin': False}",referenced,c21a7740765a315673c6a683e1e53ab14958d5bb,https://api.github.com/repos/pytorch/pytorch/commits/c21a7740765a315673c6a683e1e53ab14958d5bb,2019-08-09T20:59:58Z,56,23,33
6996,1602198331,"{'login': 'apaszke', 'id': 4583066, 'node_id': 'MDQ6VXNlcjQ1ODMwNjY=', 'avatar_url': 'https://avatars3.githubusercontent.com/u/4583066?v=4', 'gravatar_id': '', 'url': 'https://api.github.com/users/apaszke', 'html_url': 'https://github.com/apaszke', 'followers_url': 'https://api.github.com/users/apaszke/followers', 'following_url': 'https://api.github.com/users/apaszke/following{/other_user}', 'gists_url': 'https://api.github.com/users/apaszke/gists{/gist_id}', 'starred_url': 'https://api.github.com/users/apaszke/starred{/owner}{/repo}', 'subscriptions_url': 'https://api.github.com/users/apaszke/subscriptions', 'organizations_url': 'https://api.github.com/users/apaszke/orgs', 'repos_url': 'https://api.github.com/users/apaszke/repos', 'events_url': 'https://api.github.com/users/apaszke/events{/privacy}', 'received_events_url': 'https://api.github.com/users/apaszke/received_events', 'type': 'User', 'site_admin': False}",closed,20c965f7d6a664e5b5bd6b1f14762bb2d07f87b5,https://api.github.com/repos/pytorch/pytorch/commits/20c965f7d6a664e5b5bd6b1f14762bb2d07f87b5,2018-04-30T19:03:08Z,44,38,6
6968,2104847853,"{'login': 'facebook-github-bot', 'id': 6422482, 'node_id': 'MDQ6VXNlcjY0MjI0ODI=', 'avatar_url': 'https://avatars3.githubusercontent.com/u/6422482?v=4', 'gravatar_id': '', 'url': 'https://api.github.com/users/facebook-github-bot', 'html_url': 'https://github.com/facebook-github-bot', 'followers_url': 'https://api.github.com/users/facebook-github-bot/followers', 'following_url': 'https://api.github.com/users/facebook-github-bot/following{/other_user}', 'gists_url': 'https://api.github.com/users/facebook-github-bot/gists{/gist_id}', 'starred_url': 'https://api.github.com/users/facebook-github-bot/starred{/owner}{/repo}', 'subscriptions_url': 'https://api.github.com/users/facebook-github-bot/subscriptions', 'organizations_url': 'https://api.github.com/users/facebook-github-bot/orgs', 'repos_url': 'https://api.github.com/users/facebook-github-bot/repos', 'events_url': 'https://api.github.com/users/facebook-github-bot/events{/privacy}', 'received_events_url': 'https://api.github.com/users/facebook-github-bot/received_events', 'type': 'User', 'site_admin': False}",closed,ded6fb0293f45b4f6ab70a831e66516266fdc96f,https://api.github.com/repos/pytorch/pytorch/commits/ded6fb0293f45b4f6ab70a831e66516266fdc96f,2019-01-29T21:07:53Z,388,201,187
6959,2438140078,"{'login': 'facebook-github-bot', 'id': 6422482, 'node_id': 'MDQ6VXNlcjY0MjI0ODI=', 'avatar_url': 'https://avatars3.githubusercontent.com/u/6422482?v=4', 'gravatar_id': '', 'url': 'https://api.github.com/users/facebook-github-bot', 'html_url': 'https://github.com/facebook-github-bot', 'followers_url': 'https://api.github.com/users/facebook-github-bot/followers', 'following_url': 'https://api.github.com/users/facebook-github-bot/following{/other_user}', 'gists_url': 'https://api.github.com/users/facebook-github-bot/gists{/gist_id}', 'starred_url': 'https://api.github.com/users/facebook-github-bot/starred{/owner}{/repo}', 'subscriptions_url': 'https://api.github.com/users/facebook-github-bot/subscriptions', 'organizations_url': 'https://api.github.com/users/facebook-github-bot/orgs', 'repos_url': 'https://api.github.com/users/facebook-github-bot/repos', 'events_url': 'https://api.github.com/users/facebook-github-bot/events{/privacy}', 'received_events_url': 'https://api.github.com/users/facebook-github-bot/received_events', 'type': 'User', 'site_admin': False}",referenced,c8b5f1d2f8f31781e664917f132af31a9abf9cbd,https://api.github.com/repos/pytorch/pytorch/commits/c8b5f1d2f8f31781e664917f132af31a9abf9cbd,2019-06-25T16:10:56Z,144,102,42
6947,1722117256,"{'login': 'facebook-github-bot', 'id': 6422482, 'node_id': 'MDQ6VXNlcjY0MjI0ODI=', 'avatar_url': 'https://avatars3.githubusercontent.com/u/6422482?v=4', 'gravatar_id': '', 'url': 'https://api.github.com/users/facebook-github-bot', 'html_url': 'https://github.com/facebook-github-bot', 'followers_url': 'https://api.github.com/users/facebook-github-bot/followers', 'following_url': 'https://api.github.com/users/facebook-github-bot/following{/other_user}', 'gists_url': 'https://api.github.com/users/facebook-github-bot/gists{/gist_id}', 'starred_url': 'https://api.github.com/users/facebook-github-bot/starred{/owner}{/repo}', 'subscriptions_url': 'https://api.github.com/users/facebook-github-bot/subscriptions', 'organizations_url': 'https://api.github.com/users/facebook-github-bot/orgs', 'repos_url': 'https://api.github.com/users/facebook-github-bot/repos', 'events_url': 'https://api.github.com/users/facebook-github-bot/events{/privacy}', 'received_events_url': 'https://api.github.com/users/facebook-github-bot/received_events', 'type': 'User', 'site_admin': False}",closed,e8536c08a16b533fe0a9d645dd4255513f9f4fdd,https://api.github.com/repos/pytorch/pytorch/commits/e8536c08a16b533fe0a9d645dd4255513f9f4fdd,2018-07-09T02:10:44Z,479,322,157
6932,1623380591,"{'login': 'ezyang', 'id': 13564, 'node_id': 'MDQ6VXNlcjEzNTY0', 'avatar_url': 'https://avatars0.githubusercontent.com/u/13564?v=4', 'gravatar_id': '', 'url': 'https://api.github.com/users/ezyang', 'html_url': 'https://github.com/ezyang', 'followers_url': 'https://api.github.com/users/ezyang/followers', 'following_url': 'https://api.github.com/users/ezyang/following{/other_user}', 'gists_url': 'https://api.github.com/users/ezyang/gists{/gist_id}', 'starred_url': 'https://api.github.com/users/ezyang/starred{/owner}{/repo}', 'subscriptions_url': 'https://api.github.com/users/ezyang/subscriptions', 'organizations_url': 'https://api.github.com/users/ezyang/orgs', 'repos_url': 'https://api.github.com/users/ezyang/repos', 'events_url': 'https://api.github.com/users/ezyang/events{/privacy}', 'received_events_url': 'https://api.github.com/users/ezyang/received_events', 'type': 'User', 'site_admin': False}",referenced,03767b66dbeb451a1f77348d3eedc402b02cb6ce,https://api.github.com/repos/pytorch/pytorch/commits/03767b66dbeb451a1f77348d3eedc402b02cb6ce,2018-05-13T00:54:49Z,15,8,7
6917,1596740079,"{'login': 'ezyang', 'id': 13564, 'node_id': 'MDQ6VXNlcjEzNTY0', 'avatar_url': 'https://avatars0.githubusercontent.com/u/13564?v=4', 'gravatar_id': '', 'url': 'https://api.github.com/users/ezyang', 'html_url': 'https://github.com/ezyang', 'followers_url': 'https://api.github.com/users/ezyang/followers', 'following_url': 'https://api.github.com/users/ezyang/following{/other_user}', 'gists_url': 'https://api.github.com/users/ezyang/gists{/gist_id}', 'starred_url': 'https://api.github.com/users/ezyang/starred{/owner}{/repo}', 'subscriptions_url': 'https://api.github.com/users/ezyang/subscriptions', 'organizations_url': 'https://api.github.com/users/ezyang/orgs', 'repos_url': 'https://api.github.com/users/ezyang/repos', 'events_url': 'https://api.github.com/users/ezyang/events{/privacy}', 'received_events_url': 'https://api.github.com/users/ezyang/received_events', 'type': 'User', 'site_admin': False}",closed,5dc5a71d74d4080a4dd99d2037970c4124087f79,https://api.github.com/repos/pytorch/pytorch/commits/5dc5a71d74d4080a4dd99d2037970c4124087f79,2018-04-26T14:58:57Z,2,1,1
6911,1675462596,"{'login': 'Yangqing', 'id': 551151, 'node_id': 'MDQ6VXNlcjU1MTE1MQ==', 'avatar_url': 'https://avatars1.githubusercontent.com/u/551151?v=4', 'gravatar_id': '', 'url': 'https://api.github.com/users/Yangqing', 'html_url': 'https://github.com/Yangqing', 'followers_url': 'https://api.github.com/users/Yangqing/followers', 'following_url': 'https://api.github.com/users/Yangqing/following{/other_user}', 'gists_url': 'https://api.github.com/users/Yangqing/gists{/gist_id}', 'starred_url': 'https://api.github.com/users/Yangqing/starred{/owner}{/repo}', 'subscriptions_url': 'https://api.github.com/users/Yangqing/subscriptions', 'organizations_url': 'https://api.github.com/users/Yangqing/orgs', 'repos_url': 'https://api.github.com/users/Yangqing/repos', 'events_url': 'https://api.github.com/users/Yangqing/events{/privacy}', 'received_events_url': 'https://api.github.com/users/Yangqing/received_events', 'type': 'User', 'site_admin': False}",closed,a161639fcdb948639da78c6ca5d18f900654f385,https://api.github.com/repos/pytorch/pytorch/commits/a161639fcdb948639da78c6ca5d18f900654f385,2018-06-12T06:13:18Z,84,42,42
6906,1750946264,"{'login': 'facebook-github-bot', 'id': 6422482, 'node_id': 'MDQ6VXNlcjY0MjI0ODI=', 'avatar_url': 'https://avatars3.githubusercontent.com/u/6422482?v=4', 'gravatar_id': '', 'url': 'https://api.github.com/users/facebook-github-bot', 'html_url': 'https://github.com/facebook-github-bot', 'followers_url': 'https://api.github.com/users/facebook-github-bot/followers', 'following_url': 'https://api.github.com/users/facebook-github-bot/following{/other_user}', 'gists_url': 'https://api.github.com/users/facebook-github-bot/gists{/gist_id}', 'starred_url': 'https://api.github.com/users/facebook-github-bot/starred{/owner}{/repo}', 'subscriptions_url': 'https://api.github.com/users/facebook-github-bot/subscriptions', 'organizations_url': 'https://api.github.com/users/facebook-github-bot/orgs', 'repos_url': 'https://api.github.com/users/facebook-github-bot/repos', 'events_url': 'https://api.github.com/users/facebook-github-bot/events{/privacy}', 'received_events_url': 'https://api.github.com/users/facebook-github-bot/received_events', 'type': 'User', 'site_admin': False}",closed,f9a99d5504818e2d8211dd9229665fb732a9c61e,https://api.github.com/repos/pytorch/pytorch/commits/f9a99d5504818e2d8211dd9229665fb732a9c61e,2018-07-24T18:59:34Z,176,131,45
6890,1752719833,"{'login': 'facebook-github-bot', 'id': 6422482, 'node_id': 'MDQ6VXNlcjY0MjI0ODI=', 'avatar_url': 'https://avatars3.githubusercontent.com/u/6422482?v=4', 'gravatar_id': '', 'url': 'https://api.github.com/users/facebook-github-bot', 'html_url': 'https://github.com/facebook-github-bot', 'followers_url': 'https://api.github.com/users/facebook-github-bot/followers', 'following_url': 'https://api.github.com/users/facebook-github-bot/following{/other_user}', 'gists_url': 'https://api.github.com/users/facebook-github-bot/gists{/gist_id}', 'starred_url': 'https://api.github.com/users/facebook-github-bot/starred{/owner}{/repo}', 'subscriptions_url': 'https://api.github.com/users/facebook-github-bot/subscriptions', 'organizations_url': 'https://api.github.com/users/facebook-github-bot/orgs', 'repos_url': 'https://api.github.com/users/facebook-github-bot/repos', 'events_url': 'https://api.github.com/users/facebook-github-bot/events{/privacy}', 'received_events_url': 'https://api.github.com/users/facebook-github-bot/received_events', 'type': 'User', 'site_admin': False}",closed,3ef521e98a451019b272ad23567ccc1cd7629a52,https://api.github.com/repos/pytorch/pytorch/commits/3ef521e98a451019b272ad23567ccc1cd7629a52,2018-07-25T14:17:21Z,48,47,1
6885,2110446692,"{'login': 'facebook-github-bot', 'id': 6422482, 'node_id': 'MDQ6VXNlcjY0MjI0ODI=', 'avatar_url': 'https://avatars3.githubusercontent.com/u/6422482?v=4', 'gravatar_id': '', 'url': 'https://api.github.com/users/facebook-github-bot', 'html_url': 'https://github.com/facebook-github-bot', 'followers_url': 'https://api.github.com/users/facebook-github-bot/followers', 'following_url': 'https://api.github.com/users/facebook-github-bot/following{/other_user}', 'gists_url': 'https://api.github.com/users/facebook-github-bot/gists{/gist_id}', 'starred_url': 'https://api.github.com/users/facebook-github-bot/starred{/owner}{/repo}', 'subscriptions_url': 'https://api.github.com/users/facebook-github-bot/subscriptions', 'organizations_url': 'https://api.github.com/users/facebook-github-bot/orgs', 'repos_url': 'https://api.github.com/users/facebook-github-bot/repos', 'events_url': 'https://api.github.com/users/facebook-github-bot/events{/privacy}', 'received_events_url': 'https://api.github.com/users/facebook-github-bot/received_events', 'type': 'User', 'site_admin': False}",referenced,b109549bf374202809dfab1a043a8e76fe9a7075,https://api.github.com/repos/pytorch/pytorch/commits/b109549bf374202809dfab1a043a8e76fe9a7075,2019-01-31T19:52:59Z,2,1,1
6879,1620018044,"{'login': 'anderspapitto', 'id': 1388690, 'node_id': 'MDQ6VXNlcjEzODg2OTA=', 'avatar_url': 'https://avatars3.githubusercontent.com/u/1388690?v=4', 'gravatar_id': '', 'url': 'https://api.github.com/users/anderspapitto', 'html_url': 'https://github.com/anderspapitto', 'followers_url': 'https://api.github.com/users/anderspapitto/followers', 'following_url': 'https://api.github.com/users/anderspapitto/following{/other_user}', 'gists_url': 'https://api.github.com/users/anderspapitto/gists{/gist_id}', 'starred_url': 'https://api.github.com/users/anderspapitto/starred{/owner}{/repo}', 'subscriptions_url': 'https://api.github.com/users/anderspapitto/subscriptions', 'organizations_url': 'https://api.github.com/users/anderspapitto/orgs', 'repos_url': 'https://api.github.com/users/anderspapitto/repos', 'events_url': 'https://api.github.com/users/anderspapitto/events{/privacy}', 'received_events_url': 'https://api.github.com/users/anderspapitto/received_events', 'type': 'User', 'site_admin': False}",referenced,ab5c391100aa0115cca29888141d7c1611d96712,https://api.github.com/repos/pytorch/pytorch/commits/ab5c391100aa0115cca29888141d7c1611d96712,2018-05-10T15:19:48Z,90,75,15
6863,1992542664,"{'login': 'facebook-github-bot', 'id': 6422482, 'node_id': 'MDQ6VXNlcjY0MjI0ODI=', 'avatar_url': 'https://avatars3.githubusercontent.com/u/6422482?v=4', 'gravatar_id': '', 'url': 'https://api.github.com/users/facebook-github-bot', 'html_url': 'https://github.com/facebook-github-bot', 'followers_url': 'https://api.github.com/users/facebook-github-bot/followers', 'following_url': 'https://api.github.com/users/facebook-github-bot/following{/other_user}', 'gists_url': 'https://api.github.com/users/facebook-github-bot/gists{/gist_id}', 'starred_url': 'https://api.github.com/users/facebook-github-bot/starred{/owner}{/repo}', 'subscriptions_url': 'https://api.github.com/users/facebook-github-bot/subscriptions', 'organizations_url': 'https://api.github.com/users/facebook-github-bot/orgs', 'repos_url': 'https://api.github.com/users/facebook-github-bot/repos', 'events_url': 'https://api.github.com/users/facebook-github-bot/events{/privacy}', 'received_events_url': 'https://api.github.com/users/facebook-github-bot/received_events', 'type': 'User', 'site_admin': False}",referenced,68251fb93196a4c28a0c9f9ce37896b21c6c04e0,https://api.github.com/repos/pytorch/pytorch/commits/68251fb93196a4c28a0c9f9ce37896b21c6c04e0,2018-11-28T14:14:48Z,21,17,4
6817,1596198515,"{'login': 'apaszke', 'id': 4583066, 'node_id': 'MDQ6VXNlcjQ1ODMwNjY=', 'avatar_url': 'https://avatars3.githubusercontent.com/u/4583066?v=4', 'gravatar_id': '', 'url': 'https://api.github.com/users/apaszke', 'html_url': 'https://github.com/apaszke', 'followers_url': 'https://api.github.com/users/apaszke/followers', 'following_url': 'https://api.github.com/users/apaszke/following{/other_user}', 'gists_url': 'https://api.github.com/users/apaszke/gists{/gist_id}', 'starred_url': 'https://api.github.com/users/apaszke/starred{/owner}{/repo}', 'subscriptions_url': 'https://api.github.com/users/apaszke/subscriptions', 'organizations_url': 'https://api.github.com/users/apaszke/orgs', 'repos_url': 'https://api.github.com/users/apaszke/repos', 'events_url': 'https://api.github.com/users/apaszke/events{/privacy}', 'received_events_url': 'https://api.github.com/users/apaszke/received_events', 'type': 'User', 'site_admin': False}",closed,f98b7780867c847eef27fbf492c9ee8dfe023c20,https://api.github.com/repos/pytorch/pytorch/commits/f98b7780867c847eef27fbf492c9ee8dfe023c20,2018-04-26T10:55:23Z,153,134,19
6817,1911206715,"{'login': 'facebook-github-bot', 'id': 6422482, 'node_id': 'MDQ6VXNlcjY0MjI0ODI=', 'avatar_url': 'https://avatars3.githubusercontent.com/u/6422482?v=4', 'gravatar_id': '', 'url': 'https://api.github.com/users/facebook-github-bot', 'html_url': 'https://github.com/facebook-github-bot', 'followers_url': 'https://api.github.com/users/facebook-github-bot/followers', 'following_url': 'https://api.github.com/users/facebook-github-bot/following{/other_user}', 'gists_url': 'https://api.github.com/users/facebook-github-bot/gists{/gist_id}', 'starred_url': 'https://api.github.com/users/facebook-github-bot/starred{/owner}{/repo}', 'subscriptions_url': 'https://api.github.com/users/facebook-github-bot/subscriptions', 'organizations_url': 'https://api.github.com/users/facebook-github-bot/orgs', 'repos_url': 'https://api.github.com/users/facebook-github-bot/repos', 'events_url': 'https://api.github.com/users/facebook-github-bot/events{/privacy}', 'received_events_url': 'https://api.github.com/users/facebook-github-bot/received_events', 'type': 'User', 'site_admin': False}",referenced,cffeb03a2db7dd1b1f4542a0b7050cce370a9053,https://api.github.com/repos/pytorch/pytorch/commits/cffeb03a2db7dd1b1f4542a0b7050cce370a9053,2018-10-18T04:08:55Z,77,56,21
6773,2039650797,"{'login': 'facebook-github-bot', 'id': 6422482, 'node_id': 'MDQ6VXNlcjY0MjI0ODI=', 'avatar_url': 'https://avatars3.githubusercontent.com/u/6422482?v=4', 'gravatar_id': '', 'url': 'https://api.github.com/users/facebook-github-bot', 'html_url': 'https://github.com/facebook-github-bot', 'followers_url': 'https://api.github.com/users/facebook-github-bot/followers', 'following_url': 'https://api.github.com/users/facebook-github-bot/following{/other_user}', 'gists_url': 'https://api.github.com/users/facebook-github-bot/gists{/gist_id}', 'starred_url': 'https://api.github.com/users/facebook-github-bot/starred{/owner}{/repo}', 'subscriptions_url': 'https://api.github.com/users/facebook-github-bot/subscriptions', 'organizations_url': 'https://api.github.com/users/facebook-github-bot/orgs', 'repos_url': 'https://api.github.com/users/facebook-github-bot/repos', 'events_url': 'https://api.github.com/users/facebook-github-bot/events{/privacy}', 'received_events_url': 'https://api.github.com/users/facebook-github-bot/received_events', 'type': 'User', 'site_admin': False}",referenced,d6cbcb43c59cee08df6555a7d3bc3d6212f93741,https://api.github.com/repos/pytorch/pytorch/commits/d6cbcb43c59cee08df6555a7d3bc3d6212f93741,2018-12-20T23:34:19Z,31,26,5
6759,1584947195,"{'login': 'soumith', 'id': 1310570, 'node_id': 'MDQ6VXNlcjEzMTA1NzA=', 'avatar_url': 'https://avatars0.githubusercontent.com/u/1310570?v=4', 'gravatar_id': '', 'url': 'https://api.github.com/users/soumith', 'html_url': 'https://github.com/soumith', 'followers_url': 'https://api.github.com/users/soumith/followers', 'following_url': 'https://api.github.com/users/soumith/following{/other_user}', 'gists_url': 'https://api.github.com/users/soumith/gists{/gist_id}', 'starred_url': 'https://api.github.com/users/soumith/starred{/owner}{/repo}', 'subscriptions_url': 'https://api.github.com/users/soumith/subscriptions', 'organizations_url': 'https://api.github.com/users/soumith/orgs', 'repos_url': 'https://api.github.com/users/soumith/repos', 'events_url': 'https://api.github.com/users/soumith/events{/privacy}', 'received_events_url': 'https://api.github.com/users/soumith/received_events', 'type': 'User', 'site_admin': False}",referenced,d1a992a85ebce32b3aaa8efc520c35cbb17d97b0,https://api.github.com/repos/pytorch/pytorch/commits/d1a992a85ebce32b3aaa8efc520c35cbb17d97b0,2018-04-19T22:31:42Z,13,12,1
6742,1583333584,"{'login': 'apaszke', 'id': 4583066, 'node_id': 'MDQ6VXNlcjQ1ODMwNjY=', 'avatar_url': 'https://avatars3.githubusercontent.com/u/4583066?v=4', 'gravatar_id': '', 'url': 'https://api.github.com/users/apaszke', 'html_url': 'https://github.com/apaszke', 'followers_url': 'https://api.github.com/users/apaszke/followers', 'following_url': 'https://api.github.com/users/apaszke/following{/other_user}', 'gists_url': 'https://api.github.com/users/apaszke/gists{/gist_id}', 'starred_url': 'https://api.github.com/users/apaszke/starred{/owner}{/repo}', 'subscriptions_url': 'https://api.github.com/users/apaszke/subscriptions', 'organizations_url': 'https://api.github.com/users/apaszke/orgs', 'repos_url': 'https://api.github.com/users/apaszke/repos', 'events_url': 'https://api.github.com/users/apaszke/events{/privacy}', 'received_events_url': 'https://api.github.com/users/apaszke/received_events', 'type': 'User', 'site_admin': False}",closed,533beab5bbd9547be1872634ebbbd6aaac8bf37d,https://api.github.com/repos/pytorch/pytorch/commits/533beab5bbd9547be1872634ebbbd6aaac8bf37d,2018-04-19T09:26:14Z,2,1,1
6622,1599511672,"{'login': 'ezyang', 'id': 13564, 'node_id': 'MDQ6VXNlcjEzNTY0', 'avatar_url': 'https://avatars0.githubusercontent.com/u/13564?v=4', 'gravatar_id': '', 'url': 'https://api.github.com/users/ezyang', 'html_url': 'https://github.com/ezyang', 'followers_url': 'https://api.github.com/users/ezyang/followers', 'following_url': 'https://api.github.com/users/ezyang/following{/other_user}', 'gists_url': 'https://api.github.com/users/ezyang/gists{/gist_id}', 'starred_url': 'https://api.github.com/users/ezyang/starred{/owner}{/repo}', 'subscriptions_url': 'https://api.github.com/users/ezyang/subscriptions', 'organizations_url': 'https://api.github.com/users/ezyang/orgs', 'repos_url': 'https://api.github.com/users/ezyang/repos', 'events_url': 'https://api.github.com/users/ezyang/events{/privacy}', 'received_events_url': 'https://api.github.com/users/ezyang/received_events', 'type': 'User', 'site_admin': False}",referenced,c730792d5133f489e368adf2702ef11825e8f503,https://api.github.com/repos/pytorch/pytorch/commits/c730792d5133f489e368adf2702ef11825e8f503,2018-04-27T19:45:50Z,32,23,9
6622,2005385355,"{'login': 'facebook-github-bot', 'id': 6422482, 'node_id': 'MDQ6VXNlcjY0MjI0ODI=', 'avatar_url': 'https://avatars3.githubusercontent.com/u/6422482?v=4', 'gravatar_id': '', 'url': 'https://api.github.com/users/facebook-github-bot', 'html_url': 'https://github.com/facebook-github-bot', 'followers_url': 'https://api.github.com/users/facebook-github-bot/followers', 'following_url': 'https://api.github.com/users/facebook-github-bot/following{/other_user}', 'gists_url': 'https://api.github.com/users/facebook-github-bot/gists{/gist_id}', 'starred_url': 'https://api.github.com/users/facebook-github-bot/starred{/owner}{/repo}', 'subscriptions_url': 'https://api.github.com/users/facebook-github-bot/subscriptions', 'organizations_url': 'https://api.github.com/users/facebook-github-bot/orgs', 'repos_url': 'https://api.github.com/users/facebook-github-bot/repos', 'events_url': 'https://api.github.com/users/facebook-github-bot/events{/privacy}', 'received_events_url': 'https://api.github.com/users/facebook-github-bot/received_events', 'type': 'User', 'site_admin': False}",closed,ef91cfd68b952fc24fd871837be019ced8f76f8e,https://api.github.com/repos/pytorch/pytorch/commits/ef91cfd68b952fc24fd871837be019ced8f76f8e,2018-12-04T20:26:13Z,96,62,34
6593,2036471921,"{'login': 'facebook-github-bot', 'id': 6422482, 'node_id': 'MDQ6VXNlcjY0MjI0ODI=', 'avatar_url': 'https://avatars3.githubusercontent.com/u/6422482?v=4', 'gravatar_id': '', 'url': 'https://api.github.com/users/facebook-github-bot', 'html_url': 'https://github.com/facebook-github-bot', 'followers_url': 'https://api.github.com/users/facebook-github-bot/followers', 'following_url': 'https://api.github.com/users/facebook-github-bot/following{/other_user}', 'gists_url': 'https://api.github.com/users/facebook-github-bot/gists{/gist_id}', 'starred_url': 'https://api.github.com/users/facebook-github-bot/starred{/owner}{/repo}', 'subscriptions_url': 'https://api.github.com/users/facebook-github-bot/subscriptions', 'organizations_url': 'https://api.github.com/users/facebook-github-bot/orgs', 'repos_url': 'https://api.github.com/users/facebook-github-bot/repos', 'events_url': 'https://api.github.com/users/facebook-github-bot/events{/privacy}', 'received_events_url': 'https://api.github.com/users/facebook-github-bot/received_events', 'type': 'User', 'site_admin': False}",referenced,560530aeecdae8c37d47c8ee7967c8583843a0bf,https://api.github.com/repos/pytorch/pytorch/commits/560530aeecdae8c37d47c8ee7967c8583843a0bf,2018-12-19T18:46:51Z,18,16,2
6556,1584473594,"{'login': 'zdevito', 'id': 370202, 'node_id': 'MDQ6VXNlcjM3MDIwMg==', 'avatar_url': 'https://avatars0.githubusercontent.com/u/370202?v=4', 'gravatar_id': '', 'url': 'https://api.github.com/users/zdevito', 'html_url': 'https://github.com/zdevito', 'followers_url': 'https://api.github.com/users/zdevito/followers', 'following_url': 'https://api.github.com/users/zdevito/following{/other_user}', 'gists_url': 'https://api.github.com/users/zdevito/gists{/gist_id}', 'starred_url': 'https://api.github.com/users/zdevito/starred{/owner}{/repo}', 'subscriptions_url': 'https://api.github.com/users/zdevito/subscriptions', 'organizations_url': 'https://api.github.com/users/zdevito/orgs', 'repos_url': 'https://api.github.com/users/zdevito/repos', 'events_url': 'https://api.github.com/users/zdevito/events{/privacy}', 'received_events_url': 'https://api.github.com/users/zdevito/received_events', 'type': 'User', 'site_admin': False}",referenced,6dfaa1071aaea2e5eab269909345457b6e70d9d5,https://api.github.com/repos/pytorch/pytorch/commits/6dfaa1071aaea2e5eab269909345457b6e70d9d5,2018-04-19T18:12:43Z,22,22,0
6479,1596775332,"{'login': 'ezyang', 'id': 13564, 'node_id': 'MDQ6VXNlcjEzNTY0', 'avatar_url': 'https://avatars0.githubusercontent.com/u/13564?v=4', 'gravatar_id': '', 'url': 'https://api.github.com/users/ezyang', 'html_url': 'https://github.com/ezyang', 'followers_url': 'https://api.github.com/users/ezyang/followers', 'following_url': 'https://api.github.com/users/ezyang/following{/other_user}', 'gists_url': 'https://api.github.com/users/ezyang/gists{/gist_id}', 'starred_url': 'https://api.github.com/users/ezyang/starred{/owner}{/repo}', 'subscriptions_url': 'https://api.github.com/users/ezyang/subscriptions', 'organizations_url': 'https://api.github.com/users/ezyang/orgs', 'repos_url': 'https://api.github.com/users/ezyang/repos', 'events_url': 'https://api.github.com/users/ezyang/events{/privacy}', 'received_events_url': 'https://api.github.com/users/ezyang/received_events', 'type': 'User', 'site_admin': False}",closed,2b44c420c8e61501ef04a5e4af2347ecc3c86202,https://api.github.com/repos/pytorch/pytorch/commits/2b44c420c8e61501ef04a5e4af2347ecc3c86202,2018-04-26T15:11:49Z,124,113,11
6398,1570004503,"{'login': 'ezyang', 'id': 13564, 'node_id': 'MDQ6VXNlcjEzNTY0', 'avatar_url': 'https://avatars0.githubusercontent.com/u/13564?v=4', 'gravatar_id': '', 'url': 'https://api.github.com/users/ezyang', 'html_url': 'https://github.com/ezyang', 'followers_url': 'https://api.github.com/users/ezyang/followers', 'following_url': 'https://api.github.com/users/ezyang/following{/other_user}', 'gists_url': 'https://api.github.com/users/ezyang/gists{/gist_id}', 'starred_url': 'https://api.github.com/users/ezyang/starred{/owner}{/repo}', 'subscriptions_url': 'https://api.github.com/users/ezyang/subscriptions', 'organizations_url': 'https://api.github.com/users/ezyang/orgs', 'repos_url': 'https://api.github.com/users/ezyang/repos', 'events_url': 'https://api.github.com/users/ezyang/events{/privacy}', 'received_events_url': 'https://api.github.com/users/ezyang/received_events', 'type': 'User', 'site_admin': False}",closed,0a6331792dd1312e8ad7fdf21f75b69fc8daad2f,https://api.github.com/repos/pytorch/pytorch/commits/0a6331792dd1312e8ad7fdf21f75b69fc8daad2f,2018-04-12T03:10:29Z,15,14,1
6397,1576999840,"{'login': 'ezyang', 'id': 13564, 'node_id': 'MDQ6VXNlcjEzNTY0', 'avatar_url': 'https://avatars0.githubusercontent.com/u/13564?v=4', 'gravatar_id': '', 'url': 'https://api.github.com/users/ezyang', 'html_url': 'https://github.com/ezyang', 'followers_url': 'https://api.github.com/users/ezyang/followers', 'following_url': 'https://api.github.com/users/ezyang/following{/other_user}', 'gists_url': 'https://api.github.com/users/ezyang/gists{/gist_id}', 'starred_url': 'https://api.github.com/users/ezyang/starred{/owner}{/repo}', 'subscriptions_url': 'https://api.github.com/users/ezyang/subscriptions', 'organizations_url': 'https://api.github.com/users/ezyang/orgs', 'repos_url': 'https://api.github.com/users/ezyang/repos', 'events_url': 'https://api.github.com/users/ezyang/events{/privacy}', 'received_events_url': 'https://api.github.com/users/ezyang/received_events', 'type': 'User', 'site_admin': False}",referenced,4d0097fab83c9550e109a6a41c8ace735e8d23be,https://api.github.com/repos/pytorch/pytorch/commits/4d0097fab83c9550e109a6a41c8ace735e8d23be,2018-04-16T18:32:01Z,3,2,1
6386,1564426444,"{'login': 'soumith', 'id': 1310570, 'node_id': 'MDQ6VXNlcjEzMTA1NzA=', 'avatar_url': 'https://avatars0.githubusercontent.com/u/1310570?v=4', 'gravatar_id': '', 'url': 'https://api.github.com/users/soumith', 'html_url': 'https://github.com/soumith', 'followers_url': 'https://api.github.com/users/soumith/followers', 'following_url': 'https://api.github.com/users/soumith/following{/other_user}', 'gists_url': 'https://api.github.com/users/soumith/gists{/gist_id}', 'starred_url': 'https://api.github.com/users/soumith/starred{/owner}{/repo}', 'subscriptions_url': 'https://api.github.com/users/soumith/subscriptions', 'organizations_url': 'https://api.github.com/users/soumith/orgs', 'repos_url': 'https://api.github.com/users/soumith/repos', 'events_url': 'https://api.github.com/users/soumith/events{/privacy}', 'received_events_url': 'https://api.github.com/users/soumith/received_events', 'type': 'User', 'site_admin': False}",closed,5651695a99b12bc081299ecd7b7dc1effcaa5204,https://api.github.com/repos/pytorch/pytorch/commits/5651695a99b12bc081299ecd7b7dc1effcaa5204,2018-04-09T17:54:34Z,18,13,5
6312,1564433348,"{'login': 'soumith', 'id': 1310570, 'node_id': 'MDQ6VXNlcjEzMTA1NzA=', 'avatar_url': 'https://avatars0.githubusercontent.com/u/1310570?v=4', 'gravatar_id': '', 'url': 'https://api.github.com/users/soumith', 'html_url': 'https://github.com/soumith', 'followers_url': 'https://api.github.com/users/soumith/followers', 'following_url': 'https://api.github.com/users/soumith/following{/other_user}', 'gists_url': 'https://api.github.com/users/soumith/gists{/gist_id}', 'starred_url': 'https://api.github.com/users/soumith/starred{/owner}{/repo}', 'subscriptions_url': 'https://api.github.com/users/soumith/subscriptions', 'organizations_url': 'https://api.github.com/users/soumith/orgs', 'repos_url': 'https://api.github.com/users/soumith/repos', 'events_url': 'https://api.github.com/users/soumith/events{/privacy}', 'received_events_url': 'https://api.github.com/users/soumith/received_events', 'type': 'User', 'site_admin': False}",referenced,1b3a5a4e7d97d34fc446a2670a634d3c98307837,https://api.github.com/repos/pytorch/pytorch/commits/1b3a5a4e7d97d34fc446a2670a634d3c98307837,2018-04-09T17:57:50Z,13,5,8
6271,1753727527,"{'login': 'facebook-github-bot', 'id': 6422482, 'node_id': 'MDQ6VXNlcjY0MjI0ODI=', 'avatar_url': 'https://avatars3.githubusercontent.com/u/6422482?v=4', 'gravatar_id': '', 'url': 'https://api.github.com/users/facebook-github-bot', 'html_url': 'https://github.com/facebook-github-bot', 'followers_url': 'https://api.github.com/users/facebook-github-bot/followers', 'following_url': 'https://api.github.com/users/facebook-github-bot/following{/other_user}', 'gists_url': 'https://api.github.com/users/facebook-github-bot/gists{/gist_id}', 'starred_url': 'https://api.github.com/users/facebook-github-bot/starred{/owner}{/repo}', 'subscriptions_url': 'https://api.github.com/users/facebook-github-bot/subscriptions', 'organizations_url': 'https://api.github.com/users/facebook-github-bot/orgs', 'repos_url': 'https://api.github.com/users/facebook-github-bot/repos', 'events_url': 'https://api.github.com/users/facebook-github-bot/events{/privacy}', 'received_events_url': 'https://api.github.com/users/facebook-github-bot/received_events', 'type': 'User', 'site_admin': False}",closed,302adb7cc827adbcf5cd29c531cd8cbe52b2f7dc,https://api.github.com/repos/pytorch/pytorch/commits/302adb7cc827adbcf5cd29c531cd8cbe52b2f7dc,2018-07-25T22:12:56Z,233,204,29
6245,1712711371,"{'login': 'facebook-github-bot', 'id': 6422482, 'node_id': 'MDQ6VXNlcjY0MjI0ODI=', 'avatar_url': 'https://avatars3.githubusercontent.com/u/6422482?v=4', 'gravatar_id': '', 'url': 'https://api.github.com/users/facebook-github-bot', 'html_url': 'https://github.com/facebook-github-bot', 'followers_url': 'https://api.github.com/users/facebook-github-bot/followers', 'following_url': 'https://api.github.com/users/facebook-github-bot/following{/other_user}', 'gists_url': 'https://api.github.com/users/facebook-github-bot/gists{/gist_id}', 'starred_url': 'https://api.github.com/users/facebook-github-bot/starred{/owner}{/repo}', 'subscriptions_url': 'https://api.github.com/users/facebook-github-bot/subscriptions', 'organizations_url': 'https://api.github.com/users/facebook-github-bot/orgs', 'repos_url': 'https://api.github.com/users/facebook-github-bot/repos', 'events_url': 'https://api.github.com/users/facebook-github-bot/events{/privacy}', 'received_events_url': 'https://api.github.com/users/facebook-github-bot/received_events', 'type': 'User', 'site_admin': False}",closed,cb1bfe91afcab1f7431202afe03381a5d59e4ee3,https://api.github.com/repos/pytorch/pytorch/commits/cb1bfe91afcab1f7431202afe03381a5d59e4ee3,2018-07-02T22:55:57Z,41,21,20
6222,1554954504,"{'login': 'soumith', 'id': 1310570, 'node_id': 'MDQ6VXNlcjEzMTA1NzA=', 'avatar_url': 'https://avatars0.githubusercontent.com/u/1310570?v=4', 'gravatar_id': '', 'url': 'https://api.github.com/users/soumith', 'html_url': 'https://github.com/soumith', 'followers_url': 'https://api.github.com/users/soumith/followers', 'following_url': 'https://api.github.com/users/soumith/following{/other_user}', 'gists_url': 'https://api.github.com/users/soumith/gists{/gist_id}', 'starred_url': 'https://api.github.com/users/soumith/starred{/owner}{/repo}', 'subscriptions_url': 'https://api.github.com/users/soumith/subscriptions', 'organizations_url': 'https://api.github.com/users/soumith/orgs', 'repos_url': 'https://api.github.com/users/soumith/repos', 'events_url': 'https://api.github.com/users/soumith/events{/privacy}', 'received_events_url': 'https://api.github.com/users/soumith/received_events', 'type': 'User', 'site_admin': False}",referenced,de517641194a5ec70c58a2c274ccc2abdd2d8ec1,https://api.github.com/repos/pytorch/pytorch/commits/de517641194a5ec70c58a2c274ccc2abdd2d8ec1,2018-04-03T19:47:47Z,1,0,1
6219,1789297752,"{'login': 'facebook-github-bot', 'id': 6422482, 'node_id': 'MDQ6VXNlcjY0MjI0ODI=', 'avatar_url': 'https://avatars3.githubusercontent.com/u/6422482?v=4', 'gravatar_id': '', 'url': 'https://api.github.com/users/facebook-github-bot', 'html_url': 'https://github.com/facebook-github-bot', 'followers_url': 'https://api.github.com/users/facebook-github-bot/followers', 'following_url': 'https://api.github.com/users/facebook-github-bot/following{/other_user}', 'gists_url': 'https://api.github.com/users/facebook-github-bot/gists{/gist_id}', 'starred_url': 'https://api.github.com/users/facebook-github-bot/starred{/owner}{/repo}', 'subscriptions_url': 'https://api.github.com/users/facebook-github-bot/subscriptions', 'organizations_url': 'https://api.github.com/users/facebook-github-bot/orgs', 'repos_url': 'https://api.github.com/users/facebook-github-bot/repos', 'events_url': 'https://api.github.com/users/facebook-github-bot/events{/privacy}', 'received_events_url': 'https://api.github.com/users/facebook-github-bot/received_events', 'type': 'User', 'site_admin': False}",closed,19ad55cc0288fe154a1fde8592e7819c22443198,https://api.github.com/repos/pytorch/pytorch/commits/19ad55cc0288fe154a1fde8592e7819c22443198,2018-08-15T04:26:48Z,42,20,22
6217,1566534677,"{'login': 'colesbury', 'id': 655866, 'node_id': 'MDQ6VXNlcjY1NTg2Ng==', 'avatar_url': 'https://avatars1.githubusercontent.com/u/655866?v=4', 'gravatar_id': '', 'url': 'https://api.github.com/users/colesbury', 'html_url': 'https://github.com/colesbury', 'followers_url': 'https://api.github.com/users/colesbury/followers', 'following_url': 'https://api.github.com/users/colesbury/following{/other_user}', 'gists_url': 'https://api.github.com/users/colesbury/gists{/gist_id}', 'starred_url': 'https://api.github.com/users/colesbury/starred{/owner}{/repo}', 'subscriptions_url': 'https://api.github.com/users/colesbury/subscriptions', 'organizations_url': 'https://api.github.com/users/colesbury/orgs', 'repos_url': 'https://api.github.com/users/colesbury/repos', 'events_url': 'https://api.github.com/users/colesbury/events{/privacy}', 'received_events_url': 'https://api.github.com/users/colesbury/received_events', 'type': 'User', 'site_admin': False}",referenced,aa99aa1cb81fa4f5ff98785fcaba2cb88bedb57f,https://api.github.com/repos/pytorch/pytorch/commits/aa99aa1cb81fa4f5ff98785fcaba2cb88bedb57f,2018-04-10T15:47:46Z,13,12,1
6190,1573581348,"{'login': 'zou3519', 'id': 5652049, 'node_id': 'MDQ6VXNlcjU2NTIwNDk=', 'avatar_url': 'https://avatars3.githubusercontent.com/u/5652049?v=4', 'gravatar_id': '', 'url': 'https://api.github.com/users/zou3519', 'html_url': 'https://github.com/zou3519', 'followers_url': 'https://api.github.com/users/zou3519/followers', 'following_url': 'https://api.github.com/users/zou3519/following{/other_user}', 'gists_url': 'https://api.github.com/users/zou3519/gists{/gist_id}', 'starred_url': 'https://api.github.com/users/zou3519/starred{/owner}{/repo}', 'subscriptions_url': 'https://api.github.com/users/zou3519/subscriptions', 'organizations_url': 'https://api.github.com/users/zou3519/orgs', 'repos_url': 'https://api.github.com/users/zou3519/repos', 'events_url': 'https://api.github.com/users/zou3519/events{/privacy}', 'received_events_url': 'https://api.github.com/users/zou3519/received_events', 'type': 'User', 'site_admin': False}",referenced,6c0f74089fe4a338d292fe4b79cfc6a395ceab16,https://api.github.com/repos/pytorch/pytorch/commits/6c0f74089fe4a338d292fe4b79cfc6a395ceab16,2018-04-13T15:49:35Z,235,198,37
6187,1718478383,"{'login': 'facebook-github-bot', 'id': 6422482, 'node_id': 'MDQ6VXNlcjY0MjI0ODI=', 'avatar_url': 'https://avatars3.githubusercontent.com/u/6422482?v=4', 'gravatar_id': '', 'url': 'https://api.github.com/users/facebook-github-bot', 'html_url': 'https://github.com/facebook-github-bot', 'followers_url': 'https://api.github.com/users/facebook-github-bot/followers', 'following_url': 'https://api.github.com/users/facebook-github-bot/following{/other_user}', 'gists_url': 'https://api.github.com/users/facebook-github-bot/gists{/gist_id}', 'starred_url': 'https://api.github.com/users/facebook-github-bot/starred{/owner}{/repo}', 'subscriptions_url': 'https://api.github.com/users/facebook-github-bot/subscriptions', 'organizations_url': 'https://api.github.com/users/facebook-github-bot/orgs', 'repos_url': 'https://api.github.com/users/facebook-github-bot/repos', 'events_url': 'https://api.github.com/users/facebook-github-bot/events{/privacy}', 'received_events_url': 'https://api.github.com/users/facebook-github-bot/received_events', 'type': 'User', 'site_admin': False}",closed,14cbd9adb8efafbd51444fdd88d6a34e6438b1c5,https://api.github.com/repos/pytorch/pytorch/commits/14cbd9adb8efafbd51444fdd88d6a34e6438b1c5,2018-07-05T16:13:28Z,165,136,29
6111,1587971812,"{'login': 'ezyang', 'id': 13564, 'node_id': 'MDQ6VXNlcjEzNTY0', 'avatar_url': 'https://avatars0.githubusercontent.com/u/13564?v=4', 'gravatar_id': '', 'url': 'https://api.github.com/users/ezyang', 'html_url': 'https://github.com/ezyang', 'followers_url': 'https://api.github.com/users/ezyang/followers', 'following_url': 'https://api.github.com/users/ezyang/following{/other_user}', 'gists_url': 'https://api.github.com/users/ezyang/gists{/gist_id}', 'starred_url': 'https://api.github.com/users/ezyang/starred{/owner}{/repo}', 'subscriptions_url': 'https://api.github.com/users/ezyang/subscriptions', 'organizations_url': 'https://api.github.com/users/ezyang/orgs', 'repos_url': 'https://api.github.com/users/ezyang/repos', 'events_url': 'https://api.github.com/users/ezyang/events{/privacy}', 'received_events_url': 'https://api.github.com/users/ezyang/received_events', 'type': 'User', 'site_admin': False}",referenced,7a3c38ab595ea78f16935df788c4982a0ec56966,https://api.github.com/repos/pytorch/pytorch/commits/7a3c38ab595ea78f16935df788c4982a0ec56966,2018-04-22T19:18:36Z,568,494,74
6068,1550829512,"{'login': 'soumith', 'id': 1310570, 'node_id': 'MDQ6VXNlcjEzMTA1NzA=', 'avatar_url': 'https://avatars0.githubusercontent.com/u/1310570?v=4', 'gravatar_id': '', 'url': 'https://api.github.com/users/soumith', 'html_url': 'https://github.com/soumith', 'followers_url': 'https://api.github.com/users/soumith/followers', 'following_url': 'https://api.github.com/users/soumith/following{/other_user}', 'gists_url': 'https://api.github.com/users/soumith/gists{/gist_id}', 'starred_url': 'https://api.github.com/users/soumith/starred{/owner}{/repo}', 'subscriptions_url': 'https://api.github.com/users/soumith/subscriptions', 'organizations_url': 'https://api.github.com/users/soumith/orgs', 'repos_url': 'https://api.github.com/users/soumith/repos', 'events_url': 'https://api.github.com/users/soumith/events{/privacy}', 'received_events_url': 'https://api.github.com/users/soumith/received_events', 'type': 'User', 'site_admin': False}",referenced,9ce21b0e90095edbda80946cff95095a992b89d6,https://api.github.com/repos/pytorch/pytorch/commits/9ce21b0e90095edbda80946cff95095a992b89d6,2018-03-31T18:28:47Z,733,5,728
6028,1564396334,"{'login': 'colesbury', 'id': 655866, 'node_id': 'MDQ6VXNlcjY1NTg2Ng==', 'avatar_url': 'https://avatars1.githubusercontent.com/u/655866?v=4', 'gravatar_id': '', 'url': 'https://api.github.com/users/colesbury', 'html_url': 'https://github.com/colesbury', 'followers_url': 'https://api.github.com/users/colesbury/followers', 'following_url': 'https://api.github.com/users/colesbury/following{/other_user}', 'gists_url': 'https://api.github.com/users/colesbury/gists{/gist_id}', 'starred_url': 'https://api.github.com/users/colesbury/starred{/owner}{/repo}', 'subscriptions_url': 'https://api.github.com/users/colesbury/subscriptions', 'organizations_url': 'https://api.github.com/users/colesbury/orgs', 'repos_url': 'https://api.github.com/users/colesbury/repos', 'events_url': 'https://api.github.com/users/colesbury/events{/privacy}', 'received_events_url': 'https://api.github.com/users/colesbury/received_events', 'type': 'User', 'site_admin': False}",referenced,d0f395f7446a89f21dd8a5d8bce6c509975436f3,https://api.github.com/repos/pytorch/pytorch/commits/d0f395f7446a89f21dd8a5d8bce6c509975436f3,2018-04-09T17:39:53Z,82,61,21
6008,2036463068,"{'login': 'facebook-github-bot', 'id': 6422482, 'node_id': 'MDQ6VXNlcjY0MjI0ODI=', 'avatar_url': 'https://avatars3.githubusercontent.com/u/6422482?v=4', 'gravatar_id': '', 'url': 'https://api.github.com/users/facebook-github-bot', 'html_url': 'https://github.com/facebook-github-bot', 'followers_url': 'https://api.github.com/users/facebook-github-bot/followers', 'following_url': 'https://api.github.com/users/facebook-github-bot/following{/other_user}', 'gists_url': 'https://api.github.com/users/facebook-github-bot/gists{/gist_id}', 'starred_url': 'https://api.github.com/users/facebook-github-bot/starred{/owner}{/repo}', 'subscriptions_url': 'https://api.github.com/users/facebook-github-bot/subscriptions', 'organizations_url': 'https://api.github.com/users/facebook-github-bot/orgs', 'repos_url': 'https://api.github.com/users/facebook-github-bot/repos', 'events_url': 'https://api.github.com/users/facebook-github-bot/events{/privacy}', 'received_events_url': 'https://api.github.com/users/facebook-github-bot/received_events', 'type': 'User', 'site_admin': False}",referenced,54d4fe3f49d781030cb4c3b7ec3944fb2cf7aae3,https://api.github.com/repos/pytorch/pytorch/commits/54d4fe3f49d781030cb4c3b7ec3944fb2cf7aae3,2018-12-19T18:42:47Z,7,6,1
5994,2016333340,"{'login': 'facebook-github-bot', 'id': 6422482, 'node_id': 'MDQ6VXNlcjY0MjI0ODI=', 'avatar_url': 'https://avatars3.githubusercontent.com/u/6422482?v=4', 'gravatar_id': '', 'url': 'https://api.github.com/users/facebook-github-bot', 'html_url': 'https://github.com/facebook-github-bot', 'followers_url': 'https://api.github.com/users/facebook-github-bot/followers', 'following_url': 'https://api.github.com/users/facebook-github-bot/following{/other_user}', 'gists_url': 'https://api.github.com/users/facebook-github-bot/gists{/gist_id}', 'starred_url': 'https://api.github.com/users/facebook-github-bot/starred{/owner}{/repo}', 'subscriptions_url': 'https://api.github.com/users/facebook-github-bot/subscriptions', 'organizations_url': 'https://api.github.com/users/facebook-github-bot/orgs', 'repos_url': 'https://api.github.com/users/facebook-github-bot/repos', 'events_url': 'https://api.github.com/users/facebook-github-bot/events{/privacy}', 'received_events_url': 'https://api.github.com/users/facebook-github-bot/received_events', 'type': 'User', 'site_admin': False}",referenced,54d5c53826479142fcf1e4de3ad77f8e4b81c123,https://api.github.com/repos/pytorch/pytorch/commits/54d5c53826479142fcf1e4de3ad77f8e4b81c123,2018-12-10T16:09:20Z,85,70,15
5973,1540881570,"{'login': 'ezyang', 'id': 13564, 'node_id': 'MDQ6VXNlcjEzNTY0', 'avatar_url': 'https://avatars0.githubusercontent.com/u/13564?v=4', 'gravatar_id': '', 'url': 'https://api.github.com/users/ezyang', 'html_url': 'https://github.com/ezyang', 'followers_url': 'https://api.github.com/users/ezyang/followers', 'following_url': 'https://api.github.com/users/ezyang/following{/other_user}', 'gists_url': 'https://api.github.com/users/ezyang/gists{/gist_id}', 'starred_url': 'https://api.github.com/users/ezyang/starred{/owner}{/repo}', 'subscriptions_url': 'https://api.github.com/users/ezyang/subscriptions', 'organizations_url': 'https://api.github.com/users/ezyang/orgs', 'repos_url': 'https://api.github.com/users/ezyang/repos', 'events_url': 'https://api.github.com/users/ezyang/events{/privacy}', 'received_events_url': 'https://api.github.com/users/ezyang/received_events', 'type': 'User', 'site_admin': False}",referenced,1ab248d09e256944d41c3099ef0fcfb8ab844523,https://api.github.com/repos/pytorch/pytorch/commits/1ab248d09e256944d41c3099ef0fcfb8ab844523,2018-03-26T13:40:52Z,12,10,2
5946,1548400542,"{'login': 'ezyang', 'id': 13564, 'node_id': 'MDQ6VXNlcjEzNTY0', 'avatar_url': 'https://avatars0.githubusercontent.com/u/13564?v=4', 'gravatar_id': '', 'url': 'https://api.github.com/users/ezyang', 'html_url': 'https://github.com/ezyang', 'followers_url': 'https://api.github.com/users/ezyang/followers', 'following_url': 'https://api.github.com/users/ezyang/following{/other_user}', 'gists_url': 'https://api.github.com/users/ezyang/gists{/gist_id}', 'starred_url': 'https://api.github.com/users/ezyang/starred{/owner}{/repo}', 'subscriptions_url': 'https://api.github.com/users/ezyang/subscriptions', 'organizations_url': 'https://api.github.com/users/ezyang/orgs', 'repos_url': 'https://api.github.com/users/ezyang/repos', 'events_url': 'https://api.github.com/users/ezyang/events{/privacy}', 'received_events_url': 'https://api.github.com/users/ezyang/received_events', 'type': 'User', 'site_admin': False}",referenced,4f05cb710ef067e6d60e976651942e559ecf582d,https://api.github.com/repos/pytorch/pytorch/commits/4f05cb710ef067e6d60e976651942e559ecf582d,2018-03-29T17:26:28Z,219,141,78
5943,1536540563,"{'login': 'soumith', 'id': 1310570, 'node_id': 'MDQ6VXNlcjEzMTA1NzA=', 'avatar_url': 'https://avatars0.githubusercontent.com/u/1310570?v=4', 'gravatar_id': '', 'url': 'https://api.github.com/users/soumith', 'html_url': 'https://github.com/soumith', 'followers_url': 'https://api.github.com/users/soumith/followers', 'following_url': 'https://api.github.com/users/soumith/following{/other_user}', 'gists_url': 'https://api.github.com/users/soumith/gists{/gist_id}', 'starred_url': 'https://api.github.com/users/soumith/starred{/owner}{/repo}', 'subscriptions_url': 'https://api.github.com/users/soumith/subscriptions', 'organizations_url': 'https://api.github.com/users/soumith/orgs', 'repos_url': 'https://api.github.com/users/soumith/repos', 'events_url': 'https://api.github.com/users/soumith/events{/privacy}', 'received_events_url': 'https://api.github.com/users/soumith/received_events', 'type': 'User', 'site_admin': False}",referenced,c9c978dff0747796b607b1b9f383bf6e33d4245e,https://api.github.com/repos/pytorch/pytorch/commits/c9c978dff0747796b607b1b9f383bf6e33d4245e,2018-03-22T20:31:11Z,8,5,3
5921,1534786002,"{'login': 'ezyang', 'id': 13564, 'node_id': 'MDQ6VXNlcjEzNTY0', 'avatar_url': 'https://avatars0.githubusercontent.com/u/13564?v=4', 'gravatar_id': '', 'url': 'https://api.github.com/users/ezyang', 'html_url': 'https://github.com/ezyang', 'followers_url': 'https://api.github.com/users/ezyang/followers', 'following_url': 'https://api.github.com/users/ezyang/following{/other_user}', 'gists_url': 'https://api.github.com/users/ezyang/gists{/gist_id}', 'starred_url': 'https://api.github.com/users/ezyang/starred{/owner}{/repo}', 'subscriptions_url': 'https://api.github.com/users/ezyang/subscriptions', 'organizations_url': 'https://api.github.com/users/ezyang/orgs', 'repos_url': 'https://api.github.com/users/ezyang/repos', 'events_url': 'https://api.github.com/users/ezyang/events{/privacy}', 'received_events_url': 'https://api.github.com/users/ezyang/received_events', 'type': 'User', 'site_admin': False}",referenced,e9f144b3e84f03d6a507faac40bdfce58b68c1fb,https://api.github.com/repos/pytorch/pytorch/commits/e9f144b3e84f03d6a507faac40bdfce58b68c1fb,2018-03-22T05:15:12Z,118,102,16
5887,1532356782,"{'login': 'ezyang', 'id': 13564, 'node_id': 'MDQ6VXNlcjEzNTY0', 'avatar_url': 'https://avatars0.githubusercontent.com/u/13564?v=4', 'gravatar_id': '', 'url': 'https://api.github.com/users/ezyang', 'html_url': 'https://github.com/ezyang', 'followers_url': 'https://api.github.com/users/ezyang/followers', 'following_url': 'https://api.github.com/users/ezyang/following{/other_user}', 'gists_url': 'https://api.github.com/users/ezyang/gists{/gist_id}', 'starred_url': 'https://api.github.com/users/ezyang/starred{/owner}{/repo}', 'subscriptions_url': 'https://api.github.com/users/ezyang/subscriptions', 'organizations_url': 'https://api.github.com/users/ezyang/orgs', 'repos_url': 'https://api.github.com/users/ezyang/repos', 'events_url': 'https://api.github.com/users/ezyang/events{/privacy}', 'received_events_url': 'https://api.github.com/users/ezyang/received_events', 'type': 'User', 'site_admin': False}",referenced,537e0e03300a64d17a521c8574455cdf0979e2fd,https://api.github.com/repos/pytorch/pytorch/commits/537e0e03300a64d17a521c8574455cdf0979e2fd,2018-03-21T02:25:44Z,21,13,8
5851,1529333467,"{'login': 'ezyang', 'id': 13564, 'node_id': 'MDQ6VXNlcjEzNTY0', 'avatar_url': 'https://avatars0.githubusercontent.com/u/13564?v=4', 'gravatar_id': '', 'url': 'https://api.github.com/users/ezyang', 'html_url': 'https://github.com/ezyang', 'followers_url': 'https://api.github.com/users/ezyang/followers', 'following_url': 'https://api.github.com/users/ezyang/following{/other_user}', 'gists_url': 'https://api.github.com/users/ezyang/gists{/gist_id}', 'starred_url': 'https://api.github.com/users/ezyang/starred{/owner}{/repo}', 'subscriptions_url': 'https://api.github.com/users/ezyang/subscriptions', 'organizations_url': 'https://api.github.com/users/ezyang/orgs', 'repos_url': 'https://api.github.com/users/ezyang/repos', 'events_url': 'https://api.github.com/users/ezyang/events{/privacy}', 'received_events_url': 'https://api.github.com/users/ezyang/received_events', 'type': 'User', 'site_admin': False}",referenced,d11b7fbd1c49ed7bd84c89d286e2763e6ba55f51,https://api.github.com/repos/pytorch/pytorch/commits/d11b7fbd1c49ed7bd84c89d286e2763e6ba55f51,2018-03-19T19:27:09Z,39,36,3
5823,1721183772,"{'login': 'facebook-github-bot', 'id': 6422482, 'node_id': 'MDQ6VXNlcjY0MjI0ODI=', 'avatar_url': 'https://avatars3.githubusercontent.com/u/6422482?v=4', 'gravatar_id': '', 'url': 'https://api.github.com/users/facebook-github-bot', 'html_url': 'https://github.com/facebook-github-bot', 'followers_url': 'https://api.github.com/users/facebook-github-bot/followers', 'following_url': 'https://api.github.com/users/facebook-github-bot/following{/other_user}', 'gists_url': 'https://api.github.com/users/facebook-github-bot/gists{/gist_id}', 'starred_url': 'https://api.github.com/users/facebook-github-bot/starred{/owner}{/repo}', 'subscriptions_url': 'https://api.github.com/users/facebook-github-bot/subscriptions', 'organizations_url': 'https://api.github.com/users/facebook-github-bot/orgs', 'repos_url': 'https://api.github.com/users/facebook-github-bot/repos', 'events_url': 'https://api.github.com/users/facebook-github-bot/events{/privacy}', 'received_events_url': 'https://api.github.com/users/facebook-github-bot/received_events', 'type': 'User', 'site_admin': False}",referenced,227c8f2654c5aa4dda319d7401d319bb4636be47,https://api.github.com/repos/pytorch/pytorch/commits/227c8f2654c5aa4dda319d7401d319bb4636be47,2018-07-06T22:29:19Z,2394,1129,1265
5748,1577022486,"{'login': 'ezyang', 'id': 13564, 'node_id': 'MDQ6VXNlcjEzNTY0', 'avatar_url': 'https://avatars0.githubusercontent.com/u/13564?v=4', 'gravatar_id': '', 'url': 'https://api.github.com/users/ezyang', 'html_url': 'https://github.com/ezyang', 'followers_url': 'https://api.github.com/users/ezyang/followers', 'following_url': 'https://api.github.com/users/ezyang/following{/other_user}', 'gists_url': 'https://api.github.com/users/ezyang/gists{/gist_id}', 'starred_url': 'https://api.github.com/users/ezyang/starred{/owner}{/repo}', 'subscriptions_url': 'https://api.github.com/users/ezyang/subscriptions', 'organizations_url': 'https://api.github.com/users/ezyang/orgs', 'repos_url': 'https://api.github.com/users/ezyang/repos', 'events_url': 'https://api.github.com/users/ezyang/events{/privacy}', 'received_events_url': 'https://api.github.com/users/ezyang/received_events', 'type': 'User', 'site_admin': False}",referenced,ce2854c8758df972e15409cadc820bf5884f724b,https://api.github.com/repos/pytorch/pytorch/commits/ce2854c8758df972e15409cadc820bf5884f724b,2018-04-16T18:43:22Z,345,199,146
5739,1539010058,"{'login': 'soumith', 'id': 1310570, 'node_id': 'MDQ6VXNlcjEzMTA1NzA=', 'avatar_url': 'https://avatars0.githubusercontent.com/u/1310570?v=4', 'gravatar_id': '', 'url': 'https://api.github.com/users/soumith', 'html_url': 'https://github.com/soumith', 'followers_url': 'https://api.github.com/users/soumith/followers', 'following_url': 'https://api.github.com/users/soumith/following{/other_user}', 'gists_url': 'https://api.github.com/users/soumith/gists{/gist_id}', 'starred_url': 'https://api.github.com/users/soumith/starred{/owner}{/repo}', 'subscriptions_url': 'https://api.github.com/users/soumith/subscriptions', 'organizations_url': 'https://api.github.com/users/soumith/orgs', 'repos_url': 'https://api.github.com/users/soumith/repos', 'events_url': 'https://api.github.com/users/soumith/events{/privacy}', 'received_events_url': 'https://api.github.com/users/soumith/received_events', 'type': 'User', 'site_admin': False}",referenced,9923701a0d746f68fd5061a058d544759fc1609f,https://api.github.com/repos/pytorch/pytorch/commits/9923701a0d746f68fd5061a058d544759fc1609f,2018-03-24T02:22:54Z,27,23,4
5738,1566931287,"{'login': 'soumith', 'id': 1310570, 'node_id': 'MDQ6VXNlcjEzMTA1NzA=', 'avatar_url': 'https://avatars0.githubusercontent.com/u/1310570?v=4', 'gravatar_id': '', 'url': 'https://api.github.com/users/soumith', 'html_url': 'https://github.com/soumith', 'followers_url': 'https://api.github.com/users/soumith/followers', 'following_url': 'https://api.github.com/users/soumith/following{/other_user}', 'gists_url': 'https://api.github.com/users/soumith/gists{/gist_id}', 'starred_url': 'https://api.github.com/users/soumith/starred{/owner}{/repo}', 'subscriptions_url': 'https://api.github.com/users/soumith/subscriptions', 'organizations_url': 'https://api.github.com/users/soumith/orgs', 'repos_url': 'https://api.github.com/users/soumith/repos', 'events_url': 'https://api.github.com/users/soumith/events{/privacy}', 'received_events_url': 'https://api.github.com/users/soumith/received_events', 'type': 'User', 'site_admin': False}",referenced,04c215b4454aa5816a15f60567800d65a8351d33,https://api.github.com/repos/pytorch/pytorch/commits/04c215b4454aa5816a15f60567800d65a8351d33,2018-04-10T18:53:28Z,12,11,1
5719,1554461324,"{'login': 'soumith', 'id': 1310570, 'node_id': 'MDQ6VXNlcjEzMTA1NzA=', 'avatar_url': 'https://avatars0.githubusercontent.com/u/1310570?v=4', 'gravatar_id': '', 'url': 'https://api.github.com/users/soumith', 'html_url': 'https://github.com/soumith', 'followers_url': 'https://api.github.com/users/soumith/followers', 'following_url': 'https://api.github.com/users/soumith/following{/other_user}', 'gists_url': 'https://api.github.com/users/soumith/gists{/gist_id}', 'starred_url': 'https://api.github.com/users/soumith/starred{/owner}{/repo}', 'subscriptions_url': 'https://api.github.com/users/soumith/subscriptions', 'organizations_url': 'https://api.github.com/users/soumith/orgs', 'repos_url': 'https://api.github.com/users/soumith/repos', 'events_url': 'https://api.github.com/users/soumith/events{/privacy}', 'received_events_url': 'https://api.github.com/users/soumith/received_events', 'type': 'User', 'site_admin': False}",referenced,e831ad62046da7c330b566a275242b77099b28a0,https://api.github.com/repos/pytorch/pytorch/commits/e831ad62046da7c330b566a275242b77099b28a0,2018-04-03T15:49:59Z,24,24,0
5718,1518018758,"{'login': 'soumith', 'id': 1310570, 'node_id': 'MDQ6VXNlcjEzMTA1NzA=', 'avatar_url': 'https://avatars0.githubusercontent.com/u/1310570?v=4', 'gravatar_id': '', 'url': 'https://api.github.com/users/soumith', 'html_url': 'https://github.com/soumith', 'followers_url': 'https://api.github.com/users/soumith/followers', 'following_url': 'https://api.github.com/users/soumith/following{/other_user}', 'gists_url': 'https://api.github.com/users/soumith/gists{/gist_id}', 'starred_url': 'https://api.github.com/users/soumith/starred{/owner}{/repo}', 'subscriptions_url': 'https://api.github.com/users/soumith/subscriptions', 'organizations_url': 'https://api.github.com/users/soumith/orgs', 'repos_url': 'https://api.github.com/users/soumith/repos', 'events_url': 'https://api.github.com/users/soumith/events{/privacy}', 'received_events_url': 'https://api.github.com/users/soumith/received_events', 'type': 'User', 'site_admin': False}",closed,025e43c2634023de4c62fe4f1afeda6a9f7565da,https://api.github.com/repos/pytorch/pytorch/commits/025e43c2634023de4c62fe4f1afeda6a9f7565da,2018-03-13T08:38:21Z,8,4,4
5704,1516612448,"{'login': 'ezyang', 'id': 13564, 'node_id': 'MDQ6VXNlcjEzNTY0', 'avatar_url': 'https://avatars0.githubusercontent.com/u/13564?v=4', 'gravatar_id': '', 'url': 'https://api.github.com/users/ezyang', 'html_url': 'https://github.com/ezyang', 'followers_url': 'https://api.github.com/users/ezyang/followers', 'following_url': 'https://api.github.com/users/ezyang/following{/other_user}', 'gists_url': 'https://api.github.com/users/ezyang/gists{/gist_id}', 'starred_url': 'https://api.github.com/users/ezyang/starred{/owner}{/repo}', 'subscriptions_url': 'https://api.github.com/users/ezyang/subscriptions', 'organizations_url': 'https://api.github.com/users/ezyang/orgs', 'repos_url': 'https://api.github.com/users/ezyang/repos', 'events_url': 'https://api.github.com/users/ezyang/events{/privacy}', 'received_events_url': 'https://api.github.com/users/ezyang/received_events', 'type': 'User', 'site_admin': False}",referenced,42bf2f9289daf59072e5b83ed4e2dd9a03eb9739,https://api.github.com/repos/pytorch/pytorch/commits/42bf2f9289daf59072e5b83ed4e2dd9a03eb9739,2018-03-12T16:05:09Z,4,4,0
5661,1514128950,"{'login': 'apaszke', 'id': 4583066, 'node_id': 'MDQ6VXNlcjQ1ODMwNjY=', 'avatar_url': 'https://avatars3.githubusercontent.com/u/4583066?v=4', 'gravatar_id': '', 'url': 'https://api.github.com/users/apaszke', 'html_url': 'https://github.com/apaszke', 'followers_url': 'https://api.github.com/users/apaszke/followers', 'following_url': 'https://api.github.com/users/apaszke/following{/other_user}', 'gists_url': 'https://api.github.com/users/apaszke/gists{/gist_id}', 'starred_url': 'https://api.github.com/users/apaszke/starred{/owner}{/repo}', 'subscriptions_url': 'https://api.github.com/users/apaszke/subscriptions', 'organizations_url': 'https://api.github.com/users/apaszke/orgs', 'repos_url': 'https://api.github.com/users/apaszke/repos', 'events_url': 'https://api.github.com/users/apaszke/events{/privacy}', 'received_events_url': 'https://api.github.com/users/apaszke/received_events', 'type': 'User', 'site_admin': False}",closed,b543041e2119f31e4770c02190635fce82a7a564,https://api.github.com/repos/pytorch/pytorch/commits/b543041e2119f31e4770c02190635fce82a7a564,2018-03-09T21:03:41Z,2,1,1
5660,1701913985,"{'login': 'SsnL', 'id': 5674597, 'node_id': 'MDQ6VXNlcjU2NzQ1OTc=', 'avatar_url': 'https://avatars2.githubusercontent.com/u/5674597?v=4', 'gravatar_id': '', 'url': 'https://api.github.com/users/SsnL', 'html_url': 'https://github.com/SsnL', 'followers_url': 'https://api.github.com/users/SsnL/followers', 'following_url': 'https://api.github.com/users/SsnL/following{/other_user}', 'gists_url': 'https://api.github.com/users/SsnL/gists{/gist_id}', 'starred_url': 'https://api.github.com/users/SsnL/starred{/owner}{/repo}', 'subscriptions_url': 'https://api.github.com/users/SsnL/subscriptions', 'organizations_url': 'https://api.github.com/users/SsnL/orgs', 'repos_url': 'https://api.github.com/users/SsnL/repos', 'events_url': 'https://api.github.com/users/SsnL/events{/privacy}', 'received_events_url': 'https://api.github.com/users/SsnL/received_events', 'type': 'User', 'site_admin': False}",referenced,6e28d4d364246f35f5bdbd18bd8e12edc28538aa,https://api.github.com/repos/pytorch/pytorch/commits/6e28d4d364246f35f5bdbd18bd8e12edc28538aa,2018-06-26T16:31:46Z,77,65,12
5648,1529420333,"{'login': 'ezyang', 'id': 13564, 'node_id': 'MDQ6VXNlcjEzNTY0', 'avatar_url': 'https://avatars0.githubusercontent.com/u/13564?v=4', 'gravatar_id': '', 'url': 'https://api.github.com/users/ezyang', 'html_url': 'https://github.com/ezyang', 'followers_url': 'https://api.github.com/users/ezyang/followers', 'following_url': 'https://api.github.com/users/ezyang/following{/other_user}', 'gists_url': 'https://api.github.com/users/ezyang/gists{/gist_id}', 'starred_url': 'https://api.github.com/users/ezyang/starred{/owner}{/repo}', 'subscriptions_url': 'https://api.github.com/users/ezyang/subscriptions', 'organizations_url': 'https://api.github.com/users/ezyang/orgs', 'repos_url': 'https://api.github.com/users/ezyang/repos', 'events_url': 'https://api.github.com/users/ezyang/events{/privacy}', 'received_events_url': 'https://api.github.com/users/ezyang/received_events', 'type': 'User', 'site_admin': False}",referenced,6f80023c29e0fb55f46a32c4931bc5d4ba749846,https://api.github.com/repos/pytorch/pytorch/commits/6f80023c29e0fb55f46a32c4931bc5d4ba749846,2018-03-19T20:10:00Z,1394,758,636
5611,1523463808,"{'login': 'ezyang', 'id': 13564, 'node_id': 'MDQ6VXNlcjEzNTY0', 'avatar_url': 'https://avatars0.githubusercontent.com/u/13564?v=4', 'gravatar_id': '', 'url': 'https://api.github.com/users/ezyang', 'html_url': 'https://github.com/ezyang', 'followers_url': 'https://api.github.com/users/ezyang/followers', 'following_url': 'https://api.github.com/users/ezyang/following{/other_user}', 'gists_url': 'https://api.github.com/users/ezyang/gists{/gist_id}', 'starred_url': 'https://api.github.com/users/ezyang/starred{/owner}{/repo}', 'subscriptions_url': 'https://api.github.com/users/ezyang/subscriptions', 'organizations_url': 'https://api.github.com/users/ezyang/orgs', 'repos_url': 'https://api.github.com/users/ezyang/repos', 'events_url': 'https://api.github.com/users/ezyang/events{/privacy}', 'received_events_url': 'https://api.github.com/users/ezyang/received_events', 'type': 'User', 'site_admin': False}",referenced,82777815f8013f881bd8f40171b29de92fa3c360,https://api.github.com/repos/pytorch/pytorch/commits/82777815f8013f881bd8f40171b29de92fa3c360,2018-03-15T14:44:55Z,14,12,2
5556,1516612447,"{'login': 'ezyang', 'id': 13564, 'node_id': 'MDQ6VXNlcjEzNTY0', 'avatar_url': 'https://avatars0.githubusercontent.com/u/13564?v=4', 'gravatar_id': '', 'url': 'https://api.github.com/users/ezyang', 'html_url': 'https://github.com/ezyang', 'followers_url': 'https://api.github.com/users/ezyang/followers', 'following_url': 'https://api.github.com/users/ezyang/following{/other_user}', 'gists_url': 'https://api.github.com/users/ezyang/gists{/gist_id}', 'starred_url': 'https://api.github.com/users/ezyang/starred{/owner}{/repo}', 'subscriptions_url': 'https://api.github.com/users/ezyang/subscriptions', 'organizations_url': 'https://api.github.com/users/ezyang/orgs', 'repos_url': 'https://api.github.com/users/ezyang/repos', 'events_url': 'https://api.github.com/users/ezyang/events{/privacy}', 'received_events_url': 'https://api.github.com/users/ezyang/received_events', 'type': 'User', 'site_admin': False}",referenced,42bf2f9289daf59072e5b83ed4e2dd9a03eb9739,https://api.github.com/repos/pytorch/pytorch/commits/42bf2f9289daf59072e5b83ed4e2dd9a03eb9739,2018-03-12T16:05:09Z,4,4,0
5554,1546619869,"{'login': 'soumith', 'id': 1310570, 'node_id': 'MDQ6VXNlcjEzMTA1NzA=', 'avatar_url': 'https://avatars0.githubusercontent.com/u/1310570?v=4', 'gravatar_id': '', 'url': 'https://api.github.com/users/soumith', 'html_url': 'https://github.com/soumith', 'followers_url': 'https://api.github.com/users/soumith/followers', 'following_url': 'https://api.github.com/users/soumith/following{/other_user}', 'gists_url': 'https://api.github.com/users/soumith/gists{/gist_id}', 'starred_url': 'https://api.github.com/users/soumith/starred{/owner}{/repo}', 'subscriptions_url': 'https://api.github.com/users/soumith/subscriptions', 'organizations_url': 'https://api.github.com/users/soumith/orgs', 'repos_url': 'https://api.github.com/users/soumith/repos', 'events_url': 'https://api.github.com/users/soumith/events{/privacy}', 'received_events_url': 'https://api.github.com/users/soumith/received_events', 'type': 'User', 'site_admin': False}",referenced,371e14b807cfa8fc4087ecf7676ba076d0817453,https://api.github.com/repos/pytorch/pytorch/commits/371e14b807cfa8fc4087ecf7676ba076d0817453,2018-03-28T21:21:55Z,15,13,2
5552,1529412429,"{'login': 'ezyang', 'id': 13564, 'node_id': 'MDQ6VXNlcjEzNTY0', 'avatar_url': 'https://avatars0.githubusercontent.com/u/13564?v=4', 'gravatar_id': '', 'url': 'https://api.github.com/users/ezyang', 'html_url': 'https://github.com/ezyang', 'followers_url': 'https://api.github.com/users/ezyang/followers', 'following_url': 'https://api.github.com/users/ezyang/following{/other_user}', 'gists_url': 'https://api.github.com/users/ezyang/gists{/gist_id}', 'starred_url': 'https://api.github.com/users/ezyang/starred{/owner}{/repo}', 'subscriptions_url': 'https://api.github.com/users/ezyang/subscriptions', 'organizations_url': 'https://api.github.com/users/ezyang/orgs', 'repos_url': 'https://api.github.com/users/ezyang/repos', 'events_url': 'https://api.github.com/users/ezyang/events{/privacy}', 'received_events_url': 'https://api.github.com/users/ezyang/received_events', 'type': 'User', 'site_admin': False}",referenced,cf2e1760490d369e93017b9425279b235c10772d,https://api.github.com/repos/pytorch/pytorch/commits/cf2e1760490d369e93017b9425279b235c10772d,2018-03-19T20:06:45Z,45,29,16
5542,1502812058,"{'login': 'ezyang', 'id': 13564, 'node_id': 'MDQ6VXNlcjEzNTY0', 'avatar_url': 'https://avatars0.githubusercontent.com/u/13564?v=4', 'gravatar_id': '', 'url': 'https://api.github.com/users/ezyang', 'html_url': 'https://github.com/ezyang', 'followers_url': 'https://api.github.com/users/ezyang/followers', 'following_url': 'https://api.github.com/users/ezyang/following{/other_user}', 'gists_url': 'https://api.github.com/users/ezyang/gists{/gist_id}', 'starred_url': 'https://api.github.com/users/ezyang/starred{/owner}{/repo}', 'subscriptions_url': 'https://api.github.com/users/ezyang/subscriptions', 'organizations_url': 'https://api.github.com/users/ezyang/orgs', 'repos_url': 'https://api.github.com/users/ezyang/repos', 'events_url': 'https://api.github.com/users/ezyang/events{/privacy}', 'received_events_url': 'https://api.github.com/users/ezyang/received_events', 'type': 'User', 'site_admin': False}",closed,6aeaa524761092b71928ab7ee82d4953b97bb241,https://api.github.com/repos/pytorch/pytorch/commits/6aeaa524761092b71928ab7ee82d4953b97bb241,2018-03-04T07:03:03Z,5,2,3
5534,1599520619,"{'login': 'ezyang', 'id': 13564, 'node_id': 'MDQ6VXNlcjEzNTY0', 'avatar_url': 'https://avatars0.githubusercontent.com/u/13564?v=4', 'gravatar_id': '', 'url': 'https://api.github.com/users/ezyang', 'html_url': 'https://github.com/ezyang', 'followers_url': 'https://api.github.com/users/ezyang/followers', 'following_url': 'https://api.github.com/users/ezyang/following{/other_user}', 'gists_url': 'https://api.github.com/users/ezyang/gists{/gist_id}', 'starred_url': 'https://api.github.com/users/ezyang/starred{/owner}{/repo}', 'subscriptions_url': 'https://api.github.com/users/ezyang/subscriptions', 'organizations_url': 'https://api.github.com/users/ezyang/orgs', 'repos_url': 'https://api.github.com/users/ezyang/repos', 'events_url': 'https://api.github.com/users/ezyang/events{/privacy}', 'received_events_url': 'https://api.github.com/users/ezyang/received_events', 'type': 'User', 'site_admin': False}",referenced,932c4c2364884af52609ea8a86c7232a926d958f,https://api.github.com/repos/pytorch/pytorch/commits/932c4c2364884af52609ea8a86c7232a926d958f,2018-04-27T19:50:24Z,170,169,1
5462,1500157262,"{'login': 'colesbury', 'id': 655866, 'node_id': 'MDQ6VXNlcjY1NTg2Ng==', 'avatar_url': 'https://avatars1.githubusercontent.com/u/655866?v=4', 'gravatar_id': '', 'url': 'https://api.github.com/users/colesbury', 'html_url': 'https://github.com/colesbury', 'followers_url': 'https://api.github.com/users/colesbury/followers', 'following_url': 'https://api.github.com/users/colesbury/following{/other_user}', 'gists_url': 'https://api.github.com/users/colesbury/gists{/gist_id}', 'starred_url': 'https://api.github.com/users/colesbury/starred{/owner}{/repo}', 'subscriptions_url': 'https://api.github.com/users/colesbury/subscriptions', 'organizations_url': 'https://api.github.com/users/colesbury/orgs', 'repos_url': 'https://api.github.com/users/colesbury/repos', 'events_url': 'https://api.github.com/users/colesbury/events{/privacy}', 'received_events_url': 'https://api.github.com/users/colesbury/received_events', 'type': 'User', 'site_admin': False}",referenced,27265503ad1b4c63e2caceb6b991a7abe998d7bd,https://api.github.com/repos/pytorch/pytorch/commits/27265503ad1b4c63e2caceb6b991a7abe998d7bd,2018-03-01T23:11:56Z,688,337,351
5431,1846528353,"{'login': 'facebook-github-bot', 'id': 6422482, 'node_id': 'MDQ6VXNlcjY0MjI0ODI=', 'avatar_url': 'https://avatars3.githubusercontent.com/u/6422482?v=4', 'gravatar_id': '', 'url': 'https://api.github.com/users/facebook-github-bot', 'html_url': 'https://github.com/facebook-github-bot', 'followers_url': 'https://api.github.com/users/facebook-github-bot/followers', 'following_url': 'https://api.github.com/users/facebook-github-bot/following{/other_user}', 'gists_url': 'https://api.github.com/users/facebook-github-bot/gists{/gist_id}', 'starred_url': 'https://api.github.com/users/facebook-github-bot/starred{/owner}{/repo}', 'subscriptions_url': 'https://api.github.com/users/facebook-github-bot/subscriptions', 'organizations_url': 'https://api.github.com/users/facebook-github-bot/orgs', 'repos_url': 'https://api.github.com/users/facebook-github-bot/repos', 'events_url': 'https://api.github.com/users/facebook-github-bot/events{/privacy}', 'received_events_url': 'https://api.github.com/users/facebook-github-bot/received_events', 'type': 'User', 'site_admin': False}",referenced,0d9b9100f977f677a0734af9096e9121ed85b337,https://api.github.com/repos/pytorch/pytorch/commits/0d9b9100f977f677a0734af9096e9121ed85b337,2018-09-14T16:26:06Z,8,4,4
5332,1538180566,"{'login': 'ezyang', 'id': 13564, 'node_id': 'MDQ6VXNlcjEzNTY0', 'avatar_url': 'https://avatars0.githubusercontent.com/u/13564?v=4', 'gravatar_id': '', 'url': 'https://api.github.com/users/ezyang', 'html_url': 'https://github.com/ezyang', 'followers_url': 'https://api.github.com/users/ezyang/followers', 'following_url': 'https://api.github.com/users/ezyang/following{/other_user}', 'gists_url': 'https://api.github.com/users/ezyang/gists{/gist_id}', 'starred_url': 'https://api.github.com/users/ezyang/starred{/owner}{/repo}', 'subscriptions_url': 'https://api.github.com/users/ezyang/subscriptions', 'organizations_url': 'https://api.github.com/users/ezyang/orgs', 'repos_url': 'https://api.github.com/users/ezyang/repos', 'events_url': 'https://api.github.com/users/ezyang/events{/privacy}', 'received_events_url': 'https://api.github.com/users/ezyang/received_events', 'type': 'User', 'site_admin': False}",referenced,8e22ef0cb257f52d069641bd281d28d12780d22a,https://api.github.com/repos/pytorch/pytorch/commits/8e22ef0cb257f52d069641bd281d28d12780d22a,2018-03-23T15:53:46Z,63,61,2
5331,1489981176,"{'login': 'soumith', 'id': 1310570, 'node_id': 'MDQ6VXNlcjEzMTA1NzA=', 'avatar_url': 'https://avatars0.githubusercontent.com/u/1310570?v=4', 'gravatar_id': '', 'url': 'https://api.github.com/users/soumith', 'html_url': 'https://github.com/soumith', 'followers_url': 'https://api.github.com/users/soumith/followers', 'following_url': 'https://api.github.com/users/soumith/following{/other_user}', 'gists_url': 'https://api.github.com/users/soumith/gists{/gist_id}', 'starred_url': 'https://api.github.com/users/soumith/starred{/owner}{/repo}', 'subscriptions_url': 'https://api.github.com/users/soumith/subscriptions', 'organizations_url': 'https://api.github.com/users/soumith/orgs', 'repos_url': 'https://api.github.com/users/soumith/repos', 'events_url': 'https://api.github.com/users/soumith/events{/privacy}', 'received_events_url': 'https://api.github.com/users/soumith/received_events', 'type': 'User', 'site_admin': False}",referenced,7a36c132cef1c3256a26048251ef022f60e22f3e,https://api.github.com/repos/pytorch/pytorch/commits/7a36c132cef1c3256a26048251ef022f60e22f3e,2018-02-23T21:36:07Z,4,2,2
5311,1738375948,"{'login': 'facebook-github-bot', 'id': 6422482, 'node_id': 'MDQ6VXNlcjY0MjI0ODI=', 'avatar_url': 'https://avatars3.githubusercontent.com/u/6422482?v=4', 'gravatar_id': '', 'url': 'https://api.github.com/users/facebook-github-bot', 'html_url': 'https://github.com/facebook-github-bot', 'followers_url': 'https://api.github.com/users/facebook-github-bot/followers', 'following_url': 'https://api.github.com/users/facebook-github-bot/following{/other_user}', 'gists_url': 'https://api.github.com/users/facebook-github-bot/gists{/gist_id}', 'starred_url': 'https://api.github.com/users/facebook-github-bot/starred{/owner}{/repo}', 'subscriptions_url': 'https://api.github.com/users/facebook-github-bot/subscriptions', 'organizations_url': 'https://api.github.com/users/facebook-github-bot/orgs', 'repos_url': 'https://api.github.com/users/facebook-github-bot/repos', 'events_url': 'https://api.github.com/users/facebook-github-bot/events{/privacy}', 'received_events_url': 'https://api.github.com/users/facebook-github-bot/received_events', 'type': 'User', 'site_admin': False}",closed,e5678794ed43feb756417a5c56a3b2d0f38f792c,https://api.github.com/repos/pytorch/pytorch/commits/e5678794ed43feb756417a5c56a3b2d0f38f792c,2018-07-17T18:11:19Z,4,0,4
5310,1905484236,"{'login': 'facebook-github-bot', 'id': 6422482, 'node_id': 'MDQ6VXNlcjY0MjI0ODI=', 'avatar_url': 'https://avatars3.githubusercontent.com/u/6422482?v=4', 'gravatar_id': '', 'url': 'https://api.github.com/users/facebook-github-bot', 'html_url': 'https://github.com/facebook-github-bot', 'followers_url': 'https://api.github.com/users/facebook-github-bot/followers', 'following_url': 'https://api.github.com/users/facebook-github-bot/following{/other_user}', 'gists_url': 'https://api.github.com/users/facebook-github-bot/gists{/gist_id}', 'starred_url': 'https://api.github.com/users/facebook-github-bot/starred{/owner}{/repo}', 'subscriptions_url': 'https://api.github.com/users/facebook-github-bot/subscriptions', 'organizations_url': 'https://api.github.com/users/facebook-github-bot/orgs', 'repos_url': 'https://api.github.com/users/facebook-github-bot/repos', 'events_url': 'https://api.github.com/users/facebook-github-bot/events{/privacy}', 'received_events_url': 'https://api.github.com/users/facebook-github-bot/received_events', 'type': 'User', 'site_admin': False}",closed,7a521177926ce0534673d13ea908709d902cb0d6,https://api.github.com/repos/pytorch/pytorch/commits/7a521177926ce0534673d13ea908709d902cb0d6,2018-10-16T00:03:34Z,12,12,0
5240,1476734217,"{'login': 'soumith', 'id': 1310570, 'node_id': 'MDQ6VXNlcjEzMTA1NzA=', 'avatar_url': 'https://avatars0.githubusercontent.com/u/1310570?v=4', 'gravatar_id': '', 'url': 'https://api.github.com/users/soumith', 'html_url': 'https://github.com/soumith', 'followers_url': 'https://api.github.com/users/soumith/followers', 'following_url': 'https://api.github.com/users/soumith/following{/other_user}', 'gists_url': 'https://api.github.com/users/soumith/gists{/gist_id}', 'starred_url': 'https://api.github.com/users/soumith/starred{/owner}{/repo}', 'subscriptions_url': 'https://api.github.com/users/soumith/subscriptions', 'organizations_url': 'https://api.github.com/users/soumith/orgs', 'repos_url': 'https://api.github.com/users/soumith/repos', 'events_url': 'https://api.github.com/users/soumith/events{/privacy}', 'received_events_url': 'https://api.github.com/users/soumith/received_events', 'type': 'User', 'site_admin': False}",closed,170b22a8f010bf064c6a83cba9c310933323df1a,https://api.github.com/repos/pytorch/pytorch/commits/170b22a8f010bf064c6a83cba9c310933323df1a,2018-02-15T20:44:38Z,6,3,3
5169,1481509132,"{'login': 'soumith', 'id': 1310570, 'node_id': 'MDQ6VXNlcjEzMTA1NzA=', 'avatar_url': 'https://avatars0.githubusercontent.com/u/1310570?v=4', 'gravatar_id': '', 'url': 'https://api.github.com/users/soumith', 'html_url': 'https://github.com/soumith', 'followers_url': 'https://api.github.com/users/soumith/followers', 'following_url': 'https://api.github.com/users/soumith/following{/other_user}', 'gists_url': 'https://api.github.com/users/soumith/gists{/gist_id}', 'starred_url': 'https://api.github.com/users/soumith/starred{/owner}{/repo}', 'subscriptions_url': 'https://api.github.com/users/soumith/subscriptions', 'organizations_url': 'https://api.github.com/users/soumith/orgs', 'repos_url': 'https://api.github.com/users/soumith/repos', 'events_url': 'https://api.github.com/users/soumith/events{/privacy}', 'received_events_url': 'https://api.github.com/users/soumith/received_events', 'type': 'User', 'site_admin': False}",referenced,0509f26d41428d91761ed3415cc2542608c61bf0,https://api.github.com/repos/pytorch/pytorch/commits/0509f26d41428d91761ed3415cc2542608c61bf0,2018-02-20T00:47:35Z,55,33,22
5156,1472191065,"{'login': 'ezyang', 'id': 13564, 'node_id': 'MDQ6VXNlcjEzNTY0', 'avatar_url': 'https://avatars0.githubusercontent.com/u/13564?v=4', 'gravatar_id': '', 'url': 'https://api.github.com/users/ezyang', 'html_url': 'https://github.com/ezyang', 'followers_url': 'https://api.github.com/users/ezyang/followers', 'following_url': 'https://api.github.com/users/ezyang/following{/other_user}', 'gists_url': 'https://api.github.com/users/ezyang/gists{/gist_id}', 'starred_url': 'https://api.github.com/users/ezyang/starred{/owner}{/repo}', 'subscriptions_url': 'https://api.github.com/users/ezyang/subscriptions', 'organizations_url': 'https://api.github.com/users/ezyang/orgs', 'repos_url': 'https://api.github.com/users/ezyang/repos', 'events_url': 'https://api.github.com/users/ezyang/events{/privacy}', 'received_events_url': 'https://api.github.com/users/ezyang/received_events', 'type': 'User', 'site_admin': False}",referenced,da79697d454aefe5d2b551edb6738a99f47ac1d4,https://api.github.com/repos/pytorch/pytorch/commits/da79697d454aefe5d2b551edb6738a99f47ac1d4,2018-02-13T17:55:52Z,4,4,0
5151,1483458871,"{'login': 'ezyang', 'id': 13564, 'node_id': 'MDQ6VXNlcjEzNTY0', 'avatar_url': 'https://avatars0.githubusercontent.com/u/13564?v=4', 'gravatar_id': '', 'url': 'https://api.github.com/users/ezyang', 'html_url': 'https://github.com/ezyang', 'followers_url': 'https://api.github.com/users/ezyang/followers', 'following_url': 'https://api.github.com/users/ezyang/following{/other_user}', 'gists_url': 'https://api.github.com/users/ezyang/gists{/gist_id}', 'starred_url': 'https://api.github.com/users/ezyang/starred{/owner}{/repo}', 'subscriptions_url': 'https://api.github.com/users/ezyang/subscriptions', 'organizations_url': 'https://api.github.com/users/ezyang/orgs', 'repos_url': 'https://api.github.com/users/ezyang/repos', 'events_url': 'https://api.github.com/users/ezyang/events{/privacy}', 'received_events_url': 'https://api.github.com/users/ezyang/received_events', 'type': 'User', 'site_admin': False}",closed,031412a14b7c20e9030b00c26f30c5524a0eb028,https://api.github.com/repos/pytorch/pytorch/commits/031412a14b7c20e9030b00c26f30c5524a0eb028,2018-02-20T21:56:11Z,179,155,24
5138,1501313451,"{'login': 'ezyang', 'id': 13564, 'node_id': 'MDQ6VXNlcjEzNTY0', 'avatar_url': 'https://avatars0.githubusercontent.com/u/13564?v=4', 'gravatar_id': '', 'url': 'https://api.github.com/users/ezyang', 'html_url': 'https://github.com/ezyang', 'followers_url': 'https://api.github.com/users/ezyang/followers', 'following_url': 'https://api.github.com/users/ezyang/following{/other_user}', 'gists_url': 'https://api.github.com/users/ezyang/gists{/gist_id}', 'starred_url': 'https://api.github.com/users/ezyang/starred{/owner}{/repo}', 'subscriptions_url': 'https://api.github.com/users/ezyang/subscriptions', 'organizations_url': 'https://api.github.com/users/ezyang/orgs', 'repos_url': 'https://api.github.com/users/ezyang/repos', 'events_url': 'https://api.github.com/users/ezyang/events{/privacy}', 'received_events_url': 'https://api.github.com/users/ezyang/received_events', 'type': 'User', 'site_admin': False}",referenced,0877558e607f14f63bc4761a31a1c9943da688b8,https://api.github.com/repos/pytorch/pytorch/commits/0877558e607f14f63bc4761a31a1c9943da688b8,2018-03-02T15:00:18Z,56,35,21
5101,1499491978,"{'login': 'ezyang', 'id': 13564, 'node_id': 'MDQ6VXNlcjEzNTY0', 'avatar_url': 'https://avatars0.githubusercontent.com/u/13564?v=4', 'gravatar_id': '', 'url': 'https://api.github.com/users/ezyang', 'html_url': 'https://github.com/ezyang', 'followers_url': 'https://api.github.com/users/ezyang/followers', 'following_url': 'https://api.github.com/users/ezyang/following{/other_user}', 'gists_url': 'https://api.github.com/users/ezyang/gists{/gist_id}', 'starred_url': 'https://api.github.com/users/ezyang/starred{/owner}{/repo}', 'subscriptions_url': 'https://api.github.com/users/ezyang/subscriptions', 'organizations_url': 'https://api.github.com/users/ezyang/orgs', 'repos_url': 'https://api.github.com/users/ezyang/repos', 'events_url': 'https://api.github.com/users/ezyang/events{/privacy}', 'received_events_url': 'https://api.github.com/users/ezyang/received_events', 'type': 'User', 'site_admin': False}",closed,ef0ef70cf51f056d9a38ce81abdf1f1b78ac7568,https://api.github.com/repos/pytorch/pytorch/commits/ef0ef70cf51f056d9a38ce81abdf1f1b78ac7568,2018-03-01T17:09:05Z,4,4,0
5055,1463874712,"{'login': 'ezyang', 'id': 13564, 'node_id': 'MDQ6VXNlcjEzNTY0', 'avatar_url': 'https://avatars0.githubusercontent.com/u/13564?v=4', 'gravatar_id': '', 'url': 'https://api.github.com/users/ezyang', 'html_url': 'https://github.com/ezyang', 'followers_url': 'https://api.github.com/users/ezyang/followers', 'following_url': 'https://api.github.com/users/ezyang/following{/other_user}', 'gists_url': 'https://api.github.com/users/ezyang/gists{/gist_id}', 'starred_url': 'https://api.github.com/users/ezyang/starred{/owner}{/repo}', 'subscriptions_url': 'https://api.github.com/users/ezyang/subscriptions', 'organizations_url': 'https://api.github.com/users/ezyang/orgs', 'repos_url': 'https://api.github.com/users/ezyang/repos', 'events_url': 'https://api.github.com/users/ezyang/events{/privacy}', 'received_events_url': 'https://api.github.com/users/ezyang/received_events', 'type': 'User', 'site_admin': False}",referenced,5816721e3514789a6bd549b91fbfbd333779b229,https://api.github.com/repos/pytorch/pytorch/commits/5816721e3514789a6bd549b91fbfbd333779b229,2018-02-08T05:49:29Z,18,10,8
5047,1458604030,"{'login': 'soumith', 'id': 1310570, 'node_id': 'MDQ6VXNlcjEzMTA1NzA=', 'avatar_url': 'https://avatars0.githubusercontent.com/u/1310570?v=4', 'gravatar_id': '', 'url': 'https://api.github.com/users/soumith', 'html_url': 'https://github.com/soumith', 'followers_url': 'https://api.github.com/users/soumith/followers', 'following_url': 'https://api.github.com/users/soumith/following{/other_user}', 'gists_url': 'https://api.github.com/users/soumith/gists{/gist_id}', 'starred_url': 'https://api.github.com/users/soumith/starred{/owner}{/repo}', 'subscriptions_url': 'https://api.github.com/users/soumith/subscriptions', 'organizations_url': 'https://api.github.com/users/soumith/orgs', 'repos_url': 'https://api.github.com/users/soumith/repos', 'events_url': 'https://api.github.com/users/soumith/events{/privacy}', 'received_events_url': 'https://api.github.com/users/soumith/received_events', 'type': 'User', 'site_admin': False}",referenced,91efc30bfab50bf2a1bba7ddc09b3d57f67dc644,https://api.github.com/repos/pytorch/pytorch/commits/91efc30bfab50bf2a1bba7ddc09b3d57f67dc644,2018-02-05T18:58:43Z,8,4,4
5047,1463382726,"{'login': 'soumith', 'id': 1310570, 'node_id': 'MDQ6VXNlcjEzMTA1NzA=', 'avatar_url': 'https://avatars0.githubusercontent.com/u/1310570?v=4', 'gravatar_id': '', 'url': 'https://api.github.com/users/soumith', 'html_url': 'https://github.com/soumith', 'followers_url': 'https://api.github.com/users/soumith/followers', 'following_url': 'https://api.github.com/users/soumith/following{/other_user}', 'gists_url': 'https://api.github.com/users/soumith/gists{/gist_id}', 'starred_url': 'https://api.github.com/users/soumith/starred{/owner}{/repo}', 'subscriptions_url': 'https://api.github.com/users/soumith/subscriptions', 'organizations_url': 'https://api.github.com/users/soumith/orgs', 'repos_url': 'https://api.github.com/users/soumith/repos', 'events_url': 'https://api.github.com/users/soumith/events{/privacy}', 'received_events_url': 'https://api.github.com/users/soumith/received_events', 'type': 'User', 'site_admin': False}",referenced,29f897ea2f463eb1e8aa2d6f5ce27104949630b6,https://api.github.com/repos/pytorch/pytorch/commits/29f897ea2f463eb1e8aa2d6f5ce27104949630b6,2018-02-07T21:58:23Z,8,4,4
5039,1491294109,"{'login': 'soumith', 'id': 1310570, 'node_id': 'MDQ6VXNlcjEzMTA1NzA=', 'avatar_url': 'https://avatars0.githubusercontent.com/u/1310570?v=4', 'gravatar_id': '', 'url': 'https://api.github.com/users/soumith', 'html_url': 'https://github.com/soumith', 'followers_url': 'https://api.github.com/users/soumith/followers', 'following_url': 'https://api.github.com/users/soumith/following{/other_user}', 'gists_url': 'https://api.github.com/users/soumith/gists{/gist_id}', 'starred_url': 'https://api.github.com/users/soumith/starred{/owner}{/repo}', 'subscriptions_url': 'https://api.github.com/users/soumith/subscriptions', 'organizations_url': 'https://api.github.com/users/soumith/orgs', 'repos_url': 'https://api.github.com/users/soumith/repos', 'events_url': 'https://api.github.com/users/soumith/events{/privacy}', 'received_events_url': 'https://api.github.com/users/soumith/received_events', 'type': 'User', 'site_admin': False}",referenced,10fd272b7ab4b9e5ebd63120ca17cc16086e1152,https://api.github.com/repos/pytorch/pytorch/commits/10fd272b7ab4b9e5ebd63120ca17cc16086e1152,2018-02-26T05:55:27Z,4,1,3
5011,1730626015,"{'login': 'facebook-github-bot', 'id': 6422482, 'node_id': 'MDQ6VXNlcjY0MjI0ODI=', 'avatar_url': 'https://avatars3.githubusercontent.com/u/6422482?v=4', 'gravatar_id': '', 'url': 'https://api.github.com/users/facebook-github-bot', 'html_url': 'https://github.com/facebook-github-bot', 'followers_url': 'https://api.github.com/users/facebook-github-bot/followers', 'following_url': 'https://api.github.com/users/facebook-github-bot/following{/other_user}', 'gists_url': 'https://api.github.com/users/facebook-github-bot/gists{/gist_id}', 'starred_url': 'https://api.github.com/users/facebook-github-bot/starred{/owner}{/repo}', 'subscriptions_url': 'https://api.github.com/users/facebook-github-bot/subscriptions', 'organizations_url': 'https://api.github.com/users/facebook-github-bot/orgs', 'repos_url': 'https://api.github.com/users/facebook-github-bot/repos', 'events_url': 'https://api.github.com/users/facebook-github-bot/events{/privacy}', 'received_events_url': 'https://api.github.com/users/facebook-github-bot/received_events', 'type': 'User', 'site_admin': False}",referenced,483ae8cb5d28791ed668240965c01ca015a46733,https://api.github.com/repos/pytorch/pytorch/commits/483ae8cb5d28791ed668240965c01ca015a46733,2018-07-12T15:33:13Z,58,36,22
4990,1470048530,"{'login': 'ezyang', 'id': 13564, 'node_id': 'MDQ6VXNlcjEzNTY0', 'avatar_url': 'https://avatars0.githubusercontent.com/u/13564?v=4', 'gravatar_id': '', 'url': 'https://api.github.com/users/ezyang', 'html_url': 'https://github.com/ezyang', 'followers_url': 'https://api.github.com/users/ezyang/followers', 'following_url': 'https://api.github.com/users/ezyang/following{/other_user}', 'gists_url': 'https://api.github.com/users/ezyang/gists{/gist_id}', 'starred_url': 'https://api.github.com/users/ezyang/starred{/owner}{/repo}', 'subscriptions_url': 'https://api.github.com/users/ezyang/subscriptions', 'organizations_url': 'https://api.github.com/users/ezyang/orgs', 'repos_url': 'https://api.github.com/users/ezyang/repos', 'events_url': 'https://api.github.com/users/ezyang/events{/privacy}', 'received_events_url': 'https://api.github.com/users/ezyang/received_events', 'type': 'User', 'site_admin': False}",referenced,2f1493f1fb44d0a0610585dbb8295c950399d8ec,https://api.github.com/repos/pytorch/pytorch/commits/2f1493f1fb44d0a0610585dbb8295c950399d8ec,2018-02-12T18:11:31Z,4,3,1
4985,1761305416,"{'login': 'facebook-github-bot', 'id': 6422482, 'node_id': 'MDQ6VXNlcjY0MjI0ODI=', 'avatar_url': 'https://avatars3.githubusercontent.com/u/6422482?v=4', 'gravatar_id': '', 'url': 'https://api.github.com/users/facebook-github-bot', 'html_url': 'https://github.com/facebook-github-bot', 'followers_url': 'https://api.github.com/users/facebook-github-bot/followers', 'following_url': 'https://api.github.com/users/facebook-github-bot/following{/other_user}', 'gists_url': 'https://api.github.com/users/facebook-github-bot/gists{/gist_id}', 'starred_url': 'https://api.github.com/users/facebook-github-bot/starred{/owner}{/repo}', 'subscriptions_url': 'https://api.github.com/users/facebook-github-bot/subscriptions', 'organizations_url': 'https://api.github.com/users/facebook-github-bot/orgs', 'repos_url': 'https://api.github.com/users/facebook-github-bot/repos', 'events_url': 'https://api.github.com/users/facebook-github-bot/events{/privacy}', 'received_events_url': 'https://api.github.com/users/facebook-github-bot/received_events', 'type': 'User', 'site_admin': False}",closed,ea3c36b822a7940bad6f0f7bad67f04afa8f5aa2,https://api.github.com/repos/pytorch/pytorch/commits/ea3c36b822a7940bad6f0f7bad67f04afa8f5aa2,2018-07-30T21:40:55Z,20,18,2
4965,1580493346,"{'login': 'soumith', 'id': 1310570, 'node_id': 'MDQ6VXNlcjEzMTA1NzA=', 'avatar_url': 'https://avatars0.githubusercontent.com/u/1310570?v=4', 'gravatar_id': '', 'url': 'https://api.github.com/users/soumith', 'html_url': 'https://github.com/soumith', 'followers_url': 'https://api.github.com/users/soumith/followers', 'following_url': 'https://api.github.com/users/soumith/following{/other_user}', 'gists_url': 'https://api.github.com/users/soumith/gists{/gist_id}', 'starred_url': 'https://api.github.com/users/soumith/starred{/owner}{/repo}', 'subscriptions_url': 'https://api.github.com/users/soumith/subscriptions', 'organizations_url': 'https://api.github.com/users/soumith/orgs', 'repos_url': 'https://api.github.com/users/soumith/repos', 'events_url': 'https://api.github.com/users/soumith/events{/privacy}', 'received_events_url': 'https://api.github.com/users/soumith/received_events', 'type': 'User', 'site_admin': False}",referenced,dc94182db0f320f09894a99eb169fe83631e8440,https://api.github.com/repos/pytorch/pytorch/commits/dc94182db0f320f09894a99eb169fe83631e8440,2018-04-18T03:34:57Z,9,8,1
4929,1538802369,"{'login': 'ezyang', 'id': 13564, 'node_id': 'MDQ6VXNlcjEzNTY0', 'avatar_url': 'https://avatars0.githubusercontent.com/u/13564?v=4', 'gravatar_id': '', 'url': 'https://api.github.com/users/ezyang', 'html_url': 'https://github.com/ezyang', 'followers_url': 'https://api.github.com/users/ezyang/followers', 'following_url': 'https://api.github.com/users/ezyang/following{/other_user}', 'gists_url': 'https://api.github.com/users/ezyang/gists{/gist_id}', 'starred_url': 'https://api.github.com/users/ezyang/starred{/owner}{/repo}', 'subscriptions_url': 'https://api.github.com/users/ezyang/subscriptions', 'organizations_url': 'https://api.github.com/users/ezyang/orgs', 'repos_url': 'https://api.github.com/users/ezyang/repos', 'events_url': 'https://api.github.com/users/ezyang/events{/privacy}', 'received_events_url': 'https://api.github.com/users/ezyang/received_events', 'type': 'User', 'site_admin': False}",referenced,83de3a0b0e9aa0d6c054dbb3b73729d2755fa281,https://api.github.com/repos/pytorch/pytorch/commits/83de3a0b0e9aa0d6c054dbb3b73729d2755fa281,2018-03-23T21:34:49Z,80,78,2
4908,1550333171,"{'login': 'ezyang', 'id': 13564, 'node_id': 'MDQ6VXNlcjEzNTY0', 'avatar_url': 'https://avatars0.githubusercontent.com/u/13564?v=4', 'gravatar_id': '', 'url': 'https://api.github.com/users/ezyang', 'html_url': 'https://github.com/ezyang', 'followers_url': 'https://api.github.com/users/ezyang/followers', 'following_url': 'https://api.github.com/users/ezyang/following{/other_user}', 'gists_url': 'https://api.github.com/users/ezyang/gists{/gist_id}', 'starred_url': 'https://api.github.com/users/ezyang/starred{/owner}{/repo}', 'subscriptions_url': 'https://api.github.com/users/ezyang/subscriptions', 'organizations_url': 'https://api.github.com/users/ezyang/orgs', 'repos_url': 'https://api.github.com/users/ezyang/repos', 'events_url': 'https://api.github.com/users/ezyang/events{/privacy}', 'received_events_url': 'https://api.github.com/users/ezyang/received_events', 'type': 'User', 'site_admin': False}",referenced,4563e190c4e5b18322a36064854409c0fb51f32e,https://api.github.com/repos/pytorch/pytorch/commits/4563e190c4e5b18322a36064854409c0fb51f32e,2018-03-30T20:39:39Z,43,13,30
4869,1456869560,"{'login': 'soumith', 'id': 1310570, 'node_id': 'MDQ6VXNlcjEzMTA1NzA=', 'avatar_url': 'https://avatars0.githubusercontent.com/u/1310570?v=4', 'gravatar_id': '', 'url': 'https://api.github.com/users/soumith', 'html_url': 'https://github.com/soumith', 'followers_url': 'https://api.github.com/users/soumith/followers', 'following_url': 'https://api.github.com/users/soumith/following{/other_user}', 'gists_url': 'https://api.github.com/users/soumith/gists{/gist_id}', 'starred_url': 'https://api.github.com/users/soumith/starred{/owner}{/repo}', 'subscriptions_url': 'https://api.github.com/users/soumith/subscriptions', 'organizations_url': 'https://api.github.com/users/soumith/orgs', 'repos_url': 'https://api.github.com/users/soumith/repos', 'events_url': 'https://api.github.com/users/soumith/events{/privacy}', 'received_events_url': 'https://api.github.com/users/soumith/received_events', 'type': 'User', 'site_admin': False}",referenced,c65bd6660e1f9da92c331382ab73c1ca87820f3e,https://api.github.com/repos/pytorch/pytorch/commits/c65bd6660e1f9da92c331382ab73c1ca87820f3e,2018-02-04T15:36:39Z,2,1,1
4858,1526855889,"{'login': 'soumith', 'id': 1310570, 'node_id': 'MDQ6VXNlcjEzMTA1NzA=', 'avatar_url': 'https://avatars0.githubusercontent.com/u/1310570?v=4', 'gravatar_id': '', 'url': 'https://api.github.com/users/soumith', 'html_url': 'https://github.com/soumith', 'followers_url': 'https://api.github.com/users/soumith/followers', 'following_url': 'https://api.github.com/users/soumith/following{/other_user}', 'gists_url': 'https://api.github.com/users/soumith/gists{/gist_id}', 'starred_url': 'https://api.github.com/users/soumith/starred{/owner}{/repo}', 'subscriptions_url': 'https://api.github.com/users/soumith/subscriptions', 'organizations_url': 'https://api.github.com/users/soumith/orgs', 'repos_url': 'https://api.github.com/users/soumith/repos', 'events_url': 'https://api.github.com/users/soumith/events{/privacy}', 'received_events_url': 'https://api.github.com/users/soumith/received_events', 'type': 'User', 'site_admin': False}",referenced,7cbe63da8621b6063c864527592db6b1c894804f,https://api.github.com/repos/pytorch/pytorch/commits/7cbe63da8621b6063c864527592db6b1c894804f,2018-03-17T14:26:39Z,28,26,2
4858,1790902683,"{'login': 'facebook-github-bot', 'id': 6422482, 'node_id': 'MDQ6VXNlcjY0MjI0ODI=', 'avatar_url': 'https://avatars3.githubusercontent.com/u/6422482?v=4', 'gravatar_id': '', 'url': 'https://api.github.com/users/facebook-github-bot', 'html_url': 'https://github.com/facebook-github-bot', 'followers_url': 'https://api.github.com/users/facebook-github-bot/followers', 'following_url': 'https://api.github.com/users/facebook-github-bot/following{/other_user}', 'gists_url': 'https://api.github.com/users/facebook-github-bot/gists{/gist_id}', 'starred_url': 'https://api.github.com/users/facebook-github-bot/starred{/owner}{/repo}', 'subscriptions_url': 'https://api.github.com/users/facebook-github-bot/subscriptions', 'organizations_url': 'https://api.github.com/users/facebook-github-bot/orgs', 'repos_url': 'https://api.github.com/users/facebook-github-bot/repos', 'events_url': 'https://api.github.com/users/facebook-github-bot/events{/privacy}', 'received_events_url': 'https://api.github.com/users/facebook-github-bot/received_events', 'type': 'User', 'site_admin': False}",closed,484395edfbb65a3e62a7ee90bf9c95a74f508b64,https://api.github.com/repos/pytorch/pytorch/commits/484395edfbb65a3e62a7ee90bf9c95a74f508b64,2018-08-15T20:26:50Z,23,15,8
4814,1514491387,"{'login': 'soumith', 'id': 1310570, 'node_id': 'MDQ6VXNlcjEzMTA1NzA=', 'avatar_url': 'https://avatars0.githubusercontent.com/u/1310570?v=4', 'gravatar_id': '', 'url': 'https://api.github.com/users/soumith', 'html_url': 'https://github.com/soumith', 'followers_url': 'https://api.github.com/users/soumith/followers', 'following_url': 'https://api.github.com/users/soumith/following{/other_user}', 'gists_url': 'https://api.github.com/users/soumith/gists{/gist_id}', 'starred_url': 'https://api.github.com/users/soumith/starred{/owner}{/repo}', 'subscriptions_url': 'https://api.github.com/users/soumith/subscriptions', 'organizations_url': 'https://api.github.com/users/soumith/orgs', 'repos_url': 'https://api.github.com/users/soumith/repos', 'events_url': 'https://api.github.com/users/soumith/events{/privacy}', 'received_events_url': 'https://api.github.com/users/soumith/received_events', 'type': 'User', 'site_admin': False}",referenced,7368c09280b08a00f3c640dbbc2a48b913c55647,https://api.github.com/repos/pytorch/pytorch/commits/7368c09280b08a00f3c640dbbc2a48b913c55647,2018-03-10T04:53:09Z,67,44,23
4809,1441899113,"{'login': 'soumith', 'id': 1310570, 'node_id': 'MDQ6VXNlcjEzMTA1NzA=', 'avatar_url': 'https://avatars0.githubusercontent.com/u/1310570?v=4', 'gravatar_id': '', 'url': 'https://api.github.com/users/soumith', 'html_url': 'https://github.com/soumith', 'followers_url': 'https://api.github.com/users/soumith/followers', 'following_url': 'https://api.github.com/users/soumith/following{/other_user}', 'gists_url': 'https://api.github.com/users/soumith/gists{/gist_id}', 'starred_url': 'https://api.github.com/users/soumith/starred{/owner}{/repo}', 'subscriptions_url': 'https://api.github.com/users/soumith/subscriptions', 'organizations_url': 'https://api.github.com/users/soumith/orgs', 'repos_url': 'https://api.github.com/users/soumith/repos', 'events_url': 'https://api.github.com/users/soumith/events{/privacy}', 'received_events_url': 'https://api.github.com/users/soumith/received_events', 'type': 'User', 'site_admin': False}",referenced,4c29d19f531691a8f8b709c9ad071ebbc540c1bc,https://api.github.com/repos/pytorch/pytorch/commits/4c29d19f531691a8f8b709c9ad071ebbc540c1bc,2018-01-25T15:44:27Z,2,1,1
4764,2149394576,"{'login': 'facebook-github-bot', 'id': 6422482, 'node_id': 'MDQ6VXNlcjY0MjI0ODI=', 'avatar_url': 'https://avatars3.githubusercontent.com/u/6422482?v=4', 'gravatar_id': '', 'url': 'https://api.github.com/users/facebook-github-bot', 'html_url': 'https://github.com/facebook-github-bot', 'followers_url': 'https://api.github.com/users/facebook-github-bot/followers', 'following_url': 'https://api.github.com/users/facebook-github-bot/following{/other_user}', 'gists_url': 'https://api.github.com/users/facebook-github-bot/gists{/gist_id}', 'starred_url': 'https://api.github.com/users/facebook-github-bot/starred{/owner}{/repo}', 'subscriptions_url': 'https://api.github.com/users/facebook-github-bot/subscriptions', 'organizations_url': 'https://api.github.com/users/facebook-github-bot/orgs', 'repos_url': 'https://api.github.com/users/facebook-github-bot/repos', 'events_url': 'https://api.github.com/users/facebook-github-bot/events{/privacy}', 'received_events_url': 'https://api.github.com/users/facebook-github-bot/received_events', 'type': 'User', 'site_admin': False}",referenced,444039c47bb997f698c2bd9481c8649188038c51,https://api.github.com/repos/pytorch/pytorch/commits/444039c47bb997f698c2bd9481c8649188038c51,2019-02-19T16:23:58Z,343,323,20
4764,2221305944,"{'login': 'vadimkantorov', 'id': 1041752, 'node_id': 'MDQ6VXNlcjEwNDE3NTI=', 'avatar_url': 'https://avatars0.githubusercontent.com/u/1041752?v=4', 'gravatar_id': '', 'url': 'https://api.github.com/users/vadimkantorov', 'html_url': 'https://github.com/vadimkantorov', 'followers_url': 'https://api.github.com/users/vadimkantorov/followers', 'following_url': 'https://api.github.com/users/vadimkantorov/following{/other_user}', 'gists_url': 'https://api.github.com/users/vadimkantorov/gists{/gist_id}', 'starred_url': 'https://api.github.com/users/vadimkantorov/starred{/owner}{/repo}', 'subscriptions_url': 'https://api.github.com/users/vadimkantorov/subscriptions', 'organizations_url': 'https://api.github.com/users/vadimkantorov/orgs', 'repos_url': 'https://api.github.com/users/vadimkantorov/repos', 'events_url': 'https://api.github.com/users/vadimkantorov/events{/privacy}', 'received_events_url': 'https://api.github.com/users/vadimkantorov/received_events', 'type': 'User', 'site_admin': False}",referenced,3f09e084b0a06a446726e6198a91b4a4eec4d6ab,https://api.github.com/repos/pytorch/pytorch/commits/3f09e084b0a06a446726e6198a91b4a4eec4d6ab,2019-03-21T23:29:32Z,33,27,6
4682,1426741695,"{'login': 'soumith', 'id': 1310570, 'node_id': 'MDQ6VXNlcjEzMTA1NzA=', 'avatar_url': 'https://avatars0.githubusercontent.com/u/1310570?v=4', 'gravatar_id': '', 'url': 'https://api.github.com/users/soumith', 'html_url': 'https://github.com/soumith', 'followers_url': 'https://api.github.com/users/soumith/followers', 'following_url': 'https://api.github.com/users/soumith/following{/other_user}', 'gists_url': 'https://api.github.com/users/soumith/gists{/gist_id}', 'starred_url': 'https://api.github.com/users/soumith/starred{/owner}{/repo}', 'subscriptions_url': 'https://api.github.com/users/soumith/subscriptions', 'organizations_url': 'https://api.github.com/users/soumith/orgs', 'repos_url': 'https://api.github.com/users/soumith/repos', 'events_url': 'https://api.github.com/users/soumith/events{/privacy}', 'received_events_url': 'https://api.github.com/users/soumith/received_events', 'type': 'User', 'site_admin': False}",referenced,d452291a72751e94c0871c5c741316bad50b98a5,https://api.github.com/repos/pytorch/pytorch/commits/d452291a72751e94c0871c5c741316bad50b98a5,2018-01-16T18:18:39Z,2,1,1
4682,1463382705,"{'login': 'soumith', 'id': 1310570, 'node_id': 'MDQ6VXNlcjEzMTA1NzA=', 'avatar_url': 'https://avatars0.githubusercontent.com/u/1310570?v=4', 'gravatar_id': '', 'url': 'https://api.github.com/users/soumith', 'html_url': 'https://github.com/soumith', 'followers_url': 'https://api.github.com/users/soumith/followers', 'following_url': 'https://api.github.com/users/soumith/following{/other_user}', 'gists_url': 'https://api.github.com/users/soumith/gists{/gist_id}', 'starred_url': 'https://api.github.com/users/soumith/starred{/owner}{/repo}', 'subscriptions_url': 'https://api.github.com/users/soumith/subscriptions', 'organizations_url': 'https://api.github.com/users/soumith/orgs', 'repos_url': 'https://api.github.com/users/soumith/repos', 'events_url': 'https://api.github.com/users/soumith/events{/privacy}', 'received_events_url': 'https://api.github.com/users/soumith/received_events', 'type': 'User', 'site_admin': False}",referenced,281b6ce41d384124c453c722a5e84a737cf43344,https://api.github.com/repos/pytorch/pytorch/commits/281b6ce41d384124c453c722a5e84a737cf43344,2018-02-07T21:58:22Z,2,1,1
4669,2638082121,"{'login': 'facebook-github-bot', 'id': 6422482, 'node_id': 'MDQ6VXNlcjY0MjI0ODI=', 'avatar_url': 'https://avatars3.githubusercontent.com/u/6422482?v=4', 'gravatar_id': '', 'url': 'https://api.github.com/users/facebook-github-bot', 'html_url': 'https://github.com/facebook-github-bot', 'followers_url': 'https://api.github.com/users/facebook-github-bot/followers', 'following_url': 'https://api.github.com/users/facebook-github-bot/following{/other_user}', 'gists_url': 'https://api.github.com/users/facebook-github-bot/gists{/gist_id}', 'starred_url': 'https://api.github.com/users/facebook-github-bot/starred{/owner}{/repo}', 'subscriptions_url': 'https://api.github.com/users/facebook-github-bot/subscriptions', 'organizations_url': 'https://api.github.com/users/facebook-github-bot/orgs', 'repos_url': 'https://api.github.com/users/facebook-github-bot/repos', 'events_url': 'https://api.github.com/users/facebook-github-bot/events{/privacy}', 'received_events_url': 'https://api.github.com/users/facebook-github-bot/received_events', 'type': 'User', 'site_admin': False}",referenced,03e3f130c671f58b4a14e9353010be0e543b0299,https://api.github.com/repos/pytorch/pytorch/commits/03e3f130c671f58b4a14e9353010be0e543b0299,2019-09-16T23:18:37Z,45,43,2
4669,2658226856,"{'login': 'facebook-github-bot', 'id': 6422482, 'node_id': 'MDQ6VXNlcjY0MjI0ODI=', 'avatar_url': 'https://avatars3.githubusercontent.com/u/6422482?v=4', 'gravatar_id': '', 'url': 'https://api.github.com/users/facebook-github-bot', 'html_url': 'https://github.com/facebook-github-bot', 'followers_url': 'https://api.github.com/users/facebook-github-bot/followers', 'following_url': 'https://api.github.com/users/facebook-github-bot/following{/other_user}', 'gists_url': 'https://api.github.com/users/facebook-github-bot/gists{/gist_id}', 'starred_url': 'https://api.github.com/users/facebook-github-bot/starred{/owner}{/repo}', 'subscriptions_url': 'https://api.github.com/users/facebook-github-bot/subscriptions', 'organizations_url': 'https://api.github.com/users/facebook-github-bot/orgs', 'repos_url': 'https://api.github.com/users/facebook-github-bot/repos', 'events_url': 'https://api.github.com/users/facebook-github-bot/events{/privacy}', 'received_events_url': 'https://api.github.com/users/facebook-github-bot/received_events', 'type': 'User', 'site_admin': False}",closed,c643290982bbdc23bec2d340132bf21871a80156,https://api.github.com/repos/pytorch/pytorch/commits/c643290982bbdc23bec2d340132bf21871a80156,2019-09-24T14:12:55Z,41,40,1
4666,1427061232,"{'login': 'colesbury', 'id': 655866, 'node_id': 'MDQ6VXNlcjY1NTg2Ng==', 'avatar_url': 'https://avatars1.githubusercontent.com/u/655866?v=4', 'gravatar_id': '', 'url': 'https://api.github.com/users/colesbury', 'html_url': 'https://github.com/colesbury', 'followers_url': 'https://api.github.com/users/colesbury/followers', 'following_url': 'https://api.github.com/users/colesbury/following{/other_user}', 'gists_url': 'https://api.github.com/users/colesbury/gists{/gist_id}', 'starred_url': 'https://api.github.com/users/colesbury/starred{/owner}{/repo}', 'subscriptions_url': 'https://api.github.com/users/colesbury/subscriptions', 'organizations_url': 'https://api.github.com/users/colesbury/orgs', 'repos_url': 'https://api.github.com/users/colesbury/repos', 'events_url': 'https://api.github.com/users/colesbury/events{/privacy}', 'received_events_url': 'https://api.github.com/users/colesbury/received_events', 'type': 'User', 'site_admin': False}",referenced,cb83474a57d3a42dfea27d654596cd6bd351d049,https://api.github.com/repos/pytorch/pytorch/commits/cb83474a57d3a42dfea27d654596cd6bd351d049,2018-01-16T21:19:30Z,36,30,6
4526,1414577048,"{'login': 'soumith', 'id': 1310570, 'node_id': 'MDQ6VXNlcjEzMTA1NzA=', 'avatar_url': 'https://avatars0.githubusercontent.com/u/1310570?v=4', 'gravatar_id': '', 'url': 'https://api.github.com/users/soumith', 'html_url': 'https://github.com/soumith', 'followers_url': 'https://api.github.com/users/soumith/followers', 'following_url': 'https://api.github.com/users/soumith/following{/other_user}', 'gists_url': 'https://api.github.com/users/soumith/gists{/gist_id}', 'starred_url': 'https://api.github.com/users/soumith/starred{/owner}{/repo}', 'subscriptions_url': 'https://api.github.com/users/soumith/subscriptions', 'organizations_url': 'https://api.github.com/users/soumith/orgs', 'repos_url': 'https://api.github.com/users/soumith/repos', 'events_url': 'https://api.github.com/users/soumith/events{/privacy}', 'received_events_url': 'https://api.github.com/users/soumith/received_events', 'type': 'User', 'site_admin': False}",referenced,e3bafb884ad7333a489960d0ddec2f1f676cbc40,https://api.github.com/repos/pytorch/pytorch/commits/e3bafb884ad7333a489960d0ddec2f1f676cbc40,2018-01-08T22:25:42Z,8,4,4
4500,1412440678,"{'login': 'ezyang', 'id': 13564, 'node_id': 'MDQ6VXNlcjEzNTY0', 'avatar_url': 'https://avatars0.githubusercontent.com/u/13564?v=4', 'gravatar_id': '', 'url': 'https://api.github.com/users/ezyang', 'html_url': 'https://github.com/ezyang', 'followers_url': 'https://api.github.com/users/ezyang/followers', 'following_url': 'https://api.github.com/users/ezyang/following{/other_user}', 'gists_url': 'https://api.github.com/users/ezyang/gists{/gist_id}', 'starred_url': 'https://api.github.com/users/ezyang/starred{/owner}{/repo}', 'subscriptions_url': 'https://api.github.com/users/ezyang/subscriptions', 'organizations_url': 'https://api.github.com/users/ezyang/orgs', 'repos_url': 'https://api.github.com/users/ezyang/repos', 'events_url': 'https://api.github.com/users/ezyang/events{/privacy}', 'received_events_url': 'https://api.github.com/users/ezyang/received_events', 'type': 'User', 'site_admin': False}",referenced,0f8ece56576ab0820e951e783c8e422cc6365817,https://api.github.com/repos/pytorch/pytorch/commits/0f8ece56576ab0820e951e783c8e422cc6365817,2018-01-06T15:58:15Z,76,72,4
4500,1418685525,"{'login': 'ezyang', 'id': 13564, 'node_id': 'MDQ6VXNlcjEzNTY0', 'avatar_url': 'https://avatars0.githubusercontent.com/u/13564?v=4', 'gravatar_id': '', 'url': 'https://api.github.com/users/ezyang', 'html_url': 'https://github.com/ezyang', 'followers_url': 'https://api.github.com/users/ezyang/followers', 'following_url': 'https://api.github.com/users/ezyang/following{/other_user}', 'gists_url': 'https://api.github.com/users/ezyang/gists{/gist_id}', 'starred_url': 'https://api.github.com/users/ezyang/starred{/owner}{/repo}', 'subscriptions_url': 'https://api.github.com/users/ezyang/subscriptions', 'organizations_url': 'https://api.github.com/users/ezyang/orgs', 'repos_url': 'https://api.github.com/users/ezyang/repos', 'events_url': 'https://api.github.com/users/ezyang/events{/privacy}', 'received_events_url': 'https://api.github.com/users/ezyang/received_events', 'type': 'User', 'site_admin': False}",closed,bc7a41af7d541e64f8b8f7318a7a2248c0119632,https://api.github.com/repos/pytorch/pytorch/commits/bc7a41af7d541e64f8b8f7318a7a2248c0119632,2018-01-10T22:33:40Z,54,45,9
4492,1414060840,"{'login': 'ezyang', 'id': 13564, 'node_id': 'MDQ6VXNlcjEzNTY0', 'avatar_url': 'https://avatars0.githubusercontent.com/u/13564?v=4', 'gravatar_id': '', 'url': 'https://api.github.com/users/ezyang', 'html_url': 'https://github.com/ezyang', 'followers_url': 'https://api.github.com/users/ezyang/followers', 'following_url': 'https://api.github.com/users/ezyang/following{/other_user}', 'gists_url': 'https://api.github.com/users/ezyang/gists{/gist_id}', 'starred_url': 'https://api.github.com/users/ezyang/starred{/owner}{/repo}', 'subscriptions_url': 'https://api.github.com/users/ezyang/subscriptions', 'organizations_url': 'https://api.github.com/users/ezyang/orgs', 'repos_url': 'https://api.github.com/users/ezyang/repos', 'events_url': 'https://api.github.com/users/ezyang/events{/privacy}', 'received_events_url': 'https://api.github.com/users/ezyang/received_events', 'type': 'User', 'site_admin': False}",closed,7d25a4125180732e8e6882c898bcadd9c9c637a3,https://api.github.com/repos/pytorch/pytorch/commits/7d25a4125180732e8e6882c898bcadd9c9c637a3,2018-01-08T17:21:20Z,103,62,41
4480,1438439561,"{'login': 'soumith', 'id': 1310570, 'node_id': 'MDQ6VXNlcjEzMTA1NzA=', 'avatar_url': 'https://avatars0.githubusercontent.com/u/1310570?v=4', 'gravatar_id': '', 'url': 'https://api.github.com/users/soumith', 'html_url': 'https://github.com/soumith', 'followers_url': 'https://api.github.com/users/soumith/followers', 'following_url': 'https://api.github.com/users/soumith/following{/other_user}', 'gists_url': 'https://api.github.com/users/soumith/gists{/gist_id}', 'starred_url': 'https://api.github.com/users/soumith/starred{/owner}{/repo}', 'subscriptions_url': 'https://api.github.com/users/soumith/subscriptions', 'organizations_url': 'https://api.github.com/users/soumith/orgs', 'repos_url': 'https://api.github.com/users/soumith/repos', 'events_url': 'https://api.github.com/users/soumith/events{/privacy}', 'received_events_url': 'https://api.github.com/users/soumith/received_events', 'type': 'User', 'site_admin': False}",closed,27505e642963bb8b8c18abdcc6dbed4d41ffa0db,https://api.github.com/repos/pytorch/pytorch/commits/27505e642963bb8b8c18abdcc6dbed4d41ffa0db,2018-01-23T23:07:08Z,97,63,34
4475,1412378681,"{'login': 'apaszke', 'id': 4583066, 'node_id': 'MDQ6VXNlcjQ1ODMwNjY=', 'avatar_url': 'https://avatars3.githubusercontent.com/u/4583066?v=4', 'gravatar_id': '', 'url': 'https://api.github.com/users/apaszke', 'html_url': 'https://github.com/apaszke', 'followers_url': 'https://api.github.com/users/apaszke/followers', 'following_url': 'https://api.github.com/users/apaszke/following{/other_user}', 'gists_url': 'https://api.github.com/users/apaszke/gists{/gist_id}', 'starred_url': 'https://api.github.com/users/apaszke/starred{/owner}{/repo}', 'subscriptions_url': 'https://api.github.com/users/apaszke/subscriptions', 'organizations_url': 'https://api.github.com/users/apaszke/orgs', 'repos_url': 'https://api.github.com/users/apaszke/repos', 'events_url': 'https://api.github.com/users/apaszke/events{/privacy}', 'received_events_url': 'https://api.github.com/users/apaszke/received_events', 'type': 'User', 'site_admin': False}",closed,9c2561e60c6ac9003c669c4d95fdbe3e1adbb9ce,https://api.github.com/repos/pytorch/pytorch/commits/9c2561e60c6ac9003c669c4d95fdbe3e1adbb9ce,2018-01-06T11:49:45Z,27,19,8
4466,1415895394,"{'login': 'soumith', 'id': 1310570, 'node_id': 'MDQ6VXNlcjEzMTA1NzA=', 'avatar_url': 'https://avatars0.githubusercontent.com/u/1310570?v=4', 'gravatar_id': '', 'url': 'https://api.github.com/users/soumith', 'html_url': 'https://github.com/soumith', 'followers_url': 'https://api.github.com/users/soumith/followers', 'following_url': 'https://api.github.com/users/soumith/following{/other_user}', 'gists_url': 'https://api.github.com/users/soumith/gists{/gist_id}', 'starred_url': 'https://api.github.com/users/soumith/starred{/owner}{/repo}', 'subscriptions_url': 'https://api.github.com/users/soumith/subscriptions', 'organizations_url': 'https://api.github.com/users/soumith/orgs', 'repos_url': 'https://api.github.com/users/soumith/repos', 'events_url': 'https://api.github.com/users/soumith/events{/privacy}', 'received_events_url': 'https://api.github.com/users/soumith/received_events', 'type': 'User', 'site_admin': False}",referenced,f4a75deccf2b722f4f4d1d1fd08f0002a8a56565,https://api.github.com/repos/pytorch/pytorch/commits/f4a75deccf2b722f4f4d1d1fd08f0002a8a56565,2018-01-09T15:39:20Z,26,19,7
4457,1412440676,"{'login': 'ezyang', 'id': 13564, 'node_id': 'MDQ6VXNlcjEzNTY0', 'avatar_url': 'https://avatars0.githubusercontent.com/u/13564?v=4', 'gravatar_id': '', 'url': 'https://api.github.com/users/ezyang', 'html_url': 'https://github.com/ezyang', 'followers_url': 'https://api.github.com/users/ezyang/followers', 'following_url': 'https://api.github.com/users/ezyang/following{/other_user}', 'gists_url': 'https://api.github.com/users/ezyang/gists{/gist_id}', 'starred_url': 'https://api.github.com/users/ezyang/starred{/owner}{/repo}', 'subscriptions_url': 'https://api.github.com/users/ezyang/subscriptions', 'organizations_url': 'https://api.github.com/users/ezyang/orgs', 'repos_url': 'https://api.github.com/users/ezyang/repos', 'events_url': 'https://api.github.com/users/ezyang/events{/privacy}', 'received_events_url': 'https://api.github.com/users/ezyang/received_events', 'type': 'User', 'site_admin': False}",closed,4e3a4bd6887b65df680fd6c2f739255db3a35a98,https://api.github.com/repos/pytorch/pytorch/commits/4e3a4bd6887b65df680fd6c2f739255db3a35a98,2018-01-06T15:58:14Z,25,25,0
4422,1412440677,"{'login': 'ezyang', 'id': 13564, 'node_id': 'MDQ6VXNlcjEzNTY0', 'avatar_url': 'https://avatars0.githubusercontent.com/u/13564?v=4', 'gravatar_id': '', 'url': 'https://api.github.com/users/ezyang', 'html_url': 'https://github.com/ezyang', 'followers_url': 'https://api.github.com/users/ezyang/followers', 'following_url': 'https://api.github.com/users/ezyang/following{/other_user}', 'gists_url': 'https://api.github.com/users/ezyang/gists{/gist_id}', 'starred_url': 'https://api.github.com/users/ezyang/starred{/owner}{/repo}', 'subscriptions_url': 'https://api.github.com/users/ezyang/subscriptions', 'organizations_url': 'https://api.github.com/users/ezyang/orgs', 'repos_url': 'https://api.github.com/users/ezyang/repos', 'events_url': 'https://api.github.com/users/ezyang/events{/privacy}', 'received_events_url': 'https://api.github.com/users/ezyang/received_events', 'type': 'User', 'site_admin': False}",referenced,0f8ece56576ab0820e951e783c8e422cc6365817,https://api.github.com/repos/pytorch/pytorch/commits/0f8ece56576ab0820e951e783c8e422cc6365817,2018-01-06T15:58:15Z,76,72,4
4422,1426638905,"{'login': 'ezyang', 'id': 13564, 'node_id': 'MDQ6VXNlcjEzNTY0', 'avatar_url': 'https://avatars0.githubusercontent.com/u/13564?v=4', 'gravatar_id': '', 'url': 'https://api.github.com/users/ezyang', 'html_url': 'https://github.com/ezyang', 'followers_url': 'https://api.github.com/users/ezyang/followers', 'following_url': 'https://api.github.com/users/ezyang/following{/other_user}', 'gists_url': 'https://api.github.com/users/ezyang/gists{/gist_id}', 'starred_url': 'https://api.github.com/users/ezyang/starred{/owner}{/repo}', 'subscriptions_url': 'https://api.github.com/users/ezyang/subscriptions', 'organizations_url': 'https://api.github.com/users/ezyang/orgs', 'repos_url': 'https://api.github.com/users/ezyang/repos', 'events_url': 'https://api.github.com/users/ezyang/events{/privacy}', 'received_events_url': 'https://api.github.com/users/ezyang/received_events', 'type': 'User', 'site_admin': False}",closed,c3b7baecea07314d28259d410aad970f41680c0b,https://api.github.com/repos/pytorch/pytorch/commits/c3b7baecea07314d28259d410aad970f41680c0b,2018-01-16T17:25:05Z,110,83,27
4408,1407966162,"{'login': 'soumith', 'id': 1310570, 'node_id': 'MDQ6VXNlcjEzMTA1NzA=', 'avatar_url': 'https://avatars0.githubusercontent.com/u/1310570?v=4', 'gravatar_id': '', 'url': 'https://api.github.com/users/soumith', 'html_url': 'https://github.com/soumith', 'followers_url': 'https://api.github.com/users/soumith/followers', 'following_url': 'https://api.github.com/users/soumith/following{/other_user}', 'gists_url': 'https://api.github.com/users/soumith/gists{/gist_id}', 'starred_url': 'https://api.github.com/users/soumith/starred{/owner}{/repo}', 'subscriptions_url': 'https://api.github.com/users/soumith/subscriptions', 'organizations_url': 'https://api.github.com/users/soumith/orgs', 'repos_url': 'https://api.github.com/users/soumith/repos', 'events_url': 'https://api.github.com/users/soumith/events{/privacy}', 'received_events_url': 'https://api.github.com/users/soumith/received_events', 'type': 'User', 'site_admin': False}",referenced,f05ca657dd25fe064da5f771f4592da092604ce2,https://api.github.com/repos/pytorch/pytorch/commits/f05ca657dd25fe064da5f771f4592da092604ce2,2018-01-03T15:24:00Z,4,4,0
4403,1405668015,"{'login': 'apaszke', 'id': 4583066, 'node_id': 'MDQ6VXNlcjQ1ODMwNjY=', 'avatar_url': 'https://avatars3.githubusercontent.com/u/4583066?v=4', 'gravatar_id': '', 'url': 'https://api.github.com/users/apaszke', 'html_url': 'https://github.com/apaszke', 'followers_url': 'https://api.github.com/users/apaszke/followers', 'following_url': 'https://api.github.com/users/apaszke/following{/other_user}', 'gists_url': 'https://api.github.com/users/apaszke/gists{/gist_id}', 'starred_url': 'https://api.github.com/users/apaszke/starred{/owner}{/repo}', 'subscriptions_url': 'https://api.github.com/users/apaszke/subscriptions', 'organizations_url': 'https://api.github.com/users/apaszke/orgs', 'repos_url': 'https://api.github.com/users/apaszke/repos', 'events_url': 'https://api.github.com/users/apaszke/events{/privacy}', 'received_events_url': 'https://api.github.com/users/apaszke/received_events', 'type': 'User', 'site_admin': False}",closed,98c02c20b161ff8e4181e24336de4936039e9f5f,https://api.github.com/repos/pytorch/pytorch/commits/98c02c20b161ff8e4181e24336de4936039e9f5f,2018-01-01T22:44:13Z,3,2,1
4403,1463382680,"{'login': 'soumith', 'id': 1310570, 'node_id': 'MDQ6VXNlcjEzMTA1NzA=', 'avatar_url': 'https://avatars0.githubusercontent.com/u/1310570?v=4', 'gravatar_id': '', 'url': 'https://api.github.com/users/soumith', 'html_url': 'https://github.com/soumith', 'followers_url': 'https://api.github.com/users/soumith/followers', 'following_url': 'https://api.github.com/users/soumith/following{/other_user}', 'gists_url': 'https://api.github.com/users/soumith/gists{/gist_id}', 'starred_url': 'https://api.github.com/users/soumith/starred{/owner}{/repo}', 'subscriptions_url': 'https://api.github.com/users/soumith/subscriptions', 'organizations_url': 'https://api.github.com/users/soumith/orgs', 'repos_url': 'https://api.github.com/users/soumith/repos', 'events_url': 'https://api.github.com/users/soumith/events{/privacy}', 'received_events_url': 'https://api.github.com/users/soumith/received_events', 'type': 'User', 'site_admin': False}",referenced,26751c56755eb76a623cc42b467c7706997092af,https://api.github.com/repos/pytorch/pytorch/commits/26751c56755eb76a623cc42b467c7706997092af,2018-02-07T21:58:22Z,3,2,1
4386,1411710371,"{'login': 'colesbury', 'id': 655866, 'node_id': 'MDQ6VXNlcjY1NTg2Ng==', 'avatar_url': 'https://avatars1.githubusercontent.com/u/655866?v=4', 'gravatar_id': '', 'url': 'https://api.github.com/users/colesbury', 'html_url': 'https://github.com/colesbury', 'followers_url': 'https://api.github.com/users/colesbury/followers', 'following_url': 'https://api.github.com/users/colesbury/following{/other_user}', 'gists_url': 'https://api.github.com/users/colesbury/gists{/gist_id}', 'starred_url': 'https://api.github.com/users/colesbury/starred{/owner}{/repo}', 'subscriptions_url': 'https://api.github.com/users/colesbury/subscriptions', 'organizations_url': 'https://api.github.com/users/colesbury/orgs', 'repos_url': 'https://api.github.com/users/colesbury/repos', 'events_url': 'https://api.github.com/users/colesbury/events{/privacy}', 'received_events_url': 'https://api.github.com/users/colesbury/received_events', 'type': 'User', 'site_admin': False}",referenced,b8fd57a0cc271a46c0dfa9b117573d41251868af,https://api.github.com/repos/pytorch/pytorch/commits/b8fd57a0cc271a46c0dfa9b117573d41251868af,2018-01-05T17:58:37Z,15,13,2
4336,1406626386,"{'login': 'soumith', 'id': 1310570, 'node_id': 'MDQ6VXNlcjEzMTA1NzA=', 'avatar_url': 'https://avatars0.githubusercontent.com/u/1310570?v=4', 'gravatar_id': '', 'url': 'https://api.github.com/users/soumith', 'html_url': 'https://github.com/soumith', 'followers_url': 'https://api.github.com/users/soumith/followers', 'following_url': 'https://api.github.com/users/soumith/following{/other_user}', 'gists_url': 'https://api.github.com/users/soumith/gists{/gist_id}', 'starred_url': 'https://api.github.com/users/soumith/starred{/owner}{/repo}', 'subscriptions_url': 'https://api.github.com/users/soumith/subscriptions', 'organizations_url': 'https://api.github.com/users/soumith/orgs', 'repos_url': 'https://api.github.com/users/soumith/repos', 'events_url': 'https://api.github.com/users/soumith/events{/privacy}', 'received_events_url': 'https://api.github.com/users/soumith/received_events', 'type': 'User', 'site_admin': False}",referenced,57f9db9c3c89dcb98e3f65bdc2ac99117e4b932e,https://api.github.com/repos/pytorch/pytorch/commits/57f9db9c3c89dcb98e3f65bdc2ac99117e4b932e,2018-01-02T17:42:51Z,27,21,6
4288,2149394587,"{'login': 'facebook-github-bot', 'id': 6422482, 'node_id': 'MDQ6VXNlcjY0MjI0ODI=', 'avatar_url': 'https://avatars3.githubusercontent.com/u/6422482?v=4', 'gravatar_id': '', 'url': 'https://api.github.com/users/facebook-github-bot', 'html_url': 'https://github.com/facebook-github-bot', 'followers_url': 'https://api.github.com/users/facebook-github-bot/followers', 'following_url': 'https://api.github.com/users/facebook-github-bot/following{/other_user}', 'gists_url': 'https://api.github.com/users/facebook-github-bot/gists{/gist_id}', 'starred_url': 'https://api.github.com/users/facebook-github-bot/starred{/owner}{/repo}', 'subscriptions_url': 'https://api.github.com/users/facebook-github-bot/subscriptions', 'organizations_url': 'https://api.github.com/users/facebook-github-bot/orgs', 'repos_url': 'https://api.github.com/users/facebook-github-bot/repos', 'events_url': 'https://api.github.com/users/facebook-github-bot/events{/privacy}', 'received_events_url': 'https://api.github.com/users/facebook-github-bot/received_events', 'type': 'User', 'site_admin': False}",referenced,444039c47bb997f698c2bd9481c8649188038c51,https://api.github.com/repos/pytorch/pytorch/commits/444039c47bb997f698c2bd9481c8649188038c51,2019-02-19T16:23:58Z,343,323,20
4284,1398304127,"{'login': 'ezyang', 'id': 13564, 'node_id': 'MDQ6VXNlcjEzNTY0', 'avatar_url': 'https://avatars0.githubusercontent.com/u/13564?v=4', 'gravatar_id': '', 'url': 'https://api.github.com/users/ezyang', 'html_url': 'https://github.com/ezyang', 'followers_url': 'https://api.github.com/users/ezyang/followers', 'following_url': 'https://api.github.com/users/ezyang/following{/other_user}', 'gists_url': 'https://api.github.com/users/ezyang/gists{/gist_id}', 'starred_url': 'https://api.github.com/users/ezyang/starred{/owner}{/repo}', 'subscriptions_url': 'https://api.github.com/users/ezyang/subscriptions', 'organizations_url': 'https://api.github.com/users/ezyang/orgs', 'repos_url': 'https://api.github.com/users/ezyang/repos', 'events_url': 'https://api.github.com/users/ezyang/events{/privacy}', 'received_events_url': 'https://api.github.com/users/ezyang/received_events', 'type': 'User', 'site_admin': False}",referenced,5b8fe5cbb5b696d49d1480942f1904f92444857b,https://api.github.com/repos/pytorch/pytorch/commits/5b8fe5cbb5b696d49d1480942f1904f92444857b,2017-12-21T16:38:41Z,684,203,481
4219,2149394583,"{'login': 'facebook-github-bot', 'id': 6422482, 'node_id': 'MDQ6VXNlcjY0MjI0ODI=', 'avatar_url': 'https://avatars3.githubusercontent.com/u/6422482?v=4', 'gravatar_id': '', 'url': 'https://api.github.com/users/facebook-github-bot', 'html_url': 'https://github.com/facebook-github-bot', 'followers_url': 'https://api.github.com/users/facebook-github-bot/followers', 'following_url': 'https://api.github.com/users/facebook-github-bot/following{/other_user}', 'gists_url': 'https://api.github.com/users/facebook-github-bot/gists{/gist_id}', 'starred_url': 'https://api.github.com/users/facebook-github-bot/starred{/owner}{/repo}', 'subscriptions_url': 'https://api.github.com/users/facebook-github-bot/subscriptions', 'organizations_url': 'https://api.github.com/users/facebook-github-bot/orgs', 'repos_url': 'https://api.github.com/users/facebook-github-bot/repos', 'events_url': 'https://api.github.com/users/facebook-github-bot/events{/privacy}', 'received_events_url': 'https://api.github.com/users/facebook-github-bot/received_events', 'type': 'User', 'site_admin': False}",referenced,444039c47bb997f698c2bd9481c8649188038c51,https://api.github.com/repos/pytorch/pytorch/commits/444039c47bb997f698c2bd9481c8649188038c51,2019-02-19T16:23:58Z,343,323,20
4177,1829201172,"{'login': 'facebook-github-bot', 'id': 6422482, 'node_id': 'MDQ6VXNlcjY0MjI0ODI=', 'avatar_url': 'https://avatars3.githubusercontent.com/u/6422482?v=4', 'gravatar_id': '', 'url': 'https://api.github.com/users/facebook-github-bot', 'html_url': 'https://github.com/facebook-github-bot', 'followers_url': 'https://api.github.com/users/facebook-github-bot/followers', 'following_url': 'https://api.github.com/users/facebook-github-bot/following{/other_user}', 'gists_url': 'https://api.github.com/users/facebook-github-bot/gists{/gist_id}', 'starred_url': 'https://api.github.com/users/facebook-github-bot/starred{/owner}{/repo}', 'subscriptions_url': 'https://api.github.com/users/facebook-github-bot/subscriptions', 'organizations_url': 'https://api.github.com/users/facebook-github-bot/orgs', 'repos_url': 'https://api.github.com/users/facebook-github-bot/repos', 'events_url': 'https://api.github.com/users/facebook-github-bot/events{/privacy}', 'received_events_url': 'https://api.github.com/users/facebook-github-bot/received_events', 'type': 'User', 'site_admin': False}",closed,425ea6b31e433eaf1e4aa874332c1d6176cc6a8a,https://api.github.com/repos/pytorch/pytorch/commits/425ea6b31e433eaf1e4aa874332c1d6176cc6a8a,2018-09-06T00:27:00Z,66,56,10
4176,1745105322,"{'login': 'facebook-github-bot', 'id': 6422482, 'node_id': 'MDQ6VXNlcjY0MjI0ODI=', 'avatar_url': 'https://avatars3.githubusercontent.com/u/6422482?v=4', 'gravatar_id': '', 'url': 'https://api.github.com/users/facebook-github-bot', 'html_url': 'https://github.com/facebook-github-bot', 'followers_url': 'https://api.github.com/users/facebook-github-bot/followers', 'following_url': 'https://api.github.com/users/facebook-github-bot/following{/other_user}', 'gists_url': 'https://api.github.com/users/facebook-github-bot/gists{/gist_id}', 'starred_url': 'https://api.github.com/users/facebook-github-bot/starred{/owner}{/repo}', 'subscriptions_url': 'https://api.github.com/users/facebook-github-bot/subscriptions', 'organizations_url': 'https://api.github.com/users/facebook-github-bot/orgs', 'repos_url': 'https://api.github.com/users/facebook-github-bot/repos', 'events_url': 'https://api.github.com/users/facebook-github-bot/events{/privacy}', 'received_events_url': 'https://api.github.com/users/facebook-github-bot/received_events', 'type': 'User', 'site_admin': False}",closed,2a0018f2a80d98853c0733107650255929eb9d40,https://api.github.com/repos/pytorch/pytorch/commits/2a0018f2a80d98853c0733107650255929eb9d40,2018-07-20T15:42:08Z,61,53,8
4157,1388040563,"{'login': 'ezyang', 'id': 13564, 'node_id': 'MDQ6VXNlcjEzNTY0', 'avatar_url': 'https://avatars0.githubusercontent.com/u/13564?v=4', 'gravatar_id': '', 'url': 'https://api.github.com/users/ezyang', 'html_url': 'https://github.com/ezyang', 'followers_url': 'https://api.github.com/users/ezyang/followers', 'following_url': 'https://api.github.com/users/ezyang/following{/other_user}', 'gists_url': 'https://api.github.com/users/ezyang/gists{/gist_id}', 'starred_url': 'https://api.github.com/users/ezyang/starred{/owner}{/repo}', 'subscriptions_url': 'https://api.github.com/users/ezyang/subscriptions', 'organizations_url': 'https://api.github.com/users/ezyang/orgs', 'repos_url': 'https://api.github.com/users/ezyang/repos', 'events_url': 'https://api.github.com/users/ezyang/events{/privacy}', 'received_events_url': 'https://api.github.com/users/ezyang/received_events', 'type': 'User', 'site_admin': False}",referenced,dac5e6568d7cc8b62be37d94fd9556c04b61c75e,https://api.github.com/repos/pytorch/pytorch/commits/dac5e6568d7cc8b62be37d94fd9556c04b61c75e,2017-12-14T16:29:11Z,21,12,9
4157,1463382659,"{'login': 'soumith', 'id': 1310570, 'node_id': 'MDQ6VXNlcjEzMTA1NzA=', 'avatar_url': 'https://avatars0.githubusercontent.com/u/1310570?v=4', 'gravatar_id': '', 'url': 'https://api.github.com/users/soumith', 'html_url': 'https://github.com/soumith', 'followers_url': 'https://api.github.com/users/soumith/followers', 'following_url': 'https://api.github.com/users/soumith/following{/other_user}', 'gists_url': 'https://api.github.com/users/soumith/gists{/gist_id}', 'starred_url': 'https://api.github.com/users/soumith/starred{/owner}{/repo}', 'subscriptions_url': 'https://api.github.com/users/soumith/subscriptions', 'organizations_url': 'https://api.github.com/users/soumith/orgs', 'repos_url': 'https://api.github.com/users/soumith/repos', 'events_url': 'https://api.github.com/users/soumith/events{/privacy}', 'received_events_url': 'https://api.github.com/users/soumith/received_events', 'type': 'User', 'site_admin': False}",referenced,8a9f570eb182d1cb946dcc13898b8ec782407f21,https://api.github.com/repos/pytorch/pytorch/commits/8a9f570eb182d1cb946dcc13898b8ec782407f21,2018-02-07T21:58:21Z,21,12,9
4126,1537906918,"{'login': 'soumith', 'id': 1310570, 'node_id': 'MDQ6VXNlcjEzMTA1NzA=', 'avatar_url': 'https://avatars0.githubusercontent.com/u/1310570?v=4', 'gravatar_id': '', 'url': 'https://api.github.com/users/soumith', 'html_url': 'https://github.com/soumith', 'followers_url': 'https://api.github.com/users/soumith/followers', 'following_url': 'https://api.github.com/users/soumith/following{/other_user}', 'gists_url': 'https://api.github.com/users/soumith/gists{/gist_id}', 'starred_url': 'https://api.github.com/users/soumith/starred{/owner}{/repo}', 'subscriptions_url': 'https://api.github.com/users/soumith/subscriptions', 'organizations_url': 'https://api.github.com/users/soumith/orgs', 'repos_url': 'https://api.github.com/users/soumith/repos', 'events_url': 'https://api.github.com/users/soumith/events{/privacy}', 'received_events_url': 'https://api.github.com/users/soumith/received_events', 'type': 'User', 'site_admin': False}",referenced,2030ac7545b29a684a88b6f1b5fc70c2eb3bb036,https://api.github.com/repos/pytorch/pytorch/commits/2030ac7545b29a684a88b6f1b5fc70c2eb3bb036,2018-03-23T13:57:49Z,6,6,0
4119,2784860521,"{'login': 'suo', 'id': 1617424, 'node_id': 'MDQ6VXNlcjE2MTc0MjQ=', 'avatar_url': 'https://avatars2.githubusercontent.com/u/1617424?v=4', 'gravatar_id': '', 'url': 'https://api.github.com/users/suo', 'html_url': 'https://github.com/suo', 'followers_url': 'https://api.github.com/users/suo/followers', 'following_url': 'https://api.github.com/users/suo/following{/other_user}', 'gists_url': 'https://api.github.com/users/suo/gists{/gist_id}', 'starred_url': 'https://api.github.com/users/suo/starred{/owner}{/repo}', 'subscriptions_url': 'https://api.github.com/users/suo/subscriptions', 'organizations_url': 'https://api.github.com/users/suo/orgs', 'repos_url': 'https://api.github.com/users/suo/repos', 'events_url': 'https://api.github.com/users/suo/events{/privacy}', 'received_events_url': 'https://api.github.com/users/suo/received_events', 'type': 'User', 'site_admin': False}",referenced,79ad7b6236626175f06a1f02602e70906346688a,https://api.github.com/repos/pytorch/pytorch/commits/79ad7b6236626175f06a1f02602e70906346688a,2019-11-08T23:49:37Z,4,0,4
4119,2784860665,"{'login': 'suo', 'id': 1617424, 'node_id': 'MDQ6VXNlcjE2MTc0MjQ=', 'avatar_url': 'https://avatars2.githubusercontent.com/u/1617424?v=4', 'gravatar_id': '', 'url': 'https://api.github.com/users/suo', 'html_url': 'https://github.com/suo', 'followers_url': 'https://api.github.com/users/suo/followers', 'following_url': 'https://api.github.com/users/suo/following{/other_user}', 'gists_url': 'https://api.github.com/users/suo/gists{/gist_id}', 'starred_url': 'https://api.github.com/users/suo/starred{/owner}{/repo}', 'subscriptions_url': 'https://api.github.com/users/suo/subscriptions', 'organizations_url': 'https://api.github.com/users/suo/orgs', 'repos_url': 'https://api.github.com/users/suo/repos', 'events_url': 'https://api.github.com/users/suo/events{/privacy}', 'received_events_url': 'https://api.github.com/users/suo/received_events', 'type': 'User', 'site_admin': False}",referenced,e5146c83eea36250bfa19cda8934a2e63d476db0,https://api.github.com/repos/pytorch/pytorch/commits/e5146c83eea36250bfa19cda8934a2e63d476db0,2019-11-08T23:49:43Z,4,0,4
4119,2784939222,"{'login': 'facebook-github-bot', 'id': 6422482, 'node_id': 'MDQ6VXNlcjY0MjI0ODI=', 'avatar_url': 'https://avatars3.githubusercontent.com/u/6422482?v=4', 'gravatar_id': '', 'url': 'https://api.github.com/users/facebook-github-bot', 'html_url': 'https://github.com/facebook-github-bot', 'followers_url': 'https://api.github.com/users/facebook-github-bot/followers', 'following_url': 'https://api.github.com/users/facebook-github-bot/following{/other_user}', 'gists_url': 'https://api.github.com/users/facebook-github-bot/gists{/gist_id}', 'starred_url': 'https://api.github.com/users/facebook-github-bot/starred{/owner}{/repo}', 'subscriptions_url': 'https://api.github.com/users/facebook-github-bot/subscriptions', 'organizations_url': 'https://api.github.com/users/facebook-github-bot/orgs', 'repos_url': 'https://api.github.com/users/facebook-github-bot/repos', 'events_url': 'https://api.github.com/users/facebook-github-bot/events{/privacy}', 'received_events_url': 'https://api.github.com/users/facebook-github-bot/received_events', 'type': 'User', 'site_admin': False}",referenced,3657df383669a651a2d7717f93e59fbd9a8458c4,https://api.github.com/repos/pytorch/pytorch/commits/3657df383669a651a2d7717f93e59fbd9a8458c4,2019-11-09T00:53:25Z,4,0,4
4103,1390754409,"{'login': 'apaszke', 'id': 4583066, 'node_id': 'MDQ6VXNlcjQ1ODMwNjY=', 'avatar_url': 'https://avatars3.githubusercontent.com/u/4583066?v=4', 'gravatar_id': '', 'url': 'https://api.github.com/users/apaszke', 'html_url': 'https://github.com/apaszke', 'followers_url': 'https://api.github.com/users/apaszke/followers', 'following_url': 'https://api.github.com/users/apaszke/following{/other_user}', 'gists_url': 'https://api.github.com/users/apaszke/gists{/gist_id}', 'starred_url': 'https://api.github.com/users/apaszke/starred{/owner}{/repo}', 'subscriptions_url': 'https://api.github.com/users/apaszke/subscriptions', 'organizations_url': 'https://api.github.com/users/apaszke/orgs', 'repos_url': 'https://api.github.com/users/apaszke/repos', 'events_url': 'https://api.github.com/users/apaszke/events{/privacy}', 'received_events_url': 'https://api.github.com/users/apaszke/received_events', 'type': 'User', 'site_admin': False}",referenced,2e08885df8b1a2c958f4c742867541bd138e0455,https://api.github.com/repos/pytorch/pytorch/commits/2e08885df8b1a2c958f4c742867541bd138e0455,2017-12-16T14:09:19Z,11,10,1
4068,2246998930,"{'login': 'zou3519', 'id': 5652049, 'node_id': 'MDQ6VXNlcjU2NTIwNDk=', 'avatar_url': 'https://avatars3.githubusercontent.com/u/5652049?v=4', 'gravatar_id': '', 'url': 'https://api.github.com/users/zou3519', 'html_url': 'https://github.com/zou3519', 'followers_url': 'https://api.github.com/users/zou3519/followers', 'following_url': 'https://api.github.com/users/zou3519/following{/other_user}', 'gists_url': 'https://api.github.com/users/zou3519/gists{/gist_id}', 'starred_url': 'https://api.github.com/users/zou3519/starred{/owner}{/repo}', 'subscriptions_url': 'https://api.github.com/users/zou3519/subscriptions', 'organizations_url': 'https://api.github.com/users/zou3519/orgs', 'repos_url': 'https://api.github.com/users/zou3519/repos', 'events_url': 'https://api.github.com/users/zou3519/events{/privacy}', 'received_events_url': 'https://api.github.com/users/zou3519/received_events', 'type': 'User', 'site_admin': False}",referenced,4eedebf36a474a96b6ebdaea11ccf16bc565bcfa,https://api.github.com/repos/pytorch/pytorch/commits/4eedebf36a474a96b6ebdaea11ccf16bc565bcfa,2019-04-02T15:46:51Z,342,285,57
4068,2246999307,"{'login': 'zou3519', 'id': 5652049, 'node_id': 'MDQ6VXNlcjU2NTIwNDk=', 'avatar_url': 'https://avatars3.githubusercontent.com/u/5652049?v=4', 'gravatar_id': '', 'url': 'https://api.github.com/users/zou3519', 'html_url': 'https://github.com/zou3519', 'followers_url': 'https://api.github.com/users/zou3519/followers', 'following_url': 'https://api.github.com/users/zou3519/following{/other_user}', 'gists_url': 'https://api.github.com/users/zou3519/gists{/gist_id}', 'starred_url': 'https://api.github.com/users/zou3519/starred{/owner}{/repo}', 'subscriptions_url': 'https://api.github.com/users/zou3519/subscriptions', 'organizations_url': 'https://api.github.com/users/zou3519/orgs', 'repos_url': 'https://api.github.com/users/zou3519/repos', 'events_url': 'https://api.github.com/users/zou3519/events{/privacy}', 'received_events_url': 'https://api.github.com/users/zou3519/received_events', 'type': 'User', 'site_admin': False}",referenced,30e816bf1fce72b7d980c92b2a8c290ae2c0dcad,https://api.github.com/repos/pytorch/pytorch/commits/30e816bf1fce72b7d980c92b2a8c290ae2c0dcad,2019-04-02T15:46:58Z,342,285,57
4068,2249978691,"{'login': 'zou3519', 'id': 5652049, 'node_id': 'MDQ6VXNlcjU2NTIwNDk=', 'avatar_url': 'https://avatars3.githubusercontent.com/u/5652049?v=4', 'gravatar_id': '', 'url': 'https://api.github.com/users/zou3519', 'html_url': 'https://github.com/zou3519', 'followers_url': 'https://api.github.com/users/zou3519/followers', 'following_url': 'https://api.github.com/users/zou3519/following{/other_user}', 'gists_url': 'https://api.github.com/users/zou3519/gists{/gist_id}', 'starred_url': 'https://api.github.com/users/zou3519/starred{/owner}{/repo}', 'subscriptions_url': 'https://api.github.com/users/zou3519/subscriptions', 'organizations_url': 'https://api.github.com/users/zou3519/orgs', 'repos_url': 'https://api.github.com/users/zou3519/repos', 'events_url': 'https://api.github.com/users/zou3519/events{/privacy}', 'received_events_url': 'https://api.github.com/users/zou3519/received_events', 'type': 'User', 'site_admin': False}",referenced,15c3494965b583816c5deba22099e9784391e1b7,https://api.github.com/repos/pytorch/pytorch/commits/15c3494965b583816c5deba22099e9784391e1b7,2019-04-03T14:13:29Z,3592,2497,1095
4068,2250340938,"{'login': 'zou3519', 'id': 5652049, 'node_id': 'MDQ6VXNlcjU2NTIwNDk=', 'avatar_url': 'https://avatars3.githubusercontent.com/u/5652049?v=4', 'gravatar_id': '', 'url': 'https://api.github.com/users/zou3519', 'html_url': 'https://github.com/zou3519', 'followers_url': 'https://api.github.com/users/zou3519/followers', 'following_url': 'https://api.github.com/users/zou3519/following{/other_user}', 'gists_url': 'https://api.github.com/users/zou3519/gists{/gist_id}', 'starred_url': 'https://api.github.com/users/zou3519/starred{/owner}{/repo}', 'subscriptions_url': 'https://api.github.com/users/zou3519/subscriptions', 'organizations_url': 'https://api.github.com/users/zou3519/orgs', 'repos_url': 'https://api.github.com/users/zou3519/repos', 'events_url': 'https://api.github.com/users/zou3519/events{/privacy}', 'received_events_url': 'https://api.github.com/users/zou3519/received_events', 'type': 'User', 'site_admin': False}",referenced,ef7acbe9c6e6bcbf2a6ac385245537e881595726,https://api.github.com/repos/pytorch/pytorch/commits/ef7acbe9c6e6bcbf2a6ac385245537e881595726,2019-04-03T15:58:30Z,72,49,23
4068,2250847385,"{'login': 'zou3519', 'id': 5652049, 'node_id': 'MDQ6VXNlcjU2NTIwNDk=', 'avatar_url': 'https://avatars3.githubusercontent.com/u/5652049?v=4', 'gravatar_id': '', 'url': 'https://api.github.com/users/zou3519', 'html_url': 'https://github.com/zou3519', 'followers_url': 'https://api.github.com/users/zou3519/followers', 'following_url': 'https://api.github.com/users/zou3519/following{/other_user}', 'gists_url': 'https://api.github.com/users/zou3519/gists{/gist_id}', 'starred_url': 'https://api.github.com/users/zou3519/starred{/owner}{/repo}', 'subscriptions_url': 'https://api.github.com/users/zou3519/subscriptions', 'organizations_url': 'https://api.github.com/users/zou3519/orgs', 'repos_url': 'https://api.github.com/users/zou3519/repos', 'events_url': 'https://api.github.com/users/zou3519/events{/privacy}', 'received_events_url': 'https://api.github.com/users/zou3519/received_events', 'type': 'User', 'site_admin': False}",referenced,e7dfae01caab256295d8856b0943954043dbdf76,https://api.github.com/repos/pytorch/pytorch/commits/e7dfae01caab256295d8856b0943954043dbdf76,2019-04-03T19:12:03Z,20,12,8
4068,2251108370,"{'login': 'zou3519', 'id': 5652049, 'node_id': 'MDQ6VXNlcjU2NTIwNDk=', 'avatar_url': 'https://avatars3.githubusercontent.com/u/5652049?v=4', 'gravatar_id': '', 'url': 'https://api.github.com/users/zou3519', 'html_url': 'https://github.com/zou3519', 'followers_url': 'https://api.github.com/users/zou3519/followers', 'following_url': 'https://api.github.com/users/zou3519/following{/other_user}', 'gists_url': 'https://api.github.com/users/zou3519/gists{/gist_id}', 'starred_url': 'https://api.github.com/users/zou3519/starred{/owner}{/repo}', 'subscriptions_url': 'https://api.github.com/users/zou3519/subscriptions', 'organizations_url': 'https://api.github.com/users/zou3519/orgs', 'repos_url': 'https://api.github.com/users/zou3519/repos', 'events_url': 'https://api.github.com/users/zou3519/events{/privacy}', 'received_events_url': 'https://api.github.com/users/zou3519/received_events', 'type': 'User', 'site_admin': False}",referenced,d933cc43358617033f4d38921f7c0a262f6656b9,https://api.github.com/repos/pytorch/pytorch/commits/d933cc43358617033f4d38921f7c0a262f6656b9,2019-04-03T20:58:51Z,8,6,2
4068,2260110700,"{'login': 'zou3519', 'id': 5652049, 'node_id': 'MDQ6VXNlcjU2NTIwNDk=', 'avatar_url': 'https://avatars3.githubusercontent.com/u/5652049?v=4', 'gravatar_id': '', 'url': 'https://api.github.com/users/zou3519', 'html_url': 'https://github.com/zou3519', 'followers_url': 'https://api.github.com/users/zou3519/followers', 'following_url': 'https://api.github.com/users/zou3519/following{/other_user}', 'gists_url': 'https://api.github.com/users/zou3519/gists{/gist_id}', 'starred_url': 'https://api.github.com/users/zou3519/starred{/owner}{/repo}', 'subscriptions_url': 'https://api.github.com/users/zou3519/subscriptions', 'organizations_url': 'https://api.github.com/users/zou3519/orgs', 'repos_url': 'https://api.github.com/users/zou3519/repos', 'events_url': 'https://api.github.com/users/zou3519/events{/privacy}', 'received_events_url': 'https://api.github.com/users/zou3519/received_events', 'type': 'User', 'site_admin': False}",referenced,6f5246862e5447794aa4696f5685e2fbf2022738,https://api.github.com/repos/pytorch/pytorch/commits/6f5246862e5447794aa4696f5685e2fbf2022738,2019-04-08T15:32:05Z,31,5,26
4068,2260281688,"{'login': 'zou3519', 'id': 5652049, 'node_id': 'MDQ6VXNlcjU2NTIwNDk=', 'avatar_url': 'https://avatars3.githubusercontent.com/u/5652049?v=4', 'gravatar_id': '', 'url': 'https://api.github.com/users/zou3519', 'html_url': 'https://github.com/zou3519', 'followers_url': 'https://api.github.com/users/zou3519/followers', 'following_url': 'https://api.github.com/users/zou3519/following{/other_user}', 'gists_url': 'https://api.github.com/users/zou3519/gists{/gist_id}', 'starred_url': 'https://api.github.com/users/zou3519/starred{/owner}{/repo}', 'subscriptions_url': 'https://api.github.com/users/zou3519/subscriptions', 'organizations_url': 'https://api.github.com/users/zou3519/orgs', 'repos_url': 'https://api.github.com/users/zou3519/repos', 'events_url': 'https://api.github.com/users/zou3519/events{/privacy}', 'received_events_url': 'https://api.github.com/users/zou3519/received_events', 'type': 'User', 'site_admin': False}",referenced,bc9762979d9709b6c2f74e6841227fa775a46697,https://api.github.com/repos/pytorch/pytorch/commits/bc9762979d9709b6c2f74e6841227fa775a46697,2019-04-08T16:28:30Z,13652,9228,4424
4066,1377794467,"{'login': 'colesbury', 'id': 655866, 'node_id': 'MDQ6VXNlcjY1NTg2Ng==', 'avatar_url': 'https://avatars1.githubusercontent.com/u/655866?v=4', 'gravatar_id': '', 'url': 'https://api.github.com/users/colesbury', 'html_url': 'https://github.com/colesbury', 'followers_url': 'https://api.github.com/users/colesbury/followers', 'following_url': 'https://api.github.com/users/colesbury/following{/other_user}', 'gists_url': 'https://api.github.com/users/colesbury/gists{/gist_id}', 'starred_url': 'https://api.github.com/users/colesbury/starred{/owner}{/repo}', 'subscriptions_url': 'https://api.github.com/users/colesbury/subscriptions', 'organizations_url': 'https://api.github.com/users/colesbury/orgs', 'repos_url': 'https://api.github.com/users/colesbury/repos', 'events_url': 'https://api.github.com/users/colesbury/events{/privacy}', 'received_events_url': 'https://api.github.com/users/colesbury/received_events', 'type': 'User', 'site_admin': False}",referenced,9ea576d06839b7c888865921c2bd66db1fbc3648,https://api.github.com/repos/pytorch/pytorch/commits/9ea576d06839b7c888865921c2bd66db1fbc3648,2017-12-07T21:37:29Z,50,6,44
4048,1734416194,"{'login': 'facebook-github-bot', 'id': 6422482, 'node_id': 'MDQ6VXNlcjY0MjI0ODI=', 'avatar_url': 'https://avatars3.githubusercontent.com/u/6422482?v=4', 'gravatar_id': '', 'url': 'https://api.github.com/users/facebook-github-bot', 'html_url': 'https://github.com/facebook-github-bot', 'followers_url': 'https://api.github.com/users/facebook-github-bot/followers', 'following_url': 'https://api.github.com/users/facebook-github-bot/following{/other_user}', 'gists_url': 'https://api.github.com/users/facebook-github-bot/gists{/gist_id}', 'starred_url': 'https://api.github.com/users/facebook-github-bot/starred{/owner}{/repo}', 'subscriptions_url': 'https://api.github.com/users/facebook-github-bot/subscriptions', 'organizations_url': 'https://api.github.com/users/facebook-github-bot/orgs', 'repos_url': 'https://api.github.com/users/facebook-github-bot/repos', 'events_url': 'https://api.github.com/users/facebook-github-bot/events{/privacy}', 'received_events_url': 'https://api.github.com/users/facebook-github-bot/received_events', 'type': 'User', 'site_admin': False}",referenced,97008a64a1d008ea0eb1715afeadbcc0538f4c1c,https://api.github.com/repos/pytorch/pytorch/commits/97008a64a1d008ea0eb1715afeadbcc0538f4c1c,2018-07-16T00:42:03Z,427,423,4
3966,1391511468,"{'login': 'soumith', 'id': 1310570, 'node_id': 'MDQ6VXNlcjEzMTA1NzA=', 'avatar_url': 'https://avatars0.githubusercontent.com/u/1310570?v=4', 'gravatar_id': '', 'url': 'https://api.github.com/users/soumith', 'html_url': 'https://github.com/soumith', 'followers_url': 'https://api.github.com/users/soumith/followers', 'following_url': 'https://api.github.com/users/soumith/following{/other_user}', 'gists_url': 'https://api.github.com/users/soumith/gists{/gist_id}', 'starred_url': 'https://api.github.com/users/soumith/starred{/owner}{/repo}', 'subscriptions_url': 'https://api.github.com/users/soumith/subscriptions', 'organizations_url': 'https://api.github.com/users/soumith/orgs', 'repos_url': 'https://api.github.com/users/soumith/repos', 'events_url': 'https://api.github.com/users/soumith/events{/privacy}', 'received_events_url': 'https://api.github.com/users/soumith/received_events', 'type': 'User', 'site_admin': False}",referenced,b79d74aa812cf5a3370ab09e20704453b070cb0e,https://api.github.com/repos/pytorch/pytorch/commits/b79d74aa812cf5a3370ab09e20704453b070cb0e,2017-12-18T06:51:38Z,46,46,0
3914,1362111047,"{'login': 'soumith', 'id': 1310570, 'node_id': 'MDQ6VXNlcjEzMTA1NzA=', 'avatar_url': 'https://avatars0.githubusercontent.com/u/1310570?v=4', 'gravatar_id': '', 'url': 'https://api.github.com/users/soumith', 'html_url': 'https://github.com/soumith', 'followers_url': 'https://api.github.com/users/soumith/followers', 'following_url': 'https://api.github.com/users/soumith/following{/other_user}', 'gists_url': 'https://api.github.com/users/soumith/gists{/gist_id}', 'starred_url': 'https://api.github.com/users/soumith/starred{/owner}{/repo}', 'subscriptions_url': 'https://api.github.com/users/soumith/subscriptions', 'organizations_url': 'https://api.github.com/users/soumith/orgs', 'repos_url': 'https://api.github.com/users/soumith/repos', 'events_url': 'https://api.github.com/users/soumith/events{/privacy}', 'received_events_url': 'https://api.github.com/users/soumith/received_events', 'type': 'User', 'site_admin': False}",referenced,d4e5d9061da8c69d30e691e3de4ba218713e109c,https://api.github.com/repos/pytorch/pytorch/commits/d4e5d9061da8c69d30e691e3de4ba218713e109c,2017-11-28T19:32:46Z,49,44,5
3860,1364497483,"{'login': 'apaszke', 'id': 4583066, 'node_id': 'MDQ6VXNlcjQ1ODMwNjY=', 'avatar_url': 'https://avatars3.githubusercontent.com/u/4583066?v=4', 'gravatar_id': '', 'url': 'https://api.github.com/users/apaszke', 'html_url': 'https://github.com/apaszke', 'followers_url': 'https://api.github.com/users/apaszke/followers', 'following_url': 'https://api.github.com/users/apaszke/following{/other_user}', 'gists_url': 'https://api.github.com/users/apaszke/gists{/gist_id}', 'starred_url': 'https://api.github.com/users/apaszke/starred{/owner}{/repo}', 'subscriptions_url': 'https://api.github.com/users/apaszke/subscriptions', 'organizations_url': 'https://api.github.com/users/apaszke/orgs', 'repos_url': 'https://api.github.com/users/apaszke/repos', 'events_url': 'https://api.github.com/users/apaszke/events{/privacy}', 'received_events_url': 'https://api.github.com/users/apaszke/received_events', 'type': 'User', 'site_admin': False}",referenced,3c709f5b263e2c4c21f86bbc2eece9d11e0b637a,https://api.github.com/repos/pytorch/pytorch/commits/3c709f5b263e2c4c21f86bbc2eece9d11e0b637a,2017-11-29T21:54:37Z,4,4,0
3858,2211519132,"{'login': 'facebook-github-bot', 'id': 6422482, 'node_id': 'MDQ6VXNlcjY0MjI0ODI=', 'avatar_url': 'https://avatars3.githubusercontent.com/u/6422482?v=4', 'gravatar_id': '', 'url': 'https://api.github.com/users/facebook-github-bot', 'html_url': 'https://github.com/facebook-github-bot', 'followers_url': 'https://api.github.com/users/facebook-github-bot/followers', 'following_url': 'https://api.github.com/users/facebook-github-bot/following{/other_user}', 'gists_url': 'https://api.github.com/users/facebook-github-bot/gists{/gist_id}', 'starred_url': 'https://api.github.com/users/facebook-github-bot/starred{/owner}{/repo}', 'subscriptions_url': 'https://api.github.com/users/facebook-github-bot/subscriptions', 'organizations_url': 'https://api.github.com/users/facebook-github-bot/orgs', 'repos_url': 'https://api.github.com/users/facebook-github-bot/repos', 'events_url': 'https://api.github.com/users/facebook-github-bot/events{/privacy}', 'received_events_url': 'https://api.github.com/users/facebook-github-bot/received_events', 'type': 'User', 'site_admin': False}",referenced,670f509984efce8aab0b0b5b166ff01472af6f1c,https://api.github.com/repos/pytorch/pytorch/commits/670f509984efce8aab0b0b5b166ff01472af6f1c,2019-03-18T19:35:09Z,294,272,22
3835,1369069083,"{'login': 'soumith', 'id': 1310570, 'node_id': 'MDQ6VXNlcjEzMTA1NzA=', 'avatar_url': 'https://avatars0.githubusercontent.com/u/1310570?v=4', 'gravatar_id': '', 'url': 'https://api.github.com/users/soumith', 'html_url': 'https://github.com/soumith', 'followers_url': 'https://api.github.com/users/soumith/followers', 'following_url': 'https://api.github.com/users/soumith/following{/other_user}', 'gists_url': 'https://api.github.com/users/soumith/gists{/gist_id}', 'starred_url': 'https://api.github.com/users/soumith/starred{/owner}{/repo}', 'subscriptions_url': 'https://api.github.com/users/soumith/subscriptions', 'organizations_url': 'https://api.github.com/users/soumith/orgs', 'repos_url': 'https://api.github.com/users/soumith/repos', 'events_url': 'https://api.github.com/users/soumith/events{/privacy}', 'received_events_url': 'https://api.github.com/users/soumith/received_events', 'type': 'User', 'site_admin': False}",referenced,4f90f785bc1356ae5dd586f43c7374e33580ce93,https://api.github.com/repos/pytorch/pytorch/commits/4f90f785bc1356ae5dd586f43c7374e33580ce93,2017-12-02T23:25:43Z,27,19,8
3835,1369919362,"{'login': 'soumith', 'id': 1310570, 'node_id': 'MDQ6VXNlcjEzMTA1NzA=', 'avatar_url': 'https://avatars0.githubusercontent.com/u/1310570?v=4', 'gravatar_id': '', 'url': 'https://api.github.com/users/soumith', 'html_url': 'https://github.com/soumith', 'followers_url': 'https://api.github.com/users/soumith/followers', 'following_url': 'https://api.github.com/users/soumith/following{/other_user}', 'gists_url': 'https://api.github.com/users/soumith/gists{/gist_id}', 'starred_url': 'https://api.github.com/users/soumith/starred{/owner}{/repo}', 'subscriptions_url': 'https://api.github.com/users/soumith/subscriptions', 'organizations_url': 'https://api.github.com/users/soumith/orgs', 'repos_url': 'https://api.github.com/users/soumith/repos', 'events_url': 'https://api.github.com/users/soumith/events{/privacy}', 'received_events_url': 'https://api.github.com/users/soumith/received_events', 'type': 'User', 'site_admin': False}",referenced,1645546aa9790e06682804656bd2d8e20b360082,https://api.github.com/repos/pytorch/pytorch/commits/1645546aa9790e06682804656bd2d8e20b360082,2017-12-04T08:01:15Z,27,19,8
3824,1369069084,"{'login': 'soumith', 'id': 1310570, 'node_id': 'MDQ6VXNlcjEzMTA1NzA=', 'avatar_url': 'https://avatars0.githubusercontent.com/u/1310570?v=4', 'gravatar_id': '', 'url': 'https://api.github.com/users/soumith', 'html_url': 'https://github.com/soumith', 'followers_url': 'https://api.github.com/users/soumith/followers', 'following_url': 'https://api.github.com/users/soumith/following{/other_user}', 'gists_url': 'https://api.github.com/users/soumith/gists{/gist_id}', 'starred_url': 'https://api.github.com/users/soumith/starred{/owner}{/repo}', 'subscriptions_url': 'https://api.github.com/users/soumith/subscriptions', 'organizations_url': 'https://api.github.com/users/soumith/orgs', 'repos_url': 'https://api.github.com/users/soumith/repos', 'events_url': 'https://api.github.com/users/soumith/events{/privacy}', 'received_events_url': 'https://api.github.com/users/soumith/received_events', 'type': 'User', 'site_admin': False}",referenced,4f90f785bc1356ae5dd586f43c7374e33580ce93,https://api.github.com/repos/pytorch/pytorch/commits/4f90f785bc1356ae5dd586f43c7374e33580ce93,2017-12-02T23:25:43Z,27,19,8
3824,1369919364,"{'login': 'soumith', 'id': 1310570, 'node_id': 'MDQ6VXNlcjEzMTA1NzA=', 'avatar_url': 'https://avatars0.githubusercontent.com/u/1310570?v=4', 'gravatar_id': '', 'url': 'https://api.github.com/users/soumith', 'html_url': 'https://github.com/soumith', 'followers_url': 'https://api.github.com/users/soumith/followers', 'following_url': 'https://api.github.com/users/soumith/following{/other_user}', 'gists_url': 'https://api.github.com/users/soumith/gists{/gist_id}', 'starred_url': 'https://api.github.com/users/soumith/starred{/owner}{/repo}', 'subscriptions_url': 'https://api.github.com/users/soumith/subscriptions', 'organizations_url': 'https://api.github.com/users/soumith/orgs', 'repos_url': 'https://api.github.com/users/soumith/repos', 'events_url': 'https://api.github.com/users/soumith/events{/privacy}', 'received_events_url': 'https://api.github.com/users/soumith/received_events', 'type': 'User', 'site_admin': False}",referenced,1645546aa9790e06682804656bd2d8e20b360082,https://api.github.com/repos/pytorch/pytorch/commits/1645546aa9790e06682804656bd2d8e20b360082,2017-12-04T08:01:15Z,27,19,8
3677,1340896285,"{'login': 'apaszke', 'id': 4583066, 'node_id': 'MDQ6VXNlcjQ1ODMwNjY=', 'avatar_url': 'https://avatars3.githubusercontent.com/u/4583066?v=4', 'gravatar_id': '', 'url': 'https://api.github.com/users/apaszke', 'html_url': 'https://github.com/apaszke', 'followers_url': 'https://api.github.com/users/apaszke/followers', 'following_url': 'https://api.github.com/users/apaszke/following{/other_user}', 'gists_url': 'https://api.github.com/users/apaszke/gists{/gist_id}', 'starred_url': 'https://api.github.com/users/apaszke/starred{/owner}{/repo}', 'subscriptions_url': 'https://api.github.com/users/apaszke/subscriptions', 'organizations_url': 'https://api.github.com/users/apaszke/orgs', 'repos_url': 'https://api.github.com/users/apaszke/repos', 'events_url': 'https://api.github.com/users/apaszke/events{/privacy}', 'received_events_url': 'https://api.github.com/users/apaszke/received_events', 'type': 'User', 'site_admin': False}",referenced,446f869a0d22995c816d3cc425dd639f9e5faca4,https://api.github.com/repos/pytorch/pytorch/commits/446f869a0d22995c816d3cc425dd639f9e5faca4,2017-11-14T13:53:44Z,8,6,2
3671,1786891675,"{'login': 'facebook-github-bot', 'id': 6422482, 'node_id': 'MDQ6VXNlcjY0MjI0ODI=', 'avatar_url': 'https://avatars3.githubusercontent.com/u/6422482?v=4', 'gravatar_id': '', 'url': 'https://api.github.com/users/facebook-github-bot', 'html_url': 'https://github.com/facebook-github-bot', 'followers_url': 'https://api.github.com/users/facebook-github-bot/followers', 'following_url': 'https://api.github.com/users/facebook-github-bot/following{/other_user}', 'gists_url': 'https://api.github.com/users/facebook-github-bot/gists{/gist_id}', 'starred_url': 'https://api.github.com/users/facebook-github-bot/starred{/owner}{/repo}', 'subscriptions_url': 'https://api.github.com/users/facebook-github-bot/subscriptions', 'organizations_url': 'https://api.github.com/users/facebook-github-bot/orgs', 'repos_url': 'https://api.github.com/users/facebook-github-bot/repos', 'events_url': 'https://api.github.com/users/facebook-github-bot/events{/privacy}', 'received_events_url': 'https://api.github.com/users/facebook-github-bot/received_events', 'type': 'User', 'site_admin': False}",closed,7d16e87f14c4b93a0dd28363c9cb57860faa567d,https://api.github.com/repos/pytorch/pytorch/commits/7d16e87f14c4b93a0dd28363c9cb57860faa567d,2018-08-14T04:40:18Z,13,11,2
3659,1366990564,"{'login': 'ezyang', 'id': 13564, 'node_id': 'MDQ6VXNlcjEzNTY0', 'avatar_url': 'https://avatars0.githubusercontent.com/u/13564?v=4', 'gravatar_id': '', 'url': 'https://api.github.com/users/ezyang', 'html_url': 'https://github.com/ezyang', 'followers_url': 'https://api.github.com/users/ezyang/followers', 'following_url': 'https://api.github.com/users/ezyang/following{/other_user}', 'gists_url': 'https://api.github.com/users/ezyang/gists{/gist_id}', 'starred_url': 'https://api.github.com/users/ezyang/starred{/owner}{/repo}', 'subscriptions_url': 'https://api.github.com/users/ezyang/subscriptions', 'organizations_url': 'https://api.github.com/users/ezyang/orgs', 'repos_url': 'https://api.github.com/users/ezyang/repos', 'events_url': 'https://api.github.com/users/ezyang/events{/privacy}', 'received_events_url': 'https://api.github.com/users/ezyang/received_events', 'type': 'User', 'site_admin': False}",closed,1c0fbd27a10b7036b1db643014e65cae7f6d0266,https://api.github.com/repos/pytorch/pytorch/commits/1c0fbd27a10b7036b1db643014e65cae7f6d0266,2017-12-01T04:07:09Z,4938,2671,2267
3627,1392912420,"{'login': 'colesbury', 'id': 655866, 'node_id': 'MDQ6VXNlcjY1NTg2Ng==', 'avatar_url': 'https://avatars1.githubusercontent.com/u/655866?v=4', 'gravatar_id': '', 'url': 'https://api.github.com/users/colesbury', 'html_url': 'https://github.com/colesbury', 'followers_url': 'https://api.github.com/users/colesbury/followers', 'following_url': 'https://api.github.com/users/colesbury/following{/other_user}', 'gists_url': 'https://api.github.com/users/colesbury/gists{/gist_id}', 'starred_url': 'https://api.github.com/users/colesbury/starred{/owner}{/repo}', 'subscriptions_url': 'https://api.github.com/users/colesbury/subscriptions', 'organizations_url': 'https://api.github.com/users/colesbury/orgs', 'repos_url': 'https://api.github.com/users/colesbury/repos', 'events_url': 'https://api.github.com/users/colesbury/events{/privacy}', 'received_events_url': 'https://api.github.com/users/colesbury/received_events', 'type': 'User', 'site_admin': False}",referenced,d6050582122c09e52e51b518f5af9be04e12e021,https://api.github.com/repos/pytorch/pytorch/commits/d6050582122c09e52e51b518f5af9be04e12e021,2017-12-18T20:46:23Z,1080,552,528
3587,1634441692,"{'login': 'soumith', 'id': 1310570, 'node_id': 'MDQ6VXNlcjEzMTA1NzA=', 'avatar_url': 'https://avatars0.githubusercontent.com/u/1310570?v=4', 'gravatar_id': '', 'url': 'https://api.github.com/users/soumith', 'html_url': 'https://github.com/soumith', 'followers_url': 'https://api.github.com/users/soumith/followers', 'following_url': 'https://api.github.com/users/soumith/following{/other_user}', 'gists_url': 'https://api.github.com/users/soumith/gists{/gist_id}', 'starred_url': 'https://api.github.com/users/soumith/starred{/owner}{/repo}', 'subscriptions_url': 'https://api.github.com/users/soumith/subscriptions', 'organizations_url': 'https://api.github.com/users/soumith/orgs', 'repos_url': 'https://api.github.com/users/soumith/repos', 'events_url': 'https://api.github.com/users/soumith/events{/privacy}', 'received_events_url': 'https://api.github.com/users/soumith/received_events', 'type': 'User', 'site_admin': False}",referenced,8212f576dbebfb6ceb45ea550ba1521bb46e9fd4,https://api.github.com/repos/pytorch/pytorch/commits/8212f576dbebfb6ceb45ea550ba1521bb46e9fd4,2018-05-18T14:41:33Z,32,28,4
3584,2039801214,"{'login': 'facebook-github-bot', 'id': 6422482, 'node_id': 'MDQ6VXNlcjY0MjI0ODI=', 'avatar_url': 'https://avatars3.githubusercontent.com/u/6422482?v=4', 'gravatar_id': '', 'url': 'https://api.github.com/users/facebook-github-bot', 'html_url': 'https://github.com/facebook-github-bot', 'followers_url': 'https://api.github.com/users/facebook-github-bot/followers', 'following_url': 'https://api.github.com/users/facebook-github-bot/following{/other_user}', 'gists_url': 'https://api.github.com/users/facebook-github-bot/gists{/gist_id}', 'starred_url': 'https://api.github.com/users/facebook-github-bot/starred{/owner}{/repo}', 'subscriptions_url': 'https://api.github.com/users/facebook-github-bot/subscriptions', 'organizations_url': 'https://api.github.com/users/facebook-github-bot/orgs', 'repos_url': 'https://api.github.com/users/facebook-github-bot/repos', 'events_url': 'https://api.github.com/users/facebook-github-bot/events{/privacy}', 'received_events_url': 'https://api.github.com/users/facebook-github-bot/received_events', 'type': 'User', 'site_admin': False}",closed,335306406032489bfdfa5bf06220da5429ca3e8f,https://api.github.com/repos/pytorch/pytorch/commits/335306406032489bfdfa5bf06220da5429ca3e8f,2018-12-21T01:38:28Z,427,306,121
3573,1333449189,"{'login': 'ezyang', 'id': 13564, 'node_id': 'MDQ6VXNlcjEzNTY0', 'avatar_url': 'https://avatars0.githubusercontent.com/u/13564?v=4', 'gravatar_id': '', 'url': 'https://api.github.com/users/ezyang', 'html_url': 'https://github.com/ezyang', 'followers_url': 'https://api.github.com/users/ezyang/followers', 'following_url': 'https://api.github.com/users/ezyang/following{/other_user}', 'gists_url': 'https://api.github.com/users/ezyang/gists{/gist_id}', 'starred_url': 'https://api.github.com/users/ezyang/starred{/owner}{/repo}', 'subscriptions_url': 'https://api.github.com/users/ezyang/subscriptions', 'organizations_url': 'https://api.github.com/users/ezyang/orgs', 'repos_url': 'https://api.github.com/users/ezyang/repos', 'events_url': 'https://api.github.com/users/ezyang/events{/privacy}', 'received_events_url': 'https://api.github.com/users/ezyang/received_events', 'type': 'User', 'site_admin': False}",closed,0217ad29d2f2706b7d7b7989aac789dd1c2a4f0e,https://api.github.com/repos/pytorch/pytorch/commits/0217ad29d2f2706b7d7b7989aac789dd1c2a4f0e,2017-11-09T08:16:26Z,39,24,15
3554,1334466462,"{'login': 'colesbury', 'id': 655866, 'node_id': 'MDQ6VXNlcjY1NTg2Ng==', 'avatar_url': 'https://avatars1.githubusercontent.com/u/655866?v=4', 'gravatar_id': '', 'url': 'https://api.github.com/users/colesbury', 'html_url': 'https://github.com/colesbury', 'followers_url': 'https://api.github.com/users/colesbury/followers', 'following_url': 'https://api.github.com/users/colesbury/following{/other_user}', 'gists_url': 'https://api.github.com/users/colesbury/gists{/gist_id}', 'starred_url': 'https://api.github.com/users/colesbury/starred{/owner}{/repo}', 'subscriptions_url': 'https://api.github.com/users/colesbury/subscriptions', 'organizations_url': 'https://api.github.com/users/colesbury/orgs', 'repos_url': 'https://api.github.com/users/colesbury/repos', 'events_url': 'https://api.github.com/users/colesbury/events{/privacy}', 'received_events_url': 'https://api.github.com/users/colesbury/received_events', 'type': 'User', 'site_admin': False}",referenced,1bf717e17dbc9deb8845d8496a4a423a3594e98f,https://api.github.com/repos/pytorch/pytorch/commits/1bf717e17dbc9deb8845d8496a4a423a3594e98f,2017-11-09T17:30:22Z,38,24,14
3554,1334467814,"{'login': 'colesbury', 'id': 655866, 'node_id': 'MDQ6VXNlcjY1NTg2Ng==', 'avatar_url': 'https://avatars1.githubusercontent.com/u/655866?v=4', 'gravatar_id': '', 'url': 'https://api.github.com/users/colesbury', 'html_url': 'https://github.com/colesbury', 'followers_url': 'https://api.github.com/users/colesbury/followers', 'following_url': 'https://api.github.com/users/colesbury/following{/other_user}', 'gists_url': 'https://api.github.com/users/colesbury/gists{/gist_id}', 'starred_url': 'https://api.github.com/users/colesbury/starred{/owner}{/repo}', 'subscriptions_url': 'https://api.github.com/users/colesbury/subscriptions', 'organizations_url': 'https://api.github.com/users/colesbury/orgs', 'repos_url': 'https://api.github.com/users/colesbury/repos', 'events_url': 'https://api.github.com/users/colesbury/events{/privacy}', 'received_events_url': 'https://api.github.com/users/colesbury/received_events', 'type': 'User', 'site_admin': False}",referenced,1108bced80570d21475ac3d56b2ce9916e26a3f5,https://api.github.com/repos/pytorch/pytorch/commits/1108bced80570d21475ac3d56b2ce9916e26a3f5,2017-11-09T17:30:54Z,38,24,14
3525,1332005626,"{'login': 'soumith', 'id': 1310570, 'node_id': 'MDQ6VXNlcjEzMTA1NzA=', 'avatar_url': 'https://avatars0.githubusercontent.com/u/1310570?v=4', 'gravatar_id': '', 'url': 'https://api.github.com/users/soumith', 'html_url': 'https://github.com/soumith', 'followers_url': 'https://api.github.com/users/soumith/followers', 'following_url': 'https://api.github.com/users/soumith/following{/other_user}', 'gists_url': 'https://api.github.com/users/soumith/gists{/gist_id}', 'starred_url': 'https://api.github.com/users/soumith/starred{/owner}{/repo}', 'subscriptions_url': 'https://api.github.com/users/soumith/subscriptions', 'organizations_url': 'https://api.github.com/users/soumith/orgs', 'repos_url': 'https://api.github.com/users/soumith/repos', 'events_url': 'https://api.github.com/users/soumith/events{/privacy}', 'received_events_url': 'https://api.github.com/users/soumith/received_events', 'type': 'User', 'site_admin': False}",referenced,9c3cb6e652e6033e355cef92229fde5b0baf271b,https://api.github.com/repos/pytorch/pytorch/commits/9c3cb6e652e6033e355cef92229fde5b0baf271b,2017-11-08T14:55:37Z,4,2,2
3498,1329552712,"{'login': 'soumith', 'id': 1310570, 'node_id': 'MDQ6VXNlcjEzMTA1NzA=', 'avatar_url': 'https://avatars0.githubusercontent.com/u/1310570?v=4', 'gravatar_id': '', 'url': 'https://api.github.com/users/soumith', 'html_url': 'https://github.com/soumith', 'followers_url': 'https://api.github.com/users/soumith/followers', 'following_url': 'https://api.github.com/users/soumith/following{/other_user}', 'gists_url': 'https://api.github.com/users/soumith/gists{/gist_id}', 'starred_url': 'https://api.github.com/users/soumith/starred{/owner}{/repo}', 'subscriptions_url': 'https://api.github.com/users/soumith/subscriptions', 'organizations_url': 'https://api.github.com/users/soumith/orgs', 'repos_url': 'https://api.github.com/users/soumith/repos', 'events_url': 'https://api.github.com/users/soumith/events{/privacy}', 'received_events_url': 'https://api.github.com/users/soumith/received_events', 'type': 'User', 'site_admin': False}",referenced,f282d1dc7c64ace9af4ee408d34a4a6caf3f3cc0,https://api.github.com/repos/pytorch/pytorch/commits/f282d1dc7c64ace9af4ee408d34a4a6caf3f3cc0,2017-11-07T12:10:11Z,8,6,2
3498,1330242136,"{'login': 'colesbury', 'id': 655866, 'node_id': 'MDQ6VXNlcjY1NTg2Ng==', 'avatar_url': 'https://avatars1.githubusercontent.com/u/655866?v=4', 'gravatar_id': '', 'url': 'https://api.github.com/users/colesbury', 'html_url': 'https://github.com/colesbury', 'followers_url': 'https://api.github.com/users/colesbury/followers', 'following_url': 'https://api.github.com/users/colesbury/following{/other_user}', 'gists_url': 'https://api.github.com/users/colesbury/gists{/gist_id}', 'starred_url': 'https://api.github.com/users/colesbury/starred{/owner}{/repo}', 'subscriptions_url': 'https://api.github.com/users/colesbury/subscriptions', 'organizations_url': 'https://api.github.com/users/colesbury/orgs', 'repos_url': 'https://api.github.com/users/colesbury/repos', 'events_url': 'https://api.github.com/users/colesbury/events{/privacy}', 'received_events_url': 'https://api.github.com/users/colesbury/received_events', 'type': 'User', 'site_admin': False}",referenced,6fde0cb507d59d2a9168f3051feba6865e9d1048,https://api.github.com/repos/pytorch/pytorch/commits/6fde0cb507d59d2a9168f3051feba6865e9d1048,2017-11-07T17:47:22Z,8,6,2
3420,1763411582,"{'login': 'facebook-github-bot', 'id': 6422482, 'node_id': 'MDQ6VXNlcjY0MjI0ODI=', 'avatar_url': 'https://avatars3.githubusercontent.com/u/6422482?v=4', 'gravatar_id': '', 'url': 'https://api.github.com/users/facebook-github-bot', 'html_url': 'https://github.com/facebook-github-bot', 'followers_url': 'https://api.github.com/users/facebook-github-bot/followers', 'following_url': 'https://api.github.com/users/facebook-github-bot/following{/other_user}', 'gists_url': 'https://api.github.com/users/facebook-github-bot/gists{/gist_id}', 'starred_url': 'https://api.github.com/users/facebook-github-bot/starred{/owner}{/repo}', 'subscriptions_url': 'https://api.github.com/users/facebook-github-bot/subscriptions', 'organizations_url': 'https://api.github.com/users/facebook-github-bot/orgs', 'repos_url': 'https://api.github.com/users/facebook-github-bot/repos', 'events_url': 'https://api.github.com/users/facebook-github-bot/events{/privacy}', 'received_events_url': 'https://api.github.com/users/facebook-github-bot/received_events', 'type': 'User', 'site_admin': False}",closed,685224aa14b59d011d0926d615846a60f138e4ba,https://api.github.com/repos/pytorch/pytorch/commits/685224aa14b59d011d0926d615846a60f138e4ba,2018-07-31T18:10:56Z,1393,1364,29
3412,1323941340,"{'login': 'colesbury', 'id': 655866, 'node_id': 'MDQ6VXNlcjY1NTg2Ng==', 'avatar_url': 'https://avatars1.githubusercontent.com/u/655866?v=4', 'gravatar_id': '', 'url': 'https://api.github.com/users/colesbury', 'html_url': 'https://github.com/colesbury', 'followers_url': 'https://api.github.com/users/colesbury/followers', 'following_url': 'https://api.github.com/users/colesbury/following{/other_user}', 'gists_url': 'https://api.github.com/users/colesbury/gists{/gist_id}', 'starred_url': 'https://api.github.com/users/colesbury/starred{/owner}{/repo}', 'subscriptions_url': 'https://api.github.com/users/colesbury/subscriptions', 'organizations_url': 'https://api.github.com/users/colesbury/orgs', 'repos_url': 'https://api.github.com/users/colesbury/repos', 'events_url': 'https://api.github.com/users/colesbury/events{/privacy}', 'received_events_url': 'https://api.github.com/users/colesbury/received_events', 'type': 'User', 'site_admin': False}",referenced,3003ebe67ae03922312e796990eac6a00a9d1633,https://api.github.com/repos/pytorch/pytorch/commits/3003ebe67ae03922312e796990eac6a00a9d1633,2017-11-02T21:23:34Z,160,97,63
3376,1731666063,"{'login': 'facebook-github-bot', 'id': 6422482, 'node_id': 'MDQ6VXNlcjY0MjI0ODI=', 'avatar_url': 'https://avatars3.githubusercontent.com/u/6422482?v=4', 'gravatar_id': '', 'url': 'https://api.github.com/users/facebook-github-bot', 'html_url': 'https://github.com/facebook-github-bot', 'followers_url': 'https://api.github.com/users/facebook-github-bot/followers', 'following_url': 'https://api.github.com/users/facebook-github-bot/following{/other_user}', 'gists_url': 'https://api.github.com/users/facebook-github-bot/gists{/gist_id}', 'starred_url': 'https://api.github.com/users/facebook-github-bot/starred{/owner}{/repo}', 'subscriptions_url': 'https://api.github.com/users/facebook-github-bot/subscriptions', 'organizations_url': 'https://api.github.com/users/facebook-github-bot/orgs', 'repos_url': 'https://api.github.com/users/facebook-github-bot/repos', 'events_url': 'https://api.github.com/users/facebook-github-bot/events{/privacy}', 'received_events_url': 'https://api.github.com/users/facebook-github-bot/received_events', 'type': 'User', 'site_admin': False}",closed,cd3e067e4654daa0edb5f4c9db99ffce3b38c64b,https://api.github.com/repos/pytorch/pytorch/commits/cd3e067e4654daa0edb5f4c9db99ffce3b38c64b,2018-07-13T02:42:57Z,17,17,0
3313,1328672432,"{'login': 'colesbury', 'id': 655866, 'node_id': 'MDQ6VXNlcjY1NTg2Ng==', 'avatar_url': 'https://avatars1.githubusercontent.com/u/655866?v=4', 'gravatar_id': '', 'url': 'https://api.github.com/users/colesbury', 'html_url': 'https://github.com/colesbury', 'followers_url': 'https://api.github.com/users/colesbury/followers', 'following_url': 'https://api.github.com/users/colesbury/following{/other_user}', 'gists_url': 'https://api.github.com/users/colesbury/gists{/gist_id}', 'starred_url': 'https://api.github.com/users/colesbury/starred{/owner}{/repo}', 'subscriptions_url': 'https://api.github.com/users/colesbury/subscriptions', 'organizations_url': 'https://api.github.com/users/colesbury/orgs', 'repos_url': 'https://api.github.com/users/colesbury/repos', 'events_url': 'https://api.github.com/users/colesbury/events{/privacy}', 'received_events_url': 'https://api.github.com/users/colesbury/received_events', 'type': 'User', 'site_admin': False}",closed,fde355f7d4ad95a1f8cba6adc3fff7b4935ecba0,https://api.github.com/repos/pytorch/pytorch/commits/fde355f7d4ad95a1f8cba6adc3fff7b4935ecba0,2017-11-06T23:20:05Z,1188,843,345
3266,1309643325,"{'login': 'soumith', 'id': 1310570, 'node_id': 'MDQ6VXNlcjEzMTA1NzA=', 'avatar_url': 'https://avatars0.githubusercontent.com/u/1310570?v=4', 'gravatar_id': '', 'url': 'https://api.github.com/users/soumith', 'html_url': 'https://github.com/soumith', 'followers_url': 'https://api.github.com/users/soumith/followers', 'following_url': 'https://api.github.com/users/soumith/following{/other_user}', 'gists_url': 'https://api.github.com/users/soumith/gists{/gist_id}', 'starred_url': 'https://api.github.com/users/soumith/starred{/owner}{/repo}', 'subscriptions_url': 'https://api.github.com/users/soumith/subscriptions', 'organizations_url': 'https://api.github.com/users/soumith/orgs', 'repos_url': 'https://api.github.com/users/soumith/repos', 'events_url': 'https://api.github.com/users/soumith/events{/privacy}', 'received_events_url': 'https://api.github.com/users/soumith/received_events', 'type': 'User', 'site_admin': False}",referenced,e43a63a968083aeff957c04c7d8c9ffa794a446d,https://api.github.com/repos/pytorch/pytorch/commits/e43a63a968083aeff957c04c7d8c9ffa794a446d,2017-10-25T11:18:02Z,7,6,1
3264,1328572809,"{'login': 'colesbury', 'id': 655866, 'node_id': 'MDQ6VXNlcjY1NTg2Ng==', 'avatar_url': 'https://avatars1.githubusercontent.com/u/655866?v=4', 'gravatar_id': '', 'url': 'https://api.github.com/users/colesbury', 'html_url': 'https://github.com/colesbury', 'followers_url': 'https://api.github.com/users/colesbury/followers', 'following_url': 'https://api.github.com/users/colesbury/following{/other_user}', 'gists_url': 'https://api.github.com/users/colesbury/gists{/gist_id}', 'starred_url': 'https://api.github.com/users/colesbury/starred{/owner}{/repo}', 'subscriptions_url': 'https://api.github.com/users/colesbury/subscriptions', 'organizations_url': 'https://api.github.com/users/colesbury/orgs', 'repos_url': 'https://api.github.com/users/colesbury/repos', 'events_url': 'https://api.github.com/users/colesbury/events{/privacy}', 'received_events_url': 'https://api.github.com/users/colesbury/received_events', 'type': 'User', 'site_admin': False}",referenced,50a63ee6fd826669fe47c24585064718b5161e1f,https://api.github.com/repos/pytorch/pytorch/commits/50a63ee6fd826669fe47c24585064718b5161e1f,2017-11-06T22:11:52Z,71,36,35
3264,1328634462,"{'login': 'colesbury', 'id': 655866, 'node_id': 'MDQ6VXNlcjY1NTg2Ng==', 'avatar_url': 'https://avatars1.githubusercontent.com/u/655866?v=4', 'gravatar_id': '', 'url': 'https://api.github.com/users/colesbury', 'html_url': 'https://github.com/colesbury', 'followers_url': 'https://api.github.com/users/colesbury/followers', 'following_url': 'https://api.github.com/users/colesbury/following{/other_user}', 'gists_url': 'https://api.github.com/users/colesbury/gists{/gist_id}', 'starred_url': 'https://api.github.com/users/colesbury/starred{/owner}{/repo}', 'subscriptions_url': 'https://api.github.com/users/colesbury/subscriptions', 'organizations_url': 'https://api.github.com/users/colesbury/orgs', 'repos_url': 'https://api.github.com/users/colesbury/repos', 'events_url': 'https://api.github.com/users/colesbury/events{/privacy}', 'received_events_url': 'https://api.github.com/users/colesbury/received_events', 'type': 'User', 'site_admin': False}",referenced,3d9630abc23a56a1ad60f42574040e71281ea423,https://api.github.com/repos/pytorch/pytorch/commits/3d9630abc23a56a1ad60f42574040e71281ea423,2017-11-06T22:52:06Z,71,36,35
3241,1323941341,"{'login': 'colesbury', 'id': 655866, 'node_id': 'MDQ6VXNlcjY1NTg2Ng==', 'avatar_url': 'https://avatars1.githubusercontent.com/u/655866?v=4', 'gravatar_id': '', 'url': 'https://api.github.com/users/colesbury', 'html_url': 'https://github.com/colesbury', 'followers_url': 'https://api.github.com/users/colesbury/followers', 'following_url': 'https://api.github.com/users/colesbury/following{/other_user}', 'gists_url': 'https://api.github.com/users/colesbury/gists{/gist_id}', 'starred_url': 'https://api.github.com/users/colesbury/starred{/owner}{/repo}', 'subscriptions_url': 'https://api.github.com/users/colesbury/subscriptions', 'organizations_url': 'https://api.github.com/users/colesbury/orgs', 'repos_url': 'https://api.github.com/users/colesbury/repos', 'events_url': 'https://api.github.com/users/colesbury/events{/privacy}', 'received_events_url': 'https://api.github.com/users/colesbury/received_events', 'type': 'User', 'site_admin': False}",referenced,3003ebe67ae03922312e796990eac6a00a9d1633,https://api.github.com/repos/pytorch/pytorch/commits/3003ebe67ae03922312e796990eac6a00a9d1633,2017-11-02T21:23:34Z,160,97,63
3234,1308232214,"{'login': 'ezyang', 'id': 13564, 'node_id': 'MDQ6VXNlcjEzNTY0', 'avatar_url': 'https://avatars0.githubusercontent.com/u/13564?v=4', 'gravatar_id': '', 'url': 'https://api.github.com/users/ezyang', 'html_url': 'https://github.com/ezyang', 'followers_url': 'https://api.github.com/users/ezyang/followers', 'following_url': 'https://api.github.com/users/ezyang/following{/other_user}', 'gists_url': 'https://api.github.com/users/ezyang/gists{/gist_id}', 'starred_url': 'https://api.github.com/users/ezyang/starred{/owner}{/repo}', 'subscriptions_url': 'https://api.github.com/users/ezyang/subscriptions', 'organizations_url': 'https://api.github.com/users/ezyang/orgs', 'repos_url': 'https://api.github.com/users/ezyang/repos', 'events_url': 'https://api.github.com/users/ezyang/events{/privacy}', 'received_events_url': 'https://api.github.com/users/ezyang/received_events', 'type': 'User', 'site_admin': False}",closed,cc5a948e62e843453938e77cf2724e3be9f2d0b3,https://api.github.com/repos/pytorch/pytorch/commits/cc5a948e62e843453938e77cf2724e3be9f2d0b3,2017-10-24T17:13:47Z,82,59,23
3225,1377794469,"{'login': 'colesbury', 'id': 655866, 'node_id': 'MDQ6VXNlcjY1NTg2Ng==', 'avatar_url': 'https://avatars1.githubusercontent.com/u/655866?v=4', 'gravatar_id': '', 'url': 'https://api.github.com/users/colesbury', 'html_url': 'https://github.com/colesbury', 'followers_url': 'https://api.github.com/users/colesbury/followers', 'following_url': 'https://api.github.com/users/colesbury/following{/other_user}', 'gists_url': 'https://api.github.com/users/colesbury/gists{/gist_id}', 'starred_url': 'https://api.github.com/users/colesbury/starred{/owner}{/repo}', 'subscriptions_url': 'https://api.github.com/users/colesbury/subscriptions', 'organizations_url': 'https://api.github.com/users/colesbury/orgs', 'repos_url': 'https://api.github.com/users/colesbury/repos', 'events_url': 'https://api.github.com/users/colesbury/events{/privacy}', 'received_events_url': 'https://api.github.com/users/colesbury/received_events', 'type': 'User', 'site_admin': False}",referenced,9ea576d06839b7c888865921c2bd66db1fbc3648,https://api.github.com/repos/pytorch/pytorch/commits/9ea576d06839b7c888865921c2bd66db1fbc3648,2017-12-07T21:37:29Z,50,6,44
3192,1303555156,"{'login': 'gchanan', 'id': 3768583, 'node_id': 'MDQ6VXNlcjM3Njg1ODM=', 'avatar_url': 'https://avatars2.githubusercontent.com/u/3768583?v=4', 'gravatar_id': '', 'url': 'https://api.github.com/users/gchanan', 'html_url': 'https://github.com/gchanan', 'followers_url': 'https://api.github.com/users/gchanan/followers', 'following_url': 'https://api.github.com/users/gchanan/following{/other_user}', 'gists_url': 'https://api.github.com/users/gchanan/gists{/gist_id}', 'starred_url': 'https://api.github.com/users/gchanan/starred{/owner}{/repo}', 'subscriptions_url': 'https://api.github.com/users/gchanan/subscriptions', 'organizations_url': 'https://api.github.com/users/gchanan/orgs', 'repos_url': 'https://api.github.com/users/gchanan/repos', 'events_url': 'https://api.github.com/users/gchanan/events{/privacy}', 'received_events_url': 'https://api.github.com/users/gchanan/received_events', 'type': 'User', 'site_admin': False}",closed,95605400841cdd6a244d0c2a01a75f5062155ae6,https://api.github.com/repos/pytorch/pytorch/commits/95605400841cdd6a244d0c2a01a75f5062155ae6,2017-10-20T18:42:49Z,1,1,0
3192,1324121698,"{'login': 'ezyang', 'id': 13564, 'node_id': 'MDQ6VXNlcjEzNTY0', 'avatar_url': 'https://avatars0.githubusercontent.com/u/13564?v=4', 'gravatar_id': '', 'url': 'https://api.github.com/users/ezyang', 'html_url': 'https://github.com/ezyang', 'followers_url': 'https://api.github.com/users/ezyang/followers', 'following_url': 'https://api.github.com/users/ezyang/following{/other_user}', 'gists_url': 'https://api.github.com/users/ezyang/gists{/gist_id}', 'starred_url': 'https://api.github.com/users/ezyang/starred{/owner}{/repo}', 'subscriptions_url': 'https://api.github.com/users/ezyang/subscriptions', 'organizations_url': 'https://api.github.com/users/ezyang/orgs', 'repos_url': 'https://api.github.com/users/ezyang/repos', 'events_url': 'https://api.github.com/users/ezyang/events{/privacy}', 'received_events_url': 'https://api.github.com/users/ezyang/received_events', 'type': 'User', 'site_admin': False}",referenced,db1292a5098e640d26489481703b50f5ae5259c0,https://api.github.com/repos/pytorch/pytorch/commits/db1292a5098e640d26489481703b50f5ae5259c0,2017-11-02T23:53:51Z,1,1,0
3183,1302860241,"{'login': 'andreh7', 'id': 2156379, 'node_id': 'MDQ6VXNlcjIxNTYzNzk=', 'avatar_url': 'https://avatars0.githubusercontent.com/u/2156379?v=4', 'gravatar_id': '', 'url': 'https://api.github.com/users/andreh7', 'html_url': 'https://github.com/andreh7', 'followers_url': 'https://api.github.com/users/andreh7/followers', 'following_url': 'https://api.github.com/users/andreh7/following{/other_user}', 'gists_url': 'https://api.github.com/users/andreh7/gists{/gist_id}', 'starred_url': 'https://api.github.com/users/andreh7/starred{/owner}{/repo}', 'subscriptions_url': 'https://api.github.com/users/andreh7/subscriptions', 'organizations_url': 'https://api.github.com/users/andreh7/orgs', 'repos_url': 'https://api.github.com/users/andreh7/repos', 'events_url': 'https://api.github.com/users/andreh7/events{/privacy}', 'received_events_url': 'https://api.github.com/users/andreh7/received_events', 'type': 'User', 'site_admin': False}",referenced,cb011410b8a39f7f4891b967bd3d2d40c31167e0,https://api.github.com/repos/pytorch/pytorch/commits/cb011410b8a39f7f4891b967bd3d2d40c31167e0,2017-10-20T11:53:37Z,3,2,1
3164,1616284637,"{'login': 'soumith', 'id': 1310570, 'node_id': 'MDQ6VXNlcjEzMTA1NzA=', 'avatar_url': 'https://avatars0.githubusercontent.com/u/1310570?v=4', 'gravatar_id': '', 'url': 'https://api.github.com/users/soumith', 'html_url': 'https://github.com/soumith', 'followers_url': 'https://api.github.com/users/soumith/followers', 'following_url': 'https://api.github.com/users/soumith/following{/other_user}', 'gists_url': 'https://api.github.com/users/soumith/gists{/gist_id}', 'starred_url': 'https://api.github.com/users/soumith/starred{/owner}{/repo}', 'subscriptions_url': 'https://api.github.com/users/soumith/subscriptions', 'organizations_url': 'https://api.github.com/users/soumith/orgs', 'repos_url': 'https://api.github.com/users/soumith/repos', 'events_url': 'https://api.github.com/users/soumith/events{/privacy}', 'received_events_url': 'https://api.github.com/users/soumith/received_events', 'type': 'User', 'site_admin': False}",referenced,71626491c40c86eb1ee410e695c467486084144c,https://api.github.com/repos/pytorch/pytorch/commits/71626491c40c86eb1ee410e695c467486084144c,2018-05-08T21:06:54Z,524,510,14
3111,1301961630,"{'login': 'colesbury', 'id': 655866, 'node_id': 'MDQ6VXNlcjY1NTg2Ng==', 'avatar_url': 'https://avatars1.githubusercontent.com/u/655866?v=4', 'gravatar_id': '', 'url': 'https://api.github.com/users/colesbury', 'html_url': 'https://github.com/colesbury', 'followers_url': 'https://api.github.com/users/colesbury/followers', 'following_url': 'https://api.github.com/users/colesbury/following{/other_user}', 'gists_url': 'https://api.github.com/users/colesbury/gists{/gist_id}', 'starred_url': 'https://api.github.com/users/colesbury/starred{/owner}{/repo}', 'subscriptions_url': 'https://api.github.com/users/colesbury/subscriptions', 'organizations_url': 'https://api.github.com/users/colesbury/orgs', 'repos_url': 'https://api.github.com/users/colesbury/repos', 'events_url': 'https://api.github.com/users/colesbury/events{/privacy}', 'received_events_url': 'https://api.github.com/users/colesbury/received_events', 'type': 'User', 'site_admin': False}",referenced,e970d350914833aed4847520cba84123eb0c149c,https://api.github.com/repos/pytorch/pytorch/commits/e970d350914833aed4847520cba84123eb0c149c,2017-10-19T21:22:10Z,178,114,64
3104,1299984454,"{'login': 'apaszke', 'id': 4583066, 'node_id': 'MDQ6VXNlcjQ1ODMwNjY=', 'avatar_url': 'https://avatars3.githubusercontent.com/u/4583066?v=4', 'gravatar_id': '', 'url': 'https://api.github.com/users/apaszke', 'html_url': 'https://github.com/apaszke', 'followers_url': 'https://api.github.com/users/apaszke/followers', 'following_url': 'https://api.github.com/users/apaszke/following{/other_user}', 'gists_url': 'https://api.github.com/users/apaszke/gists{/gist_id}', 'starred_url': 'https://api.github.com/users/apaszke/starred{/owner}{/repo}', 'subscriptions_url': 'https://api.github.com/users/apaszke/subscriptions', 'organizations_url': 'https://api.github.com/users/apaszke/orgs', 'repos_url': 'https://api.github.com/users/apaszke/repos', 'events_url': 'https://api.github.com/users/apaszke/events{/privacy}', 'received_events_url': 'https://api.github.com/users/apaszke/received_events', 'type': 'User', 'site_admin': False}",referenced,57ffe64cbe67c6ab4e6bf0a73cf801b93c41fe7d,https://api.github.com/repos/pytorch/pytorch/commits/57ffe64cbe67c6ab4e6bf0a73cf801b93c41fe7d,2017-10-18T21:38:15Z,258,171,87
3059,2928611134,"{'login': 'ezyang', 'id': 13564, 'node_id': 'MDQ6VXNlcjEzNTY0', 'avatar_url': 'https://avatars0.githubusercontent.com/u/13564?v=4', 'gravatar_id': '', 'url': 'https://api.github.com/users/ezyang', 'html_url': 'https://github.com/ezyang', 'followers_url': 'https://api.github.com/users/ezyang/followers', 'following_url': 'https://api.github.com/users/ezyang/following{/other_user}', 'gists_url': 'https://api.github.com/users/ezyang/gists{/gist_id}', 'starred_url': 'https://api.github.com/users/ezyang/starred{/owner}{/repo}', 'subscriptions_url': 'https://api.github.com/users/ezyang/subscriptions', 'organizations_url': 'https://api.github.com/users/ezyang/orgs', 'repos_url': 'https://api.github.com/users/ezyang/repos', 'events_url': 'https://api.github.com/users/ezyang/events{/privacy}', 'received_events_url': 'https://api.github.com/users/ezyang/received_events', 'type': 'User', 'site_admin': False}",referenced,873401373852d5149bb8c657445efe73595a6d9c,https://api.github.com/repos/pytorch/pytorch/commits/873401373852d5149bb8c657445efe73595a6d9c,2020-01-07T18:27:42Z,0,0,0
3059,2928611417,"{'login': 'ezyang', 'id': 13564, 'node_id': 'MDQ6VXNlcjEzNTY0', 'avatar_url': 'https://avatars0.githubusercontent.com/u/13564?v=4', 'gravatar_id': '', 'url': 'https://api.github.com/users/ezyang', 'html_url': 'https://github.com/ezyang', 'followers_url': 'https://api.github.com/users/ezyang/followers', 'following_url': 'https://api.github.com/users/ezyang/following{/other_user}', 'gists_url': 'https://api.github.com/users/ezyang/gists{/gist_id}', 'starred_url': 'https://api.github.com/users/ezyang/starred{/owner}{/repo}', 'subscriptions_url': 'https://api.github.com/users/ezyang/subscriptions', 'organizations_url': 'https://api.github.com/users/ezyang/orgs', 'repos_url': 'https://api.github.com/users/ezyang/repos', 'events_url': 'https://api.github.com/users/ezyang/events{/privacy}', 'received_events_url': 'https://api.github.com/users/ezyang/received_events', 'type': 'User', 'site_admin': False}",referenced,20872e72d43b0708a7d3a628fcc6472fed69f844,https://api.github.com/repos/pytorch/pytorch/commits/20872e72d43b0708a7d3a628fcc6472fed69f844,2020-01-07T18:27:48Z,99,58,41
3059,2928613316,"{'login': 'ezyang', 'id': 13564, 'node_id': 'MDQ6VXNlcjEzNTY0', 'avatar_url': 'https://avatars0.githubusercontent.com/u/13564?v=4', 'gravatar_id': '', 'url': 'https://api.github.com/users/ezyang', 'html_url': 'https://github.com/ezyang', 'followers_url': 'https://api.github.com/users/ezyang/followers', 'following_url': 'https://api.github.com/users/ezyang/following{/other_user}', 'gists_url': 'https://api.github.com/users/ezyang/gists{/gist_id}', 'starred_url': 'https://api.github.com/users/ezyang/starred{/owner}{/repo}', 'subscriptions_url': 'https://api.github.com/users/ezyang/subscriptions', 'organizations_url': 'https://api.github.com/users/ezyang/orgs', 'repos_url': 'https://api.github.com/users/ezyang/repos', 'events_url': 'https://api.github.com/users/ezyang/events{/privacy}', 'received_events_url': 'https://api.github.com/users/ezyang/received_events', 'type': 'User', 'site_admin': False}",referenced,b62ee33da69c1da49e653962035764ff78e11a42,https://api.github.com/repos/pytorch/pytorch/commits/b62ee33da69c1da49e653962035764ff78e11a42,2020-01-07T18:28:29Z,314,247,67
3026,1583530231,"{'login': 'soumith', 'id': 1310570, 'node_id': 'MDQ6VXNlcjEzMTA1NzA=', 'avatar_url': 'https://avatars0.githubusercontent.com/u/1310570?v=4', 'gravatar_id': '', 'url': 'https://api.github.com/users/soumith', 'html_url': 'https://github.com/soumith', 'followers_url': 'https://api.github.com/users/soumith/followers', 'following_url': 'https://api.github.com/users/soumith/following{/other_user}', 'gists_url': 'https://api.github.com/users/soumith/gists{/gist_id}', 'starred_url': 'https://api.github.com/users/soumith/starred{/owner}{/repo}', 'subscriptions_url': 'https://api.github.com/users/soumith/subscriptions', 'organizations_url': 'https://api.github.com/users/soumith/orgs', 'repos_url': 'https://api.github.com/users/soumith/repos', 'events_url': 'https://api.github.com/users/soumith/events{/privacy}', 'received_events_url': 'https://api.github.com/users/soumith/received_events', 'type': 'User', 'site_admin': False}",closed,e44f901b55873ebb6b1b0d3bab30fd89d487b71c,https://api.github.com/repos/pytorch/pytorch/commits/e44f901b55873ebb6b1b0d3bab30fd89d487b71c,2018-04-19T11:09:29Z,59,58,1
2898,1284309978,"{'login': 'soumith', 'id': 1310570, 'node_id': 'MDQ6VXNlcjEzMTA1NzA=', 'avatar_url': 'https://avatars0.githubusercontent.com/u/1310570?v=4', 'gravatar_id': '', 'url': 'https://api.github.com/users/soumith', 'html_url': 'https://github.com/soumith', 'followers_url': 'https://api.github.com/users/soumith/followers', 'following_url': 'https://api.github.com/users/soumith/following{/other_user}', 'gists_url': 'https://api.github.com/users/soumith/gists{/gist_id}', 'starred_url': 'https://api.github.com/users/soumith/starred{/owner}{/repo}', 'subscriptions_url': 'https://api.github.com/users/soumith/subscriptions', 'organizations_url': 'https://api.github.com/users/soumith/orgs', 'repos_url': 'https://api.github.com/users/soumith/repos', 'events_url': 'https://api.github.com/users/soumith/events{/privacy}', 'received_events_url': 'https://api.github.com/users/soumith/received_events', 'type': 'User', 'site_admin': False}",referenced,a0831219cf8e06ab8438d50dbf4617db78d931c1,https://api.github.com/repos/pytorch/pytorch/commits/a0831219cf8e06ab8438d50dbf4617db78d931c1,2017-10-09T15:07:21Z,1,0,1
2809,1270964783,"{'login': 'soumith', 'id': 1310570, 'node_id': 'MDQ6VXNlcjEzMTA1NzA=', 'avatar_url': 'https://avatars0.githubusercontent.com/u/1310570?v=4', 'gravatar_id': '', 'url': 'https://api.github.com/users/soumith', 'html_url': 'https://github.com/soumith', 'followers_url': 'https://api.github.com/users/soumith/followers', 'following_url': 'https://api.github.com/users/soumith/following{/other_user}', 'gists_url': 'https://api.github.com/users/soumith/gists{/gist_id}', 'starred_url': 'https://api.github.com/users/soumith/starred{/owner}{/repo}', 'subscriptions_url': 'https://api.github.com/users/soumith/subscriptions', 'organizations_url': 'https://api.github.com/users/soumith/orgs', 'repos_url': 'https://api.github.com/users/soumith/repos', 'events_url': 'https://api.github.com/users/soumith/events{/privacy}', 'received_events_url': 'https://api.github.com/users/soumith/received_events', 'type': 'User', 'site_admin': False}",referenced,6a800be748761ab4d09b7e0473968befb94905f9,https://api.github.com/repos/pytorch/pytorch/commits/6a800be748761ab4d09b7e0473968befb94905f9,2017-09-29T03:38:32Z,1,1,0
2633,1257461335,"{'login': 'soumith', 'id': 1310570, 'node_id': 'MDQ6VXNlcjEzMTA1NzA=', 'avatar_url': 'https://avatars0.githubusercontent.com/u/1310570?v=4', 'gravatar_id': '', 'url': 'https://api.github.com/users/soumith', 'html_url': 'https://github.com/soumith', 'followers_url': 'https://api.github.com/users/soumith/followers', 'following_url': 'https://api.github.com/users/soumith/following{/other_user}', 'gists_url': 'https://api.github.com/users/soumith/gists{/gist_id}', 'starred_url': 'https://api.github.com/users/soumith/starred{/owner}{/repo}', 'subscriptions_url': 'https://api.github.com/users/soumith/subscriptions', 'organizations_url': 'https://api.github.com/users/soumith/orgs', 'repos_url': 'https://api.github.com/users/soumith/repos', 'events_url': 'https://api.github.com/users/soumith/events{/privacy}', 'received_events_url': 'https://api.github.com/users/soumith/received_events', 'type': 'User', 'site_admin': False}",referenced,06fdce04ca14bfd6c64a04736214046787966fb9,https://api.github.com/repos/pytorch/pytorch/commits/06fdce04ca14bfd6c64a04736214046787966fb9,2017-09-20T13:44:09Z,4374,4373,1
2613,1234966248,"{'login': 'soumith', 'id': 1310570, 'node_id': 'MDQ6VXNlcjEzMTA1NzA=', 'avatar_url': 'https://avatars0.githubusercontent.com/u/1310570?v=4', 'gravatar_id': '', 'url': 'https://api.github.com/users/soumith', 'html_url': 'https://github.com/soumith', 'followers_url': 'https://api.github.com/users/soumith/followers', 'following_url': 'https://api.github.com/users/soumith/following{/other_user}', 'gists_url': 'https://api.github.com/users/soumith/gists{/gist_id}', 'starred_url': 'https://api.github.com/users/soumith/starred{/owner}{/repo}', 'subscriptions_url': 'https://api.github.com/users/soumith/subscriptions', 'organizations_url': 'https://api.github.com/users/soumith/orgs', 'repos_url': 'https://api.github.com/users/soumith/repos', 'events_url': 'https://api.github.com/users/soumith/events{/privacy}', 'received_events_url': 'https://api.github.com/users/soumith/received_events', 'type': 'User', 'site_admin': False}",referenced,1b013c0b520ad7925e918f5ebe1ca8560672cb02,https://api.github.com/repos/pytorch/pytorch/commits/1b013c0b520ad7925e918f5ebe1ca8560672cb02,2017-09-05T14:14:08Z,9,5,4
2603,3079428872,"{'login': 'facebook-github-bot', 'id': 6422482, 'node_id': 'MDQ6VXNlcjY0MjI0ODI=', 'avatar_url': 'https://avatars3.githubusercontent.com/u/6422482?v=4', 'gravatar_id': '', 'url': 'https://api.github.com/users/facebook-github-bot', 'html_url': 'https://github.com/facebook-github-bot', 'followers_url': 'https://api.github.com/users/facebook-github-bot/followers', 'following_url': 'https://api.github.com/users/facebook-github-bot/following{/other_user}', 'gists_url': 'https://api.github.com/users/facebook-github-bot/gists{/gist_id}', 'starred_url': 'https://api.github.com/users/facebook-github-bot/starred{/owner}{/repo}', 'subscriptions_url': 'https://api.github.com/users/facebook-github-bot/subscriptions', 'organizations_url': 'https://api.github.com/users/facebook-github-bot/orgs', 'repos_url': 'https://api.github.com/users/facebook-github-bot/repos', 'events_url': 'https://api.github.com/users/facebook-github-bot/events{/privacy}', 'received_events_url': 'https://api.github.com/users/facebook-github-bot/received_events', 'type': 'User', 'site_admin': False}",referenced,6647a44e8cf96237851999a1d606c094b2809f5b,https://api.github.com/repos/pytorch/pytorch/commits/6647a44e8cf96237851999a1d606c094b2809f5b,2020-02-27T20:42:44Z,2,1,1
2603,3083150146,"{'login': 'hczhu', 'id': 2289363, 'node_id': 'MDQ6VXNlcjIyODkzNjM=', 'avatar_url': 'https://avatars0.githubusercontent.com/u/2289363?v=4', 'gravatar_id': '', 'url': 'https://api.github.com/users/hczhu', 'html_url': 'https://github.com/hczhu', 'followers_url': 'https://api.github.com/users/hczhu/followers', 'following_url': 'https://api.github.com/users/hczhu/following{/other_user}', 'gists_url': 'https://api.github.com/users/hczhu/gists{/gist_id}', 'starred_url': 'https://api.github.com/users/hczhu/starred{/owner}{/repo}', 'subscriptions_url': 'https://api.github.com/users/hczhu/subscriptions', 'organizations_url': 'https://api.github.com/users/hczhu/orgs', 'repos_url': 'https://api.github.com/users/hczhu/repos', 'events_url': 'https://api.github.com/users/hczhu/events{/privacy}', 'received_events_url': 'https://api.github.com/users/hczhu/received_events', 'type': 'User', 'site_admin': False}",referenced,2564b0161a08ff4724050fb4aeaa25230aa5d19d,https://api.github.com/repos/pytorch/pytorch/commits/2564b0161a08ff4724050fb4aeaa25230aa5d19d,2020-02-28T18:58:44Z,2,1,1
2598,3037459956,"{'login': 'facebook-github-bot', 'id': 6422482, 'node_id': 'MDQ6VXNlcjY0MjI0ODI=', 'avatar_url': 'https://avatars3.githubusercontent.com/u/6422482?v=4', 'gravatar_id': '', 'url': 'https://api.github.com/users/facebook-github-bot', 'html_url': 'https://github.com/facebook-github-bot', 'followers_url': 'https://api.github.com/users/facebook-github-bot/followers', 'following_url': 'https://api.github.com/users/facebook-github-bot/following{/other_user}', 'gists_url': 'https://api.github.com/users/facebook-github-bot/gists{/gist_id}', 'starred_url': 'https://api.github.com/users/facebook-github-bot/starred{/owner}{/repo}', 'subscriptions_url': 'https://api.github.com/users/facebook-github-bot/subscriptions', 'organizations_url': 'https://api.github.com/users/facebook-github-bot/orgs', 'repos_url': 'https://api.github.com/users/facebook-github-bot/repos', 'events_url': 'https://api.github.com/users/facebook-github-bot/events{/privacy}', 'received_events_url': 'https://api.github.com/users/facebook-github-bot/received_events', 'type': 'User', 'site_admin': False}",referenced,e5c7b7b8b523cab3ef6697aab0595bbeb7ece76c,https://api.github.com/repos/pytorch/pytorch/commits/e5c7b7b8b523cab3ef6697aab0595bbeb7ece76c,2020-02-14T05:05:08Z,3,2,1
2596,3037459958,"{'login': 'facebook-github-bot', 'id': 6422482, 'node_id': 'MDQ6VXNlcjY0MjI0ODI=', 'avatar_url': 'https://avatars3.githubusercontent.com/u/6422482?v=4', 'gravatar_id': '', 'url': 'https://api.github.com/users/facebook-github-bot', 'html_url': 'https://github.com/facebook-github-bot', 'followers_url': 'https://api.github.com/users/facebook-github-bot/followers', 'following_url': 'https://api.github.com/users/facebook-github-bot/following{/other_user}', 'gists_url': 'https://api.github.com/users/facebook-github-bot/gists{/gist_id}', 'starred_url': 'https://api.github.com/users/facebook-github-bot/starred{/owner}{/repo}', 'subscriptions_url': 'https://api.github.com/users/facebook-github-bot/subscriptions', 'organizations_url': 'https://api.github.com/users/facebook-github-bot/orgs', 'repos_url': 'https://api.github.com/users/facebook-github-bot/repos', 'events_url': 'https://api.github.com/users/facebook-github-bot/events{/privacy}', 'received_events_url': 'https://api.github.com/users/facebook-github-bot/received_events', 'type': 'User', 'site_admin': False}",referenced,e5c7b7b8b523cab3ef6697aab0595bbeb7ece76c,https://api.github.com/repos/pytorch/pytorch/commits/e5c7b7b8b523cab3ef6697aab0595bbeb7ece76c,2020-02-14T05:05:08Z,3,2,1
2592,3037459966,"{'login': 'facebook-github-bot', 'id': 6422482, 'node_id': 'MDQ6VXNlcjY0MjI0ODI=', 'avatar_url': 'https://avatars3.githubusercontent.com/u/6422482?v=4', 'gravatar_id': '', 'url': 'https://api.github.com/users/facebook-github-bot', 'html_url': 'https://github.com/facebook-github-bot', 'followers_url': 'https://api.github.com/users/facebook-github-bot/followers', 'following_url': 'https://api.github.com/users/facebook-github-bot/following{/other_user}', 'gists_url': 'https://api.github.com/users/facebook-github-bot/gists{/gist_id}', 'starred_url': 'https://api.github.com/users/facebook-github-bot/starred{/owner}{/repo}', 'subscriptions_url': 'https://api.github.com/users/facebook-github-bot/subscriptions', 'organizations_url': 'https://api.github.com/users/facebook-github-bot/orgs', 'repos_url': 'https://api.github.com/users/facebook-github-bot/repos', 'events_url': 'https://api.github.com/users/facebook-github-bot/events{/privacy}', 'received_events_url': 'https://api.github.com/users/facebook-github-bot/received_events', 'type': 'User', 'site_admin': False}",referenced,e5c7b7b8b523cab3ef6697aab0595bbeb7ece76c,https://api.github.com/repos/pytorch/pytorch/commits/e5c7b7b8b523cab3ef6697aab0595bbeb7ece76c,2020-02-14T05:05:08Z,3,2,1
2591,1626168502,"{'login': 'ezyang', 'id': 13564, 'node_id': 'MDQ6VXNlcjEzNTY0', 'avatar_url': 'https://avatars0.githubusercontent.com/u/13564?v=4', 'gravatar_id': '', 'url': 'https://api.github.com/users/ezyang', 'html_url': 'https://github.com/ezyang', 'followers_url': 'https://api.github.com/users/ezyang/followers', 'following_url': 'https://api.github.com/users/ezyang/following{/other_user}', 'gists_url': 'https://api.github.com/users/ezyang/gists{/gist_id}', 'starred_url': 'https://api.github.com/users/ezyang/starred{/owner}{/repo}', 'subscriptions_url': 'https://api.github.com/users/ezyang/subscriptions', 'organizations_url': 'https://api.github.com/users/ezyang/orgs', 'repos_url': 'https://api.github.com/users/ezyang/repos', 'events_url': 'https://api.github.com/users/ezyang/events{/privacy}', 'received_events_url': 'https://api.github.com/users/ezyang/received_events', 'type': 'User', 'site_admin': False}",closed,e1148db7f257c9cec1bd85b725aa647557bf2178,https://api.github.com/repos/pytorch/pytorch/commits/e1148db7f257c9cec1bd85b725aa647557bf2178,2018-05-15T02:08:39Z,82,82,0
2583,3017118509,"{'login': 'facebook-github-bot', 'id': 6422482, 'node_id': 'MDQ6VXNlcjY0MjI0ODI=', 'avatar_url': 'https://avatars3.githubusercontent.com/u/6422482?v=4', 'gravatar_id': '', 'url': 'https://api.github.com/users/facebook-github-bot', 'html_url': 'https://github.com/facebook-github-bot', 'followers_url': 'https://api.github.com/users/facebook-github-bot/followers', 'following_url': 'https://api.github.com/users/facebook-github-bot/following{/other_user}', 'gists_url': 'https://api.github.com/users/facebook-github-bot/gists{/gist_id}', 'starred_url': 'https://api.github.com/users/facebook-github-bot/starred{/owner}{/repo}', 'subscriptions_url': 'https://api.github.com/users/facebook-github-bot/subscriptions', 'organizations_url': 'https://api.github.com/users/facebook-github-bot/orgs', 'repos_url': 'https://api.github.com/users/facebook-github-bot/repos', 'events_url': 'https://api.github.com/users/facebook-github-bot/events{/privacy}', 'received_events_url': 'https://api.github.com/users/facebook-github-bot/received_events', 'type': 'User', 'site_admin': False}",referenced,674dca0831874314bf34b94f58f3a311708df34a,https://api.github.com/repos/pytorch/pytorch/commits/674dca0831874314bf34b94f58f3a311708df34a,2020-02-07T10:20:26Z,7,6,1
2577,3017118498,"{'login': 'facebook-github-bot', 'id': 6422482, 'node_id': 'MDQ6VXNlcjY0MjI0ODI=', 'avatar_url': 'https://avatars3.githubusercontent.com/u/6422482?v=4', 'gravatar_id': '', 'url': 'https://api.github.com/users/facebook-github-bot', 'html_url': 'https://github.com/facebook-github-bot', 'followers_url': 'https://api.github.com/users/facebook-github-bot/followers', 'following_url': 'https://api.github.com/users/facebook-github-bot/following{/other_user}', 'gists_url': 'https://api.github.com/users/facebook-github-bot/gists{/gist_id}', 'starred_url': 'https://api.github.com/users/facebook-github-bot/starred{/owner}{/repo}', 'subscriptions_url': 'https://api.github.com/users/facebook-github-bot/subscriptions', 'organizations_url': 'https://api.github.com/users/facebook-github-bot/orgs', 'repos_url': 'https://api.github.com/users/facebook-github-bot/repos', 'events_url': 'https://api.github.com/users/facebook-github-bot/events{/privacy}', 'received_events_url': 'https://api.github.com/users/facebook-github-bot/received_events', 'type': 'User', 'site_admin': False}",referenced,674dca0831874314bf34b94f58f3a311708df34a,https://api.github.com/repos/pytorch/pytorch/commits/674dca0831874314bf34b94f58f3a311708df34a,2020-02-07T10:20:26Z,7,6,1
2572,3017118522,"{'login': 'facebook-github-bot', 'id': 6422482, 'node_id': 'MDQ6VXNlcjY0MjI0ODI=', 'avatar_url': 'https://avatars3.githubusercontent.com/u/6422482?v=4', 'gravatar_id': '', 'url': 'https://api.github.com/users/facebook-github-bot', 'html_url': 'https://github.com/facebook-github-bot', 'followers_url': 'https://api.github.com/users/facebook-github-bot/followers', 'following_url': 'https://api.github.com/users/facebook-github-bot/following{/other_user}', 'gists_url': 'https://api.github.com/users/facebook-github-bot/gists{/gist_id}', 'starred_url': 'https://api.github.com/users/facebook-github-bot/starred{/owner}{/repo}', 'subscriptions_url': 'https://api.github.com/users/facebook-github-bot/subscriptions', 'organizations_url': 'https://api.github.com/users/facebook-github-bot/orgs', 'repos_url': 'https://api.github.com/users/facebook-github-bot/repos', 'events_url': 'https://api.github.com/users/facebook-github-bot/events{/privacy}', 'received_events_url': 'https://api.github.com/users/facebook-github-bot/received_events', 'type': 'User', 'site_admin': False}",referenced,674dca0831874314bf34b94f58f3a311708df34a,https://api.github.com/repos/pytorch/pytorch/commits/674dca0831874314bf34b94f58f3a311708df34a,2020-02-07T10:20:27Z,7,6,1
2571,3017118528,"{'login': 'facebook-github-bot', 'id': 6422482, 'node_id': 'MDQ6VXNlcjY0MjI0ODI=', 'avatar_url': 'https://avatars3.githubusercontent.com/u/6422482?v=4', 'gravatar_id': '', 'url': 'https://api.github.com/users/facebook-github-bot', 'html_url': 'https://github.com/facebook-github-bot', 'followers_url': 'https://api.github.com/users/facebook-github-bot/followers', 'following_url': 'https://api.github.com/users/facebook-github-bot/following{/other_user}', 'gists_url': 'https://api.github.com/users/facebook-github-bot/gists{/gist_id}', 'starred_url': 'https://api.github.com/users/facebook-github-bot/starred{/owner}{/repo}', 'subscriptions_url': 'https://api.github.com/users/facebook-github-bot/subscriptions', 'organizations_url': 'https://api.github.com/users/facebook-github-bot/orgs', 'repos_url': 'https://api.github.com/users/facebook-github-bot/repos', 'events_url': 'https://api.github.com/users/facebook-github-bot/events{/privacy}', 'received_events_url': 'https://api.github.com/users/facebook-github-bot/received_events', 'type': 'User', 'site_admin': False}",referenced,674dca0831874314bf34b94f58f3a311708df34a,https://api.github.com/repos/pytorch/pytorch/commits/674dca0831874314bf34b94f58f3a311708df34a,2020-02-07T10:20:27Z,7,6,1
2568,3017118491,"{'login': 'facebook-github-bot', 'id': 6422482, 'node_id': 'MDQ6VXNlcjY0MjI0ODI=', 'avatar_url': 'https://avatars3.githubusercontent.com/u/6422482?v=4', 'gravatar_id': '', 'url': 'https://api.github.com/users/facebook-github-bot', 'html_url': 'https://github.com/facebook-github-bot', 'followers_url': 'https://api.github.com/users/facebook-github-bot/followers', 'following_url': 'https://api.github.com/users/facebook-github-bot/following{/other_user}', 'gists_url': 'https://api.github.com/users/facebook-github-bot/gists{/gist_id}', 'starred_url': 'https://api.github.com/users/facebook-github-bot/starred{/owner}{/repo}', 'subscriptions_url': 'https://api.github.com/users/facebook-github-bot/subscriptions', 'organizations_url': 'https://api.github.com/users/facebook-github-bot/orgs', 'repos_url': 'https://api.github.com/users/facebook-github-bot/repos', 'events_url': 'https://api.github.com/users/facebook-github-bot/events{/privacy}', 'received_events_url': 'https://api.github.com/users/facebook-github-bot/received_events', 'type': 'User', 'site_admin': False}",referenced,674dca0831874314bf34b94f58f3a311708df34a,https://api.github.com/repos/pytorch/pytorch/commits/674dca0831874314bf34b94f58f3a311708df34a,2020-02-07T10:20:26Z,7,6,1
2567,3017118512,"{'login': 'facebook-github-bot', 'id': 6422482, 'node_id': 'MDQ6VXNlcjY0MjI0ODI=', 'avatar_url': 'https://avatars3.githubusercontent.com/u/6422482?v=4', 'gravatar_id': '', 'url': 'https://api.github.com/users/facebook-github-bot', 'html_url': 'https://github.com/facebook-github-bot', 'followers_url': 'https://api.github.com/users/facebook-github-bot/followers', 'following_url': 'https://api.github.com/users/facebook-github-bot/following{/other_user}', 'gists_url': 'https://api.github.com/users/facebook-github-bot/gists{/gist_id}', 'starred_url': 'https://api.github.com/users/facebook-github-bot/starred{/owner}{/repo}', 'subscriptions_url': 'https://api.github.com/users/facebook-github-bot/subscriptions', 'organizations_url': 'https://api.github.com/users/facebook-github-bot/orgs', 'repos_url': 'https://api.github.com/users/facebook-github-bot/repos', 'events_url': 'https://api.github.com/users/facebook-github-bot/events{/privacy}', 'received_events_url': 'https://api.github.com/users/facebook-github-bot/received_events', 'type': 'User', 'site_admin': False}",referenced,674dca0831874314bf34b94f58f3a311708df34a,https://api.github.com/repos/pytorch/pytorch/commits/674dca0831874314bf34b94f58f3a311708df34a,2020-02-07T10:20:26Z,7,6,1
2555,3017118561,"{'login': 'facebook-github-bot', 'id': 6422482, 'node_id': 'MDQ6VXNlcjY0MjI0ODI=', 'avatar_url': 'https://avatars3.githubusercontent.com/u/6422482?v=4', 'gravatar_id': '', 'url': 'https://api.github.com/users/facebook-github-bot', 'html_url': 'https://github.com/facebook-github-bot', 'followers_url': 'https://api.github.com/users/facebook-github-bot/followers', 'following_url': 'https://api.github.com/users/facebook-github-bot/following{/other_user}', 'gists_url': 'https://api.github.com/users/facebook-github-bot/gists{/gist_id}', 'starred_url': 'https://api.github.com/users/facebook-github-bot/starred{/owner}{/repo}', 'subscriptions_url': 'https://api.github.com/users/facebook-github-bot/subscriptions', 'organizations_url': 'https://api.github.com/users/facebook-github-bot/orgs', 'repos_url': 'https://api.github.com/users/facebook-github-bot/repos', 'events_url': 'https://api.github.com/users/facebook-github-bot/events{/privacy}', 'received_events_url': 'https://api.github.com/users/facebook-github-bot/received_events', 'type': 'User', 'site_admin': False}",referenced,674dca0831874314bf34b94f58f3a311708df34a,https://api.github.com/repos/pytorch/pytorch/commits/674dca0831874314bf34b94f58f3a311708df34a,2020-02-07T10:20:27Z,7,6,1
2553,1228347238,"{'login': 'apaszke', 'id': 4583066, 'node_id': 'MDQ6VXNlcjQ1ODMwNjY=', 'avatar_url': 'https://avatars3.githubusercontent.com/u/4583066?v=4', 'gravatar_id': '', 'url': 'https://api.github.com/users/apaszke', 'html_url': 'https://github.com/apaszke', 'followers_url': 'https://api.github.com/users/apaszke/followers', 'following_url': 'https://api.github.com/users/apaszke/following{/other_user}', 'gists_url': 'https://api.github.com/users/apaszke/gists{/gist_id}', 'starred_url': 'https://api.github.com/users/apaszke/starred{/owner}{/repo}', 'subscriptions_url': 'https://api.github.com/users/apaszke/subscriptions', 'organizations_url': 'https://api.github.com/users/apaszke/orgs', 'repos_url': 'https://api.github.com/users/apaszke/repos', 'events_url': 'https://api.github.com/users/apaszke/events{/privacy}', 'received_events_url': 'https://api.github.com/users/apaszke/received_events', 'type': 'User', 'site_admin': False}",closed,466f0a823adec91a1fb78b7004d9ad01dc0a4d3c,https://api.github.com/repos/pytorch/pytorch/commits/466f0a823adec91a1fb78b7004d9ad01dc0a4d3c,2017-08-30T20:14:46Z,1,1,0
2529,2948976252,"{'login': 'facebook-github-bot', 'id': 6422482, 'node_id': 'MDQ6VXNlcjY0MjI0ODI=', 'avatar_url': 'https://avatars3.githubusercontent.com/u/6422482?v=4', 'gravatar_id': '', 'url': 'https://api.github.com/users/facebook-github-bot', 'html_url': 'https://github.com/facebook-github-bot', 'followers_url': 'https://api.github.com/users/facebook-github-bot/followers', 'following_url': 'https://api.github.com/users/facebook-github-bot/following{/other_user}', 'gists_url': 'https://api.github.com/users/facebook-github-bot/gists{/gist_id}', 'starred_url': 'https://api.github.com/users/facebook-github-bot/starred{/owner}{/repo}', 'subscriptions_url': 'https://api.github.com/users/facebook-github-bot/subscriptions', 'organizations_url': 'https://api.github.com/users/facebook-github-bot/orgs', 'repos_url': 'https://api.github.com/users/facebook-github-bot/repos', 'events_url': 'https://api.github.com/users/facebook-github-bot/events{/privacy}', 'received_events_url': 'https://api.github.com/users/facebook-github-bot/received_events', 'type': 'User', 'site_admin': False}",referenced,f6f1e0aef59350df466495b4c35e2905b537eff8,https://api.github.com/repos/pytorch/pytorch/commits/f6f1e0aef59350df466495b4c35e2905b537eff8,2020-01-14T23:23:25Z,5,3,2
2527,2948976243,"{'login': 'facebook-github-bot', 'id': 6422482, 'node_id': 'MDQ6VXNlcjY0MjI0ODI=', 'avatar_url': 'https://avatars3.githubusercontent.com/u/6422482?v=4', 'gravatar_id': '', 'url': 'https://api.github.com/users/facebook-github-bot', 'html_url': 'https://github.com/facebook-github-bot', 'followers_url': 'https://api.github.com/users/facebook-github-bot/followers', 'following_url': 'https://api.github.com/users/facebook-github-bot/following{/other_user}', 'gists_url': 'https://api.github.com/users/facebook-github-bot/gists{/gist_id}', 'starred_url': 'https://api.github.com/users/facebook-github-bot/starred{/owner}{/repo}', 'subscriptions_url': 'https://api.github.com/users/facebook-github-bot/subscriptions', 'organizations_url': 'https://api.github.com/users/facebook-github-bot/orgs', 'repos_url': 'https://api.github.com/users/facebook-github-bot/repos', 'events_url': 'https://api.github.com/users/facebook-github-bot/events{/privacy}', 'received_events_url': 'https://api.github.com/users/facebook-github-bot/received_events', 'type': 'User', 'site_admin': False}",referenced,f6f1e0aef59350df466495b4c35e2905b537eff8,https://api.github.com/repos/pytorch/pytorch/commits/f6f1e0aef59350df466495b4c35e2905b537eff8,2020-01-14T23:23:25Z,5,3,2
2519,2948976262,"{'login': 'facebook-github-bot', 'id': 6422482, 'node_id': 'MDQ6VXNlcjY0MjI0ODI=', 'avatar_url': 'https://avatars3.githubusercontent.com/u/6422482?v=4', 'gravatar_id': '', 'url': 'https://api.github.com/users/facebook-github-bot', 'html_url': 'https://github.com/facebook-github-bot', 'followers_url': 'https://api.github.com/users/facebook-github-bot/followers', 'following_url': 'https://api.github.com/users/facebook-github-bot/following{/other_user}', 'gists_url': 'https://api.github.com/users/facebook-github-bot/gists{/gist_id}', 'starred_url': 'https://api.github.com/users/facebook-github-bot/starred{/owner}{/repo}', 'subscriptions_url': 'https://api.github.com/users/facebook-github-bot/subscriptions', 'organizations_url': 'https://api.github.com/users/facebook-github-bot/orgs', 'repos_url': 'https://api.github.com/users/facebook-github-bot/repos', 'events_url': 'https://api.github.com/users/facebook-github-bot/events{/privacy}', 'received_events_url': 'https://api.github.com/users/facebook-github-bot/received_events', 'type': 'User', 'site_admin': False}",referenced,f6f1e0aef59350df466495b4c35e2905b537eff8,https://api.github.com/repos/pytorch/pytorch/commits/f6f1e0aef59350df466495b4c35e2905b537eff8,2020-01-14T23:23:25Z,5,3,2
2517,1261578976,"{'login': 'soumith', 'id': 1310570, 'node_id': 'MDQ6VXNlcjEzMTA1NzA=', 'avatar_url': 'https://avatars0.githubusercontent.com/u/1310570?v=4', 'gravatar_id': '', 'url': 'https://api.github.com/users/soumith', 'html_url': 'https://github.com/soumith', 'followers_url': 'https://api.github.com/users/soumith/followers', 'following_url': 'https://api.github.com/users/soumith/following{/other_user}', 'gists_url': 'https://api.github.com/users/soumith/gists{/gist_id}', 'starred_url': 'https://api.github.com/users/soumith/starred{/owner}{/repo}', 'subscriptions_url': 'https://api.github.com/users/soumith/subscriptions', 'organizations_url': 'https://api.github.com/users/soumith/orgs', 'repos_url': 'https://api.github.com/users/soumith/repos', 'events_url': 'https://api.github.com/users/soumith/events{/privacy}', 'received_events_url': 'https://api.github.com/users/soumith/received_events', 'type': 'User', 'site_admin': False}",referenced,b17dfa07baf48058d429b1095a47c0471759908f,https://api.github.com/repos/pytorch/pytorch/commits/b17dfa07baf48058d429b1095a47c0471759908f,2017-09-22T16:37:14Z,94,81,13
2510,2948976264,"{'login': 'facebook-github-bot', 'id': 6422482, 'node_id': 'MDQ6VXNlcjY0MjI0ODI=', 'avatar_url': 'https://avatars3.githubusercontent.com/u/6422482?v=4', 'gravatar_id': '', 'url': 'https://api.github.com/users/facebook-github-bot', 'html_url': 'https://github.com/facebook-github-bot', 'followers_url': 'https://api.github.com/users/facebook-github-bot/followers', 'following_url': 'https://api.github.com/users/facebook-github-bot/following{/other_user}', 'gists_url': 'https://api.github.com/users/facebook-github-bot/gists{/gist_id}', 'starred_url': 'https://api.github.com/users/facebook-github-bot/starred{/owner}{/repo}', 'subscriptions_url': 'https://api.github.com/users/facebook-github-bot/subscriptions', 'organizations_url': 'https://api.github.com/users/facebook-github-bot/orgs', 'repos_url': 'https://api.github.com/users/facebook-github-bot/repos', 'events_url': 'https://api.github.com/users/facebook-github-bot/events{/privacy}', 'received_events_url': 'https://api.github.com/users/facebook-github-bot/received_events', 'type': 'User', 'site_admin': False}",referenced,f6f1e0aef59350df466495b4c35e2905b537eff8,https://api.github.com/repos/pytorch/pytorch/commits/f6f1e0aef59350df466495b4c35e2905b537eff8,2020-01-14T23:23:25Z,5,3,2
2504,3017118536,"{'login': 'facebook-github-bot', 'id': 6422482, 'node_id': 'MDQ6VXNlcjY0MjI0ODI=', 'avatar_url': 'https://avatars3.githubusercontent.com/u/6422482?v=4', 'gravatar_id': '', 'url': 'https://api.github.com/users/facebook-github-bot', 'html_url': 'https://github.com/facebook-github-bot', 'followers_url': 'https://api.github.com/users/facebook-github-bot/followers', 'following_url': 'https://api.github.com/users/facebook-github-bot/following{/other_user}', 'gists_url': 'https://api.github.com/users/facebook-github-bot/gists{/gist_id}', 'starred_url': 'https://api.github.com/users/facebook-github-bot/starred{/owner}{/repo}', 'subscriptions_url': 'https://api.github.com/users/facebook-github-bot/subscriptions', 'organizations_url': 'https://api.github.com/users/facebook-github-bot/orgs', 'repos_url': 'https://api.github.com/users/facebook-github-bot/repos', 'events_url': 'https://api.github.com/users/facebook-github-bot/events{/privacy}', 'received_events_url': 'https://api.github.com/users/facebook-github-bot/received_events', 'type': 'User', 'site_admin': False}",referenced,674dca0831874314bf34b94f58f3a311708df34a,https://api.github.com/repos/pytorch/pytorch/commits/674dca0831874314bf34b94f58f3a311708df34a,2020-02-07T10:20:27Z,7,6,1
2500,2948976258,"{'login': 'facebook-github-bot', 'id': 6422482, 'node_id': 'MDQ6VXNlcjY0MjI0ODI=', 'avatar_url': 'https://avatars3.githubusercontent.com/u/6422482?v=4', 'gravatar_id': '', 'url': 'https://api.github.com/users/facebook-github-bot', 'html_url': 'https://github.com/facebook-github-bot', 'followers_url': 'https://api.github.com/users/facebook-github-bot/followers', 'following_url': 'https://api.github.com/users/facebook-github-bot/following{/other_user}', 'gists_url': 'https://api.github.com/users/facebook-github-bot/gists{/gist_id}', 'starred_url': 'https://api.github.com/users/facebook-github-bot/starred{/owner}{/repo}', 'subscriptions_url': 'https://api.github.com/users/facebook-github-bot/subscriptions', 'organizations_url': 'https://api.github.com/users/facebook-github-bot/orgs', 'repos_url': 'https://api.github.com/users/facebook-github-bot/repos', 'events_url': 'https://api.github.com/users/facebook-github-bot/events{/privacy}', 'received_events_url': 'https://api.github.com/users/facebook-github-bot/received_events', 'type': 'User', 'site_admin': False}",referenced,f6f1e0aef59350df466495b4c35e2905b537eff8,https://api.github.com/repos/pytorch/pytorch/commits/f6f1e0aef59350df466495b4c35e2905b537eff8,2020-01-14T23:23:25Z,5,3,2
2491,2910089522,"{'login': 'facebook-github-bot', 'id': 6422482, 'node_id': 'MDQ6VXNlcjY0MjI0ODI=', 'avatar_url': 'https://avatars3.githubusercontent.com/u/6422482?v=4', 'gravatar_id': '', 'url': 'https://api.github.com/users/facebook-github-bot', 'html_url': 'https://github.com/facebook-github-bot', 'followers_url': 'https://api.github.com/users/facebook-github-bot/followers', 'following_url': 'https://api.github.com/users/facebook-github-bot/following{/other_user}', 'gists_url': 'https://api.github.com/users/facebook-github-bot/gists{/gist_id}', 'starred_url': 'https://api.github.com/users/facebook-github-bot/starred{/owner}{/repo}', 'subscriptions_url': 'https://api.github.com/users/facebook-github-bot/subscriptions', 'organizations_url': 'https://api.github.com/users/facebook-github-bot/orgs', 'repos_url': 'https://api.github.com/users/facebook-github-bot/repos', 'events_url': 'https://api.github.com/users/facebook-github-bot/events{/privacy}', 'received_events_url': 'https://api.github.com/users/facebook-github-bot/received_events', 'type': 'User', 'site_admin': False}",referenced,204939b40132b9c764e765073b1a4df9ed05b86e,https://api.github.com/repos/pytorch/pytorch/commits/204939b40132b9c764e765073b1a4df9ed05b86e,2019-12-27T05:25:15Z,2,1,1
2486,2910089531,"{'login': 'facebook-github-bot', 'id': 6422482, 'node_id': 'MDQ6VXNlcjY0MjI0ODI=', 'avatar_url': 'https://avatars3.githubusercontent.com/u/6422482?v=4', 'gravatar_id': '', 'url': 'https://api.github.com/users/facebook-github-bot', 'html_url': 'https://github.com/facebook-github-bot', 'followers_url': 'https://api.github.com/users/facebook-github-bot/followers', 'following_url': 'https://api.github.com/users/facebook-github-bot/following{/other_user}', 'gists_url': 'https://api.github.com/users/facebook-github-bot/gists{/gist_id}', 'starred_url': 'https://api.github.com/users/facebook-github-bot/starred{/owner}{/repo}', 'subscriptions_url': 'https://api.github.com/users/facebook-github-bot/subscriptions', 'organizations_url': 'https://api.github.com/users/facebook-github-bot/orgs', 'repos_url': 'https://api.github.com/users/facebook-github-bot/repos', 'events_url': 'https://api.github.com/users/facebook-github-bot/events{/privacy}', 'received_events_url': 'https://api.github.com/users/facebook-github-bot/received_events', 'type': 'User', 'site_admin': False}",referenced,204939b40132b9c764e765073b1a4df9ed05b86e,https://api.github.com/repos/pytorch/pytorch/commits/204939b40132b9c764e765073b1a4df9ed05b86e,2019-12-27T05:25:15Z,2,1,1
2473,2871559511,"{'login': 'facebook-github-bot', 'id': 6422482, 'node_id': 'MDQ6VXNlcjY0MjI0ODI=', 'avatar_url': 'https://avatars3.githubusercontent.com/u/6422482?v=4', 'gravatar_id': '', 'url': 'https://api.github.com/users/facebook-github-bot', 'html_url': 'https://github.com/facebook-github-bot', 'followers_url': 'https://api.github.com/users/facebook-github-bot/followers', 'following_url': 'https://api.github.com/users/facebook-github-bot/following{/other_user}', 'gists_url': 'https://api.github.com/users/facebook-github-bot/gists{/gist_id}', 'starred_url': 'https://api.github.com/users/facebook-github-bot/starred{/owner}{/repo}', 'subscriptions_url': 'https://api.github.com/users/facebook-github-bot/subscriptions', 'organizations_url': 'https://api.github.com/users/facebook-github-bot/orgs', 'repos_url': 'https://api.github.com/users/facebook-github-bot/repos', 'events_url': 'https://api.github.com/users/facebook-github-bot/events{/privacy}', 'received_events_url': 'https://api.github.com/users/facebook-github-bot/received_events', 'type': 'User', 'site_admin': False}",referenced,c34ef1aa2edb4792d7bd0cb3a75d7a68e859212b,https://api.github.com/repos/pytorch/pytorch/commits/c34ef1aa2edb4792d7bd0cb3a75d7a68e859212b,2019-12-10T18:15:19Z,4,3,1
2468,2871559521,"{'login': 'facebook-github-bot', 'id': 6422482, 'node_id': 'MDQ6VXNlcjY0MjI0ODI=', 'avatar_url': 'https://avatars3.githubusercontent.com/u/6422482?v=4', 'gravatar_id': '', 'url': 'https://api.github.com/users/facebook-github-bot', 'html_url': 'https://github.com/facebook-github-bot', 'followers_url': 'https://api.github.com/users/facebook-github-bot/followers', 'following_url': 'https://api.github.com/users/facebook-github-bot/following{/other_user}', 'gists_url': 'https://api.github.com/users/facebook-github-bot/gists{/gist_id}', 'starred_url': 'https://api.github.com/users/facebook-github-bot/starred{/owner}{/repo}', 'subscriptions_url': 'https://api.github.com/users/facebook-github-bot/subscriptions', 'organizations_url': 'https://api.github.com/users/facebook-github-bot/orgs', 'repos_url': 'https://api.github.com/users/facebook-github-bot/repos', 'events_url': 'https://api.github.com/users/facebook-github-bot/events{/privacy}', 'received_events_url': 'https://api.github.com/users/facebook-github-bot/received_events', 'type': 'User', 'site_admin': False}",referenced,c34ef1aa2edb4792d7bd0cb3a75d7a68e859212b,https://api.github.com/repos/pytorch/pytorch/commits/c34ef1aa2edb4792d7bd0cb3a75d7a68e859212b,2019-12-10T18:15:19Z,4,3,1
2462,1217627862,"{'login': 'soumith', 'id': 1310570, 'node_id': 'MDQ6VXNlcjEzMTA1NzA=', 'avatar_url': 'https://avatars0.githubusercontent.com/u/1310570?v=4', 'gravatar_id': '', 'url': 'https://api.github.com/users/soumith', 'html_url': 'https://github.com/soumith', 'followers_url': 'https://api.github.com/users/soumith/followers', 'following_url': 'https://api.github.com/users/soumith/following{/other_user}', 'gists_url': 'https://api.github.com/users/soumith/gists{/gist_id}', 'starred_url': 'https://api.github.com/users/soumith/starred{/owner}{/repo}', 'subscriptions_url': 'https://api.github.com/users/soumith/subscriptions', 'organizations_url': 'https://api.github.com/users/soumith/orgs', 'repos_url': 'https://api.github.com/users/soumith/repos', 'events_url': 'https://api.github.com/users/soumith/events{/privacy}', 'received_events_url': 'https://api.github.com/users/soumith/received_events', 'type': 'User', 'site_admin': False}",referenced,5e54d9330f93123306d88176394cdbd258f94615,https://api.github.com/repos/pytorch/pytorch/commits/5e54d9330f93123306d88176394cdbd258f94615,2017-08-23T11:18:30Z,6,6,0
2460,2871559517,"{'login': 'facebook-github-bot', 'id': 6422482, 'node_id': 'MDQ6VXNlcjY0MjI0ODI=', 'avatar_url': 'https://avatars3.githubusercontent.com/u/6422482?v=4', 'gravatar_id': '', 'url': 'https://api.github.com/users/facebook-github-bot', 'html_url': 'https://github.com/facebook-github-bot', 'followers_url': 'https://api.github.com/users/facebook-github-bot/followers', 'following_url': 'https://api.github.com/users/facebook-github-bot/following{/other_user}', 'gists_url': 'https://api.github.com/users/facebook-github-bot/gists{/gist_id}', 'starred_url': 'https://api.github.com/users/facebook-github-bot/starred{/owner}{/repo}', 'subscriptions_url': 'https://api.github.com/users/facebook-github-bot/subscriptions', 'organizations_url': 'https://api.github.com/users/facebook-github-bot/orgs', 'repos_url': 'https://api.github.com/users/facebook-github-bot/repos', 'events_url': 'https://api.github.com/users/facebook-github-bot/events{/privacy}', 'received_events_url': 'https://api.github.com/users/facebook-github-bot/received_events', 'type': 'User', 'site_admin': False}",referenced,c34ef1aa2edb4792d7bd0cb3a75d7a68e859212b,https://api.github.com/repos/pytorch/pytorch/commits/c34ef1aa2edb4792d7bd0cb3a75d7a68e859212b,2019-12-10T18:15:19Z,4,3,1
2426,1227910352,"{'login': 'apaszke', 'id': 4583066, 'node_id': 'MDQ6VXNlcjQ1ODMwNjY=', 'avatar_url': 'https://avatars3.githubusercontent.com/u/4583066?v=4', 'gravatar_id': '', 'url': 'https://api.github.com/users/apaszke', 'html_url': 'https://github.com/apaszke', 'followers_url': 'https://api.github.com/users/apaszke/followers', 'following_url': 'https://api.github.com/users/apaszke/following{/other_user}', 'gists_url': 'https://api.github.com/users/apaszke/gists{/gist_id}', 'starred_url': 'https://api.github.com/users/apaszke/starred{/owner}{/repo}', 'subscriptions_url': 'https://api.github.com/users/apaszke/subscriptions', 'organizations_url': 'https://api.github.com/users/apaszke/orgs', 'repos_url': 'https://api.github.com/users/apaszke/repos', 'events_url': 'https://api.github.com/users/apaszke/events{/privacy}', 'received_events_url': 'https://api.github.com/users/apaszke/received_events', 'type': 'User', 'site_admin': False}",referenced,7310ebb66f07743b126a9bbfc753315161677be0,https://api.github.com/repos/pytorch/pytorch/commits/7310ebb66f07743b126a9bbfc753315161677be0,2017-08-30T15:54:14Z,4,4,0
2425,2780685023,"{'login': 'facebook-github-bot', 'id': 6422482, 'node_id': 'MDQ6VXNlcjY0MjI0ODI=', 'avatar_url': 'https://avatars3.githubusercontent.com/u/6422482?v=4', 'gravatar_id': '', 'url': 'https://api.github.com/users/facebook-github-bot', 'html_url': 'https://github.com/facebook-github-bot', 'followers_url': 'https://api.github.com/users/facebook-github-bot/followers', 'following_url': 'https://api.github.com/users/facebook-github-bot/following{/other_user}', 'gists_url': 'https://api.github.com/users/facebook-github-bot/gists{/gist_id}', 'starred_url': 'https://api.github.com/users/facebook-github-bot/starred{/owner}{/repo}', 'subscriptions_url': 'https://api.github.com/users/facebook-github-bot/subscriptions', 'organizations_url': 'https://api.github.com/users/facebook-github-bot/orgs', 'repos_url': 'https://api.github.com/users/facebook-github-bot/repos', 'events_url': 'https://api.github.com/users/facebook-github-bot/events{/privacy}', 'received_events_url': 'https://api.github.com/users/facebook-github-bot/received_events', 'type': 'User', 'site_admin': False}",referenced,564384fe12ddb4d37b96b90852b7cb94429a62ae,https://api.github.com/repos/pytorch/pytorch/commits/564384fe12ddb4d37b96b90852b7cb94429a62ae,2019-11-07T20:09:30Z,2,1,1
2416,1206872218,"{'login': 'apaszke', 'id': 4583066, 'node_id': 'MDQ6VXNlcjQ1ODMwNjY=', 'avatar_url': 'https://avatars3.githubusercontent.com/u/4583066?v=4', 'gravatar_id': '', 'url': 'https://api.github.com/users/apaszke', 'html_url': 'https://github.com/apaszke', 'followers_url': 'https://api.github.com/users/apaszke/followers', 'following_url': 'https://api.github.com/users/apaszke/following{/other_user}', 'gists_url': 'https://api.github.com/users/apaszke/gists{/gist_id}', 'starred_url': 'https://api.github.com/users/apaszke/starred{/owner}{/repo}', 'subscriptions_url': 'https://api.github.com/users/apaszke/subscriptions', 'organizations_url': 'https://api.github.com/users/apaszke/orgs', 'repos_url': 'https://api.github.com/users/apaszke/repos', 'events_url': 'https://api.github.com/users/apaszke/events{/privacy}', 'received_events_url': 'https://api.github.com/users/apaszke/received_events', 'type': 'User', 'site_admin': False}",referenced,b09d7c890ef78c864ab73c1fd4eaa31a6806ee33,https://api.github.com/repos/pytorch/pytorch/commits/b09d7c890ef78c864ab73c1fd4eaa31a6806ee33,2017-08-15T17:36:37Z,24,19,5
2413,1205989956,"{'login': 'soumith', 'id': 1310570, 'node_id': 'MDQ6VXNlcjEzMTA1NzA=', 'avatar_url': 'https://avatars0.githubusercontent.com/u/1310570?v=4', 'gravatar_id': '', 'url': 'https://api.github.com/users/soumith', 'html_url': 'https://github.com/soumith', 'followers_url': 'https://api.github.com/users/soumith/followers', 'following_url': 'https://api.github.com/users/soumith/following{/other_user}', 'gists_url': 'https://api.github.com/users/soumith/gists{/gist_id}', 'starred_url': 'https://api.github.com/users/soumith/starred{/owner}{/repo}', 'subscriptions_url': 'https://api.github.com/users/soumith/subscriptions', 'organizations_url': 'https://api.github.com/users/soumith/orgs', 'repos_url': 'https://api.github.com/users/soumith/repos', 'events_url': 'https://api.github.com/users/soumith/events{/privacy}', 'received_events_url': 'https://api.github.com/users/soumith/received_events', 'type': 'User', 'site_admin': False}",referenced,f9d02903b7c56360ab8f2e774751b71c19fd7fd9,https://api.github.com/repos/pytorch/pytorch/commits/f9d02903b7c56360ab8f2e774751b71c19fd7fd9,2017-08-15T06:46:34Z,21,17,4
2411,2910089525,"{'login': 'facebook-github-bot', 'id': 6422482, 'node_id': 'MDQ6VXNlcjY0MjI0ODI=', 'avatar_url': 'https://avatars3.githubusercontent.com/u/6422482?v=4', 'gravatar_id': '', 'url': 'https://api.github.com/users/facebook-github-bot', 'html_url': 'https://github.com/facebook-github-bot', 'followers_url': 'https://api.github.com/users/facebook-github-bot/followers', 'following_url': 'https://api.github.com/users/facebook-github-bot/following{/other_user}', 'gists_url': 'https://api.github.com/users/facebook-github-bot/gists{/gist_id}', 'starred_url': 'https://api.github.com/users/facebook-github-bot/starred{/owner}{/repo}', 'subscriptions_url': 'https://api.github.com/users/facebook-github-bot/subscriptions', 'organizations_url': 'https://api.github.com/users/facebook-github-bot/orgs', 'repos_url': 'https://api.github.com/users/facebook-github-bot/repos', 'events_url': 'https://api.github.com/users/facebook-github-bot/events{/privacy}', 'received_events_url': 'https://api.github.com/users/facebook-github-bot/received_events', 'type': 'User', 'site_admin': False}",referenced,204939b40132b9c764e765073b1a4df9ed05b86e,https://api.github.com/repos/pytorch/pytorch/commits/204939b40132b9c764e765073b1a4df9ed05b86e,2019-12-27T05:25:15Z,2,1,1
2403,2780685037,"{'login': 'facebook-github-bot', 'id': 6422482, 'node_id': 'MDQ6VXNlcjY0MjI0ODI=', 'avatar_url': 'https://avatars3.githubusercontent.com/u/6422482?v=4', 'gravatar_id': '', 'url': 'https://api.github.com/users/facebook-github-bot', 'html_url': 'https://github.com/facebook-github-bot', 'followers_url': 'https://api.github.com/users/facebook-github-bot/followers', 'following_url': 'https://api.github.com/users/facebook-github-bot/following{/other_user}', 'gists_url': 'https://api.github.com/users/facebook-github-bot/gists{/gist_id}', 'starred_url': 'https://api.github.com/users/facebook-github-bot/starred{/owner}{/repo}', 'subscriptions_url': 'https://api.github.com/users/facebook-github-bot/subscriptions', 'organizations_url': 'https://api.github.com/users/facebook-github-bot/orgs', 'repos_url': 'https://api.github.com/users/facebook-github-bot/repos', 'events_url': 'https://api.github.com/users/facebook-github-bot/events{/privacy}', 'received_events_url': 'https://api.github.com/users/facebook-github-bot/received_events', 'type': 'User', 'site_admin': False}",referenced,564384fe12ddb4d37b96b90852b7cb94429a62ae,https://api.github.com/repos/pytorch/pytorch/commits/564384fe12ddb4d37b96b90852b7cb94429a62ae,2019-11-07T20:09:30Z,2,1,1
2385,2693340264,"{'login': 'facebook-github-bot', 'id': 6422482, 'node_id': 'MDQ6VXNlcjY0MjI0ODI=', 'avatar_url': 'https://avatars3.githubusercontent.com/u/6422482?v=4', 'gravatar_id': '', 'url': 'https://api.github.com/users/facebook-github-bot', 'html_url': 'https://github.com/facebook-github-bot', 'followers_url': 'https://api.github.com/users/facebook-github-bot/followers', 'following_url': 'https://api.github.com/users/facebook-github-bot/following{/other_user}', 'gists_url': 'https://api.github.com/users/facebook-github-bot/gists{/gist_id}', 'starred_url': 'https://api.github.com/users/facebook-github-bot/starred{/owner}{/repo}', 'subscriptions_url': 'https://api.github.com/users/facebook-github-bot/subscriptions', 'organizations_url': 'https://api.github.com/users/facebook-github-bot/orgs', 'repos_url': 'https://api.github.com/users/facebook-github-bot/repos', 'events_url': 'https://api.github.com/users/facebook-github-bot/events{/privacy}', 'received_events_url': 'https://api.github.com/users/facebook-github-bot/received_events', 'type': 'User', 'site_admin': False}",referenced,8cc9d276476a2793cdc8e073ce4346bd16258cf9,https://api.github.com/repos/pytorch/pytorch/commits/8cc9d276476a2793cdc8e073ce4346bd16258cf9,2019-10-07T21:16:42Z,2,1,1
2369,2693340250,"{'login': 'facebook-github-bot', 'id': 6422482, 'node_id': 'MDQ6VXNlcjY0MjI0ODI=', 'avatar_url': 'https://avatars3.githubusercontent.com/u/6422482?v=4', 'gravatar_id': '', 'url': 'https://api.github.com/users/facebook-github-bot', 'html_url': 'https://github.com/facebook-github-bot', 'followers_url': 'https://api.github.com/users/facebook-github-bot/followers', 'following_url': 'https://api.github.com/users/facebook-github-bot/following{/other_user}', 'gists_url': 'https://api.github.com/users/facebook-github-bot/gists{/gist_id}', 'starred_url': 'https://api.github.com/users/facebook-github-bot/starred{/owner}{/repo}', 'subscriptions_url': 'https://api.github.com/users/facebook-github-bot/subscriptions', 'organizations_url': 'https://api.github.com/users/facebook-github-bot/orgs', 'repos_url': 'https://api.github.com/users/facebook-github-bot/repos', 'events_url': 'https://api.github.com/users/facebook-github-bot/events{/privacy}', 'received_events_url': 'https://api.github.com/users/facebook-github-bot/received_events', 'type': 'User', 'site_admin': False}",referenced,8cc9d276476a2793cdc8e073ce4346bd16258cf9,https://api.github.com/repos/pytorch/pytorch/commits/8cc9d276476a2793cdc8e073ce4346bd16258cf9,2019-10-07T21:16:42Z,2,1,1
2367,2780685054,"{'login': 'facebook-github-bot', 'id': 6422482, 'node_id': 'MDQ6VXNlcjY0MjI0ODI=', 'avatar_url': 'https://avatars3.githubusercontent.com/u/6422482?v=4', 'gravatar_id': '', 'url': 'https://api.github.com/users/facebook-github-bot', 'html_url': 'https://github.com/facebook-github-bot', 'followers_url': 'https://api.github.com/users/facebook-github-bot/followers', 'following_url': 'https://api.github.com/users/facebook-github-bot/following{/other_user}', 'gists_url': 'https://api.github.com/users/facebook-github-bot/gists{/gist_id}', 'starred_url': 'https://api.github.com/users/facebook-github-bot/starred{/owner}{/repo}', 'subscriptions_url': 'https://api.github.com/users/facebook-github-bot/subscriptions', 'organizations_url': 'https://api.github.com/users/facebook-github-bot/orgs', 'repos_url': 'https://api.github.com/users/facebook-github-bot/repos', 'events_url': 'https://api.github.com/users/facebook-github-bot/events{/privacy}', 'received_events_url': 'https://api.github.com/users/facebook-github-bot/received_events', 'type': 'User', 'site_admin': False}",referenced,564384fe12ddb4d37b96b90852b7cb94429a62ae,https://api.github.com/repos/pytorch/pytorch/commits/564384fe12ddb4d37b96b90852b7cb94429a62ae,2019-11-07T20:09:30Z,2,1,1
2362,2875213200,"{'login': 'facebook-github-bot', 'id': 6422482, 'node_id': 'MDQ6VXNlcjY0MjI0ODI=', 'avatar_url': 'https://avatars3.githubusercontent.com/u/6422482?v=4', 'gravatar_id': '', 'url': 'https://api.github.com/users/facebook-github-bot', 'html_url': 'https://github.com/facebook-github-bot', 'followers_url': 'https://api.github.com/users/facebook-github-bot/followers', 'following_url': 'https://api.github.com/users/facebook-github-bot/following{/other_user}', 'gists_url': 'https://api.github.com/users/facebook-github-bot/gists{/gist_id}', 'starred_url': 'https://api.github.com/users/facebook-github-bot/starred{/owner}{/repo}', 'subscriptions_url': 'https://api.github.com/users/facebook-github-bot/subscriptions', 'organizations_url': 'https://api.github.com/users/facebook-github-bot/orgs', 'repos_url': 'https://api.github.com/users/facebook-github-bot/repos', 'events_url': 'https://api.github.com/users/facebook-github-bot/events{/privacy}', 'received_events_url': 'https://api.github.com/users/facebook-github-bot/received_events', 'type': 'User', 'site_admin': False}",closed,717274c001509ffbc14189edef0f7d2ee2e5b777,https://api.github.com/repos/pytorch/pytorch/commits/717274c001509ffbc14189edef0f7d2ee2e5b777,2019-12-11T17:47:33Z,62,48,14
2348,2668185915,"{'login': 'facebook-github-bot', 'id': 6422482, 'node_id': 'MDQ6VXNlcjY0MjI0ODI=', 'avatar_url': 'https://avatars3.githubusercontent.com/u/6422482?v=4', 'gravatar_id': '', 'url': 'https://api.github.com/users/facebook-github-bot', 'html_url': 'https://github.com/facebook-github-bot', 'followers_url': 'https://api.github.com/users/facebook-github-bot/followers', 'following_url': 'https://api.github.com/users/facebook-github-bot/following{/other_user}', 'gists_url': 'https://api.github.com/users/facebook-github-bot/gists{/gist_id}', 'starred_url': 'https://api.github.com/users/facebook-github-bot/starred{/owner}{/repo}', 'subscriptions_url': 'https://api.github.com/users/facebook-github-bot/subscriptions', 'organizations_url': 'https://api.github.com/users/facebook-github-bot/orgs', 'repos_url': 'https://api.github.com/users/facebook-github-bot/repos', 'events_url': 'https://api.github.com/users/facebook-github-bot/events{/privacy}', 'received_events_url': 'https://api.github.com/users/facebook-github-bot/received_events', 'type': 'User', 'site_admin': False}",referenced,8ec041405391d999478d88ca936d0ba5bdf0ea71,https://api.github.com/repos/pytorch/pytorch/commits/8ec041405391d999478d88ca936d0ba5bdf0ea71,2019-09-27T10:31:44Z,2,1,1
2343,2659902443,"{'login': 'facebook-github-bot', 'id': 6422482, 'node_id': 'MDQ6VXNlcjY0MjI0ODI=', 'avatar_url': 'https://avatars3.githubusercontent.com/u/6422482?v=4', 'gravatar_id': '', 'url': 'https://api.github.com/users/facebook-github-bot', 'html_url': 'https://github.com/facebook-github-bot', 'followers_url': 'https://api.github.com/users/facebook-github-bot/followers', 'following_url': 'https://api.github.com/users/facebook-github-bot/following{/other_user}', 'gists_url': 'https://api.github.com/users/facebook-github-bot/gists{/gist_id}', 'starred_url': 'https://api.github.com/users/facebook-github-bot/starred{/owner}{/repo}', 'subscriptions_url': 'https://api.github.com/users/facebook-github-bot/subscriptions', 'organizations_url': 'https://api.github.com/users/facebook-github-bot/orgs', 'repos_url': 'https://api.github.com/users/facebook-github-bot/repos', 'events_url': 'https://api.github.com/users/facebook-github-bot/events{/privacy}', 'received_events_url': 'https://api.github.com/users/facebook-github-bot/received_events', 'type': 'User', 'site_admin': False}",referenced,b93f0947a89b97a14b43c7b4ab79cf7a7163756d,https://api.github.com/repos/pytorch/pytorch/commits/b93f0947a89b97a14b43c7b4ab79cf7a7163756d,2019-09-25T00:14:24Z,2,1,1
2338,1221865163,"{'login': 'ngimel', 'id': 15841449, 'node_id': 'MDQ6VXNlcjE1ODQxNDQ5', 'avatar_url': 'https://avatars3.githubusercontent.com/u/15841449?v=4', 'gravatar_id': '', 'url': 'https://api.github.com/users/ngimel', 'html_url': 'https://github.com/ngimel', 'followers_url': 'https://api.github.com/users/ngimel/followers', 'following_url': 'https://api.github.com/users/ngimel/following{/other_user}', 'gists_url': 'https://api.github.com/users/ngimel/gists{/gist_id}', 'starred_url': 'https://api.github.com/users/ngimel/starred{/owner}{/repo}', 'subscriptions_url': 'https://api.github.com/users/ngimel/subscriptions', 'organizations_url': 'https://api.github.com/users/ngimel/orgs', 'repos_url': 'https://api.github.com/users/ngimel/repos', 'events_url': 'https://api.github.com/users/ngimel/events{/privacy}', 'received_events_url': 'https://api.github.com/users/ngimel/received_events', 'type': 'User', 'site_admin': False}",referenced,01adebea1c0cb9aa704e50a9d14507b0fab5939f,https://api.github.com/repos/pytorch/pytorch/commits/01adebea1c0cb9aa704e50a9d14507b0fab5939f,2017-08-25T17:32:49Z,58,28,30
2335,2659902452,"{'login': 'facebook-github-bot', 'id': 6422482, 'node_id': 'MDQ6VXNlcjY0MjI0ODI=', 'avatar_url': 'https://avatars3.githubusercontent.com/u/6422482?v=4', 'gravatar_id': '', 'url': 'https://api.github.com/users/facebook-github-bot', 'html_url': 'https://github.com/facebook-github-bot', 'followers_url': 'https://api.github.com/users/facebook-github-bot/followers', 'following_url': 'https://api.github.com/users/facebook-github-bot/following{/other_user}', 'gists_url': 'https://api.github.com/users/facebook-github-bot/gists{/gist_id}', 'starred_url': 'https://api.github.com/users/facebook-github-bot/starred{/owner}{/repo}', 'subscriptions_url': 'https://api.github.com/users/facebook-github-bot/subscriptions', 'organizations_url': 'https://api.github.com/users/facebook-github-bot/orgs', 'repos_url': 'https://api.github.com/users/facebook-github-bot/repos', 'events_url': 'https://api.github.com/users/facebook-github-bot/events{/privacy}', 'received_events_url': 'https://api.github.com/users/facebook-github-bot/received_events', 'type': 'User', 'site_admin': False}",referenced,b93f0947a89b97a14b43c7b4ab79cf7a7163756d,https://api.github.com/repos/pytorch/pytorch/commits/b93f0947a89b97a14b43c7b4ab79cf7a7163756d,2019-09-25T00:14:24Z,2,1,1
2330,2657888971,"{'login': 'facebook-github-bot', 'id': 6422482, 'node_id': 'MDQ6VXNlcjY0MjI0ODI=', 'avatar_url': 'https://avatars3.githubusercontent.com/u/6422482?v=4', 'gravatar_id': '', 'url': 'https://api.github.com/users/facebook-github-bot', 'html_url': 'https://github.com/facebook-github-bot', 'followers_url': 'https://api.github.com/users/facebook-github-bot/followers', 'following_url': 'https://api.github.com/users/facebook-github-bot/following{/other_user}', 'gists_url': 'https://api.github.com/users/facebook-github-bot/gists{/gist_id}', 'starred_url': 'https://api.github.com/users/facebook-github-bot/starred{/owner}{/repo}', 'subscriptions_url': 'https://api.github.com/users/facebook-github-bot/subscriptions', 'organizations_url': 'https://api.github.com/users/facebook-github-bot/orgs', 'repos_url': 'https://api.github.com/users/facebook-github-bot/repos', 'events_url': 'https://api.github.com/users/facebook-github-bot/events{/privacy}', 'received_events_url': 'https://api.github.com/users/facebook-github-bot/received_events', 'type': 'User', 'site_admin': False}",referenced,d6ee58494f816b9784a974c9d5a5c95376a3a55b,https://api.github.com/repos/pytorch/pytorch/commits/d6ee58494f816b9784a974c9d5a5c95376a3a55b,2019-09-24T12:40:01Z,7,6,1
2316,2639966569,"{'login': 'facebook-github-bot', 'id': 6422482, 'node_id': 'MDQ6VXNlcjY0MjI0ODI=', 'avatar_url': 'https://avatars3.githubusercontent.com/u/6422482?v=4', 'gravatar_id': '', 'url': 'https://api.github.com/users/facebook-github-bot', 'html_url': 'https://github.com/facebook-github-bot', 'followers_url': 'https://api.github.com/users/facebook-github-bot/followers', 'following_url': 'https://api.github.com/users/facebook-github-bot/following{/other_user}', 'gists_url': 'https://api.github.com/users/facebook-github-bot/gists{/gist_id}', 'starred_url': 'https://api.github.com/users/facebook-github-bot/starred{/owner}{/repo}', 'subscriptions_url': 'https://api.github.com/users/facebook-github-bot/subscriptions', 'organizations_url': 'https://api.github.com/users/facebook-github-bot/orgs', 'repos_url': 'https://api.github.com/users/facebook-github-bot/repos', 'events_url': 'https://api.github.com/users/facebook-github-bot/events{/privacy}', 'received_events_url': 'https://api.github.com/users/facebook-github-bot/received_events', 'type': 'User', 'site_admin': False}",referenced,bebc3d6aad8cd4b3ff3ccbaf5d8141bc10916df7,https://api.github.com/repos/pytorch/pytorch/commits/bebc3d6aad8cd4b3ff3ccbaf5d8141bc10916df7,2019-09-17T13:48:19Z,3,2,1
2315,2639966560,"{'login': 'facebook-github-bot', 'id': 6422482, 'node_id': 'MDQ6VXNlcjY0MjI0ODI=', 'avatar_url': 'https://avatars3.githubusercontent.com/u/6422482?v=4', 'gravatar_id': '', 'url': 'https://api.github.com/users/facebook-github-bot', 'html_url': 'https://github.com/facebook-github-bot', 'followers_url': 'https://api.github.com/users/facebook-github-bot/followers', 'following_url': 'https://api.github.com/users/facebook-github-bot/following{/other_user}', 'gists_url': 'https://api.github.com/users/facebook-github-bot/gists{/gist_id}', 'starred_url': 'https://api.github.com/users/facebook-github-bot/starred{/owner}{/repo}', 'subscriptions_url': 'https://api.github.com/users/facebook-github-bot/subscriptions', 'organizations_url': 'https://api.github.com/users/facebook-github-bot/orgs', 'repos_url': 'https://api.github.com/users/facebook-github-bot/repos', 'events_url': 'https://api.github.com/users/facebook-github-bot/events{/privacy}', 'received_events_url': 'https://api.github.com/users/facebook-github-bot/received_events', 'type': 'User', 'site_admin': False}",referenced,bebc3d6aad8cd4b3ff3ccbaf5d8141bc10916df7,https://api.github.com/repos/pytorch/pytorch/commits/bebc3d6aad8cd4b3ff3ccbaf5d8141bc10916df7,2019-09-17T13:48:19Z,3,2,1
2310,2639966586,"{'login': 'facebook-github-bot', 'id': 6422482, 'node_id': 'MDQ6VXNlcjY0MjI0ODI=', 'avatar_url': 'https://avatars3.githubusercontent.com/u/6422482?v=4', 'gravatar_id': '', 'url': 'https://api.github.com/users/facebook-github-bot', 'html_url': 'https://github.com/facebook-github-bot', 'followers_url': 'https://api.github.com/users/facebook-github-bot/followers', 'following_url': 'https://api.github.com/users/facebook-github-bot/following{/other_user}', 'gists_url': 'https://api.github.com/users/facebook-github-bot/gists{/gist_id}', 'starred_url': 'https://api.github.com/users/facebook-github-bot/starred{/owner}{/repo}', 'subscriptions_url': 'https://api.github.com/users/facebook-github-bot/subscriptions', 'organizations_url': 'https://api.github.com/users/facebook-github-bot/orgs', 'repos_url': 'https://api.github.com/users/facebook-github-bot/repos', 'events_url': 'https://api.github.com/users/facebook-github-bot/events{/privacy}', 'received_events_url': 'https://api.github.com/users/facebook-github-bot/received_events', 'type': 'User', 'site_admin': False}",referenced,bebc3d6aad8cd4b3ff3ccbaf5d8141bc10916df7,https://api.github.com/repos/pytorch/pytorch/commits/bebc3d6aad8cd4b3ff3ccbaf5d8141bc10916df7,2019-09-17T13:48:19Z,3,2,1
2304,2657889007,"{'login': 'facebook-github-bot', 'id': 6422482, 'node_id': 'MDQ6VXNlcjY0MjI0ODI=', 'avatar_url': 'https://avatars3.githubusercontent.com/u/6422482?v=4', 'gravatar_id': '', 'url': 'https://api.github.com/users/facebook-github-bot', 'html_url': 'https://github.com/facebook-github-bot', 'followers_url': 'https://api.github.com/users/facebook-github-bot/followers', 'following_url': 'https://api.github.com/users/facebook-github-bot/following{/other_user}', 'gists_url': 'https://api.github.com/users/facebook-github-bot/gists{/gist_id}', 'starred_url': 'https://api.github.com/users/facebook-github-bot/starred{/owner}{/repo}', 'subscriptions_url': 'https://api.github.com/users/facebook-github-bot/subscriptions', 'organizations_url': 'https://api.github.com/users/facebook-github-bot/orgs', 'repos_url': 'https://api.github.com/users/facebook-github-bot/repos', 'events_url': 'https://api.github.com/users/facebook-github-bot/events{/privacy}', 'received_events_url': 'https://api.github.com/users/facebook-github-bot/received_events', 'type': 'User', 'site_admin': False}",referenced,d6ee58494f816b9784a974c9d5a5c95376a3a55b,https://api.github.com/repos/pytorch/pytorch/commits/d6ee58494f816b9784a974c9d5a5c95376a3a55b,2019-09-24T12:40:02Z,7,6,1
2287,2630274923,"{'login': 'facebook-github-bot', 'id': 6422482, 'node_id': 'MDQ6VXNlcjY0MjI0ODI=', 'avatar_url': 'https://avatars3.githubusercontent.com/u/6422482?v=4', 'gravatar_id': '', 'url': 'https://api.github.com/users/facebook-github-bot', 'html_url': 'https://github.com/facebook-github-bot', 'followers_url': 'https://api.github.com/users/facebook-github-bot/followers', 'following_url': 'https://api.github.com/users/facebook-github-bot/following{/other_user}', 'gists_url': 'https://api.github.com/users/facebook-github-bot/gists{/gist_id}', 'starred_url': 'https://api.github.com/users/facebook-github-bot/starred{/owner}{/repo}', 'subscriptions_url': 'https://api.github.com/users/facebook-github-bot/subscriptions', 'organizations_url': 'https://api.github.com/users/facebook-github-bot/orgs', 'repos_url': 'https://api.github.com/users/facebook-github-bot/repos', 'events_url': 'https://api.github.com/users/facebook-github-bot/events{/privacy}', 'received_events_url': 'https://api.github.com/users/facebook-github-bot/received_events', 'type': 'User', 'site_admin': False}",referenced,7e4ac8b851b9a4fa50addaf959842130d4920d7c,https://api.github.com/repos/pytorch/pytorch/commits/7e4ac8b851b9a4fa50addaf959842130d4920d7c,2019-09-12T19:15:16Z,7,6,1
2281,2630274909,"{'login': 'facebook-github-bot', 'id': 6422482, 'node_id': 'MDQ6VXNlcjY0MjI0ODI=', 'avatar_url': 'https://avatars3.githubusercontent.com/u/6422482?v=4', 'gravatar_id': '', 'url': 'https://api.github.com/users/facebook-github-bot', 'html_url': 'https://github.com/facebook-github-bot', 'followers_url': 'https://api.github.com/users/facebook-github-bot/followers', 'following_url': 'https://api.github.com/users/facebook-github-bot/following{/other_user}', 'gists_url': 'https://api.github.com/users/facebook-github-bot/gists{/gist_id}', 'starred_url': 'https://api.github.com/users/facebook-github-bot/starred{/owner}{/repo}', 'subscriptions_url': 'https://api.github.com/users/facebook-github-bot/subscriptions', 'organizations_url': 'https://api.github.com/users/facebook-github-bot/orgs', 'repos_url': 'https://api.github.com/users/facebook-github-bot/repos', 'events_url': 'https://api.github.com/users/facebook-github-bot/events{/privacy}', 'received_events_url': 'https://api.github.com/users/facebook-github-bot/received_events', 'type': 'User', 'site_admin': False}",referenced,7e4ac8b851b9a4fa50addaf959842130d4920d7c,https://api.github.com/repos/pytorch/pytorch/commits/7e4ac8b851b9a4fa50addaf959842130d4920d7c,2019-09-12T19:15:16Z,7,6,1
2271,2630274931,"{'login': 'facebook-github-bot', 'id': 6422482, 'node_id': 'MDQ6VXNlcjY0MjI0ODI=', 'avatar_url': 'https://avatars3.githubusercontent.com/u/6422482?v=4', 'gravatar_id': '', 'url': 'https://api.github.com/users/facebook-github-bot', 'html_url': 'https://github.com/facebook-github-bot', 'followers_url': 'https://api.github.com/users/facebook-github-bot/followers', 'following_url': 'https://api.github.com/users/facebook-github-bot/following{/other_user}', 'gists_url': 'https://api.github.com/users/facebook-github-bot/gists{/gist_id}', 'starred_url': 'https://api.github.com/users/facebook-github-bot/starred{/owner}{/repo}', 'subscriptions_url': 'https://api.github.com/users/facebook-github-bot/subscriptions', 'organizations_url': 'https://api.github.com/users/facebook-github-bot/orgs', 'repos_url': 'https://api.github.com/users/facebook-github-bot/repos', 'events_url': 'https://api.github.com/users/facebook-github-bot/events{/privacy}', 'received_events_url': 'https://api.github.com/users/facebook-github-bot/received_events', 'type': 'User', 'site_admin': False}",referenced,7e4ac8b851b9a4fa50addaf959842130d4920d7c,https://api.github.com/repos/pytorch/pytorch/commits/7e4ac8b851b9a4fa50addaf959842130d4920d7c,2019-09-12T19:15:16Z,7,6,1
2261,2630274912,"{'login': 'facebook-github-bot', 'id': 6422482, 'node_id': 'MDQ6VXNlcjY0MjI0ODI=', 'avatar_url': 'https://avatars3.githubusercontent.com/u/6422482?v=4', 'gravatar_id': '', 'url': 'https://api.github.com/users/facebook-github-bot', 'html_url': 'https://github.com/facebook-github-bot', 'followers_url': 'https://api.github.com/users/facebook-github-bot/followers', 'following_url': 'https://api.github.com/users/facebook-github-bot/following{/other_user}', 'gists_url': 'https://api.github.com/users/facebook-github-bot/gists{/gist_id}', 'starred_url': 'https://api.github.com/users/facebook-github-bot/starred{/owner}{/repo}', 'subscriptions_url': 'https://api.github.com/users/facebook-github-bot/subscriptions', 'organizations_url': 'https://api.github.com/users/facebook-github-bot/orgs', 'repos_url': 'https://api.github.com/users/facebook-github-bot/repos', 'events_url': 'https://api.github.com/users/facebook-github-bot/events{/privacy}', 'received_events_url': 'https://api.github.com/users/facebook-github-bot/received_events', 'type': 'User', 'site_admin': False}",referenced,7e4ac8b851b9a4fa50addaf959842130d4920d7c,https://api.github.com/repos/pytorch/pytorch/commits/7e4ac8b851b9a4fa50addaf959842130d4920d7c,2019-09-12T19:15:16Z,7,6,1
2257,2630274942,"{'login': 'facebook-github-bot', 'id': 6422482, 'node_id': 'MDQ6VXNlcjY0MjI0ODI=', 'avatar_url': 'https://avatars3.githubusercontent.com/u/6422482?v=4', 'gravatar_id': '', 'url': 'https://api.github.com/users/facebook-github-bot', 'html_url': 'https://github.com/facebook-github-bot', 'followers_url': 'https://api.github.com/users/facebook-github-bot/followers', 'following_url': 'https://api.github.com/users/facebook-github-bot/following{/other_user}', 'gists_url': 'https://api.github.com/users/facebook-github-bot/gists{/gist_id}', 'starred_url': 'https://api.github.com/users/facebook-github-bot/starred{/owner}{/repo}', 'subscriptions_url': 'https://api.github.com/users/facebook-github-bot/subscriptions', 'organizations_url': 'https://api.github.com/users/facebook-github-bot/orgs', 'repos_url': 'https://api.github.com/users/facebook-github-bot/repos', 'events_url': 'https://api.github.com/users/facebook-github-bot/events{/privacy}', 'received_events_url': 'https://api.github.com/users/facebook-github-bot/received_events', 'type': 'User', 'site_admin': False}",referenced,7e4ac8b851b9a4fa50addaf959842130d4920d7c,https://api.github.com/repos/pytorch/pytorch/commits/7e4ac8b851b9a4fa50addaf959842130d4920d7c,2019-09-12T19:15:16Z,7,6,1
2249,2639966580,"{'login': 'facebook-github-bot', 'id': 6422482, 'node_id': 'MDQ6VXNlcjY0MjI0ODI=', 'avatar_url': 'https://avatars3.githubusercontent.com/u/6422482?v=4', 'gravatar_id': '', 'url': 'https://api.github.com/users/facebook-github-bot', 'html_url': 'https://github.com/facebook-github-bot', 'followers_url': 'https://api.github.com/users/facebook-github-bot/followers', 'following_url': 'https://api.github.com/users/facebook-github-bot/following{/other_user}', 'gists_url': 'https://api.github.com/users/facebook-github-bot/gists{/gist_id}', 'starred_url': 'https://api.github.com/users/facebook-github-bot/starred{/owner}{/repo}', 'subscriptions_url': 'https://api.github.com/users/facebook-github-bot/subscriptions', 'organizations_url': 'https://api.github.com/users/facebook-github-bot/orgs', 'repos_url': 'https://api.github.com/users/facebook-github-bot/repos', 'events_url': 'https://api.github.com/users/facebook-github-bot/events{/privacy}', 'received_events_url': 'https://api.github.com/users/facebook-github-bot/received_events', 'type': 'User', 'site_admin': False}",referenced,bebc3d6aad8cd4b3ff3ccbaf5d8141bc10916df7,https://api.github.com/repos/pytorch/pytorch/commits/bebc3d6aad8cd4b3ff3ccbaf5d8141bc10916df7,2019-09-17T13:48:19Z,3,2,1
2236,1308726656,"{'login': 'soumith', 'id': 1310570, 'node_id': 'MDQ6VXNlcjEzMTA1NzA=', 'avatar_url': 'https://avatars0.githubusercontent.com/u/1310570?v=4', 'gravatar_id': '', 'url': 'https://api.github.com/users/soumith', 'html_url': 'https://github.com/soumith', 'followers_url': 'https://api.github.com/users/soumith/followers', 'following_url': 'https://api.github.com/users/soumith/following{/other_user}', 'gists_url': 'https://api.github.com/users/soumith/gists{/gist_id}', 'starred_url': 'https://api.github.com/users/soumith/starred{/owner}{/repo}', 'subscriptions_url': 'https://api.github.com/users/soumith/subscriptions', 'organizations_url': 'https://api.github.com/users/soumith/orgs', 'repos_url': 'https://api.github.com/users/soumith/repos', 'events_url': 'https://api.github.com/users/soumith/events{/privacy}', 'received_events_url': 'https://api.github.com/users/soumith/received_events', 'type': 'User', 'site_admin': False}",referenced,5fc122bf3973504e619cd677ad4a7fc1011642cd,https://api.github.com/repos/pytorch/pytorch/commits/5fc122bf3973504e619cd677ad4a7fc1011642cd,2017-10-24T21:54:37Z,2,2,0
2236,1308726656,"{'login': 'soumith', 'id': 1310570, 'node_id': 'MDQ6VXNlcjEzMTA1NzA=', 'avatar_url': 'https://avatars0.githubusercontent.com/u/1310570?v=4', 'gravatar_id': '', 'url': 'https://api.github.com/users/soumith', 'html_url': 'https://github.com/soumith', 'followers_url': 'https://api.github.com/users/soumith/followers', 'following_url': 'https://api.github.com/users/soumith/following{/other_user}', 'gists_url': 'https://api.github.com/users/soumith/gists{/gist_id}', 'starred_url': 'https://api.github.com/users/soumith/starred{/owner}{/repo}', 'subscriptions_url': 'https://api.github.com/users/soumith/subscriptions', 'organizations_url': 'https://api.github.com/users/soumith/orgs', 'repos_url': 'https://api.github.com/users/soumith/repos', 'events_url': 'https://api.github.com/users/soumith/events{/privacy}', 'received_events_url': 'https://api.github.com/users/soumith/received_events', 'type': 'User', 'site_admin': False}",referenced,5fc122bf3973504e619cd677ad4a7fc1011642cd,https://api.github.com/repos/pytorch/pytorch/commits/5fc122bf3973504e619cd677ad4a7fc1011642cd,2017-10-24T21:54:37Z,2,2,0
2236,1308726656,"{'login': 'soumith', 'id': 1310570, 'node_id': 'MDQ6VXNlcjEzMTA1NzA=', 'avatar_url': 'https://avatars0.githubusercontent.com/u/1310570?v=4', 'gravatar_id': '', 'url': 'https://api.github.com/users/soumith', 'html_url': 'https://github.com/soumith', 'followers_url': 'https://api.github.com/users/soumith/followers', 'following_url': 'https://api.github.com/users/soumith/following{/other_user}', 'gists_url': 'https://api.github.com/users/soumith/gists{/gist_id}', 'starred_url': 'https://api.github.com/users/soumith/starred{/owner}{/repo}', 'subscriptions_url': 'https://api.github.com/users/soumith/subscriptions', 'organizations_url': 'https://api.github.com/users/soumith/orgs', 'repos_url': 'https://api.github.com/users/soumith/repos', 'events_url': 'https://api.github.com/users/soumith/events{/privacy}', 'received_events_url': 'https://api.github.com/users/soumith/received_events', 'type': 'User', 'site_admin': False}",referenced,5fc122bf3973504e619cd677ad4a7fc1011642cd,https://api.github.com/repos/pytorch/pytorch/commits/5fc122bf3973504e619cd677ad4a7fc1011642cd,2017-10-24T21:54:37Z,2,2,0
2236,1308726656,"{'login': 'soumith', 'id': 1310570, 'node_id': 'MDQ6VXNlcjEzMTA1NzA=', 'avatar_url': 'https://avatars0.githubusercontent.com/u/1310570?v=4', 'gravatar_id': '', 'url': 'https://api.github.com/users/soumith', 'html_url': 'https://github.com/soumith', 'followers_url': 'https://api.github.com/users/soumith/followers', 'following_url': 'https://api.github.com/users/soumith/following{/other_user}', 'gists_url': 'https://api.github.com/users/soumith/gists{/gist_id}', 'starred_url': 'https://api.github.com/users/soumith/starred{/owner}{/repo}', 'subscriptions_url': 'https://api.github.com/users/soumith/subscriptions', 'organizations_url': 'https://api.github.com/users/soumith/orgs', 'repos_url': 'https://api.github.com/users/soumith/repos', 'events_url': 'https://api.github.com/users/soumith/events{/privacy}', 'received_events_url': 'https://api.github.com/users/soumith/received_events', 'type': 'User', 'site_admin': False}",referenced,5fc122bf3973504e619cd677ad4a7fc1011642cd,https://api.github.com/repos/pytorch/pytorch/commits/5fc122bf3973504e619cd677ad4a7fc1011642cd,2017-10-24T21:54:37Z,2,2,0
2231,2630274951,"{'login': 'facebook-github-bot', 'id': 6422482, 'node_id': 'MDQ6VXNlcjY0MjI0ODI=', 'avatar_url': 'https://avatars3.githubusercontent.com/u/6422482?v=4', 'gravatar_id': '', 'url': 'https://api.github.com/users/facebook-github-bot', 'html_url': 'https://github.com/facebook-github-bot', 'followers_url': 'https://api.github.com/users/facebook-github-bot/followers', 'following_url': 'https://api.github.com/users/facebook-github-bot/following{/other_user}', 'gists_url': 'https://api.github.com/users/facebook-github-bot/gists{/gist_id}', 'starred_url': 'https://api.github.com/users/facebook-github-bot/starred{/owner}{/repo}', 'subscriptions_url': 'https://api.github.com/users/facebook-github-bot/subscriptions', 'organizations_url': 'https://api.github.com/users/facebook-github-bot/orgs', 'repos_url': 'https://api.github.com/users/facebook-github-bot/repos', 'events_url': 'https://api.github.com/users/facebook-github-bot/events{/privacy}', 'received_events_url': 'https://api.github.com/users/facebook-github-bot/received_events', 'type': 'User', 'site_admin': False}",referenced,7e4ac8b851b9a4fa50addaf959842130d4920d7c,https://api.github.com/repos/pytorch/pytorch/commits/7e4ac8b851b9a4fa50addaf959842130d4920d7c,2019-09-12T19:15:17Z,7,6,1
2220,2630274937,"{'login': 'facebook-github-bot', 'id': 6422482, 'node_id': 'MDQ6VXNlcjY0MjI0ODI=', 'avatar_url': 'https://avatars3.githubusercontent.com/u/6422482?v=4', 'gravatar_id': '', 'url': 'https://api.github.com/users/facebook-github-bot', 'html_url': 'https://github.com/facebook-github-bot', 'followers_url': 'https://api.github.com/users/facebook-github-bot/followers', 'following_url': 'https://api.github.com/users/facebook-github-bot/following{/other_user}', 'gists_url': 'https://api.github.com/users/facebook-github-bot/gists{/gist_id}', 'starred_url': 'https://api.github.com/users/facebook-github-bot/starred{/owner}{/repo}', 'subscriptions_url': 'https://api.github.com/users/facebook-github-bot/subscriptions', 'organizations_url': 'https://api.github.com/users/facebook-github-bot/orgs', 'repos_url': 'https://api.github.com/users/facebook-github-bot/repos', 'events_url': 'https://api.github.com/users/facebook-github-bot/events{/privacy}', 'received_events_url': 'https://api.github.com/users/facebook-github-bot/received_events', 'type': 'User', 'site_admin': False}",referenced,7e4ac8b851b9a4fa50addaf959842130d4920d7c,https://api.github.com/repos/pytorch/pytorch/commits/7e4ac8b851b9a4fa50addaf959842130d4920d7c,2019-09-12T19:15:16Z,7,6,1
2206,1941357471,"{'login': 'facebook-github-bot', 'id': 6422482, 'node_id': 'MDQ6VXNlcjY0MjI0ODI=', 'avatar_url': 'https://avatars3.githubusercontent.com/u/6422482?v=4', 'gravatar_id': '', 'url': 'https://api.github.com/users/facebook-github-bot', 'html_url': 'https://github.com/facebook-github-bot', 'followers_url': 'https://api.github.com/users/facebook-github-bot/followers', 'following_url': 'https://api.github.com/users/facebook-github-bot/following{/other_user}', 'gists_url': 'https://api.github.com/users/facebook-github-bot/gists{/gist_id}', 'starred_url': 'https://api.github.com/users/facebook-github-bot/starred{/owner}{/repo}', 'subscriptions_url': 'https://api.github.com/users/facebook-github-bot/subscriptions', 'organizations_url': 'https://api.github.com/users/facebook-github-bot/orgs', 'repos_url': 'https://api.github.com/users/facebook-github-bot/repos', 'events_url': 'https://api.github.com/users/facebook-github-bot/events{/privacy}', 'received_events_url': 'https://api.github.com/users/facebook-github-bot/received_events', 'type': 'User', 'site_admin': False}",referenced,de0d85ba98489060f447af14f3fed89b75498a94,https://api.github.com/repos/pytorch/pytorch/commits/de0d85ba98489060f447af14f3fed89b75498a94,2018-11-01T19:20:04Z,23,0,23
2188,2630275023,"{'login': 'facebook-github-bot', 'id': 6422482, 'node_id': 'MDQ6VXNlcjY0MjI0ODI=', 'avatar_url': 'https://avatars3.githubusercontent.com/u/6422482?v=4', 'gravatar_id': '', 'url': 'https://api.github.com/users/facebook-github-bot', 'html_url': 'https://github.com/facebook-github-bot', 'followers_url': 'https://api.github.com/users/facebook-github-bot/followers', 'following_url': 'https://api.github.com/users/facebook-github-bot/following{/other_user}', 'gists_url': 'https://api.github.com/users/facebook-github-bot/gists{/gist_id}', 'starred_url': 'https://api.github.com/users/facebook-github-bot/starred{/owner}{/repo}', 'subscriptions_url': 'https://api.github.com/users/facebook-github-bot/subscriptions', 'organizations_url': 'https://api.github.com/users/facebook-github-bot/orgs', 'repos_url': 'https://api.github.com/users/facebook-github-bot/repos', 'events_url': 'https://api.github.com/users/facebook-github-bot/events{/privacy}', 'received_events_url': 'https://api.github.com/users/facebook-github-bot/received_events', 'type': 'User', 'site_admin': False}",referenced,7e4ac8b851b9a4fa50addaf959842130d4920d7c,https://api.github.com/repos/pytorch/pytorch/commits/7e4ac8b851b9a4fa50addaf959842130d4920d7c,2019-09-12T19:15:18Z,7,6,1
2187,2630274948,"{'login': 'facebook-github-bot', 'id': 6422482, 'node_id': 'MDQ6VXNlcjY0MjI0ODI=', 'avatar_url': 'https://avatars3.githubusercontent.com/u/6422482?v=4', 'gravatar_id': '', 'url': 'https://api.github.com/users/facebook-github-bot', 'html_url': 'https://github.com/facebook-github-bot', 'followers_url': 'https://api.github.com/users/facebook-github-bot/followers', 'following_url': 'https://api.github.com/users/facebook-github-bot/following{/other_user}', 'gists_url': 'https://api.github.com/users/facebook-github-bot/gists{/gist_id}', 'starred_url': 'https://api.github.com/users/facebook-github-bot/starred{/owner}{/repo}', 'subscriptions_url': 'https://api.github.com/users/facebook-github-bot/subscriptions', 'organizations_url': 'https://api.github.com/users/facebook-github-bot/orgs', 'repos_url': 'https://api.github.com/users/facebook-github-bot/repos', 'events_url': 'https://api.github.com/users/facebook-github-bot/events{/privacy}', 'received_events_url': 'https://api.github.com/users/facebook-github-bot/received_events', 'type': 'User', 'site_admin': False}",referenced,7e4ac8b851b9a4fa50addaf959842130d4920d7c,https://api.github.com/repos/pytorch/pytorch/commits/7e4ac8b851b9a4fa50addaf959842130d4920d7c,2019-09-12T19:15:17Z,7,6,1
2177,2630274992,"{'login': 'facebook-github-bot', 'id': 6422482, 'node_id': 'MDQ6VXNlcjY0MjI0ODI=', 'avatar_url': 'https://avatars3.githubusercontent.com/u/6422482?v=4', 'gravatar_id': '', 'url': 'https://api.github.com/users/facebook-github-bot', 'html_url': 'https://github.com/facebook-github-bot', 'followers_url': 'https://api.github.com/users/facebook-github-bot/followers', 'following_url': 'https://api.github.com/users/facebook-github-bot/following{/other_user}', 'gists_url': 'https://api.github.com/users/facebook-github-bot/gists{/gist_id}', 'starred_url': 'https://api.github.com/users/facebook-github-bot/starred{/owner}{/repo}', 'subscriptions_url': 'https://api.github.com/users/facebook-github-bot/subscriptions', 'organizations_url': 'https://api.github.com/users/facebook-github-bot/orgs', 'repos_url': 'https://api.github.com/users/facebook-github-bot/repos', 'events_url': 'https://api.github.com/users/facebook-github-bot/events{/privacy}', 'received_events_url': 'https://api.github.com/users/facebook-github-bot/received_events', 'type': 'User', 'site_admin': False}",referenced,7e4ac8b851b9a4fa50addaf959842130d4920d7c,https://api.github.com/repos/pytorch/pytorch/commits/7e4ac8b851b9a4fa50addaf959842130d4920d7c,2019-09-12T19:15:17Z,7,6,1
2156,1174471696,"{'login': 'soumith', 'id': 1310570, 'node_id': 'MDQ6VXNlcjEzMTA1NzA=', 'avatar_url': 'https://avatars0.githubusercontent.com/u/1310570?v=4', 'gravatar_id': '', 'url': 'https://api.github.com/users/soumith', 'html_url': 'https://github.com/soumith', 'followers_url': 'https://api.github.com/users/soumith/followers', 'following_url': 'https://api.github.com/users/soumith/following{/other_user}', 'gists_url': 'https://api.github.com/users/soumith/gists{/gist_id}', 'starred_url': 'https://api.github.com/users/soumith/starred{/owner}{/repo}', 'subscriptions_url': 'https://api.github.com/users/soumith/subscriptions', 'organizations_url': 'https://api.github.com/users/soumith/orgs', 'repos_url': 'https://api.github.com/users/soumith/repos', 'events_url': 'https://api.github.com/users/soumith/events{/privacy}', 'received_events_url': 'https://api.github.com/users/soumith/received_events', 'type': 'User', 'site_admin': False}",closed,2efac3ed83a29f57f914e9044fdddd2ce7ecd6b7,https://api.github.com/repos/pytorch/pytorch/commits/2efac3ed83a29f57f914e9044fdddd2ce7ecd6b7,2017-07-21T19:58:49Z,41,14,27
2156,1174471697,"{'login': 'soumith', 'id': 1310570, 'node_id': 'MDQ6VXNlcjEzMTA1NzA=', 'avatar_url': 'https://avatars0.githubusercontent.com/u/1310570?v=4', 'gravatar_id': '', 'url': 'https://api.github.com/users/soumith', 'html_url': 'https://github.com/soumith', 'followers_url': 'https://api.github.com/users/soumith/followers', 'following_url': 'https://api.github.com/users/soumith/following{/other_user}', 'gists_url': 'https://api.github.com/users/soumith/gists{/gist_id}', 'starred_url': 'https://api.github.com/users/soumith/starred{/owner}{/repo}', 'subscriptions_url': 'https://api.github.com/users/soumith/subscriptions', 'organizations_url': 'https://api.github.com/users/soumith/orgs', 'repos_url': 'https://api.github.com/users/soumith/repos', 'events_url': 'https://api.github.com/users/soumith/events{/privacy}', 'received_events_url': 'https://api.github.com/users/soumith/received_events', 'type': 'User', 'site_admin': False}",referenced,71ce3448d959ed97f77460d200dbdbdecd28cf12,https://api.github.com/repos/pytorch/pytorch/commits/71ce3448d959ed97f77460d200dbdbdecd28cf12,2017-07-21T19:58:49Z,1,1,0
2148,2639966583,"{'login': 'facebook-github-bot', 'id': 6422482, 'node_id': 'MDQ6VXNlcjY0MjI0ODI=', 'avatar_url': 'https://avatars3.githubusercontent.com/u/6422482?v=4', 'gravatar_id': '', 'url': 'https://api.github.com/users/facebook-github-bot', 'html_url': 'https://github.com/facebook-github-bot', 'followers_url': 'https://api.github.com/users/facebook-github-bot/followers', 'following_url': 'https://api.github.com/users/facebook-github-bot/following{/other_user}', 'gists_url': 'https://api.github.com/users/facebook-github-bot/gists{/gist_id}', 'starred_url': 'https://api.github.com/users/facebook-github-bot/starred{/owner}{/repo}', 'subscriptions_url': 'https://api.github.com/users/facebook-github-bot/subscriptions', 'organizations_url': 'https://api.github.com/users/facebook-github-bot/orgs', 'repos_url': 'https://api.github.com/users/facebook-github-bot/repos', 'events_url': 'https://api.github.com/users/facebook-github-bot/events{/privacy}', 'received_events_url': 'https://api.github.com/users/facebook-github-bot/received_events', 'type': 'User', 'site_admin': False}",referenced,bebc3d6aad8cd4b3ff3ccbaf5d8141bc10916df7,https://api.github.com/repos/pytorch/pytorch/commits/bebc3d6aad8cd4b3ff3ccbaf5d8141bc10916df7,2019-09-17T13:48:19Z,3,2,1
2147,2490872771,"{'login': 'facebook-github-bot', 'id': 6422482, 'node_id': 'MDQ6VXNlcjY0MjI0ODI=', 'avatar_url': 'https://avatars3.githubusercontent.com/u/6422482?v=4', 'gravatar_id': '', 'url': 'https://api.github.com/users/facebook-github-bot', 'html_url': 'https://github.com/facebook-github-bot', 'followers_url': 'https://api.github.com/users/facebook-github-bot/followers', 'following_url': 'https://api.github.com/users/facebook-github-bot/following{/other_user}', 'gists_url': 'https://api.github.com/users/facebook-github-bot/gists{/gist_id}', 'starred_url': 'https://api.github.com/users/facebook-github-bot/starred{/owner}{/repo}', 'subscriptions_url': 'https://api.github.com/users/facebook-github-bot/subscriptions', 'organizations_url': 'https://api.github.com/users/facebook-github-bot/orgs', 'repos_url': 'https://api.github.com/users/facebook-github-bot/repos', 'events_url': 'https://api.github.com/users/facebook-github-bot/events{/privacy}', 'received_events_url': 'https://api.github.com/users/facebook-github-bot/received_events', 'type': 'User', 'site_admin': False}",referenced,796a39ba85e6cb14d1fd3a6e7c6322e0b7e28ec2,https://api.github.com/repos/pytorch/pytorch/commits/796a39ba85e6cb14d1fd3a6e7c6322e0b7e28ec2,2019-07-17T21:07:55Z,3,2,1
2143,2630274963,"{'login': 'facebook-github-bot', 'id': 6422482, 'node_id': 'MDQ6VXNlcjY0MjI0ODI=', 'avatar_url': 'https://avatars3.githubusercontent.com/u/6422482?v=4', 'gravatar_id': '', 'url': 'https://api.github.com/users/facebook-github-bot', 'html_url': 'https://github.com/facebook-github-bot', 'followers_url': 'https://api.github.com/users/facebook-github-bot/followers', 'following_url': 'https://api.github.com/users/facebook-github-bot/following{/other_user}', 'gists_url': 'https://api.github.com/users/facebook-github-bot/gists{/gist_id}', 'starred_url': 'https://api.github.com/users/facebook-github-bot/starred{/owner}{/repo}', 'subscriptions_url': 'https://api.github.com/users/facebook-github-bot/subscriptions', 'organizations_url': 'https://api.github.com/users/facebook-github-bot/orgs', 'repos_url': 'https://api.github.com/users/facebook-github-bot/repos', 'events_url': 'https://api.github.com/users/facebook-github-bot/events{/privacy}', 'received_events_url': 'https://api.github.com/users/facebook-github-bot/received_events', 'type': 'User', 'site_admin': False}",referenced,7e4ac8b851b9a4fa50addaf959842130d4920d7c,https://api.github.com/repos/pytorch/pytorch/commits/7e4ac8b851b9a4fa50addaf959842130d4920d7c,2019-09-12T19:15:17Z,7,6,1
2141,1169454957,"{'login': 'apaszke', 'id': 4583066, 'node_id': 'MDQ6VXNlcjQ1ODMwNjY=', 'avatar_url': 'https://avatars3.githubusercontent.com/u/4583066?v=4', 'gravatar_id': '', 'url': 'https://api.github.com/users/apaszke', 'html_url': 'https://github.com/apaszke', 'followers_url': 'https://api.github.com/users/apaszke/followers', 'following_url': 'https://api.github.com/users/apaszke/following{/other_user}', 'gists_url': 'https://api.github.com/users/apaszke/gists{/gist_id}', 'starred_url': 'https://api.github.com/users/apaszke/starred{/owner}{/repo}', 'subscriptions_url': 'https://api.github.com/users/apaszke/subscriptions', 'organizations_url': 'https://api.github.com/users/apaszke/orgs', 'repos_url': 'https://api.github.com/users/apaszke/repos', 'events_url': 'https://api.github.com/users/apaszke/events{/privacy}', 'received_events_url': 'https://api.github.com/users/apaszke/received_events', 'type': 'User', 'site_admin': False}",referenced,685ae4813ef634c20bb8892444faf9de1e80eb2c,https://api.github.com/repos/pytorch/pytorch/commits/685ae4813ef634c20bb8892444faf9de1e80eb2c,2017-07-19T02:25:01Z,58,50,8
2141,2630274968,"{'login': 'facebook-github-bot', 'id': 6422482, 'node_id': 'MDQ6VXNlcjY0MjI0ODI=', 'avatar_url': 'https://avatars3.githubusercontent.com/u/6422482?v=4', 'gravatar_id': '', 'url': 'https://api.github.com/users/facebook-github-bot', 'html_url': 'https://github.com/facebook-github-bot', 'followers_url': 'https://api.github.com/users/facebook-github-bot/followers', 'following_url': 'https://api.github.com/users/facebook-github-bot/following{/other_user}', 'gists_url': 'https://api.github.com/users/facebook-github-bot/gists{/gist_id}', 'starred_url': 'https://api.github.com/users/facebook-github-bot/starred{/owner}{/repo}', 'subscriptions_url': 'https://api.github.com/users/facebook-github-bot/subscriptions', 'organizations_url': 'https://api.github.com/users/facebook-github-bot/orgs', 'repos_url': 'https://api.github.com/users/facebook-github-bot/repos', 'events_url': 'https://api.github.com/users/facebook-github-bot/events{/privacy}', 'received_events_url': 'https://api.github.com/users/facebook-github-bot/received_events', 'type': 'User', 'site_admin': False}",referenced,7e4ac8b851b9a4fa50addaf959842130d4920d7c,https://api.github.com/repos/pytorch/pytorch/commits/7e4ac8b851b9a4fa50addaf959842130d4920d7c,2019-09-12T19:15:17Z,7,6,1
2138,2448770705,"{'login': 'facebook-github-bot', 'id': 6422482, 'node_id': 'MDQ6VXNlcjY0MjI0ODI=', 'avatar_url': 'https://avatars3.githubusercontent.com/u/6422482?v=4', 'gravatar_id': '', 'url': 'https://api.github.com/users/facebook-github-bot', 'html_url': 'https://github.com/facebook-github-bot', 'followers_url': 'https://api.github.com/users/facebook-github-bot/followers', 'following_url': 'https://api.github.com/users/facebook-github-bot/following{/other_user}', 'gists_url': 'https://api.github.com/users/facebook-github-bot/gists{/gist_id}', 'starred_url': 'https://api.github.com/users/facebook-github-bot/starred{/owner}{/repo}', 'subscriptions_url': 'https://api.github.com/users/facebook-github-bot/subscriptions', 'organizations_url': 'https://api.github.com/users/facebook-github-bot/orgs', 'repos_url': 'https://api.github.com/users/facebook-github-bot/repos', 'events_url': 'https://api.github.com/users/facebook-github-bot/events{/privacy}', 'received_events_url': 'https://api.github.com/users/facebook-github-bot/received_events', 'type': 'User', 'site_admin': False}",referenced,9e18234109778fc5ab6f03fc00164d3468102e01,https://api.github.com/repos/pytorch/pytorch/commits/9e18234109778fc5ab6f03fc00164d3468102e01,2019-06-29T05:24:53Z,2,1,1
2133,2657889002,"{'login': 'facebook-github-bot', 'id': 6422482, 'node_id': 'MDQ6VXNlcjY0MjI0ODI=', 'avatar_url': 'https://avatars3.githubusercontent.com/u/6422482?v=4', 'gravatar_id': '', 'url': 'https://api.github.com/users/facebook-github-bot', 'html_url': 'https://github.com/facebook-github-bot', 'followers_url': 'https://api.github.com/users/facebook-github-bot/followers', 'following_url': 'https://api.github.com/users/facebook-github-bot/following{/other_user}', 'gists_url': 'https://api.github.com/users/facebook-github-bot/gists{/gist_id}', 'starred_url': 'https://api.github.com/users/facebook-github-bot/starred{/owner}{/repo}', 'subscriptions_url': 'https://api.github.com/users/facebook-github-bot/subscriptions', 'organizations_url': 'https://api.github.com/users/facebook-github-bot/orgs', 'repos_url': 'https://api.github.com/users/facebook-github-bot/repos', 'events_url': 'https://api.github.com/users/facebook-github-bot/events{/privacy}', 'received_events_url': 'https://api.github.com/users/facebook-github-bot/received_events', 'type': 'User', 'site_admin': False}",referenced,d6ee58494f816b9784a974c9d5a5c95376a3a55b,https://api.github.com/repos/pytorch/pytorch/commits/d6ee58494f816b9784a974c9d5a5c95376a3a55b,2019-09-24T12:40:02Z,7,6,1
2126,2630274976,"{'login': 'facebook-github-bot', 'id': 6422482, 'node_id': 'MDQ6VXNlcjY0MjI0ODI=', 'avatar_url': 'https://avatars3.githubusercontent.com/u/6422482?v=4', 'gravatar_id': '', 'url': 'https://api.github.com/users/facebook-github-bot', 'html_url': 'https://github.com/facebook-github-bot', 'followers_url': 'https://api.github.com/users/facebook-github-bot/followers', 'following_url': 'https://api.github.com/users/facebook-github-bot/following{/other_user}', 'gists_url': 'https://api.github.com/users/facebook-github-bot/gists{/gist_id}', 'starred_url': 'https://api.github.com/users/facebook-github-bot/starred{/owner}{/repo}', 'subscriptions_url': 'https://api.github.com/users/facebook-github-bot/subscriptions', 'organizations_url': 'https://api.github.com/users/facebook-github-bot/orgs', 'repos_url': 'https://api.github.com/users/facebook-github-bot/repos', 'events_url': 'https://api.github.com/users/facebook-github-bot/events{/privacy}', 'received_events_url': 'https://api.github.com/users/facebook-github-bot/received_events', 'type': 'User', 'site_admin': False}",referenced,7e4ac8b851b9a4fa50addaf959842130d4920d7c,https://api.github.com/repos/pytorch/pytorch/commits/7e4ac8b851b9a4fa50addaf959842130d4920d7c,2019-09-12T19:15:17Z,7,6,1
2115,2448770712,"{'login': 'facebook-github-bot', 'id': 6422482, 'node_id': 'MDQ6VXNlcjY0MjI0ODI=', 'avatar_url': 'https://avatars3.githubusercontent.com/u/6422482?v=4', 'gravatar_id': '', 'url': 'https://api.github.com/users/facebook-github-bot', 'html_url': 'https://github.com/facebook-github-bot', 'followers_url': 'https://api.github.com/users/facebook-github-bot/followers', 'following_url': 'https://api.github.com/users/facebook-github-bot/following{/other_user}', 'gists_url': 'https://api.github.com/users/facebook-github-bot/gists{/gist_id}', 'starred_url': 'https://api.github.com/users/facebook-github-bot/starred{/owner}{/repo}', 'subscriptions_url': 'https://api.github.com/users/facebook-github-bot/subscriptions', 'organizations_url': 'https://api.github.com/users/facebook-github-bot/orgs', 'repos_url': 'https://api.github.com/users/facebook-github-bot/repos', 'events_url': 'https://api.github.com/users/facebook-github-bot/events{/privacy}', 'received_events_url': 'https://api.github.com/users/facebook-github-bot/received_events', 'type': 'User', 'site_admin': False}",referenced,9e18234109778fc5ab6f03fc00164d3468102e01,https://api.github.com/repos/pytorch/pytorch/commits/9e18234109778fc5ab6f03fc00164d3468102e01,2019-06-29T05:24:53Z,2,1,1
2104,2428835005,"{'login': 'facebook-github-bot', 'id': 6422482, 'node_id': 'MDQ6VXNlcjY0MjI0ODI=', 'avatar_url': 'https://avatars3.githubusercontent.com/u/6422482?v=4', 'gravatar_id': '', 'url': 'https://api.github.com/users/facebook-github-bot', 'html_url': 'https://github.com/facebook-github-bot', 'followers_url': 'https://api.github.com/users/facebook-github-bot/followers', 'following_url': 'https://api.github.com/users/facebook-github-bot/following{/other_user}', 'gists_url': 'https://api.github.com/users/facebook-github-bot/gists{/gist_id}', 'starred_url': 'https://api.github.com/users/facebook-github-bot/starred{/owner}{/repo}', 'subscriptions_url': 'https://api.github.com/users/facebook-github-bot/subscriptions', 'organizations_url': 'https://api.github.com/users/facebook-github-bot/orgs', 'repos_url': 'https://api.github.com/users/facebook-github-bot/repos', 'events_url': 'https://api.github.com/users/facebook-github-bot/events{/privacy}', 'received_events_url': 'https://api.github.com/users/facebook-github-bot/received_events', 'type': 'User', 'site_admin': False}",referenced,d4119f8fcbde15569b8f2993973439f2961ea22a,https://api.github.com/repos/pytorch/pytorch/commits/d4119f8fcbde15569b8f2993973439f2961ea22a,2019-06-20T22:55:19Z,2,1,1
2098,2448770707,"{'login': 'facebook-github-bot', 'id': 6422482, 'node_id': 'MDQ6VXNlcjY0MjI0ODI=', 'avatar_url': 'https://avatars3.githubusercontent.com/u/6422482?v=4', 'gravatar_id': '', 'url': 'https://api.github.com/users/facebook-github-bot', 'html_url': 'https://github.com/facebook-github-bot', 'followers_url': 'https://api.github.com/users/facebook-github-bot/followers', 'following_url': 'https://api.github.com/users/facebook-github-bot/following{/other_user}', 'gists_url': 'https://api.github.com/users/facebook-github-bot/gists{/gist_id}', 'starred_url': 'https://api.github.com/users/facebook-github-bot/starred{/owner}{/repo}', 'subscriptions_url': 'https://api.github.com/users/facebook-github-bot/subscriptions', 'organizations_url': 'https://api.github.com/users/facebook-github-bot/orgs', 'repos_url': 'https://api.github.com/users/facebook-github-bot/repos', 'events_url': 'https://api.github.com/users/facebook-github-bot/events{/privacy}', 'received_events_url': 'https://api.github.com/users/facebook-github-bot/received_events', 'type': 'User', 'site_admin': False}",referenced,9e18234109778fc5ab6f03fc00164d3468102e01,https://api.github.com/repos/pytorch/pytorch/commits/9e18234109778fc5ab6f03fc00164d3468102e01,2019-06-29T05:24:53Z,2,1,1
2088,2428835011,"{'login': 'facebook-github-bot', 'id': 6422482, 'node_id': 'MDQ6VXNlcjY0MjI0ODI=', 'avatar_url': 'https://avatars3.githubusercontent.com/u/6422482?v=4', 'gravatar_id': '', 'url': 'https://api.github.com/users/facebook-github-bot', 'html_url': 'https://github.com/facebook-github-bot', 'followers_url': 'https://api.github.com/users/facebook-github-bot/followers', 'following_url': 'https://api.github.com/users/facebook-github-bot/following{/other_user}', 'gists_url': 'https://api.github.com/users/facebook-github-bot/gists{/gist_id}', 'starred_url': 'https://api.github.com/users/facebook-github-bot/starred{/owner}{/repo}', 'subscriptions_url': 'https://api.github.com/users/facebook-github-bot/subscriptions', 'organizations_url': 'https://api.github.com/users/facebook-github-bot/orgs', 'repos_url': 'https://api.github.com/users/facebook-github-bot/repos', 'events_url': 'https://api.github.com/users/facebook-github-bot/events{/privacy}', 'received_events_url': 'https://api.github.com/users/facebook-github-bot/received_events', 'type': 'User', 'site_admin': False}",referenced,d4119f8fcbde15569b8f2993973439f2961ea22a,https://api.github.com/repos/pytorch/pytorch/commits/d4119f8fcbde15569b8f2993973439f2961ea22a,2019-06-20T22:55:19Z,2,1,1
2085,2428835009,"{'login': 'facebook-github-bot', 'id': 6422482, 'node_id': 'MDQ6VXNlcjY0MjI0ODI=', 'avatar_url': 'https://avatars3.githubusercontent.com/u/6422482?v=4', 'gravatar_id': '', 'url': 'https://api.github.com/users/facebook-github-bot', 'html_url': 'https://github.com/facebook-github-bot', 'followers_url': 'https://api.github.com/users/facebook-github-bot/followers', 'following_url': 'https://api.github.com/users/facebook-github-bot/following{/other_user}', 'gists_url': 'https://api.github.com/users/facebook-github-bot/gists{/gist_id}', 'starred_url': 'https://api.github.com/users/facebook-github-bot/starred{/owner}{/repo}', 'subscriptions_url': 'https://api.github.com/users/facebook-github-bot/subscriptions', 'organizations_url': 'https://api.github.com/users/facebook-github-bot/orgs', 'repos_url': 'https://api.github.com/users/facebook-github-bot/repos', 'events_url': 'https://api.github.com/users/facebook-github-bot/events{/privacy}', 'received_events_url': 'https://api.github.com/users/facebook-github-bot/received_events', 'type': 'User', 'site_admin': False}",referenced,d4119f8fcbde15569b8f2993973439f2961ea22a,https://api.github.com/repos/pytorch/pytorch/commits/d4119f8fcbde15569b8f2993973439f2961ea22a,2019-06-20T22:55:19Z,2,1,1
2076,2405803958,"{'login': 'facebook-github-bot', 'id': 6422482, 'node_id': 'MDQ6VXNlcjY0MjI0ODI=', 'avatar_url': 'https://avatars3.githubusercontent.com/u/6422482?v=4', 'gravatar_id': '', 'url': 'https://api.github.com/users/facebook-github-bot', 'html_url': 'https://github.com/facebook-github-bot', 'followers_url': 'https://api.github.com/users/facebook-github-bot/followers', 'following_url': 'https://api.github.com/users/facebook-github-bot/following{/other_user}', 'gists_url': 'https://api.github.com/users/facebook-github-bot/gists{/gist_id}', 'starred_url': 'https://api.github.com/users/facebook-github-bot/starred{/owner}{/repo}', 'subscriptions_url': 'https://api.github.com/users/facebook-github-bot/subscriptions', 'organizations_url': 'https://api.github.com/users/facebook-github-bot/orgs', 'repos_url': 'https://api.github.com/users/facebook-github-bot/repos', 'events_url': 'https://api.github.com/users/facebook-github-bot/events{/privacy}', 'received_events_url': 'https://api.github.com/users/facebook-github-bot/received_events', 'type': 'User', 'site_admin': False}",referenced,c2a08d339b373cf3df70283d0c479cecfa3104b3,https://api.github.com/repos/pytorch/pytorch/commits/c2a08d339b373cf3df70283d0c479cecfa3104b3,2019-06-11T23:57:36Z,3,2,1
2068,2405803962,"{'login': 'facebook-github-bot', 'id': 6422482, 'node_id': 'MDQ6VXNlcjY0MjI0ODI=', 'avatar_url': 'https://avatars3.githubusercontent.com/u/6422482?v=4', 'gravatar_id': '', 'url': 'https://api.github.com/users/facebook-github-bot', 'html_url': 'https://github.com/facebook-github-bot', 'followers_url': 'https://api.github.com/users/facebook-github-bot/followers', 'following_url': 'https://api.github.com/users/facebook-github-bot/following{/other_user}', 'gists_url': 'https://api.github.com/users/facebook-github-bot/gists{/gist_id}', 'starred_url': 'https://api.github.com/users/facebook-github-bot/starred{/owner}{/repo}', 'subscriptions_url': 'https://api.github.com/users/facebook-github-bot/subscriptions', 'organizations_url': 'https://api.github.com/users/facebook-github-bot/orgs', 'repos_url': 'https://api.github.com/users/facebook-github-bot/repos', 'events_url': 'https://api.github.com/users/facebook-github-bot/events{/privacy}', 'received_events_url': 'https://api.github.com/users/facebook-github-bot/received_events', 'type': 'User', 'site_admin': False}",referenced,c2a08d339b373cf3df70283d0c479cecfa3104b3,https://api.github.com/repos/pytorch/pytorch/commits/c2a08d339b373cf3df70283d0c479cecfa3104b3,2019-06-11T23:57:36Z,3,2,1
2060,2657888993,"{'login': 'facebook-github-bot', 'id': 6422482, 'node_id': 'MDQ6VXNlcjY0MjI0ODI=', 'avatar_url': 'https://avatars3.githubusercontent.com/u/6422482?v=4', 'gravatar_id': '', 'url': 'https://api.github.com/users/facebook-github-bot', 'html_url': 'https://github.com/facebook-github-bot', 'followers_url': 'https://api.github.com/users/facebook-github-bot/followers', 'following_url': 'https://api.github.com/users/facebook-github-bot/following{/other_user}', 'gists_url': 'https://api.github.com/users/facebook-github-bot/gists{/gist_id}', 'starred_url': 'https://api.github.com/users/facebook-github-bot/starred{/owner}{/repo}', 'subscriptions_url': 'https://api.github.com/users/facebook-github-bot/subscriptions', 'organizations_url': 'https://api.github.com/users/facebook-github-bot/orgs', 'repos_url': 'https://api.github.com/users/facebook-github-bot/repos', 'events_url': 'https://api.github.com/users/facebook-github-bot/events{/privacy}', 'received_events_url': 'https://api.github.com/users/facebook-github-bot/received_events', 'type': 'User', 'site_admin': False}",referenced,d6ee58494f816b9784a974c9d5a5c95376a3a55b,https://api.github.com/repos/pytorch/pytorch/commits/d6ee58494f816b9784a974c9d5a5c95376a3a55b,2019-09-24T12:40:02Z,7,6,1
2055,1162616755,"{'login': 'soumith', 'id': 1310570, 'node_id': 'MDQ6VXNlcjEzMTA1NzA=', 'avatar_url': 'https://avatars0.githubusercontent.com/u/1310570?v=4', 'gravatar_id': '', 'url': 'https://api.github.com/users/soumith', 'html_url': 'https://github.com/soumith', 'followers_url': 'https://api.github.com/users/soumith/followers', 'following_url': 'https://api.github.com/users/soumith/following{/other_user}', 'gists_url': 'https://api.github.com/users/soumith/gists{/gist_id}', 'starred_url': 'https://api.github.com/users/soumith/starred{/owner}{/repo}', 'subscriptions_url': 'https://api.github.com/users/soumith/subscriptions', 'organizations_url': 'https://api.github.com/users/soumith/orgs', 'repos_url': 'https://api.github.com/users/soumith/repos', 'events_url': 'https://api.github.com/users/soumith/events{/privacy}', 'received_events_url': 'https://api.github.com/users/soumith/received_events', 'type': 'User', 'site_admin': False}",referenced,f98c38497398ac2adb43e8d04b491d6f2e126fdf,https://api.github.com/repos/pytorch/pytorch/commits/f98c38497398ac2adb43e8d04b491d6f2e126fdf,2017-07-13T13:56:17Z,10,7,3
2032,2360235639,"{'login': 'facebook-github-bot', 'id': 6422482, 'node_id': 'MDQ6VXNlcjY0MjI0ODI=', 'avatar_url': 'https://avatars3.githubusercontent.com/u/6422482?v=4', 'gravatar_id': '', 'url': 'https://api.github.com/users/facebook-github-bot', 'html_url': 'https://github.com/facebook-github-bot', 'followers_url': 'https://api.github.com/users/facebook-github-bot/followers', 'following_url': 'https://api.github.com/users/facebook-github-bot/following{/other_user}', 'gists_url': 'https://api.github.com/users/facebook-github-bot/gists{/gist_id}', 'starred_url': 'https://api.github.com/users/facebook-github-bot/starred{/owner}{/repo}', 'subscriptions_url': 'https://api.github.com/users/facebook-github-bot/subscriptions', 'organizations_url': 'https://api.github.com/users/facebook-github-bot/orgs', 'repos_url': 'https://api.github.com/users/facebook-github-bot/repos', 'events_url': 'https://api.github.com/users/facebook-github-bot/events{/privacy}', 'received_events_url': 'https://api.github.com/users/facebook-github-bot/received_events', 'type': 'User', 'site_admin': False}",referenced,810816a1f95e4bbbd9b7416d317875aecc5f40a5,https://api.github.com/repos/pytorch/pytorch/commits/810816a1f95e4bbbd9b7416d317875aecc5f40a5,2019-05-22T18:39:34Z,2,1,1
2031,1510066381,"{'login': 'ezyang', 'id': 13564, 'node_id': 'MDQ6VXNlcjEzNTY0', 'avatar_url': 'https://avatars0.githubusercontent.com/u/13564?v=4', 'gravatar_id': '', 'url': 'https://api.github.com/users/ezyang', 'html_url': 'https://github.com/ezyang', 'followers_url': 'https://api.github.com/users/ezyang/followers', 'following_url': 'https://api.github.com/users/ezyang/following{/other_user}', 'gists_url': 'https://api.github.com/users/ezyang/gists{/gist_id}', 'starred_url': 'https://api.github.com/users/ezyang/starred{/owner}{/repo}', 'subscriptions_url': 'https://api.github.com/users/ezyang/subscriptions', 'organizations_url': 'https://api.github.com/users/ezyang/orgs', 'repos_url': 'https://api.github.com/users/ezyang/repos', 'events_url': 'https://api.github.com/users/ezyang/events{/privacy}', 'received_events_url': 'https://api.github.com/users/ezyang/received_events', 'type': 'User', 'site_admin': False}",closed,c2721ab5039466ced3af077fae14d8ee578ff484,https://api.github.com/repos/pytorch/pytorch/commits/c2721ab5039466ced3af077fae14d8ee578ff484,2018-03-07T23:17:09Z,248,246,2
2031,2657889011,"{'login': 'facebook-github-bot', 'id': 6422482, 'node_id': 'MDQ6VXNlcjY0MjI0ODI=', 'avatar_url': 'https://avatars3.githubusercontent.com/u/6422482?v=4', 'gravatar_id': '', 'url': 'https://api.github.com/users/facebook-github-bot', 'html_url': 'https://github.com/facebook-github-bot', 'followers_url': 'https://api.github.com/users/facebook-github-bot/followers', 'following_url': 'https://api.github.com/users/facebook-github-bot/following{/other_user}', 'gists_url': 'https://api.github.com/users/facebook-github-bot/gists{/gist_id}', 'starred_url': 'https://api.github.com/users/facebook-github-bot/starred{/owner}{/repo}', 'subscriptions_url': 'https://api.github.com/users/facebook-github-bot/subscriptions', 'organizations_url': 'https://api.github.com/users/facebook-github-bot/orgs', 'repos_url': 'https://api.github.com/users/facebook-github-bot/repos', 'events_url': 'https://api.github.com/users/facebook-github-bot/events{/privacy}', 'received_events_url': 'https://api.github.com/users/facebook-github-bot/received_events', 'type': 'User', 'site_admin': False}",referenced,d6ee58494f816b9784a974c9d5a5c95376a3a55b,https://api.github.com/repos/pytorch/pytorch/commits/d6ee58494f816b9784a974c9d5a5c95376a3a55b,2019-09-24T12:40:02Z,7,6,1
2028,2360235643,"{'login': 'facebook-github-bot', 'id': 6422482, 'node_id': 'MDQ6VXNlcjY0MjI0ODI=', 'avatar_url': 'https://avatars3.githubusercontent.com/u/6422482?v=4', 'gravatar_id': '', 'url': 'https://api.github.com/users/facebook-github-bot', 'html_url': 'https://github.com/facebook-github-bot', 'followers_url': 'https://api.github.com/users/facebook-github-bot/followers', 'following_url': 'https://api.github.com/users/facebook-github-bot/following{/other_user}', 'gists_url': 'https://api.github.com/users/facebook-github-bot/gists{/gist_id}', 'starred_url': 'https://api.github.com/users/facebook-github-bot/starred{/owner}{/repo}', 'subscriptions_url': 'https://api.github.com/users/facebook-github-bot/subscriptions', 'organizations_url': 'https://api.github.com/users/facebook-github-bot/orgs', 'repos_url': 'https://api.github.com/users/facebook-github-bot/repos', 'events_url': 'https://api.github.com/users/facebook-github-bot/events{/privacy}', 'received_events_url': 'https://api.github.com/users/facebook-github-bot/received_events', 'type': 'User', 'site_admin': False}",referenced,810816a1f95e4bbbd9b7416d317875aecc5f40a5,https://api.github.com/repos/pytorch/pytorch/commits/810816a1f95e4bbbd9b7416d317875aecc5f40a5,2019-05-22T18:39:34Z,2,1,1
2027,1975336689,"{'login': 'facebook-github-bot', 'id': 6422482, 'node_id': 'MDQ6VXNlcjY0MjI0ODI=', 'avatar_url': 'https://avatars3.githubusercontent.com/u/6422482?v=4', 'gravatar_id': '', 'url': 'https://api.github.com/users/facebook-github-bot', 'html_url': 'https://github.com/facebook-github-bot', 'followers_url': 'https://api.github.com/users/facebook-github-bot/followers', 'following_url': 'https://api.github.com/users/facebook-github-bot/following{/other_user}', 'gists_url': 'https://api.github.com/users/facebook-github-bot/gists{/gist_id}', 'starred_url': 'https://api.github.com/users/facebook-github-bot/starred{/owner}{/repo}', 'subscriptions_url': 'https://api.github.com/users/facebook-github-bot/subscriptions', 'organizations_url': 'https://api.github.com/users/facebook-github-bot/orgs', 'repos_url': 'https://api.github.com/users/facebook-github-bot/repos', 'events_url': 'https://api.github.com/users/facebook-github-bot/events{/privacy}', 'received_events_url': 'https://api.github.com/users/facebook-github-bot/received_events', 'type': 'User', 'site_admin': False}",closed,e387d945c227a0e50672b9e6c28b79620b7d26c8,https://api.github.com/repos/pytorch/pytorch/commits/e387d945c227a0e50672b9e6c28b79620b7d26c8,2018-11-19T17:51:57Z,72,58,14
2017,1163277520,"{'login': 'colesbury', 'id': 655866, 'node_id': 'MDQ6VXNlcjY1NTg2Ng==', 'avatar_url': 'https://avatars1.githubusercontent.com/u/655866?v=4', 'gravatar_id': '', 'url': 'https://api.github.com/users/colesbury', 'html_url': 'https://github.com/colesbury', 'followers_url': 'https://api.github.com/users/colesbury/followers', 'following_url': 'https://api.github.com/users/colesbury/following{/other_user}', 'gists_url': 'https://api.github.com/users/colesbury/gists{/gist_id}', 'starred_url': 'https://api.github.com/users/colesbury/starred{/owner}{/repo}', 'subscriptions_url': 'https://api.github.com/users/colesbury/subscriptions', 'organizations_url': 'https://api.github.com/users/colesbury/orgs', 'repos_url': 'https://api.github.com/users/colesbury/repos', 'events_url': 'https://api.github.com/users/colesbury/events{/privacy}', 'received_events_url': 'https://api.github.com/users/colesbury/received_events', 'type': 'User', 'site_admin': False}",referenced,42485d87c24305a770aa52c0ec9988c4e86b3154,https://api.github.com/repos/pytorch/pytorch/commits/42485d87c24305a770aa52c0ec9988c4e86b3154,2017-07-13T20:24:43Z,40,31,9
2017,2360235647,"{'login': 'facebook-github-bot', 'id': 6422482, 'node_id': 'MDQ6VXNlcjY0MjI0ODI=', 'avatar_url': 'https://avatars3.githubusercontent.com/u/6422482?v=4', 'gravatar_id': '', 'url': 'https://api.github.com/users/facebook-github-bot', 'html_url': 'https://github.com/facebook-github-bot', 'followers_url': 'https://api.github.com/users/facebook-github-bot/followers', 'following_url': 'https://api.github.com/users/facebook-github-bot/following{/other_user}', 'gists_url': 'https://api.github.com/users/facebook-github-bot/gists{/gist_id}', 'starred_url': 'https://api.github.com/users/facebook-github-bot/starred{/owner}{/repo}', 'subscriptions_url': 'https://api.github.com/users/facebook-github-bot/subscriptions', 'organizations_url': 'https://api.github.com/users/facebook-github-bot/orgs', 'repos_url': 'https://api.github.com/users/facebook-github-bot/repos', 'events_url': 'https://api.github.com/users/facebook-github-bot/events{/privacy}', 'received_events_url': 'https://api.github.com/users/facebook-github-bot/received_events', 'type': 'User', 'site_admin': False}",referenced,810816a1f95e4bbbd9b7416d317875aecc5f40a5,https://api.github.com/repos/pytorch/pytorch/commits/810816a1f95e4bbbd9b7416d317875aecc5f40a5,2019-05-22T18:39:34Z,2,1,1
1988,2325849596,"{'login': 'facebook-github-bot', 'id': 6422482, 'node_id': 'MDQ6VXNlcjY0MjI0ODI=', 'avatar_url': 'https://avatars3.githubusercontent.com/u/6422482?v=4', 'gravatar_id': '', 'url': 'https://api.github.com/users/facebook-github-bot', 'html_url': 'https://github.com/facebook-github-bot', 'followers_url': 'https://api.github.com/users/facebook-github-bot/followers', 'following_url': 'https://api.github.com/users/facebook-github-bot/following{/other_user}', 'gists_url': 'https://api.github.com/users/facebook-github-bot/gists{/gist_id}', 'starred_url': 'https://api.github.com/users/facebook-github-bot/starred{/owner}{/repo}', 'subscriptions_url': 'https://api.github.com/users/facebook-github-bot/subscriptions', 'organizations_url': 'https://api.github.com/users/facebook-github-bot/orgs', 'repos_url': 'https://api.github.com/users/facebook-github-bot/repos', 'events_url': 'https://api.github.com/users/facebook-github-bot/events{/privacy}', 'received_events_url': 'https://api.github.com/users/facebook-github-bot/received_events', 'type': 'User', 'site_admin': False}",referenced,48e649b8039a29a48cdb8f9a6a8d44250a118461,https://api.github.com/repos/pytorch/pytorch/commits/48e649b8039a29a48cdb8f9a6a8d44250a118461,2019-05-08T00:34:42Z,2,1,1
1985,2325849600,"{'login': 'facebook-github-bot', 'id': 6422482, 'node_id': 'MDQ6VXNlcjY0MjI0ODI=', 'avatar_url': 'https://avatars3.githubusercontent.com/u/6422482?v=4', 'gravatar_id': '', 'url': 'https://api.github.com/users/facebook-github-bot', 'html_url': 'https://github.com/facebook-github-bot', 'followers_url': 'https://api.github.com/users/facebook-github-bot/followers', 'following_url': 'https://api.github.com/users/facebook-github-bot/following{/other_user}', 'gists_url': 'https://api.github.com/users/facebook-github-bot/gists{/gist_id}', 'starred_url': 'https://api.github.com/users/facebook-github-bot/starred{/owner}{/repo}', 'subscriptions_url': 'https://api.github.com/users/facebook-github-bot/subscriptions', 'organizations_url': 'https://api.github.com/users/facebook-github-bot/orgs', 'repos_url': 'https://api.github.com/users/facebook-github-bot/repos', 'events_url': 'https://api.github.com/users/facebook-github-bot/events{/privacy}', 'received_events_url': 'https://api.github.com/users/facebook-github-bot/received_events', 'type': 'User', 'site_admin': False}",referenced,48e649b8039a29a48cdb8f9a6a8d44250a118461,https://api.github.com/repos/pytorch/pytorch/commits/48e649b8039a29a48cdb8f9a6a8d44250a118461,2019-05-08T00:34:42Z,2,1,1
1984,2313552196,"{'login': 'facebook-github-bot', 'id': 6422482, 'node_id': 'MDQ6VXNlcjY0MjI0ODI=', 'avatar_url': 'https://avatars3.githubusercontent.com/u/6422482?v=4', 'gravatar_id': '', 'url': 'https://api.github.com/users/facebook-github-bot', 'html_url': 'https://github.com/facebook-github-bot', 'followers_url': 'https://api.github.com/users/facebook-github-bot/followers', 'following_url': 'https://api.github.com/users/facebook-github-bot/following{/other_user}', 'gists_url': 'https://api.github.com/users/facebook-github-bot/gists{/gist_id}', 'starred_url': 'https://api.github.com/users/facebook-github-bot/starred{/owner}{/repo}', 'subscriptions_url': 'https://api.github.com/users/facebook-github-bot/subscriptions', 'organizations_url': 'https://api.github.com/users/facebook-github-bot/orgs', 'repos_url': 'https://api.github.com/users/facebook-github-bot/repos', 'events_url': 'https://api.github.com/users/facebook-github-bot/events{/privacy}', 'received_events_url': 'https://api.github.com/users/facebook-github-bot/received_events', 'type': 'User', 'site_admin': False}",referenced,002009b5a99f225d898600f13c55087e2ab39cc9,https://api.github.com/repos/pytorch/pytorch/commits/002009b5a99f225d898600f13c55087e2ab39cc9,2019-05-02T05:18:17Z,2,1,1
1981,2630274911,"{'login': 'facebook-github-bot', 'id': 6422482, 'node_id': 'MDQ6VXNlcjY0MjI0ODI=', 'avatar_url': 'https://avatars3.githubusercontent.com/u/6422482?v=4', 'gravatar_id': '', 'url': 'https://api.github.com/users/facebook-github-bot', 'html_url': 'https://github.com/facebook-github-bot', 'followers_url': 'https://api.github.com/users/facebook-github-bot/followers', 'following_url': 'https://api.github.com/users/facebook-github-bot/following{/other_user}', 'gists_url': 'https://api.github.com/users/facebook-github-bot/gists{/gist_id}', 'starred_url': 'https://api.github.com/users/facebook-github-bot/starred{/owner}{/repo}', 'subscriptions_url': 'https://api.github.com/users/facebook-github-bot/subscriptions', 'organizations_url': 'https://api.github.com/users/facebook-github-bot/orgs', 'repos_url': 'https://api.github.com/users/facebook-github-bot/repos', 'events_url': 'https://api.github.com/users/facebook-github-bot/events{/privacy}', 'received_events_url': 'https://api.github.com/users/facebook-github-bot/received_events', 'type': 'User', 'site_admin': False}",referenced,7e4ac8b851b9a4fa50addaf959842130d4920d7c,https://api.github.com/repos/pytorch/pytorch/commits/7e4ac8b851b9a4fa50addaf959842130d4920d7c,2019-09-12T19:15:16Z,7,6,1
1980,2325849598,"{'login': 'facebook-github-bot', 'id': 6422482, 'node_id': 'MDQ6VXNlcjY0MjI0ODI=', 'avatar_url': 'https://avatars3.githubusercontent.com/u/6422482?v=4', 'gravatar_id': '', 'url': 'https://api.github.com/users/facebook-github-bot', 'html_url': 'https://github.com/facebook-github-bot', 'followers_url': 'https://api.github.com/users/facebook-github-bot/followers', 'following_url': 'https://api.github.com/users/facebook-github-bot/following{/other_user}', 'gists_url': 'https://api.github.com/users/facebook-github-bot/gists{/gist_id}', 'starred_url': 'https://api.github.com/users/facebook-github-bot/starred{/owner}{/repo}', 'subscriptions_url': 'https://api.github.com/users/facebook-github-bot/subscriptions', 'organizations_url': 'https://api.github.com/users/facebook-github-bot/orgs', 'repos_url': 'https://api.github.com/users/facebook-github-bot/repos', 'events_url': 'https://api.github.com/users/facebook-github-bot/events{/privacy}', 'received_events_url': 'https://api.github.com/users/facebook-github-bot/received_events', 'type': 'User', 'site_admin': False}",referenced,48e649b8039a29a48cdb8f9a6a8d44250a118461,https://api.github.com/repos/pytorch/pytorch/commits/48e649b8039a29a48cdb8f9a6a8d44250a118461,2019-05-08T00:34:42Z,2,1,1
1964,2302095903,"{'login': 'facebook-github-bot', 'id': 6422482, 'node_id': 'MDQ6VXNlcjY0MjI0ODI=', 'avatar_url': 'https://avatars3.githubusercontent.com/u/6422482?v=4', 'gravatar_id': '', 'url': 'https://api.github.com/users/facebook-github-bot', 'html_url': 'https://github.com/facebook-github-bot', 'followers_url': 'https://api.github.com/users/facebook-github-bot/followers', 'following_url': 'https://api.github.com/users/facebook-github-bot/following{/other_user}', 'gists_url': 'https://api.github.com/users/facebook-github-bot/gists{/gist_id}', 'starred_url': 'https://api.github.com/users/facebook-github-bot/starred{/owner}{/repo}', 'subscriptions_url': 'https://api.github.com/users/facebook-github-bot/subscriptions', 'organizations_url': 'https://api.github.com/users/facebook-github-bot/orgs', 'repos_url': 'https://api.github.com/users/facebook-github-bot/repos', 'events_url': 'https://api.github.com/users/facebook-github-bot/events{/privacy}', 'received_events_url': 'https://api.github.com/users/facebook-github-bot/received_events', 'type': 'User', 'site_admin': False}",referenced,20c22bcae4c86c33b4698fefdb6ba41936ab1a2f,https://api.github.com/repos/pytorch/pytorch/commits/20c22bcae4c86c33b4698fefdb6ba41936ab1a2f,2019-04-26T05:25:32Z,2,1,1
1963,1157790332,"{'login': 'soumith', 'id': 1310570, 'node_id': 'MDQ6VXNlcjEzMTA1NzA=', 'avatar_url': 'https://avatars0.githubusercontent.com/u/1310570?v=4', 'gravatar_id': '', 'url': 'https://api.github.com/users/soumith', 'html_url': 'https://github.com/soumith', 'followers_url': 'https://api.github.com/users/soumith/followers', 'following_url': 'https://api.github.com/users/soumith/following{/other_user}', 'gists_url': 'https://api.github.com/users/soumith/gists{/gist_id}', 'starred_url': 'https://api.github.com/users/soumith/starred{/owner}{/repo}', 'subscriptions_url': 'https://api.github.com/users/soumith/subscriptions', 'organizations_url': 'https://api.github.com/users/soumith/orgs', 'repos_url': 'https://api.github.com/users/soumith/repos', 'events_url': 'https://api.github.com/users/soumith/events{/privacy}', 'received_events_url': 'https://api.github.com/users/soumith/received_events', 'type': 'User', 'site_admin': False}",referenced,98206c326ecbd9194ff44b052661830e0608d7ab,https://api.github.com/repos/pytorch/pytorch/commits/98206c326ecbd9194ff44b052661830e0608d7ab,2017-07-10T22:46:11Z,9,4,5
1962,2313552198,"{'login': 'facebook-github-bot', 'id': 6422482, 'node_id': 'MDQ6VXNlcjY0MjI0ODI=', 'avatar_url': 'https://avatars3.githubusercontent.com/u/6422482?v=4', 'gravatar_id': '', 'url': 'https://api.github.com/users/facebook-github-bot', 'html_url': 'https://github.com/facebook-github-bot', 'followers_url': 'https://api.github.com/users/facebook-github-bot/followers', 'following_url': 'https://api.github.com/users/facebook-github-bot/following{/other_user}', 'gists_url': 'https://api.github.com/users/facebook-github-bot/gists{/gist_id}', 'starred_url': 'https://api.github.com/users/facebook-github-bot/starred{/owner}{/repo}', 'subscriptions_url': 'https://api.github.com/users/facebook-github-bot/subscriptions', 'organizations_url': 'https://api.github.com/users/facebook-github-bot/orgs', 'repos_url': 'https://api.github.com/users/facebook-github-bot/repos', 'events_url': 'https://api.github.com/users/facebook-github-bot/events{/privacy}', 'received_events_url': 'https://api.github.com/users/facebook-github-bot/received_events', 'type': 'User', 'site_admin': False}",referenced,002009b5a99f225d898600f13c55087e2ab39cc9,https://api.github.com/repos/pytorch/pytorch/commits/002009b5a99f225d898600f13c55087e2ab39cc9,2019-05-02T05:18:17Z,2,1,1
1953,2292625970,"{'login': 'facebook-github-bot', 'id': 6422482, 'node_id': 'MDQ6VXNlcjY0MjI0ODI=', 'avatar_url': 'https://avatars3.githubusercontent.com/u/6422482?v=4', 'gravatar_id': '', 'url': 'https://api.github.com/users/facebook-github-bot', 'html_url': 'https://github.com/facebook-github-bot', 'followers_url': 'https://api.github.com/users/facebook-github-bot/followers', 'following_url': 'https://api.github.com/users/facebook-github-bot/following{/other_user}', 'gists_url': 'https://api.github.com/users/facebook-github-bot/gists{/gist_id}', 'starred_url': 'https://api.github.com/users/facebook-github-bot/starred{/owner}{/repo}', 'subscriptions_url': 'https://api.github.com/users/facebook-github-bot/subscriptions', 'organizations_url': 'https://api.github.com/users/facebook-github-bot/orgs', 'repos_url': 'https://api.github.com/users/facebook-github-bot/repos', 'events_url': 'https://api.github.com/users/facebook-github-bot/events{/privacy}', 'received_events_url': 'https://api.github.com/users/facebook-github-bot/received_events', 'type': 'User', 'site_admin': False}",referenced,5a796d15be92a58a2387e0c05d9f0f613893df74,https://api.github.com/repos/pytorch/pytorch/commits/5a796d15be92a58a2387e0c05d9f0f613893df74,2019-04-23T00:38:48Z,4,3,1
1951,2292625974,"{'login': 'facebook-github-bot', 'id': 6422482, 'node_id': 'MDQ6VXNlcjY0MjI0ODI=', 'avatar_url': 'https://avatars3.githubusercontent.com/u/6422482?v=4', 'gravatar_id': '', 'url': 'https://api.github.com/users/facebook-github-bot', 'html_url': 'https://github.com/facebook-github-bot', 'followers_url': 'https://api.github.com/users/facebook-github-bot/followers', 'following_url': 'https://api.github.com/users/facebook-github-bot/following{/other_user}', 'gists_url': 'https://api.github.com/users/facebook-github-bot/gists{/gist_id}', 'starred_url': 'https://api.github.com/users/facebook-github-bot/starred{/owner}{/repo}', 'subscriptions_url': 'https://api.github.com/users/facebook-github-bot/subscriptions', 'organizations_url': 'https://api.github.com/users/facebook-github-bot/orgs', 'repos_url': 'https://api.github.com/users/facebook-github-bot/repos', 'events_url': 'https://api.github.com/users/facebook-github-bot/events{/privacy}', 'received_events_url': 'https://api.github.com/users/facebook-github-bot/received_events', 'type': 'User', 'site_admin': False}",referenced,5a796d15be92a58a2387e0c05d9f0f613893df74,https://api.github.com/repos/pytorch/pytorch/commits/5a796d15be92a58a2387e0c05d9f0f613893df74,2019-04-23T00:38:48Z,4,3,1
1950,1163285187,"{'login': 'colesbury', 'id': 655866, 'node_id': 'MDQ6VXNlcjY1NTg2Ng==', 'avatar_url': 'https://avatars1.githubusercontent.com/u/655866?v=4', 'gravatar_id': '', 'url': 'https://api.github.com/users/colesbury', 'html_url': 'https://github.com/colesbury', 'followers_url': 'https://api.github.com/users/colesbury/followers', 'following_url': 'https://api.github.com/users/colesbury/following{/other_user}', 'gists_url': 'https://api.github.com/users/colesbury/gists{/gist_id}', 'starred_url': 'https://api.github.com/users/colesbury/starred{/owner}{/repo}', 'subscriptions_url': 'https://api.github.com/users/colesbury/subscriptions', 'organizations_url': 'https://api.github.com/users/colesbury/orgs', 'repos_url': 'https://api.github.com/users/colesbury/repos', 'events_url': 'https://api.github.com/users/colesbury/events{/privacy}', 'received_events_url': 'https://api.github.com/users/colesbury/received_events', 'type': 'User', 'site_admin': False}",referenced,54cabb8bf3d866797347aeea28b0a202bea9d0a6,https://api.github.com/repos/pytorch/pytorch/commits/54cabb8bf3d866797347aeea28b0a202bea9d0a6,2017-07-13T20:29:35Z,5,3,2
1950,2292625973,"{'login': 'facebook-github-bot', 'id': 6422482, 'node_id': 'MDQ6VXNlcjY0MjI0ODI=', 'avatar_url': 'https://avatars3.githubusercontent.com/u/6422482?v=4', 'gravatar_id': '', 'url': 'https://api.github.com/users/facebook-github-bot', 'html_url': 'https://github.com/facebook-github-bot', 'followers_url': 'https://api.github.com/users/facebook-github-bot/followers', 'following_url': 'https://api.github.com/users/facebook-github-bot/following{/other_user}', 'gists_url': 'https://api.github.com/users/facebook-github-bot/gists{/gist_id}', 'starred_url': 'https://api.github.com/users/facebook-github-bot/starred{/owner}{/repo}', 'subscriptions_url': 'https://api.github.com/users/facebook-github-bot/subscriptions', 'organizations_url': 'https://api.github.com/users/facebook-github-bot/orgs', 'repos_url': 'https://api.github.com/users/facebook-github-bot/repos', 'events_url': 'https://api.github.com/users/facebook-github-bot/events{/privacy}', 'received_events_url': 'https://api.github.com/users/facebook-github-bot/received_events', 'type': 'User', 'site_admin': False}",referenced,5a796d15be92a58a2387e0c05d9f0f613893df74,https://api.github.com/repos/pytorch/pytorch/commits/5a796d15be92a58a2387e0c05d9f0f613893df74,2019-04-23T00:38:48Z,4,3,1
1941,2284871956,"{'login': 'facebook-github-bot', 'id': 6422482, 'node_id': 'MDQ6VXNlcjY0MjI0ODI=', 'avatar_url': 'https://avatars3.githubusercontent.com/u/6422482?v=4', 'gravatar_id': '', 'url': 'https://api.github.com/users/facebook-github-bot', 'html_url': 'https://github.com/facebook-github-bot', 'followers_url': 'https://api.github.com/users/facebook-github-bot/followers', 'following_url': 'https://api.github.com/users/facebook-github-bot/following{/other_user}', 'gists_url': 'https://api.github.com/users/facebook-github-bot/gists{/gist_id}', 'starred_url': 'https://api.github.com/users/facebook-github-bot/starred{/owner}{/repo}', 'subscriptions_url': 'https://api.github.com/users/facebook-github-bot/subscriptions', 'organizations_url': 'https://api.github.com/users/facebook-github-bot/orgs', 'repos_url': 'https://api.github.com/users/facebook-github-bot/repos', 'events_url': 'https://api.github.com/users/facebook-github-bot/events{/privacy}', 'received_events_url': 'https://api.github.com/users/facebook-github-bot/received_events', 'type': 'User', 'site_admin': False}",referenced,789c438d868937810b8ffb00271de11d9f598b89,https://api.github.com/repos/pytorch/pytorch/commits/789c438d868937810b8ffb00271de11d9f598b89,2019-04-18T07:47:11Z,2,1,1
1930,2284871960,"{'login': 'facebook-github-bot', 'id': 6422482, 'node_id': 'MDQ6VXNlcjY0MjI0ODI=', 'avatar_url': 'https://avatars3.githubusercontent.com/u/6422482?v=4', 'gravatar_id': '', 'url': 'https://api.github.com/users/facebook-github-bot', 'html_url': 'https://github.com/facebook-github-bot', 'followers_url': 'https://api.github.com/users/facebook-github-bot/followers', 'following_url': 'https://api.github.com/users/facebook-github-bot/following{/other_user}', 'gists_url': 'https://api.github.com/users/facebook-github-bot/gists{/gist_id}', 'starred_url': 'https://api.github.com/users/facebook-github-bot/starred{/owner}{/repo}', 'subscriptions_url': 'https://api.github.com/users/facebook-github-bot/subscriptions', 'organizations_url': 'https://api.github.com/users/facebook-github-bot/orgs', 'repos_url': 'https://api.github.com/users/facebook-github-bot/repos', 'events_url': 'https://api.github.com/users/facebook-github-bot/events{/privacy}', 'received_events_url': 'https://api.github.com/users/facebook-github-bot/received_events', 'type': 'User', 'site_admin': False}",referenced,789c438d868937810b8ffb00271de11d9f598b89,https://api.github.com/repos/pytorch/pytorch/commits/789c438d868937810b8ffb00271de11d9f598b89,2019-04-18T07:47:12Z,2,1,1
1929,2284871958,"{'login': 'facebook-github-bot', 'id': 6422482, 'node_id': 'MDQ6VXNlcjY0MjI0ODI=', 'avatar_url': 'https://avatars3.githubusercontent.com/u/6422482?v=4', 'gravatar_id': '', 'url': 'https://api.github.com/users/facebook-github-bot', 'html_url': 'https://github.com/facebook-github-bot', 'followers_url': 'https://api.github.com/users/facebook-github-bot/followers', 'following_url': 'https://api.github.com/users/facebook-github-bot/following{/other_user}', 'gists_url': 'https://api.github.com/users/facebook-github-bot/gists{/gist_id}', 'starred_url': 'https://api.github.com/users/facebook-github-bot/starred{/owner}{/repo}', 'subscriptions_url': 'https://api.github.com/users/facebook-github-bot/subscriptions', 'organizations_url': 'https://api.github.com/users/facebook-github-bot/orgs', 'repos_url': 'https://api.github.com/users/facebook-github-bot/repos', 'events_url': 'https://api.github.com/users/facebook-github-bot/events{/privacy}', 'received_events_url': 'https://api.github.com/users/facebook-github-bot/received_events', 'type': 'User', 'site_admin': False}",referenced,789c438d868937810b8ffb00271de11d9f598b89,https://api.github.com/repos/pytorch/pytorch/commits/789c438d868937810b8ffb00271de11d9f598b89,2019-04-18T07:47:12Z,2,1,1
1928,1164936441,"{'login': 'soumith', 'id': 1310570, 'node_id': 'MDQ6VXNlcjEzMTA1NzA=', 'avatar_url': 'https://avatars0.githubusercontent.com/u/1310570?v=4', 'gravatar_id': '', 'url': 'https://api.github.com/users/soumith', 'html_url': 'https://github.com/soumith', 'followers_url': 'https://api.github.com/users/soumith/followers', 'following_url': 'https://api.github.com/users/soumith/following{/other_user}', 'gists_url': 'https://api.github.com/users/soumith/gists{/gist_id}', 'starred_url': 'https://api.github.com/users/soumith/starred{/owner}{/repo}', 'subscriptions_url': 'https://api.github.com/users/soumith/subscriptions', 'organizations_url': 'https://api.github.com/users/soumith/orgs', 'repos_url': 'https://api.github.com/users/soumith/repos', 'events_url': 'https://api.github.com/users/soumith/events{/privacy}', 'received_events_url': 'https://api.github.com/users/soumith/received_events', 'type': 'User', 'site_admin': False}",referenced,80d067e70f0862e132bafd7b24563f168cd3a36b,https://api.github.com/repos/pytorch/pytorch/commits/80d067e70f0862e132bafd7b24563f168cd3a36b,2017-07-14T20:45:30Z,2,1,1
1919,2284871961,"{'login': 'facebook-github-bot', 'id': 6422482, 'node_id': 'MDQ6VXNlcjY0MjI0ODI=', 'avatar_url': 'https://avatars3.githubusercontent.com/u/6422482?v=4', 'gravatar_id': '', 'url': 'https://api.github.com/users/facebook-github-bot', 'html_url': 'https://github.com/facebook-github-bot', 'followers_url': 'https://api.github.com/users/facebook-github-bot/followers', 'following_url': 'https://api.github.com/users/facebook-github-bot/following{/other_user}', 'gists_url': 'https://api.github.com/users/facebook-github-bot/gists{/gist_id}', 'starred_url': 'https://api.github.com/users/facebook-github-bot/starred{/owner}{/repo}', 'subscriptions_url': 'https://api.github.com/users/facebook-github-bot/subscriptions', 'organizations_url': 'https://api.github.com/users/facebook-github-bot/orgs', 'repos_url': 'https://api.github.com/users/facebook-github-bot/repos', 'events_url': 'https://api.github.com/users/facebook-github-bot/events{/privacy}', 'received_events_url': 'https://api.github.com/users/facebook-github-bot/received_events', 'type': 'User', 'site_admin': False}",referenced,789c438d868937810b8ffb00271de11d9f598b89,https://api.github.com/repos/pytorch/pytorch/commits/789c438d868937810b8ffb00271de11d9f598b89,2019-04-18T07:47:12Z,2,1,1
1911,2261762869,"{'login': 'facebook-github-bot', 'id': 6422482, 'node_id': 'MDQ6VXNlcjY0MjI0ODI=', 'avatar_url': 'https://avatars3.githubusercontent.com/u/6422482?v=4', 'gravatar_id': '', 'url': 'https://api.github.com/users/facebook-github-bot', 'html_url': 'https://github.com/facebook-github-bot', 'followers_url': 'https://api.github.com/users/facebook-github-bot/followers', 'following_url': 'https://api.github.com/users/facebook-github-bot/following{/other_user}', 'gists_url': 'https://api.github.com/users/facebook-github-bot/gists{/gist_id}', 'starred_url': 'https://api.github.com/users/facebook-github-bot/starred{/owner}{/repo}', 'subscriptions_url': 'https://api.github.com/users/facebook-github-bot/subscriptions', 'organizations_url': 'https://api.github.com/users/facebook-github-bot/orgs', 'repos_url': 'https://api.github.com/users/facebook-github-bot/repos', 'events_url': 'https://api.github.com/users/facebook-github-bot/events{/privacy}', 'received_events_url': 'https://api.github.com/users/facebook-github-bot/received_events', 'type': 'User', 'site_admin': False}",referenced,72e171dc52540093c8ad4b6b539ce30ea200e6fd,https://api.github.com/repos/pytorch/pytorch/commits/72e171dc52540093c8ad4b6b539ce30ea200e6fd,2019-04-09T06:21:55Z,2,1,1
1885,1756445502,"{'login': 'facebook-github-bot', 'id': 6422482, 'node_id': 'MDQ6VXNlcjY0MjI0ODI=', 'avatar_url': 'https://avatars3.githubusercontent.com/u/6422482?v=4', 'gravatar_id': '', 'url': 'https://api.github.com/users/facebook-github-bot', 'html_url': 'https://github.com/facebook-github-bot', 'followers_url': 'https://api.github.com/users/facebook-github-bot/followers', 'following_url': 'https://api.github.com/users/facebook-github-bot/following{/other_user}', 'gists_url': 'https://api.github.com/users/facebook-github-bot/gists{/gist_id}', 'starred_url': 'https://api.github.com/users/facebook-github-bot/starred{/owner}{/repo}', 'subscriptions_url': 'https://api.github.com/users/facebook-github-bot/subscriptions', 'organizations_url': 'https://api.github.com/users/facebook-github-bot/orgs', 'repos_url': 'https://api.github.com/users/facebook-github-bot/repos', 'events_url': 'https://api.github.com/users/facebook-github-bot/events{/privacy}', 'received_events_url': 'https://api.github.com/users/facebook-github-bot/received_events', 'type': 'User', 'site_admin': False}",closed,e41eb4332783ce32d26fdf3418688a583a5cc478,https://api.github.com/repos/pytorch/pytorch/commits/e41eb4332783ce32d26fdf3418688a583a5cc478,2018-07-27T03:56:16Z,10,2,8
1885,2231917224,"{'login': 'facebook-github-bot', 'id': 6422482, 'node_id': 'MDQ6VXNlcjY0MjI0ODI=', 'avatar_url': 'https://avatars3.githubusercontent.com/u/6422482?v=4', 'gravatar_id': '', 'url': 'https://api.github.com/users/facebook-github-bot', 'html_url': 'https://github.com/facebook-github-bot', 'followers_url': 'https://api.github.com/users/facebook-github-bot/followers', 'following_url': 'https://api.github.com/users/facebook-github-bot/following{/other_user}', 'gists_url': 'https://api.github.com/users/facebook-github-bot/gists{/gist_id}', 'starred_url': 'https://api.github.com/users/facebook-github-bot/starred{/owner}{/repo}', 'subscriptions_url': 'https://api.github.com/users/facebook-github-bot/subscriptions', 'organizations_url': 'https://api.github.com/users/facebook-github-bot/orgs', 'repos_url': 'https://api.github.com/users/facebook-github-bot/repos', 'events_url': 'https://api.github.com/users/facebook-github-bot/events{/privacy}', 'received_events_url': 'https://api.github.com/users/facebook-github-bot/received_events', 'type': 'User', 'site_admin': False}",referenced,eae7ad4ca8a4081802d239a489d05b5d835100d2,https://api.github.com/repos/pytorch/pytorch/commits/eae7ad4ca8a4081802d239a489d05b5d835100d2,2019-03-27T05:00:16Z,2,1,1
1882,2231917230,"{'login': 'facebook-github-bot', 'id': 6422482, 'node_id': 'MDQ6VXNlcjY0MjI0ODI=', 'avatar_url': 'https://avatars3.githubusercontent.com/u/6422482?v=4', 'gravatar_id': '', 'url': 'https://api.github.com/users/facebook-github-bot', 'html_url': 'https://github.com/facebook-github-bot', 'followers_url': 'https://api.github.com/users/facebook-github-bot/followers', 'following_url': 'https://api.github.com/users/facebook-github-bot/following{/other_user}', 'gists_url': 'https://api.github.com/users/facebook-github-bot/gists{/gist_id}', 'starred_url': 'https://api.github.com/users/facebook-github-bot/starred{/owner}{/repo}', 'subscriptions_url': 'https://api.github.com/users/facebook-github-bot/subscriptions', 'organizations_url': 'https://api.github.com/users/facebook-github-bot/orgs', 'repos_url': 'https://api.github.com/users/facebook-github-bot/repos', 'events_url': 'https://api.github.com/users/facebook-github-bot/events{/privacy}', 'received_events_url': 'https://api.github.com/users/facebook-github-bot/received_events', 'type': 'User', 'site_admin': False}",referenced,eae7ad4ca8a4081802d239a489d05b5d835100d2,https://api.github.com/repos/pytorch/pytorch/commits/eae7ad4ca8a4081802d239a489d05b5d835100d2,2019-03-27T05:00:17Z,2,1,1
1878,2221825625,"{'login': 'facebook-github-bot', 'id': 6422482, 'node_id': 'MDQ6VXNlcjY0MjI0ODI=', 'avatar_url': 'https://avatars3.githubusercontent.com/u/6422482?v=4', 'gravatar_id': '', 'url': 'https://api.github.com/users/facebook-github-bot', 'html_url': 'https://github.com/facebook-github-bot', 'followers_url': 'https://api.github.com/users/facebook-github-bot/followers', 'following_url': 'https://api.github.com/users/facebook-github-bot/following{/other_user}', 'gists_url': 'https://api.github.com/users/facebook-github-bot/gists{/gist_id}', 'starred_url': 'https://api.github.com/users/facebook-github-bot/starred{/owner}{/repo}', 'subscriptions_url': 'https://api.github.com/users/facebook-github-bot/subscriptions', 'organizations_url': 'https://api.github.com/users/facebook-github-bot/orgs', 'repos_url': 'https://api.github.com/users/facebook-github-bot/repos', 'events_url': 'https://api.github.com/users/facebook-github-bot/events{/privacy}', 'received_events_url': 'https://api.github.com/users/facebook-github-bot/received_events', 'type': 'User', 'site_admin': False}",referenced,afc7574aed08a1a37ec132489a7010eed04da66f,https://api.github.com/repos/pytorch/pytorch/commits/afc7574aed08a1a37ec132489a7010eed04da66f,2019-03-22T07:16:08Z,10,8,2
1874,2292625972,"{'login': 'facebook-github-bot', 'id': 6422482, 'node_id': 'MDQ6VXNlcjY0MjI0ODI=', 'avatar_url': 'https://avatars3.githubusercontent.com/u/6422482?v=4', 'gravatar_id': '', 'url': 'https://api.github.com/users/facebook-github-bot', 'html_url': 'https://github.com/facebook-github-bot', 'followers_url': 'https://api.github.com/users/facebook-github-bot/followers', 'following_url': 'https://api.github.com/users/facebook-github-bot/following{/other_user}', 'gists_url': 'https://api.github.com/users/facebook-github-bot/gists{/gist_id}', 'starred_url': 'https://api.github.com/users/facebook-github-bot/starred{/owner}{/repo}', 'subscriptions_url': 'https://api.github.com/users/facebook-github-bot/subscriptions', 'organizations_url': 'https://api.github.com/users/facebook-github-bot/orgs', 'repos_url': 'https://api.github.com/users/facebook-github-bot/repos', 'events_url': 'https://api.github.com/users/facebook-github-bot/events{/privacy}', 'received_events_url': 'https://api.github.com/users/facebook-github-bot/received_events', 'type': 'User', 'site_admin': False}",referenced,5a796d15be92a58a2387e0c05d9f0f613893df74,https://api.github.com/repos/pytorch/pytorch/commits/5a796d15be92a58a2387e0c05d9f0f613893df74,2019-04-23T00:38:48Z,4,3,1
1872,2261762864,"{'login': 'facebook-github-bot', 'id': 6422482, 'node_id': 'MDQ6VXNlcjY0MjI0ODI=', 'avatar_url': 'https://avatars3.githubusercontent.com/u/6422482?v=4', 'gravatar_id': '', 'url': 'https://api.github.com/users/facebook-github-bot', 'html_url': 'https://github.com/facebook-github-bot', 'followers_url': 'https://api.github.com/users/facebook-github-bot/followers', 'following_url': 'https://api.github.com/users/facebook-github-bot/following{/other_user}', 'gists_url': 'https://api.github.com/users/facebook-github-bot/gists{/gist_id}', 'starred_url': 'https://api.github.com/users/facebook-github-bot/starred{/owner}{/repo}', 'subscriptions_url': 'https://api.github.com/users/facebook-github-bot/subscriptions', 'organizations_url': 'https://api.github.com/users/facebook-github-bot/orgs', 'repos_url': 'https://api.github.com/users/facebook-github-bot/repos', 'events_url': 'https://api.github.com/users/facebook-github-bot/events{/privacy}', 'received_events_url': 'https://api.github.com/users/facebook-github-bot/received_events', 'type': 'User', 'site_admin': False}",referenced,72e171dc52540093c8ad4b6b539ce30ea200e6fd,https://api.github.com/repos/pytorch/pytorch/commits/72e171dc52540093c8ad4b6b539ce30ea200e6fd,2019-04-09T06:21:55Z,2,1,1
1868,1961630786,"{'login': 'facebook-github-bot', 'id': 6422482, 'node_id': 'MDQ6VXNlcjY0MjI0ODI=', 'avatar_url': 'https://avatars3.githubusercontent.com/u/6422482?v=4', 'gravatar_id': '', 'url': 'https://api.github.com/users/facebook-github-bot', 'html_url': 'https://github.com/facebook-github-bot', 'followers_url': 'https://api.github.com/users/facebook-github-bot/followers', 'following_url': 'https://api.github.com/users/facebook-github-bot/following{/other_user}', 'gists_url': 'https://api.github.com/users/facebook-github-bot/gists{/gist_id}', 'starred_url': 'https://api.github.com/users/facebook-github-bot/starred{/owner}{/repo}', 'subscriptions_url': 'https://api.github.com/users/facebook-github-bot/subscriptions', 'organizations_url': 'https://api.github.com/users/facebook-github-bot/orgs', 'repos_url': 'https://api.github.com/users/facebook-github-bot/repos', 'events_url': 'https://api.github.com/users/facebook-github-bot/events{/privacy}', 'received_events_url': 'https://api.github.com/users/facebook-github-bot/received_events', 'type': 'User', 'site_admin': False}",closed,03c0f4fbe7f09f31db9dc918a09d0886eeac41f8,https://api.github.com/repos/pytorch/pytorch/commits/03c0f4fbe7f09f31db9dc918a09d0886eeac41f8,2018-11-12T23:29:17Z,4,4,0
1868,2221825630,"{'login': 'facebook-github-bot', 'id': 6422482, 'node_id': 'MDQ6VXNlcjY0MjI0ODI=', 'avatar_url': 'https://avatars3.githubusercontent.com/u/6422482?v=4', 'gravatar_id': '', 'url': 'https://api.github.com/users/facebook-github-bot', 'html_url': 'https://github.com/facebook-github-bot', 'followers_url': 'https://api.github.com/users/facebook-github-bot/followers', 'following_url': 'https://api.github.com/users/facebook-github-bot/following{/other_user}', 'gists_url': 'https://api.github.com/users/facebook-github-bot/gists{/gist_id}', 'starred_url': 'https://api.github.com/users/facebook-github-bot/starred{/owner}{/repo}', 'subscriptions_url': 'https://api.github.com/users/facebook-github-bot/subscriptions', 'organizations_url': 'https://api.github.com/users/facebook-github-bot/orgs', 'repos_url': 'https://api.github.com/users/facebook-github-bot/repos', 'events_url': 'https://api.github.com/users/facebook-github-bot/events{/privacy}', 'received_events_url': 'https://api.github.com/users/facebook-github-bot/received_events', 'type': 'User', 'site_admin': False}",referenced,afc7574aed08a1a37ec132489a7010eed04da66f,https://api.github.com/repos/pytorch/pytorch/commits/afc7574aed08a1a37ec132489a7010eed04da66f,2019-03-22T07:16:08Z,10,8,2
1866,2221825634,"{'login': 'facebook-github-bot', 'id': 6422482, 'node_id': 'MDQ6VXNlcjY0MjI0ODI=', 'avatar_url': 'https://avatars3.githubusercontent.com/u/6422482?v=4', 'gravatar_id': '', 'url': 'https://api.github.com/users/facebook-github-bot', 'html_url': 'https://github.com/facebook-github-bot', 'followers_url': 'https://api.github.com/users/facebook-github-bot/followers', 'following_url': 'https://api.github.com/users/facebook-github-bot/following{/other_user}', 'gists_url': 'https://api.github.com/users/facebook-github-bot/gists{/gist_id}', 'starred_url': 'https://api.github.com/users/facebook-github-bot/starred{/owner}{/repo}', 'subscriptions_url': 'https://api.github.com/users/facebook-github-bot/subscriptions', 'organizations_url': 'https://api.github.com/users/facebook-github-bot/orgs', 'repos_url': 'https://api.github.com/users/facebook-github-bot/repos', 'events_url': 'https://api.github.com/users/facebook-github-bot/events{/privacy}', 'received_events_url': 'https://api.github.com/users/facebook-github-bot/received_events', 'type': 'User', 'site_admin': False}",referenced,afc7574aed08a1a37ec132489a7010eed04da66f,https://api.github.com/repos/pytorch/pytorch/commits/afc7574aed08a1a37ec132489a7010eed04da66f,2019-03-22T07:16:08Z,10,8,2
1864,2238367784,"{'login': 'facebook-github-bot', 'id': 6422482, 'node_id': 'MDQ6VXNlcjY0MjI0ODI=', 'avatar_url': 'https://avatars3.githubusercontent.com/u/6422482?v=4', 'gravatar_id': '', 'url': 'https://api.github.com/users/facebook-github-bot', 'html_url': 'https://github.com/facebook-github-bot', 'followers_url': 'https://api.github.com/users/facebook-github-bot/followers', 'following_url': 'https://api.github.com/users/facebook-github-bot/following{/other_user}', 'gists_url': 'https://api.github.com/users/facebook-github-bot/gists{/gist_id}', 'starred_url': 'https://api.github.com/users/facebook-github-bot/starred{/owner}{/repo}', 'subscriptions_url': 'https://api.github.com/users/facebook-github-bot/subscriptions', 'organizations_url': 'https://api.github.com/users/facebook-github-bot/orgs', 'repos_url': 'https://api.github.com/users/facebook-github-bot/repos', 'events_url': 'https://api.github.com/users/facebook-github-bot/events{/privacy}', 'received_events_url': 'https://api.github.com/users/facebook-github-bot/received_events', 'type': 'User', 'site_admin': False}",referenced,a5a1c9a171874971b7ddf276c0332c064e3fffec,https://api.github.com/repos/pytorch/pytorch/commits/a5a1c9a171874971b7ddf276c0332c064e3fffec,2019-03-29T06:49:00Z,3,2,1
1860,2221825636,"{'login': 'facebook-github-bot', 'id': 6422482, 'node_id': 'MDQ6VXNlcjY0MjI0ODI=', 'avatar_url': 'https://avatars3.githubusercontent.com/u/6422482?v=4', 'gravatar_id': '', 'url': 'https://api.github.com/users/facebook-github-bot', 'html_url': 'https://github.com/facebook-github-bot', 'followers_url': 'https://api.github.com/users/facebook-github-bot/followers', 'following_url': 'https://api.github.com/users/facebook-github-bot/following{/other_user}', 'gists_url': 'https://api.github.com/users/facebook-github-bot/gists{/gist_id}', 'starred_url': 'https://api.github.com/users/facebook-github-bot/starred{/owner}{/repo}', 'subscriptions_url': 'https://api.github.com/users/facebook-github-bot/subscriptions', 'organizations_url': 'https://api.github.com/users/facebook-github-bot/orgs', 'repos_url': 'https://api.github.com/users/facebook-github-bot/repos', 'events_url': 'https://api.github.com/users/facebook-github-bot/events{/privacy}', 'received_events_url': 'https://api.github.com/users/facebook-github-bot/received_events', 'type': 'User', 'site_admin': False}",referenced,afc7574aed08a1a37ec132489a7010eed04da66f,https://api.github.com/repos/pytorch/pytorch/commits/afc7574aed08a1a37ec132489a7010eed04da66f,2019-03-22T07:16:08Z,10,8,2
1857,1151172309,"{'login': 'soumith', 'id': 1310570, 'node_id': 'MDQ6VXNlcjEzMTA1NzA=', 'avatar_url': 'https://avatars0.githubusercontent.com/u/1310570?v=4', 'gravatar_id': '', 'url': 'https://api.github.com/users/soumith', 'html_url': 'https://github.com/soumith', 'followers_url': 'https://api.github.com/users/soumith/followers', 'following_url': 'https://api.github.com/users/soumith/following{/other_user}', 'gists_url': 'https://api.github.com/users/soumith/gists{/gist_id}', 'starred_url': 'https://api.github.com/users/soumith/starred{/owner}{/repo}', 'subscriptions_url': 'https://api.github.com/users/soumith/subscriptions', 'organizations_url': 'https://api.github.com/users/soumith/orgs', 'repos_url': 'https://api.github.com/users/soumith/repos', 'events_url': 'https://api.github.com/users/soumith/events{/privacy}', 'received_events_url': 'https://api.github.com/users/soumith/received_events', 'type': 'User', 'site_admin': False}",referenced,3748b6d3ebf3e7132453db61b25666d32e774e65,https://api.github.com/repos/pytorch/pytorch/commits/3748b6d3ebf3e7132453db61b25666d32e774e65,2017-07-05T15:46:04Z,21,18,3
1856,2221825644,"{'login': 'facebook-github-bot', 'id': 6422482, 'node_id': 'MDQ6VXNlcjY0MjI0ODI=', 'avatar_url': 'https://avatars3.githubusercontent.com/u/6422482?v=4', 'gravatar_id': '', 'url': 'https://api.github.com/users/facebook-github-bot', 'html_url': 'https://github.com/facebook-github-bot', 'followers_url': 'https://api.github.com/users/facebook-github-bot/followers', 'following_url': 'https://api.github.com/users/facebook-github-bot/following{/other_user}', 'gists_url': 'https://api.github.com/users/facebook-github-bot/gists{/gist_id}', 'starred_url': 'https://api.github.com/users/facebook-github-bot/starred{/owner}{/repo}', 'subscriptions_url': 'https://api.github.com/users/facebook-github-bot/subscriptions', 'organizations_url': 'https://api.github.com/users/facebook-github-bot/orgs', 'repos_url': 'https://api.github.com/users/facebook-github-bot/repos', 'events_url': 'https://api.github.com/users/facebook-github-bot/events{/privacy}', 'received_events_url': 'https://api.github.com/users/facebook-github-bot/received_events', 'type': 'User', 'site_admin': False}",referenced,afc7574aed08a1a37ec132489a7010eed04da66f,https://api.github.com/repos/pytorch/pytorch/commits/afc7574aed08a1a37ec132489a7010eed04da66f,2019-03-22T07:16:08Z,10,8,2
1851,2221825650,"{'login': 'facebook-github-bot', 'id': 6422482, 'node_id': 'MDQ6VXNlcjY0MjI0ODI=', 'avatar_url': 'https://avatars3.githubusercontent.com/u/6422482?v=4', 'gravatar_id': '', 'url': 'https://api.github.com/users/facebook-github-bot', 'html_url': 'https://github.com/facebook-github-bot', 'followers_url': 'https://api.github.com/users/facebook-github-bot/followers', 'following_url': 'https://api.github.com/users/facebook-github-bot/following{/other_user}', 'gists_url': 'https://api.github.com/users/facebook-github-bot/gists{/gist_id}', 'starred_url': 'https://api.github.com/users/facebook-github-bot/starred{/owner}{/repo}', 'subscriptions_url': 'https://api.github.com/users/facebook-github-bot/subscriptions', 'organizations_url': 'https://api.github.com/users/facebook-github-bot/orgs', 'repos_url': 'https://api.github.com/users/facebook-github-bot/repos', 'events_url': 'https://api.github.com/users/facebook-github-bot/events{/privacy}', 'received_events_url': 'https://api.github.com/users/facebook-github-bot/received_events', 'type': 'User', 'site_admin': False}",referenced,afc7574aed08a1a37ec132489a7010eed04da66f,https://api.github.com/repos/pytorch/pytorch/commits/afc7574aed08a1a37ec132489a7010eed04da66f,2019-03-22T07:16:08Z,10,8,2
1848,2221825653,"{'login': 'facebook-github-bot', 'id': 6422482, 'node_id': 'MDQ6VXNlcjY0MjI0ODI=', 'avatar_url': 'https://avatars3.githubusercontent.com/u/6422482?v=4', 'gravatar_id': '', 'url': 'https://api.github.com/users/facebook-github-bot', 'html_url': 'https://github.com/facebook-github-bot', 'followers_url': 'https://api.github.com/users/facebook-github-bot/followers', 'following_url': 'https://api.github.com/users/facebook-github-bot/following{/other_user}', 'gists_url': 'https://api.github.com/users/facebook-github-bot/gists{/gist_id}', 'starred_url': 'https://api.github.com/users/facebook-github-bot/starred{/owner}{/repo}', 'subscriptions_url': 'https://api.github.com/users/facebook-github-bot/subscriptions', 'organizations_url': 'https://api.github.com/users/facebook-github-bot/orgs', 'repos_url': 'https://api.github.com/users/facebook-github-bot/repos', 'events_url': 'https://api.github.com/users/facebook-github-bot/events{/privacy}', 'received_events_url': 'https://api.github.com/users/facebook-github-bot/received_events', 'type': 'User', 'site_admin': False}",referenced,afc7574aed08a1a37ec132489a7010eed04da66f,https://api.github.com/repos/pytorch/pytorch/commits/afc7574aed08a1a37ec132489a7010eed04da66f,2019-03-22T07:16:08Z,10,8,2
1834,2221825648,"{'login': 'facebook-github-bot', 'id': 6422482, 'node_id': 'MDQ6VXNlcjY0MjI0ODI=', 'avatar_url': 'https://avatars3.githubusercontent.com/u/6422482?v=4', 'gravatar_id': '', 'url': 'https://api.github.com/users/facebook-github-bot', 'html_url': 'https://github.com/facebook-github-bot', 'followers_url': 'https://api.github.com/users/facebook-github-bot/followers', 'following_url': 'https://api.github.com/users/facebook-github-bot/following{/other_user}', 'gists_url': 'https://api.github.com/users/facebook-github-bot/gists{/gist_id}', 'starred_url': 'https://api.github.com/users/facebook-github-bot/starred{/owner}{/repo}', 'subscriptions_url': 'https://api.github.com/users/facebook-github-bot/subscriptions', 'organizations_url': 'https://api.github.com/users/facebook-github-bot/orgs', 'repos_url': 'https://api.github.com/users/facebook-github-bot/repos', 'events_url': 'https://api.github.com/users/facebook-github-bot/events{/privacy}', 'received_events_url': 'https://api.github.com/users/facebook-github-bot/received_events', 'type': 'User', 'site_admin': False}",referenced,afc7574aed08a1a37ec132489a7010eed04da66f,https://api.github.com/repos/pytorch/pytorch/commits/afc7574aed08a1a37ec132489a7010eed04da66f,2019-03-22T07:16:08Z,10,8,2
1830,2188190238,"{'login': 'facebook-github-bot', 'id': 6422482, 'node_id': 'MDQ6VXNlcjY0MjI0ODI=', 'avatar_url': 'https://avatars3.githubusercontent.com/u/6422482?v=4', 'gravatar_id': '', 'url': 'https://api.github.com/users/facebook-github-bot', 'html_url': 'https://github.com/facebook-github-bot', 'followers_url': 'https://api.github.com/users/facebook-github-bot/followers', 'following_url': 'https://api.github.com/users/facebook-github-bot/following{/other_user}', 'gists_url': 'https://api.github.com/users/facebook-github-bot/gists{/gist_id}', 'starred_url': 'https://api.github.com/users/facebook-github-bot/starred{/owner}{/repo}', 'subscriptions_url': 'https://api.github.com/users/facebook-github-bot/subscriptions', 'organizations_url': 'https://api.github.com/users/facebook-github-bot/orgs', 'repos_url': 'https://api.github.com/users/facebook-github-bot/repos', 'events_url': 'https://api.github.com/users/facebook-github-bot/events{/privacy}', 'received_events_url': 'https://api.github.com/users/facebook-github-bot/received_events', 'type': 'User', 'site_admin': False}",referenced,4480aa31c2b46d8c5f6e80eb44ded8bfa71205c9,https://api.github.com/repos/pytorch/pytorch/commits/4480aa31c2b46d8c5f6e80eb44ded8bfa71205c9,2019-03-07T19:12:46Z,8,6,2
1829,2221825657,"{'login': 'facebook-github-bot', 'id': 6422482, 'node_id': 'MDQ6VXNlcjY0MjI0ODI=', 'avatar_url': 'https://avatars3.githubusercontent.com/u/6422482?v=4', 'gravatar_id': '', 'url': 'https://api.github.com/users/facebook-github-bot', 'html_url': 'https://github.com/facebook-github-bot', 'followers_url': 'https://api.github.com/users/facebook-github-bot/followers', 'following_url': 'https://api.github.com/users/facebook-github-bot/following{/other_user}', 'gists_url': 'https://api.github.com/users/facebook-github-bot/gists{/gist_id}', 'starred_url': 'https://api.github.com/users/facebook-github-bot/starred{/owner}{/repo}', 'subscriptions_url': 'https://api.github.com/users/facebook-github-bot/subscriptions', 'organizations_url': 'https://api.github.com/users/facebook-github-bot/orgs', 'repos_url': 'https://api.github.com/users/facebook-github-bot/repos', 'events_url': 'https://api.github.com/users/facebook-github-bot/events{/privacy}', 'received_events_url': 'https://api.github.com/users/facebook-github-bot/received_events', 'type': 'User', 'site_admin': False}",referenced,afc7574aed08a1a37ec132489a7010eed04da66f,https://api.github.com/repos/pytorch/pytorch/commits/afc7574aed08a1a37ec132489a7010eed04da66f,2019-03-22T07:16:08Z,10,8,2
1773,2221825631,"{'login': 'facebook-github-bot', 'id': 6422482, 'node_id': 'MDQ6VXNlcjY0MjI0ODI=', 'avatar_url': 'https://avatars3.githubusercontent.com/u/6422482?v=4', 'gravatar_id': '', 'url': 'https://api.github.com/users/facebook-github-bot', 'html_url': 'https://github.com/facebook-github-bot', 'followers_url': 'https://api.github.com/users/facebook-github-bot/followers', 'following_url': 'https://api.github.com/users/facebook-github-bot/following{/other_user}', 'gists_url': 'https://api.github.com/users/facebook-github-bot/gists{/gist_id}', 'starred_url': 'https://api.github.com/users/facebook-github-bot/starred{/owner}{/repo}', 'subscriptions_url': 'https://api.github.com/users/facebook-github-bot/subscriptions', 'organizations_url': 'https://api.github.com/users/facebook-github-bot/orgs', 'repos_url': 'https://api.github.com/users/facebook-github-bot/repos', 'events_url': 'https://api.github.com/users/facebook-github-bot/events{/privacy}', 'received_events_url': 'https://api.github.com/users/facebook-github-bot/received_events', 'type': 'User', 'site_admin': False}",referenced,afc7574aed08a1a37ec132489a7010eed04da66f,https://api.github.com/repos/pytorch/pytorch/commits/afc7574aed08a1a37ec132489a7010eed04da66f,2019-03-22T07:16:08Z,10,8,2
1768,2104943756,"{'login': 'facebook-github-bot', 'id': 6422482, 'node_id': 'MDQ6VXNlcjY0MjI0ODI=', 'avatar_url': 'https://avatars3.githubusercontent.com/u/6422482?v=4', 'gravatar_id': '', 'url': 'https://api.github.com/users/facebook-github-bot', 'html_url': 'https://github.com/facebook-github-bot', 'followers_url': 'https://api.github.com/users/facebook-github-bot/followers', 'following_url': 'https://api.github.com/users/facebook-github-bot/following{/other_user}', 'gists_url': 'https://api.github.com/users/facebook-github-bot/gists{/gist_id}', 'starred_url': 'https://api.github.com/users/facebook-github-bot/starred{/owner}{/repo}', 'subscriptions_url': 'https://api.github.com/users/facebook-github-bot/subscriptions', 'organizations_url': 'https://api.github.com/users/facebook-github-bot/orgs', 'repos_url': 'https://api.github.com/users/facebook-github-bot/repos', 'events_url': 'https://api.github.com/users/facebook-github-bot/events{/privacy}', 'received_events_url': 'https://api.github.com/users/facebook-github-bot/received_events', 'type': 'User', 'site_admin': False}",referenced,719134f3c30f72a9a42100129f6ff8e851208f3f,https://api.github.com/repos/pytorch/pytorch/commits/719134f3c30f72a9a42100129f6ff8e851208f3f,2019-01-29T21:50:12Z,3,2,1
1767,2104943761,"{'login': 'facebook-github-bot', 'id': 6422482, 'node_id': 'MDQ6VXNlcjY0MjI0ODI=', 'avatar_url': 'https://avatars3.githubusercontent.com/u/6422482?v=4', 'gravatar_id': '', 'url': 'https://api.github.com/users/facebook-github-bot', 'html_url': 'https://github.com/facebook-github-bot', 'followers_url': 'https://api.github.com/users/facebook-github-bot/followers', 'following_url': 'https://api.github.com/users/facebook-github-bot/following{/other_user}', 'gists_url': 'https://api.github.com/users/facebook-github-bot/gists{/gist_id}', 'starred_url': 'https://api.github.com/users/facebook-github-bot/starred{/owner}{/repo}', 'subscriptions_url': 'https://api.github.com/users/facebook-github-bot/subscriptions', 'organizations_url': 'https://api.github.com/users/facebook-github-bot/orgs', 'repos_url': 'https://api.github.com/users/facebook-github-bot/repos', 'events_url': 'https://api.github.com/users/facebook-github-bot/events{/privacy}', 'received_events_url': 'https://api.github.com/users/facebook-github-bot/received_events', 'type': 'User', 'site_admin': False}",referenced,719134f3c30f72a9a42100129f6ff8e851208f3f,https://api.github.com/repos/pytorch/pytorch/commits/719134f3c30f72a9a42100129f6ff8e851208f3f,2019-01-29T21:50:12Z,3,2,1
1763,2104943766,"{'login': 'facebook-github-bot', 'id': 6422482, 'node_id': 'MDQ6VXNlcjY0MjI0ODI=', 'avatar_url': 'https://avatars3.githubusercontent.com/u/6422482?v=4', 'gravatar_id': '', 'url': 'https://api.github.com/users/facebook-github-bot', 'html_url': 'https://github.com/facebook-github-bot', 'followers_url': 'https://api.github.com/users/facebook-github-bot/followers', 'following_url': 'https://api.github.com/users/facebook-github-bot/following{/other_user}', 'gists_url': 'https://api.github.com/users/facebook-github-bot/gists{/gist_id}', 'starred_url': 'https://api.github.com/users/facebook-github-bot/starred{/owner}{/repo}', 'subscriptions_url': 'https://api.github.com/users/facebook-github-bot/subscriptions', 'organizations_url': 'https://api.github.com/users/facebook-github-bot/orgs', 'repos_url': 'https://api.github.com/users/facebook-github-bot/repos', 'events_url': 'https://api.github.com/users/facebook-github-bot/events{/privacy}', 'received_events_url': 'https://api.github.com/users/facebook-github-bot/received_events', 'type': 'User', 'site_admin': False}",referenced,719134f3c30f72a9a42100129f6ff8e851208f3f,https://api.github.com/repos/pytorch/pytorch/commits/719134f3c30f72a9a42100129f6ff8e851208f3f,2019-01-29T21:50:12Z,3,2,1
1744,2090205955,"{'login': 'facebook-github-bot', 'id': 6422482, 'node_id': 'MDQ6VXNlcjY0MjI0ODI=', 'avatar_url': 'https://avatars3.githubusercontent.com/u/6422482?v=4', 'gravatar_id': '', 'url': 'https://api.github.com/users/facebook-github-bot', 'html_url': 'https://github.com/facebook-github-bot', 'followers_url': 'https://api.github.com/users/facebook-github-bot/followers', 'following_url': 'https://api.github.com/users/facebook-github-bot/following{/other_user}', 'gists_url': 'https://api.github.com/users/facebook-github-bot/gists{/gist_id}', 'starred_url': 'https://api.github.com/users/facebook-github-bot/starred{/owner}{/repo}', 'subscriptions_url': 'https://api.github.com/users/facebook-github-bot/subscriptions', 'organizations_url': 'https://api.github.com/users/facebook-github-bot/orgs', 'repos_url': 'https://api.github.com/users/facebook-github-bot/repos', 'events_url': 'https://api.github.com/users/facebook-github-bot/events{/privacy}', 'received_events_url': 'https://api.github.com/users/facebook-github-bot/received_events', 'type': 'User', 'site_admin': False}",referenced,e7a77ac3b0d76254ea6413021d7eec369d9c1ac9,https://api.github.com/repos/pytorch/pytorch/commits/e7a77ac3b0d76254ea6413021d7eec369d9c1ac9,2019-01-22T23:02:52Z,170,85,85
1737,2087009899,"{'login': 'facebook-github-bot', 'id': 6422482, 'node_id': 'MDQ6VXNlcjY0MjI0ODI=', 'avatar_url': 'https://avatars3.githubusercontent.com/u/6422482?v=4', 'gravatar_id': '', 'url': 'https://api.github.com/users/facebook-github-bot', 'html_url': 'https://github.com/facebook-github-bot', 'followers_url': 'https://api.github.com/users/facebook-github-bot/followers', 'following_url': 'https://api.github.com/users/facebook-github-bot/following{/other_user}', 'gists_url': 'https://api.github.com/users/facebook-github-bot/gists{/gist_id}', 'starred_url': 'https://api.github.com/users/facebook-github-bot/starred{/owner}{/repo}', 'subscriptions_url': 'https://api.github.com/users/facebook-github-bot/subscriptions', 'organizations_url': 'https://api.github.com/users/facebook-github-bot/orgs', 'repos_url': 'https://api.github.com/users/facebook-github-bot/repos', 'events_url': 'https://api.github.com/users/facebook-github-bot/events{/privacy}', 'received_events_url': 'https://api.github.com/users/facebook-github-bot/received_events', 'type': 'User', 'site_admin': False}",referenced,c33512bdfc2d2bd702bea26d950032b407a5305f,https://api.github.com/repos/pytorch/pytorch/commits/c33512bdfc2d2bd702bea26d950032b407a5305f,2019-01-21T17:48:10Z,3,2,1
1734,2076202149,"{'login': 'facebook-github-bot', 'id': 6422482, 'node_id': 'MDQ6VXNlcjY0MjI0ODI=', 'avatar_url': 'https://avatars3.githubusercontent.com/u/6422482?v=4', 'gravatar_id': '', 'url': 'https://api.github.com/users/facebook-github-bot', 'html_url': 'https://github.com/facebook-github-bot', 'followers_url': 'https://api.github.com/users/facebook-github-bot/followers', 'following_url': 'https://api.github.com/users/facebook-github-bot/following{/other_user}', 'gists_url': 'https://api.github.com/users/facebook-github-bot/gists{/gist_id}', 'starred_url': 'https://api.github.com/users/facebook-github-bot/starred{/owner}{/repo}', 'subscriptions_url': 'https://api.github.com/users/facebook-github-bot/subscriptions', 'organizations_url': 'https://api.github.com/users/facebook-github-bot/orgs', 'repos_url': 'https://api.github.com/users/facebook-github-bot/repos', 'events_url': 'https://api.github.com/users/facebook-github-bot/events{/privacy}', 'received_events_url': 'https://api.github.com/users/facebook-github-bot/received_events', 'type': 'User', 'site_admin': False}",referenced,8f11df3cb7d43a433d12617078a263937f2734aa,https://api.github.com/repos/pytorch/pytorch/commits/8f11df3cb7d43a433d12617078a263937f2734aa,2019-01-16T01:18:49Z,4,3,1
1724,2068983595,"{'login': 'facebook-github-bot', 'id': 6422482, 'node_id': 'MDQ6VXNlcjY0MjI0ODI=', 'avatar_url': 'https://avatars3.githubusercontent.com/u/6422482?v=4', 'gravatar_id': '', 'url': 'https://api.github.com/users/facebook-github-bot', 'html_url': 'https://github.com/facebook-github-bot', 'followers_url': 'https://api.github.com/users/facebook-github-bot/followers', 'following_url': 'https://api.github.com/users/facebook-github-bot/following{/other_user}', 'gists_url': 'https://api.github.com/users/facebook-github-bot/gists{/gist_id}', 'starred_url': 'https://api.github.com/users/facebook-github-bot/starred{/owner}{/repo}', 'subscriptions_url': 'https://api.github.com/users/facebook-github-bot/subscriptions', 'organizations_url': 'https://api.github.com/users/facebook-github-bot/orgs', 'repos_url': 'https://api.github.com/users/facebook-github-bot/repos', 'events_url': 'https://api.github.com/users/facebook-github-bot/events{/privacy}', 'received_events_url': 'https://api.github.com/users/facebook-github-bot/received_events', 'type': 'User', 'site_admin': False}",referenced,7841fe4f27e0553179f2019da79f0f046d61c69d,https://api.github.com/repos/pytorch/pytorch/commits/7841fe4f27e0553179f2019da79f0f046d61c69d,2019-01-11T16:29:32Z,2,1,1
1721,1112951813,"{'login': 'soumith', 'id': 1310570, 'node_id': 'MDQ6VXNlcjEzMTA1NzA=', 'avatar_url': 'https://avatars0.githubusercontent.com/u/1310570?v=4', 'gravatar_id': '', 'url': 'https://api.github.com/users/soumith', 'html_url': 'https://github.com/soumith', 'followers_url': 'https://api.github.com/users/soumith/followers', 'following_url': 'https://api.github.com/users/soumith/following{/other_user}', 'gists_url': 'https://api.github.com/users/soumith/gists{/gist_id}', 'starred_url': 'https://api.github.com/users/soumith/starred{/owner}{/repo}', 'subscriptions_url': 'https://api.github.com/users/soumith/subscriptions', 'organizations_url': 'https://api.github.com/users/soumith/orgs', 'repos_url': 'https://api.github.com/users/soumith/repos', 'events_url': 'https://api.github.com/users/soumith/events{/privacy}', 'received_events_url': 'https://api.github.com/users/soumith/received_events', 'type': 'User', 'site_admin': False}",referenced,db620304b2bcbaf14ca643220b42aeff717e37ec,https://api.github.com/repos/pytorch/pytorch/commits/db620304b2bcbaf14ca643220b42aeff717e37ec,2017-06-07T04:20:29Z,32,18,14
1721,1112951818,"{'login': 'soumith', 'id': 1310570, 'node_id': 'MDQ6VXNlcjEzMTA1NzA=', 'avatar_url': 'https://avatars0.githubusercontent.com/u/1310570?v=4', 'gravatar_id': '', 'url': 'https://api.github.com/users/soumith', 'html_url': 'https://github.com/soumith', 'followers_url': 'https://api.github.com/users/soumith/followers', 'following_url': 'https://api.github.com/users/soumith/following{/other_user}', 'gists_url': 'https://api.github.com/users/soumith/gists{/gist_id}', 'starred_url': 'https://api.github.com/users/soumith/starred{/owner}{/repo}', 'subscriptions_url': 'https://api.github.com/users/soumith/subscriptions', 'organizations_url': 'https://api.github.com/users/soumith/orgs', 'repos_url': 'https://api.github.com/users/soumith/repos', 'events_url': 'https://api.github.com/users/soumith/events{/privacy}', 'received_events_url': 'https://api.github.com/users/soumith/received_events', 'type': 'User', 'site_admin': False}",referenced,22949350b6e853f4dc881491e6726d5b2a398107,https://api.github.com/repos/pytorch/pytorch/commits/22949350b6e853f4dc881491e6726d5b2a398107,2017-06-07T04:20:29Z,73,45,28
1721,2104943768,"{'login': 'facebook-github-bot', 'id': 6422482, 'node_id': 'MDQ6VXNlcjY0MjI0ODI=', 'avatar_url': 'https://avatars3.githubusercontent.com/u/6422482?v=4', 'gravatar_id': '', 'url': 'https://api.github.com/users/facebook-github-bot', 'html_url': 'https://github.com/facebook-github-bot', 'followers_url': 'https://api.github.com/users/facebook-github-bot/followers', 'following_url': 'https://api.github.com/users/facebook-github-bot/following{/other_user}', 'gists_url': 'https://api.github.com/users/facebook-github-bot/gists{/gist_id}', 'starred_url': 'https://api.github.com/users/facebook-github-bot/starred{/owner}{/repo}', 'subscriptions_url': 'https://api.github.com/users/facebook-github-bot/subscriptions', 'organizations_url': 'https://api.github.com/users/facebook-github-bot/orgs', 'repos_url': 'https://api.github.com/users/facebook-github-bot/repos', 'events_url': 'https://api.github.com/users/facebook-github-bot/events{/privacy}', 'received_events_url': 'https://api.github.com/users/facebook-github-bot/received_events', 'type': 'User', 'site_admin': False}",referenced,719134f3c30f72a9a42100129f6ff8e851208f3f,https://api.github.com/repos/pytorch/pytorch/commits/719134f3c30f72a9a42100129f6ff8e851208f3f,2019-01-29T21:50:12Z,3,2,1
1717,2068983602,"{'login': 'facebook-github-bot', 'id': 6422482, 'node_id': 'MDQ6VXNlcjY0MjI0ODI=', 'avatar_url': 'https://avatars3.githubusercontent.com/u/6422482?v=4', 'gravatar_id': '', 'url': 'https://api.github.com/users/facebook-github-bot', 'html_url': 'https://github.com/facebook-github-bot', 'followers_url': 'https://api.github.com/users/facebook-github-bot/followers', 'following_url': 'https://api.github.com/users/facebook-github-bot/following{/other_user}', 'gists_url': 'https://api.github.com/users/facebook-github-bot/gists{/gist_id}', 'starred_url': 'https://api.github.com/users/facebook-github-bot/starred{/owner}{/repo}', 'subscriptions_url': 'https://api.github.com/users/facebook-github-bot/subscriptions', 'organizations_url': 'https://api.github.com/users/facebook-github-bot/orgs', 'repos_url': 'https://api.github.com/users/facebook-github-bot/repos', 'events_url': 'https://api.github.com/users/facebook-github-bot/events{/privacy}', 'received_events_url': 'https://api.github.com/users/facebook-github-bot/received_events', 'type': 'User', 'site_admin': False}",referenced,7841fe4f27e0553179f2019da79f0f046d61c69d,https://api.github.com/repos/pytorch/pytorch/commits/7841fe4f27e0553179f2019da79f0f046d61c69d,2019-01-11T16:29:32Z,2,1,1
1712,2087009906,"{'login': 'facebook-github-bot', 'id': 6422482, 'node_id': 'MDQ6VXNlcjY0MjI0ODI=', 'avatar_url': 'https://avatars3.githubusercontent.com/u/6422482?v=4', 'gravatar_id': '', 'url': 'https://api.github.com/users/facebook-github-bot', 'html_url': 'https://github.com/facebook-github-bot', 'followers_url': 'https://api.github.com/users/facebook-github-bot/followers', 'following_url': 'https://api.github.com/users/facebook-github-bot/following{/other_user}', 'gists_url': 'https://api.github.com/users/facebook-github-bot/gists{/gist_id}', 'starred_url': 'https://api.github.com/users/facebook-github-bot/starred{/owner}{/repo}', 'subscriptions_url': 'https://api.github.com/users/facebook-github-bot/subscriptions', 'organizations_url': 'https://api.github.com/users/facebook-github-bot/orgs', 'repos_url': 'https://api.github.com/users/facebook-github-bot/repos', 'events_url': 'https://api.github.com/users/facebook-github-bot/events{/privacy}', 'received_events_url': 'https://api.github.com/users/facebook-github-bot/received_events', 'type': 'User', 'site_admin': False}",referenced,c33512bdfc2d2bd702bea26d950032b407a5305f,https://api.github.com/repos/pytorch/pytorch/commits/c33512bdfc2d2bd702bea26d950032b407a5305f,2019-01-21T17:48:10Z,3,2,1
1707,1110321477,"{'login': 'soumith', 'id': 1310570, 'node_id': 'MDQ6VXNlcjEzMTA1NzA=', 'avatar_url': 'https://avatars0.githubusercontent.com/u/1310570?v=4', 'gravatar_id': '', 'url': 'https://api.github.com/users/soumith', 'html_url': 'https://github.com/soumith', 'followers_url': 'https://api.github.com/users/soumith/followers', 'following_url': 'https://api.github.com/users/soumith/following{/other_user}', 'gists_url': 'https://api.github.com/users/soumith/gists{/gist_id}', 'starred_url': 'https://api.github.com/users/soumith/starred{/owner}{/repo}', 'subscriptions_url': 'https://api.github.com/users/soumith/subscriptions', 'organizations_url': 'https://api.github.com/users/soumith/orgs', 'repos_url': 'https://api.github.com/users/soumith/repos', 'events_url': 'https://api.github.com/users/soumith/events{/privacy}', 'received_events_url': 'https://api.github.com/users/soumith/received_events', 'type': 'User', 'site_admin': False}",closed,85a95d8a23ff5a58792932680e7769b57e668b78,https://api.github.com/repos/pytorch/pytorch/commits/85a95d8a23ff5a58792932680e7769b57e668b78,2017-06-05T17:02:07Z,11,7,4
1707,2055600189,"{'login': 'facebook-github-bot', 'id': 6422482, 'node_id': 'MDQ6VXNlcjY0MjI0ODI=', 'avatar_url': 'https://avatars3.githubusercontent.com/u/6422482?v=4', 'gravatar_id': '', 'url': 'https://api.github.com/users/facebook-github-bot', 'html_url': 'https://github.com/facebook-github-bot', 'followers_url': 'https://api.github.com/users/facebook-github-bot/followers', 'following_url': 'https://api.github.com/users/facebook-github-bot/following{/other_user}', 'gists_url': 'https://api.github.com/users/facebook-github-bot/gists{/gist_id}', 'starred_url': 'https://api.github.com/users/facebook-github-bot/starred{/owner}{/repo}', 'subscriptions_url': 'https://api.github.com/users/facebook-github-bot/subscriptions', 'organizations_url': 'https://api.github.com/users/facebook-github-bot/orgs', 'repos_url': 'https://api.github.com/users/facebook-github-bot/repos', 'events_url': 'https://api.github.com/users/facebook-github-bot/events{/privacy}', 'received_events_url': 'https://api.github.com/users/facebook-github-bot/received_events', 'type': 'User', 'site_admin': False}",referenced,12e6c1ceeb74fc0a1ea6a1af9eb60174b26ce4f6,https://api.github.com/repos/pytorch/pytorch/commits/12e6c1ceeb74fc0a1ea6a1af9eb60174b26ce4f6,2019-01-04T23:58:13Z,3,2,1
1696,2055600193,"{'login': 'facebook-github-bot', 'id': 6422482, 'node_id': 'MDQ6VXNlcjY0MjI0ODI=', 'avatar_url': 'https://avatars3.githubusercontent.com/u/6422482?v=4', 'gravatar_id': '', 'url': 'https://api.github.com/users/facebook-github-bot', 'html_url': 'https://github.com/facebook-github-bot', 'followers_url': 'https://api.github.com/users/facebook-github-bot/followers', 'following_url': 'https://api.github.com/users/facebook-github-bot/following{/other_user}', 'gists_url': 'https://api.github.com/users/facebook-github-bot/gists{/gist_id}', 'starred_url': 'https://api.github.com/users/facebook-github-bot/starred{/owner}{/repo}', 'subscriptions_url': 'https://api.github.com/users/facebook-github-bot/subscriptions', 'organizations_url': 'https://api.github.com/users/facebook-github-bot/orgs', 'repos_url': 'https://api.github.com/users/facebook-github-bot/repos', 'events_url': 'https://api.github.com/users/facebook-github-bot/events{/privacy}', 'received_events_url': 'https://api.github.com/users/facebook-github-bot/received_events', 'type': 'User', 'site_admin': False}",referenced,12e6c1ceeb74fc0a1ea6a1af9eb60174b26ce4f6,https://api.github.com/repos/pytorch/pytorch/commits/12e6c1ceeb74fc0a1ea6a1af9eb60174b26ce4f6,2019-01-04T23:58:13Z,3,2,1
1639,1996772697,"{'login': 'facebook-github-bot', 'id': 6422482, 'node_id': 'MDQ6VXNlcjY0MjI0ODI=', 'avatar_url': 'https://avatars3.githubusercontent.com/u/6422482?v=4', 'gravatar_id': '', 'url': 'https://api.github.com/users/facebook-github-bot', 'html_url': 'https://github.com/facebook-github-bot', 'followers_url': 'https://api.github.com/users/facebook-github-bot/followers', 'following_url': 'https://api.github.com/users/facebook-github-bot/following{/other_user}', 'gists_url': 'https://api.github.com/users/facebook-github-bot/gists{/gist_id}', 'starred_url': 'https://api.github.com/users/facebook-github-bot/starred{/owner}{/repo}', 'subscriptions_url': 'https://api.github.com/users/facebook-github-bot/subscriptions', 'organizations_url': 'https://api.github.com/users/facebook-github-bot/orgs', 'repos_url': 'https://api.github.com/users/facebook-github-bot/repos', 'events_url': 'https://api.github.com/users/facebook-github-bot/events{/privacy}', 'received_events_url': 'https://api.github.com/users/facebook-github-bot/received_events', 'type': 'User', 'site_admin': False}",referenced,2752ad8045c59c4eafe45fe94b6672cb436da523,https://api.github.com/repos/pytorch/pytorch/commits/2752ad8045c59c4eafe45fe94b6672cb436da523,2018-11-30T00:33:42Z,4,4,0
1634,1996772701,"{'login': 'facebook-github-bot', 'id': 6422482, 'node_id': 'MDQ6VXNlcjY0MjI0ODI=', 'avatar_url': 'https://avatars3.githubusercontent.com/u/6422482?v=4', 'gravatar_id': '', 'url': 'https://api.github.com/users/facebook-github-bot', 'html_url': 'https://github.com/facebook-github-bot', 'followers_url': 'https://api.github.com/users/facebook-github-bot/followers', 'following_url': 'https://api.github.com/users/facebook-github-bot/following{/other_user}', 'gists_url': 'https://api.github.com/users/facebook-github-bot/gists{/gist_id}', 'starred_url': 'https://api.github.com/users/facebook-github-bot/starred{/owner}{/repo}', 'subscriptions_url': 'https://api.github.com/users/facebook-github-bot/subscriptions', 'organizations_url': 'https://api.github.com/users/facebook-github-bot/orgs', 'repos_url': 'https://api.github.com/users/facebook-github-bot/repos', 'events_url': 'https://api.github.com/users/facebook-github-bot/events{/privacy}', 'received_events_url': 'https://api.github.com/users/facebook-github-bot/received_events', 'type': 'User', 'site_admin': False}",referenced,2752ad8045c59c4eafe45fe94b6672cb436da523,https://api.github.com/repos/pytorch/pytorch/commits/2752ad8045c59c4eafe45fe94b6672cb436da523,2018-11-30T00:33:42Z,4,4,0
1633,1996772703,"{'login': 'facebook-github-bot', 'id': 6422482, 'node_id': 'MDQ6VXNlcjY0MjI0ODI=', 'avatar_url': 'https://avatars3.githubusercontent.com/u/6422482?v=4', 'gravatar_id': '', 'url': 'https://api.github.com/users/facebook-github-bot', 'html_url': 'https://github.com/facebook-github-bot', 'followers_url': 'https://api.github.com/users/facebook-github-bot/followers', 'following_url': 'https://api.github.com/users/facebook-github-bot/following{/other_user}', 'gists_url': 'https://api.github.com/users/facebook-github-bot/gists{/gist_id}', 'starred_url': 'https://api.github.com/users/facebook-github-bot/starred{/owner}{/repo}', 'subscriptions_url': 'https://api.github.com/users/facebook-github-bot/subscriptions', 'organizations_url': 'https://api.github.com/users/facebook-github-bot/orgs', 'repos_url': 'https://api.github.com/users/facebook-github-bot/repos', 'events_url': 'https://api.github.com/users/facebook-github-bot/events{/privacy}', 'received_events_url': 'https://api.github.com/users/facebook-github-bot/received_events', 'type': 'User', 'site_admin': False}",referenced,2752ad8045c59c4eafe45fe94b6672cb436da523,https://api.github.com/repos/pytorch/pytorch/commits/2752ad8045c59c4eafe45fe94b6672cb436da523,2018-11-30T00:33:42Z,4,4,0
1626,1108681378,"{'login': 'soumith', 'id': 1310570, 'node_id': 'MDQ6VXNlcjEzMTA1NzA=', 'avatar_url': 'https://avatars0.githubusercontent.com/u/1310570?v=4', 'gravatar_id': '', 'url': 'https://api.github.com/users/soumith', 'html_url': 'https://github.com/soumith', 'followers_url': 'https://api.github.com/users/soumith/followers', 'following_url': 'https://api.github.com/users/soumith/following{/other_user}', 'gists_url': 'https://api.github.com/users/soumith/gists{/gist_id}', 'starred_url': 'https://api.github.com/users/soumith/starred{/owner}{/repo}', 'subscriptions_url': 'https://api.github.com/users/soumith/subscriptions', 'organizations_url': 'https://api.github.com/users/soumith/orgs', 'repos_url': 'https://api.github.com/users/soumith/repos', 'events_url': 'https://api.github.com/users/soumith/events{/privacy}', 'received_events_url': 'https://api.github.com/users/soumith/received_events', 'type': 'User', 'site_admin': False}",referenced,eba3dc85617351077689f1e49b662b67e40b318e,https://api.github.com/repos/pytorch/pytorch/commits/eba3dc85617351077689f1e49b662b67e40b318e,2017-06-03T01:08:59Z,125,54,71
1623,1996772687,"{'login': 'facebook-github-bot', 'id': 6422482, 'node_id': 'MDQ6VXNlcjY0MjI0ODI=', 'avatar_url': 'https://avatars3.githubusercontent.com/u/6422482?v=4', 'gravatar_id': '', 'url': 'https://api.github.com/users/facebook-github-bot', 'html_url': 'https://github.com/facebook-github-bot', 'followers_url': 'https://api.github.com/users/facebook-github-bot/followers', 'following_url': 'https://api.github.com/users/facebook-github-bot/following{/other_user}', 'gists_url': 'https://api.github.com/users/facebook-github-bot/gists{/gist_id}', 'starred_url': 'https://api.github.com/users/facebook-github-bot/starred{/owner}{/repo}', 'subscriptions_url': 'https://api.github.com/users/facebook-github-bot/subscriptions', 'organizations_url': 'https://api.github.com/users/facebook-github-bot/orgs', 'repos_url': 'https://api.github.com/users/facebook-github-bot/repos', 'events_url': 'https://api.github.com/users/facebook-github-bot/events{/privacy}', 'received_events_url': 'https://api.github.com/users/facebook-github-bot/received_events', 'type': 'User', 'site_admin': False}",referenced,2752ad8045c59c4eafe45fe94b6672cb436da523,https://api.github.com/repos/pytorch/pytorch/commits/2752ad8045c59c4eafe45fe94b6672cb436da523,2018-11-30T00:33:42Z,4,4,0
1622,2076202162,"{'login': 'facebook-github-bot', 'id': 6422482, 'node_id': 'MDQ6VXNlcjY0MjI0ODI=', 'avatar_url': 'https://avatars3.githubusercontent.com/u/6422482?v=4', 'gravatar_id': '', 'url': 'https://api.github.com/users/facebook-github-bot', 'html_url': 'https://github.com/facebook-github-bot', 'followers_url': 'https://api.github.com/users/facebook-github-bot/followers', 'following_url': 'https://api.github.com/users/facebook-github-bot/following{/other_user}', 'gists_url': 'https://api.github.com/users/facebook-github-bot/gists{/gist_id}', 'starred_url': 'https://api.github.com/users/facebook-github-bot/starred{/owner}{/repo}', 'subscriptions_url': 'https://api.github.com/users/facebook-github-bot/subscriptions', 'organizations_url': 'https://api.github.com/users/facebook-github-bot/orgs', 'repos_url': 'https://api.github.com/users/facebook-github-bot/repos', 'events_url': 'https://api.github.com/users/facebook-github-bot/events{/privacy}', 'received_events_url': 'https://api.github.com/users/facebook-github-bot/received_events', 'type': 'User', 'site_admin': False}",referenced,8f11df3cb7d43a433d12617078a263937f2734aa,https://api.github.com/repos/pytorch/pytorch/commits/8f11df3cb7d43a433d12617078a263937f2734aa,2019-01-16T01:18:49Z,4,3,1
1615,1996772708,"{'login': 'facebook-github-bot', 'id': 6422482, 'node_id': 'MDQ6VXNlcjY0MjI0ODI=', 'avatar_url': 'https://avatars3.githubusercontent.com/u/6422482?v=4', 'gravatar_id': '', 'url': 'https://api.github.com/users/facebook-github-bot', 'html_url': 'https://github.com/facebook-github-bot', 'followers_url': 'https://api.github.com/users/facebook-github-bot/followers', 'following_url': 'https://api.github.com/users/facebook-github-bot/following{/other_user}', 'gists_url': 'https://api.github.com/users/facebook-github-bot/gists{/gist_id}', 'starred_url': 'https://api.github.com/users/facebook-github-bot/starred{/owner}{/repo}', 'subscriptions_url': 'https://api.github.com/users/facebook-github-bot/subscriptions', 'organizations_url': 'https://api.github.com/users/facebook-github-bot/orgs', 'repos_url': 'https://api.github.com/users/facebook-github-bot/repos', 'events_url': 'https://api.github.com/users/facebook-github-bot/events{/privacy}', 'received_events_url': 'https://api.github.com/users/facebook-github-bot/received_events', 'type': 'User', 'site_admin': False}",referenced,2752ad8045c59c4eafe45fe94b6672cb436da523,https://api.github.com/repos/pytorch/pytorch/commits/2752ad8045c59c4eafe45fe94b6672cb436da523,2018-11-30T00:33:42Z,4,4,0
1613,1092533961,"{'login': 'pytorchbot', 'id': 21957446, 'node_id': 'MDQ6VXNlcjIxOTU3NDQ2', 'avatar_url': 'https://avatars2.githubusercontent.com/u/21957446?v=4', 'gravatar_id': '', 'url': 'https://api.github.com/users/pytorchbot', 'html_url': 'https://github.com/pytorchbot', 'followers_url': 'https://api.github.com/users/pytorchbot/followers', 'following_url': 'https://api.github.com/users/pytorchbot/following{/other_user}', 'gists_url': 'https://api.github.com/users/pytorchbot/gists{/gist_id}', 'starred_url': 'https://api.github.com/users/pytorchbot/starred{/owner}{/repo}', 'subscriptions_url': 'https://api.github.com/users/pytorchbot/subscriptions', 'organizations_url': 'https://api.github.com/users/pytorchbot/orgs', 'repos_url': 'https://api.github.com/users/pytorchbot/repos', 'events_url': 'https://api.github.com/users/pytorchbot/events{/privacy}', 'received_events_url': 'https://api.github.com/users/pytorchbot/received_events', 'type': 'User', 'site_admin': False}",referenced,45524ec33ce1bf75ece04d4f6eb939ba0c9469e9,https://api.github.com/repos/pytorch/pytorch/commits/45524ec33ce1bf75ece04d4f6eb939ba0c9469e9,2017-05-22T20:47:56Z,4,2,2
1608,1996772714,"{'login': 'facebook-github-bot', 'id': 6422482, 'node_id': 'MDQ6VXNlcjY0MjI0ODI=', 'avatar_url': 'https://avatars3.githubusercontent.com/u/6422482?v=4', 'gravatar_id': '', 'url': 'https://api.github.com/users/facebook-github-bot', 'html_url': 'https://github.com/facebook-github-bot', 'followers_url': 'https://api.github.com/users/facebook-github-bot/followers', 'following_url': 'https://api.github.com/users/facebook-github-bot/following{/other_user}', 'gists_url': 'https://api.github.com/users/facebook-github-bot/gists{/gist_id}', 'starred_url': 'https://api.github.com/users/facebook-github-bot/starred{/owner}{/repo}', 'subscriptions_url': 'https://api.github.com/users/facebook-github-bot/subscriptions', 'organizations_url': 'https://api.github.com/users/facebook-github-bot/orgs', 'repos_url': 'https://api.github.com/users/facebook-github-bot/repos', 'events_url': 'https://api.github.com/users/facebook-github-bot/events{/privacy}', 'received_events_url': 'https://api.github.com/users/facebook-github-bot/received_events', 'type': 'User', 'site_admin': False}",referenced,2752ad8045c59c4eafe45fe94b6672cb436da523,https://api.github.com/repos/pytorch/pytorch/commits/2752ad8045c59c4eafe45fe94b6672cb436da523,2018-11-30T00:33:43Z,4,4,0
1607,1996772706,"{'login': 'facebook-github-bot', 'id': 6422482, 'node_id': 'MDQ6VXNlcjY0MjI0ODI=', 'avatar_url': 'https://avatars3.githubusercontent.com/u/6422482?v=4', 'gravatar_id': '', 'url': 'https://api.github.com/users/facebook-github-bot', 'html_url': 'https://github.com/facebook-github-bot', 'followers_url': 'https://api.github.com/users/facebook-github-bot/followers', 'following_url': 'https://api.github.com/users/facebook-github-bot/following{/other_user}', 'gists_url': 'https://api.github.com/users/facebook-github-bot/gists{/gist_id}', 'starred_url': 'https://api.github.com/users/facebook-github-bot/starred{/owner}{/repo}', 'subscriptions_url': 'https://api.github.com/users/facebook-github-bot/subscriptions', 'organizations_url': 'https://api.github.com/users/facebook-github-bot/orgs', 'repos_url': 'https://api.github.com/users/facebook-github-bot/repos', 'events_url': 'https://api.github.com/users/facebook-github-bot/events{/privacy}', 'received_events_url': 'https://api.github.com/users/facebook-github-bot/received_events', 'type': 'User', 'site_admin': False}",referenced,2752ad8045c59c4eafe45fe94b6672cb436da523,https://api.github.com/repos/pytorch/pytorch/commits/2752ad8045c59c4eafe45fe94b6672cb436da523,2018-11-30T00:33:42Z,4,4,0
1606,1996772716,"{'login': 'facebook-github-bot', 'id': 6422482, 'node_id': 'MDQ6VXNlcjY0MjI0ODI=', 'avatar_url': 'https://avatars3.githubusercontent.com/u/6422482?v=4', 'gravatar_id': '', 'url': 'https://api.github.com/users/facebook-github-bot', 'html_url': 'https://github.com/facebook-github-bot', 'followers_url': 'https://api.github.com/users/facebook-github-bot/followers', 'following_url': 'https://api.github.com/users/facebook-github-bot/following{/other_user}', 'gists_url': 'https://api.github.com/users/facebook-github-bot/gists{/gist_id}', 'starred_url': 'https://api.github.com/users/facebook-github-bot/starred{/owner}{/repo}', 'subscriptions_url': 'https://api.github.com/users/facebook-github-bot/subscriptions', 'organizations_url': 'https://api.github.com/users/facebook-github-bot/orgs', 'repos_url': 'https://api.github.com/users/facebook-github-bot/repos', 'events_url': 'https://api.github.com/users/facebook-github-bot/events{/privacy}', 'received_events_url': 'https://api.github.com/users/facebook-github-bot/received_events', 'type': 'User', 'site_admin': False}",referenced,2752ad8045c59c4eafe45fe94b6672cb436da523,https://api.github.com/repos/pytorch/pytorch/commits/2752ad8045c59c4eafe45fe94b6672cb436da523,2018-11-30T00:33:43Z,4,4,0
1600,1096576167,"{'login': 'soumith', 'id': 1310570, 'node_id': 'MDQ6VXNlcjEzMTA1NzA=', 'avatar_url': 'https://avatars0.githubusercontent.com/u/1310570?v=4', 'gravatar_id': '', 'url': 'https://api.github.com/users/soumith', 'html_url': 'https://github.com/soumith', 'followers_url': 'https://api.github.com/users/soumith/followers', 'following_url': 'https://api.github.com/users/soumith/following{/other_user}', 'gists_url': 'https://api.github.com/users/soumith/gists{/gist_id}', 'starred_url': 'https://api.github.com/users/soumith/starred{/owner}{/repo}', 'subscriptions_url': 'https://api.github.com/users/soumith/subscriptions', 'organizations_url': 'https://api.github.com/users/soumith/orgs', 'repos_url': 'https://api.github.com/users/soumith/repos', 'events_url': 'https://api.github.com/users/soumith/events{/privacy}', 'received_events_url': 'https://api.github.com/users/soumith/received_events', 'type': 'User', 'site_admin': False}",referenced,98581b9f7eab4d05613c39bb0f0573b9455e2bb8,https://api.github.com/repos/pytorch/pytorch/commits/98581b9f7eab4d05613c39bb0f0573b9455e2bb8,2017-05-25T00:46:38Z,8,5,3
1597,1996772725,"{'login': 'facebook-github-bot', 'id': 6422482, 'node_id': 'MDQ6VXNlcjY0MjI0ODI=', 'avatar_url': 'https://avatars3.githubusercontent.com/u/6422482?v=4', 'gravatar_id': '', 'url': 'https://api.github.com/users/facebook-github-bot', 'html_url': 'https://github.com/facebook-github-bot', 'followers_url': 'https://api.github.com/users/facebook-github-bot/followers', 'following_url': 'https://api.github.com/users/facebook-github-bot/following{/other_user}', 'gists_url': 'https://api.github.com/users/facebook-github-bot/gists{/gist_id}', 'starred_url': 'https://api.github.com/users/facebook-github-bot/starred{/owner}{/repo}', 'subscriptions_url': 'https://api.github.com/users/facebook-github-bot/subscriptions', 'organizations_url': 'https://api.github.com/users/facebook-github-bot/orgs', 'repos_url': 'https://api.github.com/users/facebook-github-bot/repos', 'events_url': 'https://api.github.com/users/facebook-github-bot/events{/privacy}', 'received_events_url': 'https://api.github.com/users/facebook-github-bot/received_events', 'type': 'User', 'site_admin': False}",referenced,2752ad8045c59c4eafe45fe94b6672cb436da523,https://api.github.com/repos/pytorch/pytorch/commits/2752ad8045c59c4eafe45fe94b6672cb436da523,2018-11-30T00:33:43Z,4,4,0
1595,1996772726,"{'login': 'facebook-github-bot', 'id': 6422482, 'node_id': 'MDQ6VXNlcjY0MjI0ODI=', 'avatar_url': 'https://avatars3.githubusercontent.com/u/6422482?v=4', 'gravatar_id': '', 'url': 'https://api.github.com/users/facebook-github-bot', 'html_url': 'https://github.com/facebook-github-bot', 'followers_url': 'https://api.github.com/users/facebook-github-bot/followers', 'following_url': 'https://api.github.com/users/facebook-github-bot/following{/other_user}', 'gists_url': 'https://api.github.com/users/facebook-github-bot/gists{/gist_id}', 'starred_url': 'https://api.github.com/users/facebook-github-bot/starred{/owner}{/repo}', 'subscriptions_url': 'https://api.github.com/users/facebook-github-bot/subscriptions', 'organizations_url': 'https://api.github.com/users/facebook-github-bot/orgs', 'repos_url': 'https://api.github.com/users/facebook-github-bot/repos', 'events_url': 'https://api.github.com/users/facebook-github-bot/events{/privacy}', 'received_events_url': 'https://api.github.com/users/facebook-github-bot/received_events', 'type': 'User', 'site_admin': False}",referenced,2752ad8045c59c4eafe45fe94b6672cb436da523,https://api.github.com/repos/pytorch/pytorch/commits/2752ad8045c59c4eafe45fe94b6672cb436da523,2018-11-30T00:33:43Z,4,4,0
1587,2068983582,"{'login': 'facebook-github-bot', 'id': 6422482, 'node_id': 'MDQ6VXNlcjY0MjI0ODI=', 'avatar_url': 'https://avatars3.githubusercontent.com/u/6422482?v=4', 'gravatar_id': '', 'url': 'https://api.github.com/users/facebook-github-bot', 'html_url': 'https://github.com/facebook-github-bot', 'followers_url': 'https://api.github.com/users/facebook-github-bot/followers', 'following_url': 'https://api.github.com/users/facebook-github-bot/following{/other_user}', 'gists_url': 'https://api.github.com/users/facebook-github-bot/gists{/gist_id}', 'starred_url': 'https://api.github.com/users/facebook-github-bot/starred{/owner}{/repo}', 'subscriptions_url': 'https://api.github.com/users/facebook-github-bot/subscriptions', 'organizations_url': 'https://api.github.com/users/facebook-github-bot/orgs', 'repos_url': 'https://api.github.com/users/facebook-github-bot/repos', 'events_url': 'https://api.github.com/users/facebook-github-bot/events{/privacy}', 'received_events_url': 'https://api.github.com/users/facebook-github-bot/received_events', 'type': 'User', 'site_admin': False}",referenced,7841fe4f27e0553179f2019da79f0f046d61c69d,https://api.github.com/repos/pytorch/pytorch/commits/7841fe4f27e0553179f2019da79f0f046d61c69d,2019-01-11T16:29:31Z,2,1,1
1584,1270113113,"{'login': 'soumith', 'id': 1310570, 'node_id': 'MDQ6VXNlcjEzMTA1NzA=', 'avatar_url': 'https://avatars0.githubusercontent.com/u/1310570?v=4', 'gravatar_id': '', 'url': 'https://api.github.com/users/soumith', 'html_url': 'https://github.com/soumith', 'followers_url': 'https://api.github.com/users/soumith/followers', 'following_url': 'https://api.github.com/users/soumith/following{/other_user}', 'gists_url': 'https://api.github.com/users/soumith/gists{/gist_id}', 'starred_url': 'https://api.github.com/users/soumith/starred{/owner}{/repo}', 'subscriptions_url': 'https://api.github.com/users/soumith/subscriptions', 'organizations_url': 'https://api.github.com/users/soumith/orgs', 'repos_url': 'https://api.github.com/users/soumith/repos', 'events_url': 'https://api.github.com/users/soumith/events{/privacy}', 'received_events_url': 'https://api.github.com/users/soumith/received_events', 'type': 'User', 'site_admin': False}",closed,f2037970cb665c894d52adfa68e05a48b05a6a73,https://api.github.com/repos/pytorch/pytorch/commits/f2037970cb665c894d52adfa68e05a48b05a6a73,2017-09-28T16:07:17Z,15,11,4
1582,2055600188,"{'login': 'facebook-github-bot', 'id': 6422482, 'node_id': 'MDQ6VXNlcjY0MjI0ODI=', 'avatar_url': 'https://avatars3.githubusercontent.com/u/6422482?v=4', 'gravatar_id': '', 'url': 'https://api.github.com/users/facebook-github-bot', 'html_url': 'https://github.com/facebook-github-bot', 'followers_url': 'https://api.github.com/users/facebook-github-bot/followers', 'following_url': 'https://api.github.com/users/facebook-github-bot/following{/other_user}', 'gists_url': 'https://api.github.com/users/facebook-github-bot/gists{/gist_id}', 'starred_url': 'https://api.github.com/users/facebook-github-bot/starred{/owner}{/repo}', 'subscriptions_url': 'https://api.github.com/users/facebook-github-bot/subscriptions', 'organizations_url': 'https://api.github.com/users/facebook-github-bot/orgs', 'repos_url': 'https://api.github.com/users/facebook-github-bot/repos', 'events_url': 'https://api.github.com/users/facebook-github-bot/events{/privacy}', 'received_events_url': 'https://api.github.com/users/facebook-github-bot/received_events', 'type': 'User', 'site_admin': False}",referenced,12e6c1ceeb74fc0a1ea6a1af9eb60174b26ce4f6,https://api.github.com/repos/pytorch/pytorch/commits/12e6c1ceeb74fc0a1ea6a1af9eb60174b26ce4f6,2019-01-04T23:58:13Z,3,2,1
1578,1996772739,"{'login': 'facebook-github-bot', 'id': 6422482, 'node_id': 'MDQ6VXNlcjY0MjI0ODI=', 'avatar_url': 'https://avatars3.githubusercontent.com/u/6422482?v=4', 'gravatar_id': '', 'url': 'https://api.github.com/users/facebook-github-bot', 'html_url': 'https://github.com/facebook-github-bot', 'followers_url': 'https://api.github.com/users/facebook-github-bot/followers', 'following_url': 'https://api.github.com/users/facebook-github-bot/following{/other_user}', 'gists_url': 'https://api.github.com/users/facebook-github-bot/gists{/gist_id}', 'starred_url': 'https://api.github.com/users/facebook-github-bot/starred{/owner}{/repo}', 'subscriptions_url': 'https://api.github.com/users/facebook-github-bot/subscriptions', 'organizations_url': 'https://api.github.com/users/facebook-github-bot/orgs', 'repos_url': 'https://api.github.com/users/facebook-github-bot/repos', 'events_url': 'https://api.github.com/users/facebook-github-bot/events{/privacy}', 'received_events_url': 'https://api.github.com/users/facebook-github-bot/received_events', 'type': 'User', 'site_admin': False}",referenced,2752ad8045c59c4eafe45fe94b6672cb436da523,https://api.github.com/repos/pytorch/pytorch/commits/2752ad8045c59c4eafe45fe94b6672cb436da523,2018-11-30T00:33:43Z,4,4,0
1571,1996772740,"{'login': 'facebook-github-bot', 'id': 6422482, 'node_id': 'MDQ6VXNlcjY0MjI0ODI=', 'avatar_url': 'https://avatars3.githubusercontent.com/u/6422482?v=4', 'gravatar_id': '', 'url': 'https://api.github.com/users/facebook-github-bot', 'html_url': 'https://github.com/facebook-github-bot', 'followers_url': 'https://api.github.com/users/facebook-github-bot/followers', 'following_url': 'https://api.github.com/users/facebook-github-bot/following{/other_user}', 'gists_url': 'https://api.github.com/users/facebook-github-bot/gists{/gist_id}', 'starred_url': 'https://api.github.com/users/facebook-github-bot/starred{/owner}{/repo}', 'subscriptions_url': 'https://api.github.com/users/facebook-github-bot/subscriptions', 'organizations_url': 'https://api.github.com/users/facebook-github-bot/orgs', 'repos_url': 'https://api.github.com/users/facebook-github-bot/repos', 'events_url': 'https://api.github.com/users/facebook-github-bot/events{/privacy}', 'received_events_url': 'https://api.github.com/users/facebook-github-bot/received_events', 'type': 'User', 'site_admin': False}",referenced,2752ad8045c59c4eafe45fe94b6672cb436da523,https://api.github.com/repos/pytorch/pytorch/commits/2752ad8045c59c4eafe45fe94b6672cb436da523,2018-11-30T00:33:43Z,4,4,0
1570,1913937240,"{'login': 'facebook-github-bot', 'id': 6422482, 'node_id': 'MDQ6VXNlcjY0MjI0ODI=', 'avatar_url': 'https://avatars3.githubusercontent.com/u/6422482?v=4', 'gravatar_id': '', 'url': 'https://api.github.com/users/facebook-github-bot', 'html_url': 'https://github.com/facebook-github-bot', 'followers_url': 'https://api.github.com/users/facebook-github-bot/followers', 'following_url': 'https://api.github.com/users/facebook-github-bot/following{/other_user}', 'gists_url': 'https://api.github.com/users/facebook-github-bot/gists{/gist_id}', 'starred_url': 'https://api.github.com/users/facebook-github-bot/starred{/owner}{/repo}', 'subscriptions_url': 'https://api.github.com/users/facebook-github-bot/subscriptions', 'organizations_url': 'https://api.github.com/users/facebook-github-bot/orgs', 'repos_url': 'https://api.github.com/users/facebook-github-bot/repos', 'events_url': 'https://api.github.com/users/facebook-github-bot/events{/privacy}', 'received_events_url': 'https://api.github.com/users/facebook-github-bot/received_events', 'type': 'User', 'site_admin': False}",closed,373b5080dacc4c4fa958e36182f8c41a0a9dc425,https://api.github.com/repos/pytorch/pytorch/commits/373b5080dacc4c4fa958e36182f8c41a0a9dc425,2018-10-19T05:48:42Z,9,9,0
1567,1996772737,"{'login': 'facebook-github-bot', 'id': 6422482, 'node_id': 'MDQ6VXNlcjY0MjI0ODI=', 'avatar_url': 'https://avatars3.githubusercontent.com/u/6422482?v=4', 'gravatar_id': '', 'url': 'https://api.github.com/users/facebook-github-bot', 'html_url': 'https://github.com/facebook-github-bot', 'followers_url': 'https://api.github.com/users/facebook-github-bot/followers', 'following_url': 'https://api.github.com/users/facebook-github-bot/following{/other_user}', 'gists_url': 'https://api.github.com/users/facebook-github-bot/gists{/gist_id}', 'starred_url': 'https://api.github.com/users/facebook-github-bot/starred{/owner}{/repo}', 'subscriptions_url': 'https://api.github.com/users/facebook-github-bot/subscriptions', 'organizations_url': 'https://api.github.com/users/facebook-github-bot/orgs', 'repos_url': 'https://api.github.com/users/facebook-github-bot/repos', 'events_url': 'https://api.github.com/users/facebook-github-bot/events{/privacy}', 'received_events_url': 'https://api.github.com/users/facebook-github-bot/received_events', 'type': 'User', 'site_admin': False}",referenced,2752ad8045c59c4eafe45fe94b6672cb436da523,https://api.github.com/repos/pytorch/pytorch/commits/2752ad8045c59c4eafe45fe94b6672cb436da523,2018-11-30T00:33:43Z,4,4,0
1565,1996772699,"{'login': 'facebook-github-bot', 'id': 6422482, 'node_id': 'MDQ6VXNlcjY0MjI0ODI=', 'avatar_url': 'https://avatars3.githubusercontent.com/u/6422482?v=4', 'gravatar_id': '', 'url': 'https://api.github.com/users/facebook-github-bot', 'html_url': 'https://github.com/facebook-github-bot', 'followers_url': 'https://api.github.com/users/facebook-github-bot/followers', 'following_url': 'https://api.github.com/users/facebook-github-bot/following{/other_user}', 'gists_url': 'https://api.github.com/users/facebook-github-bot/gists{/gist_id}', 'starred_url': 'https://api.github.com/users/facebook-github-bot/starred{/owner}{/repo}', 'subscriptions_url': 'https://api.github.com/users/facebook-github-bot/subscriptions', 'organizations_url': 'https://api.github.com/users/facebook-github-bot/orgs', 'repos_url': 'https://api.github.com/users/facebook-github-bot/repos', 'events_url': 'https://api.github.com/users/facebook-github-bot/events{/privacy}', 'received_events_url': 'https://api.github.com/users/facebook-github-bot/received_events', 'type': 'User', 'site_admin': False}",referenced,2752ad8045c59c4eafe45fe94b6672cb436da523,https://api.github.com/repos/pytorch/pytorch/commits/2752ad8045c59c4eafe45fe94b6672cb436da523,2018-11-30T00:33:42Z,4,4,0
1532,1112951812,"{'login': 'soumith', 'id': 1310570, 'node_id': 'MDQ6VXNlcjEzMTA1NzA=', 'avatar_url': 'https://avatars0.githubusercontent.com/u/1310570?v=4', 'gravatar_id': '', 'url': 'https://api.github.com/users/soumith', 'html_url': 'https://github.com/soumith', 'followers_url': 'https://api.github.com/users/soumith/followers', 'following_url': 'https://api.github.com/users/soumith/following{/other_user}', 'gists_url': 'https://api.github.com/users/soumith/gists{/gist_id}', 'starred_url': 'https://api.github.com/users/soumith/starred{/owner}{/repo}', 'subscriptions_url': 'https://api.github.com/users/soumith/subscriptions', 'organizations_url': 'https://api.github.com/users/soumith/orgs', 'repos_url': 'https://api.github.com/users/soumith/repos', 'events_url': 'https://api.github.com/users/soumith/events{/privacy}', 'received_events_url': 'https://api.github.com/users/soumith/received_events', 'type': 'User', 'site_admin': False}",referenced,db620304b2bcbaf14ca643220b42aeff717e37ec,https://api.github.com/repos/pytorch/pytorch/commits/db620304b2bcbaf14ca643220b42aeff717e37ec,2017-06-07T04:20:29Z,32,18,14
1532,1112951816,"{'login': 'soumith', 'id': 1310570, 'node_id': 'MDQ6VXNlcjEzMTA1NzA=', 'avatar_url': 'https://avatars0.githubusercontent.com/u/1310570?v=4', 'gravatar_id': '', 'url': 'https://api.github.com/users/soumith', 'html_url': 'https://github.com/soumith', 'followers_url': 'https://api.github.com/users/soumith/followers', 'following_url': 'https://api.github.com/users/soumith/following{/other_user}', 'gists_url': 'https://api.github.com/users/soumith/gists{/gist_id}', 'starred_url': 'https://api.github.com/users/soumith/starred{/owner}{/repo}', 'subscriptions_url': 'https://api.github.com/users/soumith/subscriptions', 'organizations_url': 'https://api.github.com/users/soumith/orgs', 'repos_url': 'https://api.github.com/users/soumith/repos', 'events_url': 'https://api.github.com/users/soumith/events{/privacy}', 'received_events_url': 'https://api.github.com/users/soumith/received_events', 'type': 'User', 'site_admin': False}",referenced,22949350b6e853f4dc881491e6726d5b2a398107,https://api.github.com/repos/pytorch/pytorch/commits/22949350b6e853f4dc881491e6726d5b2a398107,2017-06-07T04:20:29Z,73,45,28
1524,1088719967,"{'login': 'soumith', 'id': 1310570, 'node_id': 'MDQ6VXNlcjEzMTA1NzA=', 'avatar_url': 'https://avatars0.githubusercontent.com/u/1310570?v=4', 'gravatar_id': '', 'url': 'https://api.github.com/users/soumith', 'html_url': 'https://github.com/soumith', 'followers_url': 'https://api.github.com/users/soumith/followers', 'following_url': 'https://api.github.com/users/soumith/following{/other_user}', 'gists_url': 'https://api.github.com/users/soumith/gists{/gist_id}', 'starred_url': 'https://api.github.com/users/soumith/starred{/owner}{/repo}', 'subscriptions_url': 'https://api.github.com/users/soumith/subscriptions', 'organizations_url': 'https://api.github.com/users/soumith/orgs', 'repos_url': 'https://api.github.com/users/soumith/repos', 'events_url': 'https://api.github.com/users/soumith/events{/privacy}', 'received_events_url': 'https://api.github.com/users/soumith/received_events', 'type': 'User', 'site_admin': False}",closed,c57f0530e73da090a12a8ca9bcf26a8edda1df3e,https://api.github.com/repos/pytorch/pytorch/commits/c57f0530e73da090a12a8ca9bcf26a8edda1df3e,2017-05-18T23:31:40Z,14,5,9
1524,1913572741,"{'login': 'facebook-github-bot', 'id': 6422482, 'node_id': 'MDQ6VXNlcjY0MjI0ODI=', 'avatar_url': 'https://avatars3.githubusercontent.com/u/6422482?v=4', 'gravatar_id': '', 'url': 'https://api.github.com/users/facebook-github-bot', 'html_url': 'https://github.com/facebook-github-bot', 'followers_url': 'https://api.github.com/users/facebook-github-bot/followers', 'following_url': 'https://api.github.com/users/facebook-github-bot/following{/other_user}', 'gists_url': 'https://api.github.com/users/facebook-github-bot/gists{/gist_id}', 'starred_url': 'https://api.github.com/users/facebook-github-bot/starred{/owner}{/repo}', 'subscriptions_url': 'https://api.github.com/users/facebook-github-bot/subscriptions', 'organizations_url': 'https://api.github.com/users/facebook-github-bot/orgs', 'repos_url': 'https://api.github.com/users/facebook-github-bot/repos', 'events_url': 'https://api.github.com/users/facebook-github-bot/events{/privacy}', 'received_events_url': 'https://api.github.com/users/facebook-github-bot/received_events', 'type': 'User', 'site_admin': False}",referenced,f9d1b63d18b91888cdaedc5cb9f39c63d4f822e7,https://api.github.com/repos/pytorch/pytorch/commits/f9d1b63d18b91888cdaedc5cb9f39c63d4f822e7,2018-10-18T23:18:43Z,3,2,1
1521,1122140220,"{'login': 'soumith', 'id': 1310570, 'node_id': 'MDQ6VXNlcjEzMTA1NzA=', 'avatar_url': 'https://avatars0.githubusercontent.com/u/1310570?v=4', 'gravatar_id': '', 'url': 'https://api.github.com/users/soumith', 'html_url': 'https://github.com/soumith', 'followers_url': 'https://api.github.com/users/soumith/followers', 'following_url': 'https://api.github.com/users/soumith/following{/other_user}', 'gists_url': 'https://api.github.com/users/soumith/gists{/gist_id}', 'starred_url': 'https://api.github.com/users/soumith/starred{/owner}{/repo}', 'subscriptions_url': 'https://api.github.com/users/soumith/subscriptions', 'organizations_url': 'https://api.github.com/users/soumith/orgs', 'repos_url': 'https://api.github.com/users/soumith/repos', 'events_url': 'https://api.github.com/users/soumith/events{/privacy}', 'received_events_url': 'https://api.github.com/users/soumith/received_events', 'type': 'User', 'site_admin': False}",referenced,6a46863c833c11ea33976eb67091d323135d0315,https://api.github.com/repos/pytorch/pytorch/commits/6a46863c833c11ea33976eb67091d323135d0315,2017-06-13T20:32:36Z,3,3,0
1518,1913572742,"{'login': 'facebook-github-bot', 'id': 6422482, 'node_id': 'MDQ6VXNlcjY0MjI0ODI=', 'avatar_url': 'https://avatars3.githubusercontent.com/u/6422482?v=4', 'gravatar_id': '', 'url': 'https://api.github.com/users/facebook-github-bot', 'html_url': 'https://github.com/facebook-github-bot', 'followers_url': 'https://api.github.com/users/facebook-github-bot/followers', 'following_url': 'https://api.github.com/users/facebook-github-bot/following{/other_user}', 'gists_url': 'https://api.github.com/users/facebook-github-bot/gists{/gist_id}', 'starred_url': 'https://api.github.com/users/facebook-github-bot/starred{/owner}{/repo}', 'subscriptions_url': 'https://api.github.com/users/facebook-github-bot/subscriptions', 'organizations_url': 'https://api.github.com/users/facebook-github-bot/orgs', 'repos_url': 'https://api.github.com/users/facebook-github-bot/repos', 'events_url': 'https://api.github.com/users/facebook-github-bot/events{/privacy}', 'received_events_url': 'https://api.github.com/users/facebook-github-bot/received_events', 'type': 'User', 'site_admin': False}",referenced,f9d1b63d18b91888cdaedc5cb9f39c63d4f822e7,https://api.github.com/repos/pytorch/pytorch/commits/f9d1b63d18b91888cdaedc5cb9f39c63d4f822e7,2018-10-18T23:18:43Z,3,2,1
1511,1913572748,"{'login': 'facebook-github-bot', 'id': 6422482, 'node_id': 'MDQ6VXNlcjY0MjI0ODI=', 'avatar_url': 'https://avatars3.githubusercontent.com/u/6422482?v=4', 'gravatar_id': '', 'url': 'https://api.github.com/users/facebook-github-bot', 'html_url': 'https://github.com/facebook-github-bot', 'followers_url': 'https://api.github.com/users/facebook-github-bot/followers', 'following_url': 'https://api.github.com/users/facebook-github-bot/following{/other_user}', 'gists_url': 'https://api.github.com/users/facebook-github-bot/gists{/gist_id}', 'starred_url': 'https://api.github.com/users/facebook-github-bot/starred{/owner}{/repo}', 'subscriptions_url': 'https://api.github.com/users/facebook-github-bot/subscriptions', 'organizations_url': 'https://api.github.com/users/facebook-github-bot/orgs', 'repos_url': 'https://api.github.com/users/facebook-github-bot/repos', 'events_url': 'https://api.github.com/users/facebook-github-bot/events{/privacy}', 'received_events_url': 'https://api.github.com/users/facebook-github-bot/received_events', 'type': 'User', 'site_admin': False}",referenced,f9d1b63d18b91888cdaedc5cb9f39c63d4f822e7,https://api.github.com/repos/pytorch/pytorch/commits/f9d1b63d18b91888cdaedc5cb9f39c63d4f822e7,2018-10-18T23:18:43Z,3,2,1
1501,1905231358,"{'login': 'bddppq', 'id': 9300575, 'node_id': 'MDQ6VXNlcjkzMDA1NzU=', 'avatar_url': 'https://avatars2.githubusercontent.com/u/9300575?v=4', 'gravatar_id': '', 'url': 'https://api.github.com/users/bddppq', 'html_url': 'https://github.com/bddppq', 'followers_url': 'https://api.github.com/users/bddppq/followers', 'following_url': 'https://api.github.com/users/bddppq/following{/other_user}', 'gists_url': 'https://api.github.com/users/bddppq/gists{/gist_id}', 'starred_url': 'https://api.github.com/users/bddppq/starred{/owner}{/repo}', 'subscriptions_url': 'https://api.github.com/users/bddppq/subscriptions', 'organizations_url': 'https://api.github.com/users/bddppq/orgs', 'repos_url': 'https://api.github.com/users/bddppq/repos', 'events_url': 'https://api.github.com/users/bddppq/events{/privacy}', 'received_events_url': 'https://api.github.com/users/bddppq/received_events', 'type': 'User', 'site_admin': False}",referenced,a0f1f87ab6896982ceb610573267cdb598bbbc22,https://api.github.com/repos/pytorch/pytorch/commits/a0f1f87ab6896982ceb610573267cdb598bbbc22,2018-10-15T21:13:17Z,29,29,0
1499,1996772735,"{'login': 'facebook-github-bot', 'id': 6422482, 'node_id': 'MDQ6VXNlcjY0MjI0ODI=', 'avatar_url': 'https://avatars3.githubusercontent.com/u/6422482?v=4', 'gravatar_id': '', 'url': 'https://api.github.com/users/facebook-github-bot', 'html_url': 'https://github.com/facebook-github-bot', 'followers_url': 'https://api.github.com/users/facebook-github-bot/followers', 'following_url': 'https://api.github.com/users/facebook-github-bot/following{/other_user}', 'gists_url': 'https://api.github.com/users/facebook-github-bot/gists{/gist_id}', 'starred_url': 'https://api.github.com/users/facebook-github-bot/starred{/owner}{/repo}', 'subscriptions_url': 'https://api.github.com/users/facebook-github-bot/subscriptions', 'organizations_url': 'https://api.github.com/users/facebook-github-bot/orgs', 'repos_url': 'https://api.github.com/users/facebook-github-bot/repos', 'events_url': 'https://api.github.com/users/facebook-github-bot/events{/privacy}', 'received_events_url': 'https://api.github.com/users/facebook-github-bot/received_events', 'type': 'User', 'site_admin': False}",referenced,2752ad8045c59c4eafe45fe94b6672cb436da523,https://api.github.com/repos/pytorch/pytorch/commits/2752ad8045c59c4eafe45fe94b6672cb436da523,2018-11-30T00:33:43Z,4,4,0
1498,1905231353,"{'login': 'bddppq', 'id': 9300575, 'node_id': 'MDQ6VXNlcjkzMDA1NzU=', 'avatar_url': 'https://avatars2.githubusercontent.com/u/9300575?v=4', 'gravatar_id': '', 'url': 'https://api.github.com/users/bddppq', 'html_url': 'https://github.com/bddppq', 'followers_url': 'https://api.github.com/users/bddppq/followers', 'following_url': 'https://api.github.com/users/bddppq/following{/other_user}', 'gists_url': 'https://api.github.com/users/bddppq/gists{/gist_id}', 'starred_url': 'https://api.github.com/users/bddppq/starred{/owner}{/repo}', 'subscriptions_url': 'https://api.github.com/users/bddppq/subscriptions', 'organizations_url': 'https://api.github.com/users/bddppq/orgs', 'repos_url': 'https://api.github.com/users/bddppq/repos', 'events_url': 'https://api.github.com/users/bddppq/events{/privacy}', 'received_events_url': 'https://api.github.com/users/bddppq/received_events', 'type': 'User', 'site_admin': False}",referenced,2f1ad9a3a0cf6a91cb89bddc6700a6c65e472200,https://api.github.com/repos/pytorch/pytorch/commits/2f1ad9a3a0cf6a91cb89bddc6700a6c65e472200,2018-10-15T21:13:17Z,104,59,45
1495,1905231351,"{'login': 'bddppq', 'id': 9300575, 'node_id': 'MDQ6VXNlcjkzMDA1NzU=', 'avatar_url': 'https://avatars2.githubusercontent.com/u/9300575?v=4', 'gravatar_id': '', 'url': 'https://api.github.com/users/bddppq', 'html_url': 'https://github.com/bddppq', 'followers_url': 'https://api.github.com/users/bddppq/followers', 'following_url': 'https://api.github.com/users/bddppq/following{/other_user}', 'gists_url': 'https://api.github.com/users/bddppq/gists{/gist_id}', 'starred_url': 'https://api.github.com/users/bddppq/starred{/owner}{/repo}', 'subscriptions_url': 'https://api.github.com/users/bddppq/subscriptions', 'organizations_url': 'https://api.github.com/users/bddppq/orgs', 'repos_url': 'https://api.github.com/users/bddppq/repos', 'events_url': 'https://api.github.com/users/bddppq/events{/privacy}', 'received_events_url': 'https://api.github.com/users/bddppq/received_events', 'type': 'User', 'site_admin': False}",referenced,f50513efe2b8b31e9915c65ab5668fa0d67429d0,https://api.github.com/repos/pytorch/pytorch/commits/f50513efe2b8b31e9915c65ab5668fa0d67429d0,2018-10-15T21:13:17Z,23,13,10
1494,1913572746,"{'login': 'facebook-github-bot', 'id': 6422482, 'node_id': 'MDQ6VXNlcjY0MjI0ODI=', 'avatar_url': 'https://avatars3.githubusercontent.com/u/6422482?v=4', 'gravatar_id': '', 'url': 'https://api.github.com/users/facebook-github-bot', 'html_url': 'https://github.com/facebook-github-bot', 'followers_url': 'https://api.github.com/users/facebook-github-bot/followers', 'following_url': 'https://api.github.com/users/facebook-github-bot/following{/other_user}', 'gists_url': 'https://api.github.com/users/facebook-github-bot/gists{/gist_id}', 'starred_url': 'https://api.github.com/users/facebook-github-bot/starred{/owner}{/repo}', 'subscriptions_url': 'https://api.github.com/users/facebook-github-bot/subscriptions', 'organizations_url': 'https://api.github.com/users/facebook-github-bot/orgs', 'repos_url': 'https://api.github.com/users/facebook-github-bot/repos', 'events_url': 'https://api.github.com/users/facebook-github-bot/events{/privacy}', 'received_events_url': 'https://api.github.com/users/facebook-github-bot/received_events', 'type': 'User', 'site_admin': False}",referenced,f9d1b63d18b91888cdaedc5cb9f39c63d4f822e7,https://api.github.com/repos/pytorch/pytorch/commits/f9d1b63d18b91888cdaedc5cb9f39c63d4f822e7,2018-10-18T23:18:43Z,3,2,1
1488,1258054330,"{'login': 'apaszke', 'id': 4583066, 'node_id': 'MDQ6VXNlcjQ1ODMwNjY=', 'avatar_url': 'https://avatars3.githubusercontent.com/u/4583066?v=4', 'gravatar_id': '', 'url': 'https://api.github.com/users/apaszke', 'html_url': 'https://github.com/apaszke', 'followers_url': 'https://api.github.com/users/apaszke/followers', 'following_url': 'https://api.github.com/users/apaszke/following{/other_user}', 'gists_url': 'https://api.github.com/users/apaszke/gists{/gist_id}', 'starred_url': 'https://api.github.com/users/apaszke/starred{/owner}{/repo}', 'subscriptions_url': 'https://api.github.com/users/apaszke/subscriptions', 'organizations_url': 'https://api.github.com/users/apaszke/orgs', 'repos_url': 'https://api.github.com/users/apaszke/repos', 'events_url': 'https://api.github.com/users/apaszke/events{/privacy}', 'received_events_url': 'https://api.github.com/users/apaszke/received_events', 'type': 'User', 'site_admin': False}",referenced,1a83c372ecb0c81bdd5110c516cc6e9f9554a469,https://api.github.com/repos/pytorch/pytorch/commits/1a83c372ecb0c81bdd5110c516cc6e9f9554a469,2017-09-20T18:56:29Z,3,2,1
1488,1905231339,"{'login': 'bddppq', 'id': 9300575, 'node_id': 'MDQ6VXNlcjkzMDA1NzU=', 'avatar_url': 'https://avatars2.githubusercontent.com/u/9300575?v=4', 'gravatar_id': '', 'url': 'https://api.github.com/users/bddppq', 'html_url': 'https://github.com/bddppq', 'followers_url': 'https://api.github.com/users/bddppq/followers', 'following_url': 'https://api.github.com/users/bddppq/following{/other_user}', 'gists_url': 'https://api.github.com/users/bddppq/gists{/gist_id}', 'starred_url': 'https://api.github.com/users/bddppq/starred{/owner}{/repo}', 'subscriptions_url': 'https://api.github.com/users/bddppq/subscriptions', 'organizations_url': 'https://api.github.com/users/bddppq/orgs', 'repos_url': 'https://api.github.com/users/bddppq/repos', 'events_url': 'https://api.github.com/users/bddppq/events{/privacy}', 'received_events_url': 'https://api.github.com/users/bddppq/received_events', 'type': 'User', 'site_admin': False}",referenced,008e381855db1f0ed4d30e01237f99e1c0442a90,https://api.github.com/repos/pytorch/pytorch/commits/008e381855db1f0ed4d30e01237f99e1c0442a90,2018-10-15T21:13:16Z,8,5,3
1486,1905231335,"{'login': 'bddppq', 'id': 9300575, 'node_id': 'MDQ6VXNlcjkzMDA1NzU=', 'avatar_url': 'https://avatars2.githubusercontent.com/u/9300575?v=4', 'gravatar_id': '', 'url': 'https://api.github.com/users/bddppq', 'html_url': 'https://github.com/bddppq', 'followers_url': 'https://api.github.com/users/bddppq/followers', 'following_url': 'https://api.github.com/users/bddppq/following{/other_user}', 'gists_url': 'https://api.github.com/users/bddppq/gists{/gist_id}', 'starred_url': 'https://api.github.com/users/bddppq/starred{/owner}{/repo}', 'subscriptions_url': 'https://api.github.com/users/bddppq/subscriptions', 'organizations_url': 'https://api.github.com/users/bddppq/orgs', 'repos_url': 'https://api.github.com/users/bddppq/repos', 'events_url': 'https://api.github.com/users/bddppq/events{/privacy}', 'received_events_url': 'https://api.github.com/users/bddppq/received_events', 'type': 'User', 'site_admin': False}",referenced,ca864c7dff0ef178ff57cdda4ef7208d2c9983cc,https://api.github.com/repos/pytorch/pytorch/commits/ca864c7dff0ef178ff57cdda4ef7208d2c9983cc,2018-10-15T21:13:16Z,2,1,1
1484,1905231341,"{'login': 'bddppq', 'id': 9300575, 'node_id': 'MDQ6VXNlcjkzMDA1NzU=', 'avatar_url': 'https://avatars2.githubusercontent.com/u/9300575?v=4', 'gravatar_id': '', 'url': 'https://api.github.com/users/bddppq', 'html_url': 'https://github.com/bddppq', 'followers_url': 'https://api.github.com/users/bddppq/followers', 'following_url': 'https://api.github.com/users/bddppq/following{/other_user}', 'gists_url': 'https://api.github.com/users/bddppq/gists{/gist_id}', 'starred_url': 'https://api.github.com/users/bddppq/starred{/owner}{/repo}', 'subscriptions_url': 'https://api.github.com/users/bddppq/subscriptions', 'organizations_url': 'https://api.github.com/users/bddppq/orgs', 'repos_url': 'https://api.github.com/users/bddppq/repos', 'events_url': 'https://api.github.com/users/bddppq/events{/privacy}', 'received_events_url': 'https://api.github.com/users/bddppq/received_events', 'type': 'User', 'site_admin': False}",referenced,0c8deadab9a593c620967c40e52726b0c68fbe64,https://api.github.com/repos/pytorch/pytorch/commits/0c8deadab9a593c620967c40e52726b0c68fbe64,2018-10-15T21:13:16Z,37,18,19
1482,1073552494,"{'login': 'apaszke', 'id': 4583066, 'node_id': 'MDQ6VXNlcjQ1ODMwNjY=', 'avatar_url': 'https://avatars3.githubusercontent.com/u/4583066?v=4', 'gravatar_id': '', 'url': 'https://api.github.com/users/apaszke', 'html_url': 'https://github.com/apaszke', 'followers_url': 'https://api.github.com/users/apaszke/followers', 'following_url': 'https://api.github.com/users/apaszke/following{/other_user}', 'gists_url': 'https://api.github.com/users/apaszke/gists{/gist_id}', 'starred_url': 'https://api.github.com/users/apaszke/starred{/owner}{/repo}', 'subscriptions_url': 'https://api.github.com/users/apaszke/subscriptions', 'organizations_url': 'https://api.github.com/users/apaszke/orgs', 'repos_url': 'https://api.github.com/users/apaszke/repos', 'events_url': 'https://api.github.com/users/apaszke/events{/privacy}', 'received_events_url': 'https://api.github.com/users/apaszke/received_events', 'type': 'User', 'site_admin': False}",referenced,e694db0eeb3ff380b476e92710475efc4551c826,https://api.github.com/repos/pytorch/pytorch/commits/e694db0eeb3ff380b476e92710475efc4551c826,2017-05-08T21:14:15Z,47,30,17
1482,1905231333,"{'login': 'bddppq', 'id': 9300575, 'node_id': 'MDQ6VXNlcjkzMDA1NzU=', 'avatar_url': 'https://avatars2.githubusercontent.com/u/9300575?v=4', 'gravatar_id': '', 'url': 'https://api.github.com/users/bddppq', 'html_url': 'https://github.com/bddppq', 'followers_url': 'https://api.github.com/users/bddppq/followers', 'following_url': 'https://api.github.com/users/bddppq/following{/other_user}', 'gists_url': 'https://api.github.com/users/bddppq/gists{/gist_id}', 'starred_url': 'https://api.github.com/users/bddppq/starred{/owner}{/repo}', 'subscriptions_url': 'https://api.github.com/users/bddppq/subscriptions', 'organizations_url': 'https://api.github.com/users/bddppq/orgs', 'repos_url': 'https://api.github.com/users/bddppq/repos', 'events_url': 'https://api.github.com/users/bddppq/events{/privacy}', 'received_events_url': 'https://api.github.com/users/bddppq/received_events', 'type': 'User', 'site_admin': False}",referenced,ab46930d5c519a964af87d23655d9425159b3daf,https://api.github.com/repos/pytorch/pytorch/commits/ab46930d5c519a964af87d23655d9425159b3daf,2018-10-15T21:13:16Z,38,20,18
1480,1905231330,"{'login': 'bddppq', 'id': 9300575, 'node_id': 'MDQ6VXNlcjkzMDA1NzU=', 'avatar_url': 'https://avatars2.githubusercontent.com/u/9300575?v=4', 'gravatar_id': '', 'url': 'https://api.github.com/users/bddppq', 'html_url': 'https://github.com/bddppq', 'followers_url': 'https://api.github.com/users/bddppq/followers', 'following_url': 'https://api.github.com/users/bddppq/following{/other_user}', 'gists_url': 'https://api.github.com/users/bddppq/gists{/gist_id}', 'starred_url': 'https://api.github.com/users/bddppq/starred{/owner}{/repo}', 'subscriptions_url': 'https://api.github.com/users/bddppq/subscriptions', 'organizations_url': 'https://api.github.com/users/bddppq/orgs', 'repos_url': 'https://api.github.com/users/bddppq/repos', 'events_url': 'https://api.github.com/users/bddppq/events{/privacy}', 'received_events_url': 'https://api.github.com/users/bddppq/received_events', 'type': 'User', 'site_admin': False}",referenced,e4e3d46c0bb928882cb38f37289193c82f462bee,https://api.github.com/repos/pytorch/pytorch/commits/e4e3d46c0bb928882cb38f37289193c82f462bee,2018-10-15T21:13:16Z,41,31,10
1476,1088971933,"{'login': 'soumith', 'id': 1310570, 'node_id': 'MDQ6VXNlcjEzMTA1NzA=', 'avatar_url': 'https://avatars0.githubusercontent.com/u/1310570?v=4', 'gravatar_id': '', 'url': 'https://api.github.com/users/soumith', 'html_url': 'https://github.com/soumith', 'followers_url': 'https://api.github.com/users/soumith/followers', 'following_url': 'https://api.github.com/users/soumith/following{/other_user}', 'gists_url': 'https://api.github.com/users/soumith/gists{/gist_id}', 'starred_url': 'https://api.github.com/users/soumith/starred{/owner}{/repo}', 'subscriptions_url': 'https://api.github.com/users/soumith/subscriptions', 'organizations_url': 'https://api.github.com/users/soumith/orgs', 'repos_url': 'https://api.github.com/users/soumith/repos', 'events_url': 'https://api.github.com/users/soumith/events{/privacy}', 'received_events_url': 'https://api.github.com/users/soumith/received_events', 'type': 'User', 'site_admin': False}",referenced,625850c2c2f28c67881dc24f5d3abb80fd6e8483,https://api.github.com/repos/pytorch/pytorch/commits/625850c2c2f28c67881dc24f5d3abb80fd6e8483,2017-05-19T05:55:13Z,21,18,3
1476,1905231329,"{'login': 'bddppq', 'id': 9300575, 'node_id': 'MDQ6VXNlcjkzMDA1NzU=', 'avatar_url': 'https://avatars2.githubusercontent.com/u/9300575?v=4', 'gravatar_id': '', 'url': 'https://api.github.com/users/bddppq', 'html_url': 'https://github.com/bddppq', 'followers_url': 'https://api.github.com/users/bddppq/followers', 'following_url': 'https://api.github.com/users/bddppq/following{/other_user}', 'gists_url': 'https://api.github.com/users/bddppq/gists{/gist_id}', 'starred_url': 'https://api.github.com/users/bddppq/starred{/owner}{/repo}', 'subscriptions_url': 'https://api.github.com/users/bddppq/subscriptions', 'organizations_url': 'https://api.github.com/users/bddppq/orgs', 'repos_url': 'https://api.github.com/users/bddppq/repos', 'events_url': 'https://api.github.com/users/bddppq/events{/privacy}', 'received_events_url': 'https://api.github.com/users/bddppq/received_events', 'type': 'User', 'site_admin': False}",referenced,6ef49ecee91e6f13ea7022fe544cf639ef4df75f,https://api.github.com/repos/pytorch/pytorch/commits/6ef49ecee91e6f13ea7022fe544cf639ef4df75f,2018-10-15T21:13:16Z,47,33,14
1475,1905231325,"{'login': 'bddppq', 'id': 9300575, 'node_id': 'MDQ6VXNlcjkzMDA1NzU=', 'avatar_url': 'https://avatars2.githubusercontent.com/u/9300575?v=4', 'gravatar_id': '', 'url': 'https://api.github.com/users/bddppq', 'html_url': 'https://github.com/bddppq', 'followers_url': 'https://api.github.com/users/bddppq/followers', 'following_url': 'https://api.github.com/users/bddppq/following{/other_user}', 'gists_url': 'https://api.github.com/users/bddppq/gists{/gist_id}', 'starred_url': 'https://api.github.com/users/bddppq/starred{/owner}{/repo}', 'subscriptions_url': 'https://api.github.com/users/bddppq/subscriptions', 'organizations_url': 'https://api.github.com/users/bddppq/orgs', 'repos_url': 'https://api.github.com/users/bddppq/repos', 'events_url': 'https://api.github.com/users/bddppq/events{/privacy}', 'received_events_url': 'https://api.github.com/users/bddppq/received_events', 'type': 'User', 'site_admin': False}",referenced,07f359a1433caa341094693d7059b364e73db95e,https://api.github.com/repos/pytorch/pytorch/commits/07f359a1433caa341094693d7059b364e73db95e,2018-10-15T21:13:16Z,23,9,14
1473,1905231324,"{'login': 'bddppq', 'id': 9300575, 'node_id': 'MDQ6VXNlcjkzMDA1NzU=', 'avatar_url': 'https://avatars2.githubusercontent.com/u/9300575?v=4', 'gravatar_id': '', 'url': 'https://api.github.com/users/bddppq', 'html_url': 'https://github.com/bddppq', 'followers_url': 'https://api.github.com/users/bddppq/followers', 'following_url': 'https://api.github.com/users/bddppq/following{/other_user}', 'gists_url': 'https://api.github.com/users/bddppq/gists{/gist_id}', 'starred_url': 'https://api.github.com/users/bddppq/starred{/owner}{/repo}', 'subscriptions_url': 'https://api.github.com/users/bddppq/subscriptions', 'organizations_url': 'https://api.github.com/users/bddppq/orgs', 'repos_url': 'https://api.github.com/users/bddppq/repos', 'events_url': 'https://api.github.com/users/bddppq/events{/privacy}', 'received_events_url': 'https://api.github.com/users/bddppq/received_events', 'type': 'User', 'site_admin': False}",referenced,f71e163bc6777c3b48d38cda845e61932e2feab9,https://api.github.com/repos/pytorch/pytorch/commits/f71e163bc6777c3b48d38cda845e61932e2feab9,2018-10-15T21:13:16Z,5,3,2
1472,1905231320,"{'login': 'bddppq', 'id': 9300575, 'node_id': 'MDQ6VXNlcjkzMDA1NzU=', 'avatar_url': 'https://avatars2.githubusercontent.com/u/9300575?v=4', 'gravatar_id': '', 'url': 'https://api.github.com/users/bddppq', 'html_url': 'https://github.com/bddppq', 'followers_url': 'https://api.github.com/users/bddppq/followers', 'following_url': 'https://api.github.com/users/bddppq/following{/other_user}', 'gists_url': 'https://api.github.com/users/bddppq/gists{/gist_id}', 'starred_url': 'https://api.github.com/users/bddppq/starred{/owner}{/repo}', 'subscriptions_url': 'https://api.github.com/users/bddppq/subscriptions', 'organizations_url': 'https://api.github.com/users/bddppq/orgs', 'repos_url': 'https://api.github.com/users/bddppq/repos', 'events_url': 'https://api.github.com/users/bddppq/events{/privacy}', 'received_events_url': 'https://api.github.com/users/bddppq/received_events', 'type': 'User', 'site_admin': False}",referenced,7044aebb8f38e74322efaa252d9b91b38cba4317,https://api.github.com/repos/pytorch/pytorch/commits/7044aebb8f38e74322efaa252d9b91b38cba4317,2018-10-15T21:13:16Z,429,355,74
1456,1905231288,"{'login': 'bddppq', 'id': 9300575, 'node_id': 'MDQ6VXNlcjkzMDA1NzU=', 'avatar_url': 'https://avatars2.githubusercontent.com/u/9300575?v=4', 'gravatar_id': '', 'url': 'https://api.github.com/users/bddppq', 'html_url': 'https://github.com/bddppq', 'followers_url': 'https://api.github.com/users/bddppq/followers', 'following_url': 'https://api.github.com/users/bddppq/following{/other_user}', 'gists_url': 'https://api.github.com/users/bddppq/gists{/gist_id}', 'starred_url': 'https://api.github.com/users/bddppq/starred{/owner}{/repo}', 'subscriptions_url': 'https://api.github.com/users/bddppq/subscriptions', 'organizations_url': 'https://api.github.com/users/bddppq/orgs', 'repos_url': 'https://api.github.com/users/bddppq/repos', 'events_url': 'https://api.github.com/users/bddppq/events{/privacy}', 'received_events_url': 'https://api.github.com/users/bddppq/received_events', 'type': 'User', 'site_admin': False}",referenced,5236bfc1854c5ac0a2b35b1700d6f2d338131168,https://api.github.com/repos/pytorch/pytorch/commits/5236bfc1854c5ac0a2b35b1700d6f2d338131168,2018-10-15T21:13:15Z,14,7,7
1455,1905231285,"{'login': 'bddppq', 'id': 9300575, 'node_id': 'MDQ6VXNlcjkzMDA1NzU=', 'avatar_url': 'https://avatars2.githubusercontent.com/u/9300575?v=4', 'gravatar_id': '', 'url': 'https://api.github.com/users/bddppq', 'html_url': 'https://github.com/bddppq', 'followers_url': 'https://api.github.com/users/bddppq/followers', 'following_url': 'https://api.github.com/users/bddppq/following{/other_user}', 'gists_url': 'https://api.github.com/users/bddppq/gists{/gist_id}', 'starred_url': 'https://api.github.com/users/bddppq/starred{/owner}{/repo}', 'subscriptions_url': 'https://api.github.com/users/bddppq/subscriptions', 'organizations_url': 'https://api.github.com/users/bddppq/orgs', 'repos_url': 'https://api.github.com/users/bddppq/repos', 'events_url': 'https://api.github.com/users/bddppq/events{/privacy}', 'received_events_url': 'https://api.github.com/users/bddppq/received_events', 'type': 'User', 'site_admin': False}",referenced,26f63d33818ec4cd650d7e50a70115929200d336,https://api.github.com/repos/pytorch/pytorch/commits/26f63d33818ec4cd650d7e50a70115929200d336,2018-10-15T21:13:15Z,6,4,2
1452,1913572743,"{'login': 'facebook-github-bot', 'id': 6422482, 'node_id': 'MDQ6VXNlcjY0MjI0ODI=', 'avatar_url': 'https://avatars3.githubusercontent.com/u/6422482?v=4', 'gravatar_id': '', 'url': 'https://api.github.com/users/facebook-github-bot', 'html_url': 'https://github.com/facebook-github-bot', 'followers_url': 'https://api.github.com/users/facebook-github-bot/followers', 'following_url': 'https://api.github.com/users/facebook-github-bot/following{/other_user}', 'gists_url': 'https://api.github.com/users/facebook-github-bot/gists{/gist_id}', 'starred_url': 'https://api.github.com/users/facebook-github-bot/starred{/owner}{/repo}', 'subscriptions_url': 'https://api.github.com/users/facebook-github-bot/subscriptions', 'organizations_url': 'https://api.github.com/users/facebook-github-bot/orgs', 'repos_url': 'https://api.github.com/users/facebook-github-bot/repos', 'events_url': 'https://api.github.com/users/facebook-github-bot/events{/privacy}', 'received_events_url': 'https://api.github.com/users/facebook-github-bot/received_events', 'type': 'User', 'site_admin': False}",referenced,f9d1b63d18b91888cdaedc5cb9f39c63d4f822e7,https://api.github.com/repos/pytorch/pytorch/commits/f9d1b63d18b91888cdaedc5cb9f39c63d4f822e7,2018-10-18T23:18:43Z,3,2,1
1449,1067664969,"{'login': 'soumith', 'id': 1310570, 'node_id': 'MDQ6VXNlcjEzMTA1NzA=', 'avatar_url': 'https://avatars0.githubusercontent.com/u/1310570?v=4', 'gravatar_id': '', 'url': 'https://api.github.com/users/soumith', 'html_url': 'https://github.com/soumith', 'followers_url': 'https://api.github.com/users/soumith/followers', 'following_url': 'https://api.github.com/users/soumith/following{/other_user}', 'gists_url': 'https://api.github.com/users/soumith/gists{/gist_id}', 'starred_url': 'https://api.github.com/users/soumith/starred{/owner}{/repo}', 'subscriptions_url': 'https://api.github.com/users/soumith/subscriptions', 'organizations_url': 'https://api.github.com/users/soumith/orgs', 'repos_url': 'https://api.github.com/users/soumith/repos', 'events_url': 'https://api.github.com/users/soumith/events{/privacy}', 'received_events_url': 'https://api.github.com/users/soumith/received_events', 'type': 'User', 'site_admin': False}",referenced,0910e0ac901d21888d5f8462bb1a7fd0c5719e9a,https://api.github.com/repos/pytorch/pytorch/commits/0910e0ac901d21888d5f8462bb1a7fd0c5719e9a,2017-05-03T17:29:43Z,2,2,0
1447,1068056733,"{'login': 'soumith', 'id': 1310570, 'node_id': 'MDQ6VXNlcjEzMTA1NzA=', 'avatar_url': 'https://avatars0.githubusercontent.com/u/1310570?v=4', 'gravatar_id': '', 'url': 'https://api.github.com/users/soumith', 'html_url': 'https://github.com/soumith', 'followers_url': 'https://api.github.com/users/soumith/followers', 'following_url': 'https://api.github.com/users/soumith/following{/other_user}', 'gists_url': 'https://api.github.com/users/soumith/gists{/gist_id}', 'starred_url': 'https://api.github.com/users/soumith/starred{/owner}{/repo}', 'subscriptions_url': 'https://api.github.com/users/soumith/subscriptions', 'organizations_url': 'https://api.github.com/users/soumith/orgs', 'repos_url': 'https://api.github.com/users/soumith/repos', 'events_url': 'https://api.github.com/users/soumith/events{/privacy}', 'received_events_url': 'https://api.github.com/users/soumith/received_events', 'type': 'User', 'site_admin': False}",closed,80c0a8776bee6e42ddb07e4dcb19c561fc7a8e61,https://api.github.com/repos/pytorch/pytorch/commits/80c0a8776bee6e42ddb07e4dcb19c561fc7a8e61,2017-05-03T21:53:48Z,71,61,10
1441,1067429301,"{'login': 'soumith', 'id': 1310570, 'node_id': 'MDQ6VXNlcjEzMTA1NzA=', 'avatar_url': 'https://avatars0.githubusercontent.com/u/1310570?v=4', 'gravatar_id': '', 'url': 'https://api.github.com/users/soumith', 'html_url': 'https://github.com/soumith', 'followers_url': 'https://api.github.com/users/soumith/followers', 'following_url': 'https://api.github.com/users/soumith/following{/other_user}', 'gists_url': 'https://api.github.com/users/soumith/gists{/gist_id}', 'starred_url': 'https://api.github.com/users/soumith/starred{/owner}{/repo}', 'subscriptions_url': 'https://api.github.com/users/soumith/subscriptions', 'organizations_url': 'https://api.github.com/users/soumith/orgs', 'repos_url': 'https://api.github.com/users/soumith/repos', 'events_url': 'https://api.github.com/users/soumith/events{/privacy}', 'received_events_url': 'https://api.github.com/users/soumith/received_events', 'type': 'User', 'site_admin': False}",referenced,743e4894d2865108dc0ea2a1f344d9f34eb2b29d,https://api.github.com/repos/pytorch/pytorch/commits/743e4894d2865108dc0ea2a1f344d9f34eb2b29d,2017-05-03T15:14:14Z,148,89,59
1411,1905231233,"{'login': 'bddppq', 'id': 9300575, 'node_id': 'MDQ6VXNlcjkzMDA1NzU=', 'avatar_url': 'https://avatars2.githubusercontent.com/u/9300575?v=4', 'gravatar_id': '', 'url': 'https://api.github.com/users/bddppq', 'html_url': 'https://github.com/bddppq', 'followers_url': 'https://api.github.com/users/bddppq/followers', 'following_url': 'https://api.github.com/users/bddppq/following{/other_user}', 'gists_url': 'https://api.github.com/users/bddppq/gists{/gist_id}', 'starred_url': 'https://api.github.com/users/bddppq/starred{/owner}{/repo}', 'subscriptions_url': 'https://api.github.com/users/bddppq/subscriptions', 'organizations_url': 'https://api.github.com/users/bddppq/orgs', 'repos_url': 'https://api.github.com/users/bddppq/repos', 'events_url': 'https://api.github.com/users/bddppq/events{/privacy}', 'received_events_url': 'https://api.github.com/users/bddppq/received_events', 'type': 'User', 'site_admin': False}",referenced,2c1658dac6b7470a64846c80d5597ddf30239609,https://api.github.com/repos/pytorch/pytorch/commits/2c1658dac6b7470a64846c80d5597ddf30239609,2018-10-15T21:13:14Z,10,10,0
1407,1844251837,"{'login': 'facebook-github-bot', 'id': 6422482, 'node_id': 'MDQ6VXNlcjY0MjI0ODI=', 'avatar_url': 'https://avatars3.githubusercontent.com/u/6422482?v=4', 'gravatar_id': '', 'url': 'https://api.github.com/users/facebook-github-bot', 'html_url': 'https://github.com/facebook-github-bot', 'followers_url': 'https://api.github.com/users/facebook-github-bot/followers', 'following_url': 'https://api.github.com/users/facebook-github-bot/following{/other_user}', 'gists_url': 'https://api.github.com/users/facebook-github-bot/gists{/gist_id}', 'starred_url': 'https://api.github.com/users/facebook-github-bot/starred{/owner}{/repo}', 'subscriptions_url': 'https://api.github.com/users/facebook-github-bot/subscriptions', 'organizations_url': 'https://api.github.com/users/facebook-github-bot/orgs', 'repos_url': 'https://api.github.com/users/facebook-github-bot/repos', 'events_url': 'https://api.github.com/users/facebook-github-bot/events{/privacy}', 'received_events_url': 'https://api.github.com/users/facebook-github-bot/received_events', 'type': 'User', 'site_admin': False}",referenced,d278344e36dde4170da4e4d0c45953dcb53dcf65,https://api.github.com/repos/pytorch/pytorch/commits/d278344e36dde4170da4e4d0c45953dcb53dcf65,2018-09-13T17:42:18Z,2,1,1
1407,1905231229,"{'login': 'bddppq', 'id': 9300575, 'node_id': 'MDQ6VXNlcjkzMDA1NzU=', 'avatar_url': 'https://avatars2.githubusercontent.com/u/9300575?v=4', 'gravatar_id': '', 'url': 'https://api.github.com/users/bddppq', 'html_url': 'https://github.com/bddppq', 'followers_url': 'https://api.github.com/users/bddppq/followers', 'following_url': 'https://api.github.com/users/bddppq/following{/other_user}', 'gists_url': 'https://api.github.com/users/bddppq/gists{/gist_id}', 'starred_url': 'https://api.github.com/users/bddppq/starred{/owner}{/repo}', 'subscriptions_url': 'https://api.github.com/users/bddppq/subscriptions', 'organizations_url': 'https://api.github.com/users/bddppq/orgs', 'repos_url': 'https://api.github.com/users/bddppq/repos', 'events_url': 'https://api.github.com/users/bddppq/events{/privacy}', 'received_events_url': 'https://api.github.com/users/bddppq/received_events', 'type': 'User', 'site_admin': False}",referenced,39dd0d4fec5913aa517b71bcfcbf638a427894eb,https://api.github.com/repos/pytorch/pytorch/commits/39dd0d4fec5913aa517b71bcfcbf638a427894eb,2018-10-15T21:13:14Z,51,23,28
1406,1905231245,"{'login': 'bddppq', 'id': 9300575, 'node_id': 'MDQ6VXNlcjkzMDA1NzU=', 'avatar_url': 'https://avatars2.githubusercontent.com/u/9300575?v=4', 'gravatar_id': '', 'url': 'https://api.github.com/users/bddppq', 'html_url': 'https://github.com/bddppq', 'followers_url': 'https://api.github.com/users/bddppq/followers', 'following_url': 'https://api.github.com/users/bddppq/following{/other_user}', 'gists_url': 'https://api.github.com/users/bddppq/gists{/gist_id}', 'starred_url': 'https://api.github.com/users/bddppq/starred{/owner}{/repo}', 'subscriptions_url': 'https://api.github.com/users/bddppq/subscriptions', 'organizations_url': 'https://api.github.com/users/bddppq/orgs', 'repos_url': 'https://api.github.com/users/bddppq/repos', 'events_url': 'https://api.github.com/users/bddppq/events{/privacy}', 'received_events_url': 'https://api.github.com/users/bddppq/received_events', 'type': 'User', 'site_admin': False}",referenced,79c788f2cfb8f8575fb798f8c6bcb9fe9db19e90,https://api.github.com/repos/pytorch/pytorch/commits/79c788f2cfb8f8575fb798f8c6bcb9fe9db19e90,2018-10-15T21:13:14Z,382,381,1
1391,1844251848,"{'login': 'facebook-github-bot', 'id': 6422482, 'node_id': 'MDQ6VXNlcjY0MjI0ODI=', 'avatar_url': 'https://avatars3.githubusercontent.com/u/6422482?v=4', 'gravatar_id': '', 'url': 'https://api.github.com/users/facebook-github-bot', 'html_url': 'https://github.com/facebook-github-bot', 'followers_url': 'https://api.github.com/users/facebook-github-bot/followers', 'following_url': 'https://api.github.com/users/facebook-github-bot/following{/other_user}', 'gists_url': 'https://api.github.com/users/facebook-github-bot/gists{/gist_id}', 'starred_url': 'https://api.github.com/users/facebook-github-bot/starred{/owner}{/repo}', 'subscriptions_url': 'https://api.github.com/users/facebook-github-bot/subscriptions', 'organizations_url': 'https://api.github.com/users/facebook-github-bot/orgs', 'repos_url': 'https://api.github.com/users/facebook-github-bot/repos', 'events_url': 'https://api.github.com/users/facebook-github-bot/events{/privacy}', 'received_events_url': 'https://api.github.com/users/facebook-github-bot/received_events', 'type': 'User', 'site_admin': False}",referenced,d278344e36dde4170da4e4d0c45953dcb53dcf65,https://api.github.com/repos/pytorch/pytorch/commits/d278344e36dde4170da4e4d0c45953dcb53dcf65,2018-09-13T17:42:18Z,2,1,1
1391,1905231216,"{'login': 'bddppq', 'id': 9300575, 'node_id': 'MDQ6VXNlcjkzMDA1NzU=', 'avatar_url': 'https://avatars2.githubusercontent.com/u/9300575?v=4', 'gravatar_id': '', 'url': 'https://api.github.com/users/bddppq', 'html_url': 'https://github.com/bddppq', 'followers_url': 'https://api.github.com/users/bddppq/followers', 'following_url': 'https://api.github.com/users/bddppq/following{/other_user}', 'gists_url': 'https://api.github.com/users/bddppq/gists{/gist_id}', 'starred_url': 'https://api.github.com/users/bddppq/starred{/owner}{/repo}', 'subscriptions_url': 'https://api.github.com/users/bddppq/subscriptions', 'organizations_url': 'https://api.github.com/users/bddppq/orgs', 'repos_url': 'https://api.github.com/users/bddppq/repos', 'events_url': 'https://api.github.com/users/bddppq/events{/privacy}', 'received_events_url': 'https://api.github.com/users/bddppq/received_events', 'type': 'User', 'site_admin': False}",referenced,31fd87ffff1f5b0c9886c94ca219982e1a5ee32e,https://api.github.com/repos/pytorch/pytorch/commits/31fd87ffff1f5b0c9886c94ca219982e1a5ee32e,2018-10-15T21:13:13Z,6,3,3
1374,1831760195,"{'login': 'facebook-github-bot', 'id': 6422482, 'node_id': 'MDQ6VXNlcjY0MjI0ODI=', 'avatar_url': 'https://avatars3.githubusercontent.com/u/6422482?v=4', 'gravatar_id': '', 'url': 'https://api.github.com/users/facebook-github-bot', 'html_url': 'https://github.com/facebook-github-bot', 'followers_url': 'https://api.github.com/users/facebook-github-bot/followers', 'following_url': 'https://api.github.com/users/facebook-github-bot/following{/other_user}', 'gists_url': 'https://api.github.com/users/facebook-github-bot/gists{/gist_id}', 'starred_url': 'https://api.github.com/users/facebook-github-bot/starred{/owner}{/repo}', 'subscriptions_url': 'https://api.github.com/users/facebook-github-bot/subscriptions', 'organizations_url': 'https://api.github.com/users/facebook-github-bot/orgs', 'repos_url': 'https://api.github.com/users/facebook-github-bot/repos', 'events_url': 'https://api.github.com/users/facebook-github-bot/events{/privacy}', 'received_events_url': 'https://api.github.com/users/facebook-github-bot/received_events', 'type': 'User', 'site_admin': False}",referenced,c39216f8c49361456d7d827b6199ac54799ff2e2,https://api.github.com/repos/pytorch/pytorch/commits/c39216f8c49361456d7d827b6199ac54799ff2e2,2018-09-07T00:41:12Z,3,2,1
1374,1905231200,"{'login': 'bddppq', 'id': 9300575, 'node_id': 'MDQ6VXNlcjkzMDA1NzU=', 'avatar_url': 'https://avatars2.githubusercontent.com/u/9300575?v=4', 'gravatar_id': '', 'url': 'https://api.github.com/users/bddppq', 'html_url': 'https://github.com/bddppq', 'followers_url': 'https://api.github.com/users/bddppq/followers', 'following_url': 'https://api.github.com/users/bddppq/following{/other_user}', 'gists_url': 'https://api.github.com/users/bddppq/gists{/gist_id}', 'starred_url': 'https://api.github.com/users/bddppq/starred{/owner}{/repo}', 'subscriptions_url': 'https://api.github.com/users/bddppq/subscriptions', 'organizations_url': 'https://api.github.com/users/bddppq/orgs', 'repos_url': 'https://api.github.com/users/bddppq/repos', 'events_url': 'https://api.github.com/users/bddppq/events{/privacy}', 'received_events_url': 'https://api.github.com/users/bddppq/received_events', 'type': 'User', 'site_admin': False}",referenced,36643c6091d84355ae040da20afc711be95c67e2,https://api.github.com/repos/pytorch/pytorch/commits/36643c6091d84355ae040da20afc711be95c67e2,2018-10-15T21:13:13Z,56,28,28
1371,1831760197,"{'login': 'facebook-github-bot', 'id': 6422482, 'node_id': 'MDQ6VXNlcjY0MjI0ODI=', 'avatar_url': 'https://avatars3.githubusercontent.com/u/6422482?v=4', 'gravatar_id': '', 'url': 'https://api.github.com/users/facebook-github-bot', 'html_url': 'https://github.com/facebook-github-bot', 'followers_url': 'https://api.github.com/users/facebook-github-bot/followers', 'following_url': 'https://api.github.com/users/facebook-github-bot/following{/other_user}', 'gists_url': 'https://api.github.com/users/facebook-github-bot/gists{/gist_id}', 'starred_url': 'https://api.github.com/users/facebook-github-bot/starred{/owner}{/repo}', 'subscriptions_url': 'https://api.github.com/users/facebook-github-bot/subscriptions', 'organizations_url': 'https://api.github.com/users/facebook-github-bot/orgs', 'repos_url': 'https://api.github.com/users/facebook-github-bot/repos', 'events_url': 'https://api.github.com/users/facebook-github-bot/events{/privacy}', 'received_events_url': 'https://api.github.com/users/facebook-github-bot/received_events', 'type': 'User', 'site_admin': False}",referenced,c39216f8c49361456d7d827b6199ac54799ff2e2,https://api.github.com/repos/pytorch/pytorch/commits/c39216f8c49361456d7d827b6199ac54799ff2e2,2018-09-07T00:41:12Z,3,2,1
1371,1905231197,"{'login': 'bddppq', 'id': 9300575, 'node_id': 'MDQ6VXNlcjkzMDA1NzU=', 'avatar_url': 'https://avatars2.githubusercontent.com/u/9300575?v=4', 'gravatar_id': '', 'url': 'https://api.github.com/users/bddppq', 'html_url': 'https://github.com/bddppq', 'followers_url': 'https://api.github.com/users/bddppq/followers', 'following_url': 'https://api.github.com/users/bddppq/following{/other_user}', 'gists_url': 'https://api.github.com/users/bddppq/gists{/gist_id}', 'starred_url': 'https://api.github.com/users/bddppq/starred{/owner}{/repo}', 'subscriptions_url': 'https://api.github.com/users/bddppq/subscriptions', 'organizations_url': 'https://api.github.com/users/bddppq/orgs', 'repos_url': 'https://api.github.com/users/bddppq/repos', 'events_url': 'https://api.github.com/users/bddppq/events{/privacy}', 'received_events_url': 'https://api.github.com/users/bddppq/received_events', 'type': 'User', 'site_admin': False}",referenced,8c64acd3931bd18158f4d8511e6b8c3c2a4ccec8,https://api.github.com/repos/pytorch/pytorch/commits/8c64acd3931bd18158f4d8511e6b8c3c2a4ccec8,2018-10-15T21:13:13Z,4,2,2
1368,1831760199,"{'login': 'facebook-github-bot', 'id': 6422482, 'node_id': 'MDQ6VXNlcjY0MjI0ODI=', 'avatar_url': 'https://avatars3.githubusercontent.com/u/6422482?v=4', 'gravatar_id': '', 'url': 'https://api.github.com/users/facebook-github-bot', 'html_url': 'https://github.com/facebook-github-bot', 'followers_url': 'https://api.github.com/users/facebook-github-bot/followers', 'following_url': 'https://api.github.com/users/facebook-github-bot/following{/other_user}', 'gists_url': 'https://api.github.com/users/facebook-github-bot/gists{/gist_id}', 'starred_url': 'https://api.github.com/users/facebook-github-bot/starred{/owner}{/repo}', 'subscriptions_url': 'https://api.github.com/users/facebook-github-bot/subscriptions', 'organizations_url': 'https://api.github.com/users/facebook-github-bot/orgs', 'repos_url': 'https://api.github.com/users/facebook-github-bot/repos', 'events_url': 'https://api.github.com/users/facebook-github-bot/events{/privacy}', 'received_events_url': 'https://api.github.com/users/facebook-github-bot/received_events', 'type': 'User', 'site_admin': False}",referenced,c39216f8c49361456d7d827b6199ac54799ff2e2,https://api.github.com/repos/pytorch/pytorch/commits/c39216f8c49361456d7d827b6199ac54799ff2e2,2018-09-07T00:41:12Z,3,2,1
1368,1905231182,"{'login': 'bddppq', 'id': 9300575, 'node_id': 'MDQ6VXNlcjkzMDA1NzU=', 'avatar_url': 'https://avatars2.githubusercontent.com/u/9300575?v=4', 'gravatar_id': '', 'url': 'https://api.github.com/users/bddppq', 'html_url': 'https://github.com/bddppq', 'followers_url': 'https://api.github.com/users/bddppq/followers', 'following_url': 'https://api.github.com/users/bddppq/following{/other_user}', 'gists_url': 'https://api.github.com/users/bddppq/gists{/gist_id}', 'starred_url': 'https://api.github.com/users/bddppq/starred{/owner}{/repo}', 'subscriptions_url': 'https://api.github.com/users/bddppq/subscriptions', 'organizations_url': 'https://api.github.com/users/bddppq/orgs', 'repos_url': 'https://api.github.com/users/bddppq/repos', 'events_url': 'https://api.github.com/users/bddppq/events{/privacy}', 'received_events_url': 'https://api.github.com/users/bddppq/received_events', 'type': 'User', 'site_admin': False}",referenced,8aec4e23a0bf22f9dd5945bec425fb72da8582e7,https://api.github.com/repos/pytorch/pytorch/commits/8aec4e23a0bf22f9dd5945bec425fb72da8582e7,2018-10-15T21:13:13Z,9,7,2
1357,1059195824,"{'login': 'colesbury', 'id': 655866, 'node_id': 'MDQ6VXNlcjY1NTg2Ng==', 'avatar_url': 'https://avatars1.githubusercontent.com/u/655866?v=4', 'gravatar_id': '', 'url': 'https://api.github.com/users/colesbury', 'html_url': 'https://github.com/colesbury', 'followers_url': 'https://api.github.com/users/colesbury/followers', 'following_url': 'https://api.github.com/users/colesbury/following{/other_user}', 'gists_url': 'https://api.github.com/users/colesbury/gists{/gist_id}', 'starred_url': 'https://api.github.com/users/colesbury/starred{/owner}{/repo}', 'subscriptions_url': 'https://api.github.com/users/colesbury/subscriptions', 'organizations_url': 'https://api.github.com/users/colesbury/orgs', 'repos_url': 'https://api.github.com/users/colesbury/repos', 'events_url': 'https://api.github.com/users/colesbury/events{/privacy}', 'received_events_url': 'https://api.github.com/users/colesbury/received_events', 'type': 'User', 'site_admin': False}",referenced,8ca7bf2ab3b1eb474a481e3a6673312d0b63f4a6,https://api.github.com/repos/pytorch/pytorch/commits/8ca7bf2ab3b1eb474a481e3a6673312d0b63f4a6,2017-04-26T19:00:46Z,11,11,0
1356,1905231170,"{'login': 'bddppq', 'id': 9300575, 'node_id': 'MDQ6VXNlcjkzMDA1NzU=', 'avatar_url': 'https://avatars2.githubusercontent.com/u/9300575?v=4', 'gravatar_id': '', 'url': 'https://api.github.com/users/bddppq', 'html_url': 'https://github.com/bddppq', 'followers_url': 'https://api.github.com/users/bddppq/followers', 'following_url': 'https://api.github.com/users/bddppq/following{/other_user}', 'gists_url': 'https://api.github.com/users/bddppq/gists{/gist_id}', 'starred_url': 'https://api.github.com/users/bddppq/starred{/owner}{/repo}', 'subscriptions_url': 'https://api.github.com/users/bddppq/subscriptions', 'organizations_url': 'https://api.github.com/users/bddppq/orgs', 'repos_url': 'https://api.github.com/users/bddppq/repos', 'events_url': 'https://api.github.com/users/bddppq/events{/privacy}', 'received_events_url': 'https://api.github.com/users/bddppq/received_events', 'type': 'User', 'site_admin': False}",referenced,bfb9e7a84244e86aa3e59947b4405e6f6919b95f,https://api.github.com/repos/pytorch/pytorch/commits/bfb9e7a84244e86aa3e59947b4405e6f6919b95f,2018-10-15T21:13:13Z,63,45,18
1352,1905231157,"{'login': 'bddppq', 'id': 9300575, 'node_id': 'MDQ6VXNlcjkzMDA1NzU=', 'avatar_url': 'https://avatars2.githubusercontent.com/u/9300575?v=4', 'gravatar_id': '', 'url': 'https://api.github.com/users/bddppq', 'html_url': 'https://github.com/bddppq', 'followers_url': 'https://api.github.com/users/bddppq/followers', 'following_url': 'https://api.github.com/users/bddppq/following{/other_user}', 'gists_url': 'https://api.github.com/users/bddppq/gists{/gist_id}', 'starred_url': 'https://api.github.com/users/bddppq/starred{/owner}{/repo}', 'subscriptions_url': 'https://api.github.com/users/bddppq/subscriptions', 'organizations_url': 'https://api.github.com/users/bddppq/orgs', 'repos_url': 'https://api.github.com/users/bddppq/repos', 'events_url': 'https://api.github.com/users/bddppq/events{/privacy}', 'received_events_url': 'https://api.github.com/users/bddppq/received_events', 'type': 'User', 'site_admin': False}",referenced,42c06046ac0033380fde00c97c27eaf372047369,https://api.github.com/repos/pytorch/pytorch/commits/42c06046ac0033380fde00c97c27eaf372047369,2018-10-15T21:13:12Z,55,31,24
1347,1905231152,"{'login': 'bddppq', 'id': 9300575, 'node_id': 'MDQ6VXNlcjkzMDA1NzU=', 'avatar_url': 'https://avatars2.githubusercontent.com/u/9300575?v=4', 'gravatar_id': '', 'url': 'https://api.github.com/users/bddppq', 'html_url': 'https://github.com/bddppq', 'followers_url': 'https://api.github.com/users/bddppq/followers', 'following_url': 'https://api.github.com/users/bddppq/following{/other_user}', 'gists_url': 'https://api.github.com/users/bddppq/gists{/gist_id}', 'starred_url': 'https://api.github.com/users/bddppq/starred{/owner}{/repo}', 'subscriptions_url': 'https://api.github.com/users/bddppq/subscriptions', 'organizations_url': 'https://api.github.com/users/bddppq/orgs', 'repos_url': 'https://api.github.com/users/bddppq/repos', 'events_url': 'https://api.github.com/users/bddppq/events{/privacy}', 'received_events_url': 'https://api.github.com/users/bddppq/received_events', 'type': 'User', 'site_admin': False}",referenced,080394f705d29885f20d641dc5c3375b08e0bd0b,https://api.github.com/repos/pytorch/pytorch/commits/080394f705d29885f20d641dc5c3375b08e0bd0b,2018-10-15T21:13:12Z,37,24,13
1346,1905231148,"{'login': 'bddppq', 'id': 9300575, 'node_id': 'MDQ6VXNlcjkzMDA1NzU=', 'avatar_url': 'https://avatars2.githubusercontent.com/u/9300575?v=4', 'gravatar_id': '', 'url': 'https://api.github.com/users/bddppq', 'html_url': 'https://github.com/bddppq', 'followers_url': 'https://api.github.com/users/bddppq/followers', 'following_url': 'https://api.github.com/users/bddppq/following{/other_user}', 'gists_url': 'https://api.github.com/users/bddppq/gists{/gist_id}', 'starred_url': 'https://api.github.com/users/bddppq/starred{/owner}{/repo}', 'subscriptions_url': 'https://api.github.com/users/bddppq/subscriptions', 'organizations_url': 'https://api.github.com/users/bddppq/orgs', 'repos_url': 'https://api.github.com/users/bddppq/repos', 'events_url': 'https://api.github.com/users/bddppq/events{/privacy}', 'received_events_url': 'https://api.github.com/users/bddppq/received_events', 'type': 'User', 'site_admin': False}",referenced,2e248ffd4feab97b2587bee400c4d8f79e253857,https://api.github.com/repos/pytorch/pytorch/commits/2e248ffd4feab97b2587bee400c4d8f79e253857,2018-10-15T21:13:12Z,2,0,2
1344,1831760196,"{'login': 'facebook-github-bot', 'id': 6422482, 'node_id': 'MDQ6VXNlcjY0MjI0ODI=', 'avatar_url': 'https://avatars3.githubusercontent.com/u/6422482?v=4', 'gravatar_id': '', 'url': 'https://api.github.com/users/facebook-github-bot', 'html_url': 'https://github.com/facebook-github-bot', 'followers_url': 'https://api.github.com/users/facebook-github-bot/followers', 'following_url': 'https://api.github.com/users/facebook-github-bot/following{/other_user}', 'gists_url': 'https://api.github.com/users/facebook-github-bot/gists{/gist_id}', 'starred_url': 'https://api.github.com/users/facebook-github-bot/starred{/owner}{/repo}', 'subscriptions_url': 'https://api.github.com/users/facebook-github-bot/subscriptions', 'organizations_url': 'https://api.github.com/users/facebook-github-bot/orgs', 'repos_url': 'https://api.github.com/users/facebook-github-bot/repos', 'events_url': 'https://api.github.com/users/facebook-github-bot/events{/privacy}', 'received_events_url': 'https://api.github.com/users/facebook-github-bot/received_events', 'type': 'User', 'site_admin': False}",referenced,c39216f8c49361456d7d827b6199ac54799ff2e2,https://api.github.com/repos/pytorch/pytorch/commits/c39216f8c49361456d7d827b6199ac54799ff2e2,2018-09-07T00:41:12Z,3,2,1
1344,1905231195,"{'login': 'bddppq', 'id': 9300575, 'node_id': 'MDQ6VXNlcjkzMDA1NzU=', 'avatar_url': 'https://avatars2.githubusercontent.com/u/9300575?v=4', 'gravatar_id': '', 'url': 'https://api.github.com/users/bddppq', 'html_url': 'https://github.com/bddppq', 'followers_url': 'https://api.github.com/users/bddppq/followers', 'following_url': 'https://api.github.com/users/bddppq/following{/other_user}', 'gists_url': 'https://api.github.com/users/bddppq/gists{/gist_id}', 'starred_url': 'https://api.github.com/users/bddppq/starred{/owner}{/repo}', 'subscriptions_url': 'https://api.github.com/users/bddppq/subscriptions', 'organizations_url': 'https://api.github.com/users/bddppq/orgs', 'repos_url': 'https://api.github.com/users/bddppq/repos', 'events_url': 'https://api.github.com/users/bddppq/events{/privacy}', 'received_events_url': 'https://api.github.com/users/bddppq/received_events', 'type': 'User', 'site_admin': False}",referenced,8c64acd3931bd18158f4d8511e6b8c3c2a4ccec8,https://api.github.com/repos/pytorch/pytorch/commits/8c64acd3931bd18158f4d8511e6b8c3c2a4ccec8,2018-10-15T21:13:13Z,4,2,2
1343,1905231134,"{'login': 'bddppq', 'id': 9300575, 'node_id': 'MDQ6VXNlcjkzMDA1NzU=', 'avatar_url': 'https://avatars2.githubusercontent.com/u/9300575?v=4', 'gravatar_id': '', 'url': 'https://api.github.com/users/bddppq', 'html_url': 'https://github.com/bddppq', 'followers_url': 'https://api.github.com/users/bddppq/followers', 'following_url': 'https://api.github.com/users/bddppq/following{/other_user}', 'gists_url': 'https://api.github.com/users/bddppq/gists{/gist_id}', 'starred_url': 'https://api.github.com/users/bddppq/starred{/owner}{/repo}', 'subscriptions_url': 'https://api.github.com/users/bddppq/subscriptions', 'organizations_url': 'https://api.github.com/users/bddppq/orgs', 'repos_url': 'https://api.github.com/users/bddppq/repos', 'events_url': 'https://api.github.com/users/bddppq/events{/privacy}', 'received_events_url': 'https://api.github.com/users/bddppq/received_events', 'type': 'User', 'site_admin': False}",referenced,765d2e73cc099278497baef716776bf037b0d3fd,https://api.github.com/repos/pytorch/pytorch/commits/765d2e73cc099278497baef716776bf037b0d3fd,2018-10-15T21:13:12Z,1,1,0
1342,1905231140,"{'login': 'bddppq', 'id': 9300575, 'node_id': 'MDQ6VXNlcjkzMDA1NzU=', 'avatar_url': 'https://avatars2.githubusercontent.com/u/9300575?v=4', 'gravatar_id': '', 'url': 'https://api.github.com/users/bddppq', 'html_url': 'https://github.com/bddppq', 'followers_url': 'https://api.github.com/users/bddppq/followers', 'following_url': 'https://api.github.com/users/bddppq/following{/other_user}', 'gists_url': 'https://api.github.com/users/bddppq/gists{/gist_id}', 'starred_url': 'https://api.github.com/users/bddppq/starred{/owner}{/repo}', 'subscriptions_url': 'https://api.github.com/users/bddppq/subscriptions', 'organizations_url': 'https://api.github.com/users/bddppq/orgs', 'repos_url': 'https://api.github.com/users/bddppq/repos', 'events_url': 'https://api.github.com/users/bddppq/events{/privacy}', 'received_events_url': 'https://api.github.com/users/bddppq/received_events', 'type': 'User', 'site_admin': False}",referenced,427ac0c1b792363d373e3d7e4eef97fa46458420,https://api.github.com/repos/pytorch/pytorch/commits/427ac0c1b792363d373e3d7e4eef97fa46458420,2018-10-15T21:13:12Z,28,26,2
1339,1905231118,"{'login': 'bddppq', 'id': 9300575, 'node_id': 'MDQ6VXNlcjkzMDA1NzU=', 'avatar_url': 'https://avatars2.githubusercontent.com/u/9300575?v=4', 'gravatar_id': '', 'url': 'https://api.github.com/users/bddppq', 'html_url': 'https://github.com/bddppq', 'followers_url': 'https://api.github.com/users/bddppq/followers', 'following_url': 'https://api.github.com/users/bddppq/following{/other_user}', 'gists_url': 'https://api.github.com/users/bddppq/gists{/gist_id}', 'starred_url': 'https://api.github.com/users/bddppq/starred{/owner}{/repo}', 'subscriptions_url': 'https://api.github.com/users/bddppq/subscriptions', 'organizations_url': 'https://api.github.com/users/bddppq/orgs', 'repos_url': 'https://api.github.com/users/bddppq/repos', 'events_url': 'https://api.github.com/users/bddppq/events{/privacy}', 'received_events_url': 'https://api.github.com/users/bddppq/received_events', 'type': 'User', 'site_admin': False}",referenced,c7a4323c79bfa2ec0332d7eb5b37df8782605a85,https://api.github.com/repos/pytorch/pytorch/commits/c7a4323c79bfa2ec0332d7eb5b37df8782605a85,2018-10-15T21:13:12Z,6,3,3
1335,1905231114,"{'login': 'bddppq', 'id': 9300575, 'node_id': 'MDQ6VXNlcjkzMDA1NzU=', 'avatar_url': 'https://avatars2.githubusercontent.com/u/9300575?v=4', 'gravatar_id': '', 'url': 'https://api.github.com/users/bddppq', 'html_url': 'https://github.com/bddppq', 'followers_url': 'https://api.github.com/users/bddppq/followers', 'following_url': 'https://api.github.com/users/bddppq/following{/other_user}', 'gists_url': 'https://api.github.com/users/bddppq/gists{/gist_id}', 'starred_url': 'https://api.github.com/users/bddppq/starred{/owner}{/repo}', 'subscriptions_url': 'https://api.github.com/users/bddppq/subscriptions', 'organizations_url': 'https://api.github.com/users/bddppq/orgs', 'repos_url': 'https://api.github.com/users/bddppq/repos', 'events_url': 'https://api.github.com/users/bddppq/events{/privacy}', 'received_events_url': 'https://api.github.com/users/bddppq/received_events', 'type': 'User', 'site_admin': False}",referenced,ddcaf8adc3ed0d6c40d5c2691ad231593c40df61,https://api.github.com/repos/pytorch/pytorch/commits/ddcaf8adc3ed0d6c40d5c2691ad231593c40df61,2018-10-15T21:13:11Z,23,20,3
1332,1905231102,"{'login': 'bddppq', 'id': 9300575, 'node_id': 'MDQ6VXNlcjkzMDA1NzU=', 'avatar_url': 'https://avatars2.githubusercontent.com/u/9300575?v=4', 'gravatar_id': '', 'url': 'https://api.github.com/users/bddppq', 'html_url': 'https://github.com/bddppq', 'followers_url': 'https://api.github.com/users/bddppq/followers', 'following_url': 'https://api.github.com/users/bddppq/following{/other_user}', 'gists_url': 'https://api.github.com/users/bddppq/gists{/gist_id}', 'starred_url': 'https://api.github.com/users/bddppq/starred{/owner}{/repo}', 'subscriptions_url': 'https://api.github.com/users/bddppq/subscriptions', 'organizations_url': 'https://api.github.com/users/bddppq/orgs', 'repos_url': 'https://api.github.com/users/bddppq/repos', 'events_url': 'https://api.github.com/users/bddppq/events{/privacy}', 'received_events_url': 'https://api.github.com/users/bddppq/received_events', 'type': 'User', 'site_admin': False}",referenced,14ee8de06a0ed41ee75390a442ec96064febed2d,https://api.github.com/repos/pytorch/pytorch/commits/14ee8de06a0ed41ee75390a442ec96064febed2d,2018-10-15T21:13:11Z,4,2,2
1320,1905231122,"{'login': 'bddppq', 'id': 9300575, 'node_id': 'MDQ6VXNlcjkzMDA1NzU=', 'avatar_url': 'https://avatars2.githubusercontent.com/u/9300575?v=4', 'gravatar_id': '', 'url': 'https://api.github.com/users/bddppq', 'html_url': 'https://github.com/bddppq', 'followers_url': 'https://api.github.com/users/bddppq/followers', 'following_url': 'https://api.github.com/users/bddppq/following{/other_user}', 'gists_url': 'https://api.github.com/users/bddppq/gists{/gist_id}', 'starred_url': 'https://api.github.com/users/bddppq/starred{/owner}{/repo}', 'subscriptions_url': 'https://api.github.com/users/bddppq/subscriptions', 'organizations_url': 'https://api.github.com/users/bddppq/orgs', 'repos_url': 'https://api.github.com/users/bddppq/repos', 'events_url': 'https://api.github.com/users/bddppq/events{/privacy}', 'received_events_url': 'https://api.github.com/users/bddppq/received_events', 'type': 'User', 'site_admin': False}",referenced,79027b36564ca79aae2e391bbcc28b9ac038f2ea,https://api.github.com/repos/pytorch/pytorch/commits/79027b36564ca79aae2e391bbcc28b9ac038f2ea,2018-10-15T21:13:12Z,27,26,1
1318,1905231087,"{'login': 'bddppq', 'id': 9300575, 'node_id': 'MDQ6VXNlcjkzMDA1NzU=', 'avatar_url': 'https://avatars2.githubusercontent.com/u/9300575?v=4', 'gravatar_id': '', 'url': 'https://api.github.com/users/bddppq', 'html_url': 'https://github.com/bddppq', 'followers_url': 'https://api.github.com/users/bddppq/followers', 'following_url': 'https://api.github.com/users/bddppq/following{/other_user}', 'gists_url': 'https://api.github.com/users/bddppq/gists{/gist_id}', 'starred_url': 'https://api.github.com/users/bddppq/starred{/owner}{/repo}', 'subscriptions_url': 'https://api.github.com/users/bddppq/subscriptions', 'organizations_url': 'https://api.github.com/users/bddppq/orgs', 'repos_url': 'https://api.github.com/users/bddppq/repos', 'events_url': 'https://api.github.com/users/bddppq/events{/privacy}', 'received_events_url': 'https://api.github.com/users/bddppq/received_events', 'type': 'User', 'site_admin': False}",referenced,9f5a706602f1cf2879ddc4accb3c00432c774049,https://api.github.com/repos/pytorch/pytorch/commits/9f5a706602f1cf2879ddc4accb3c00432c774049,2018-10-15T21:13:11Z,18,13,5
1310,1808215264,"{'login': 'facebook-github-bot', 'id': 6422482, 'node_id': 'MDQ6VXNlcjY0MjI0ODI=', 'avatar_url': 'https://avatars3.githubusercontent.com/u/6422482?v=4', 'gravatar_id': '', 'url': 'https://api.github.com/users/facebook-github-bot', 'html_url': 'https://github.com/facebook-github-bot', 'followers_url': 'https://api.github.com/users/facebook-github-bot/followers', 'following_url': 'https://api.github.com/users/facebook-github-bot/following{/other_user}', 'gists_url': 'https://api.github.com/users/facebook-github-bot/gists{/gist_id}', 'starred_url': 'https://api.github.com/users/facebook-github-bot/starred{/owner}{/repo}', 'subscriptions_url': 'https://api.github.com/users/facebook-github-bot/subscriptions', 'organizations_url': 'https://api.github.com/users/facebook-github-bot/orgs', 'repos_url': 'https://api.github.com/users/facebook-github-bot/repos', 'events_url': 'https://api.github.com/users/facebook-github-bot/events{/privacy}', 'received_events_url': 'https://api.github.com/users/facebook-github-bot/received_events', 'type': 'User', 'site_admin': False}",referenced,e3d12d7afb6d92e2b43fad016e8d851161af6a12,https://api.github.com/repos/pytorch/pytorch/commits/e3d12d7afb6d92e2b43fad016e8d851161af6a12,2018-08-24T17:55:50Z,2,1,1
1310,1905231060,"{'login': 'bddppq', 'id': 9300575, 'node_id': 'MDQ6VXNlcjkzMDA1NzU=', 'avatar_url': 'https://avatars2.githubusercontent.com/u/9300575?v=4', 'gravatar_id': '', 'url': 'https://api.github.com/users/bddppq', 'html_url': 'https://github.com/bddppq', 'followers_url': 'https://api.github.com/users/bddppq/followers', 'following_url': 'https://api.github.com/users/bddppq/following{/other_user}', 'gists_url': 'https://api.github.com/users/bddppq/gists{/gist_id}', 'starred_url': 'https://api.github.com/users/bddppq/starred{/owner}{/repo}', 'subscriptions_url': 'https://api.github.com/users/bddppq/subscriptions', 'organizations_url': 'https://api.github.com/users/bddppq/orgs', 'repos_url': 'https://api.github.com/users/bddppq/repos', 'events_url': 'https://api.github.com/users/bddppq/events{/privacy}', 'received_events_url': 'https://api.github.com/users/bddppq/received_events', 'type': 'User', 'site_admin': False}",referenced,2cbf7407f275e225e50c6739776d9d67456665a6,https://api.github.com/repos/pytorch/pytorch/commits/2cbf7407f275e225e50c6739776d9d67456665a6,2018-10-15T21:13:10Z,19,19,0
1267,1053727318,"{'login': 'soumith', 'id': 1310570, 'node_id': 'MDQ6VXNlcjEzMTA1NzA=', 'avatar_url': 'https://avatars0.githubusercontent.com/u/1310570?v=4', 'gravatar_id': '', 'url': 'https://api.github.com/users/soumith', 'html_url': 'https://github.com/soumith', 'followers_url': 'https://api.github.com/users/soumith/followers', 'following_url': 'https://api.github.com/users/soumith/following{/other_user}', 'gists_url': 'https://api.github.com/users/soumith/gists{/gist_id}', 'starred_url': 'https://api.github.com/users/soumith/starred{/owner}{/repo}', 'subscriptions_url': 'https://api.github.com/users/soumith/subscriptions', 'organizations_url': 'https://api.github.com/users/soumith/orgs', 'repos_url': 'https://api.github.com/users/soumith/repos', 'events_url': 'https://api.github.com/users/soumith/events{/privacy}', 'received_events_url': 'https://api.github.com/users/soumith/received_events', 'type': 'User', 'site_admin': False}",referenced,aab30d4ea25686bcd8502aa280ba75d73559c2e4,https://api.github.com/repos/pytorch/pytorch/commits/aab30d4ea25686bcd8502aa280ba75d73559c2e4,2017-04-23T12:45:32Z,69,36,33
1267,1190657564,"{'login': 'soumith', 'id': 1310570, 'node_id': 'MDQ6VXNlcjEzMTA1NzA=', 'avatar_url': 'https://avatars0.githubusercontent.com/u/1310570?v=4', 'gravatar_id': '', 'url': 'https://api.github.com/users/soumith', 'html_url': 'https://github.com/soumith', 'followers_url': 'https://api.github.com/users/soumith/followers', 'following_url': 'https://api.github.com/users/soumith/following{/other_user}', 'gists_url': 'https://api.github.com/users/soumith/gists{/gist_id}', 'starred_url': 'https://api.github.com/users/soumith/starred{/owner}{/repo}', 'subscriptions_url': 'https://api.github.com/users/soumith/subscriptions', 'organizations_url': 'https://api.github.com/users/soumith/orgs', 'repos_url': 'https://api.github.com/users/soumith/repos', 'events_url': 'https://api.github.com/users/soumith/events{/privacy}', 'received_events_url': 'https://api.github.com/users/soumith/received_events', 'type': 'User', 'site_admin': False}",referenced,e25b3d7bc5621e3d8d9469a59238e0d9a09e89dc,https://api.github.com/repos/pytorch/pytorch/commits/e25b3d7bc5621e3d8d9469a59238e0d9a09e89dc,2017-08-03T02:52:17Z,8,4,4
1267,1905231032,"{'login': 'bddppq', 'id': 9300575, 'node_id': 'MDQ6VXNlcjkzMDA1NzU=', 'avatar_url': 'https://avatars2.githubusercontent.com/u/9300575?v=4', 'gravatar_id': '', 'url': 'https://api.github.com/users/bddppq', 'html_url': 'https://github.com/bddppq', 'followers_url': 'https://api.github.com/users/bddppq/followers', 'following_url': 'https://api.github.com/users/bddppq/following{/other_user}', 'gists_url': 'https://api.github.com/users/bddppq/gists{/gist_id}', 'starred_url': 'https://api.github.com/users/bddppq/starred{/owner}{/repo}', 'subscriptions_url': 'https://api.github.com/users/bddppq/subscriptions', 'organizations_url': 'https://api.github.com/users/bddppq/orgs', 'repos_url': 'https://api.github.com/users/bddppq/repos', 'events_url': 'https://api.github.com/users/bddppq/events{/privacy}', 'received_events_url': 'https://api.github.com/users/bddppq/received_events', 'type': 'User', 'site_admin': False}",referenced,970c839cce9e93a84ed6319a7a0215d37dd66ba4,https://api.github.com/repos/pytorch/pytorch/commits/970c839cce9e93a84ed6319a7a0215d37dd66ba4,2018-10-15T21:13:10Z,8,4,4
1263,1905231030,"{'login': 'bddppq', 'id': 9300575, 'node_id': 'MDQ6VXNlcjkzMDA1NzU=', 'avatar_url': 'https://avatars2.githubusercontent.com/u/9300575?v=4', 'gravatar_id': '', 'url': 'https://api.github.com/users/bddppq', 'html_url': 'https://github.com/bddppq', 'followers_url': 'https://api.github.com/users/bddppq/followers', 'following_url': 'https://api.github.com/users/bddppq/following{/other_user}', 'gists_url': 'https://api.github.com/users/bddppq/gists{/gist_id}', 'starred_url': 'https://api.github.com/users/bddppq/starred{/owner}{/repo}', 'subscriptions_url': 'https://api.github.com/users/bddppq/subscriptions', 'organizations_url': 'https://api.github.com/users/bddppq/orgs', 'repos_url': 'https://api.github.com/users/bddppq/repos', 'events_url': 'https://api.github.com/users/bddppq/events{/privacy}', 'received_events_url': 'https://api.github.com/users/bddppq/received_events', 'type': 'User', 'site_admin': False}",referenced,eedf469a8e23ff8a5db6ecbebfe090a58376bdb7,https://api.github.com/repos/pytorch/pytorch/commits/eedf469a8e23ff8a5db6ecbebfe090a58376bdb7,2018-10-15T21:13:10Z,2,1,1
1262,1905231034,"{'login': 'bddppq', 'id': 9300575, 'node_id': 'MDQ6VXNlcjkzMDA1NzU=', 'avatar_url': 'https://avatars2.githubusercontent.com/u/9300575?v=4', 'gravatar_id': '', 'url': 'https://api.github.com/users/bddppq', 'html_url': 'https://github.com/bddppq', 'followers_url': 'https://api.github.com/users/bddppq/followers', 'following_url': 'https://api.github.com/users/bddppq/following{/other_user}', 'gists_url': 'https://api.github.com/users/bddppq/gists{/gist_id}', 'starred_url': 'https://api.github.com/users/bddppq/starred{/owner}{/repo}', 'subscriptions_url': 'https://api.github.com/users/bddppq/subscriptions', 'organizations_url': 'https://api.github.com/users/bddppq/orgs', 'repos_url': 'https://api.github.com/users/bddppq/repos', 'events_url': 'https://api.github.com/users/bddppq/events{/privacy}', 'received_events_url': 'https://api.github.com/users/bddppq/received_events', 'type': 'User', 'site_admin': False}",referenced,4b51596acb67d0c2a6b19931fac48c5ec4a17799,https://api.github.com/repos/pytorch/pytorch/commits/4b51596acb67d0c2a6b19931fac48c5ec4a17799,2018-10-15T21:13:10Z,56,43,13
1261,1905231028,"{'login': 'bddppq', 'id': 9300575, 'node_id': 'MDQ6VXNlcjkzMDA1NzU=', 'avatar_url': 'https://avatars2.githubusercontent.com/u/9300575?v=4', 'gravatar_id': '', 'url': 'https://api.github.com/users/bddppq', 'html_url': 'https://github.com/bddppq', 'followers_url': 'https://api.github.com/users/bddppq/followers', 'following_url': 'https://api.github.com/users/bddppq/following{/other_user}', 'gists_url': 'https://api.github.com/users/bddppq/gists{/gist_id}', 'starred_url': 'https://api.github.com/users/bddppq/starred{/owner}{/repo}', 'subscriptions_url': 'https://api.github.com/users/bddppq/subscriptions', 'organizations_url': 'https://api.github.com/users/bddppq/orgs', 'repos_url': 'https://api.github.com/users/bddppq/repos', 'events_url': 'https://api.github.com/users/bddppq/events{/privacy}', 'received_events_url': 'https://api.github.com/users/bddppq/received_events', 'type': 'User', 'site_admin': False}",referenced,554422b9eee18e050357711b64b23043cd9062d8,https://api.github.com/repos/pytorch/pytorch/commits/554422b9eee18e050357711b64b23043cd9062d8,2018-10-15T21:13:10Z,2,1,1
1258,1905230992,"{'login': 'bddppq', 'id': 9300575, 'node_id': 'MDQ6VXNlcjkzMDA1NzU=', 'avatar_url': 'https://avatars2.githubusercontent.com/u/9300575?v=4', 'gravatar_id': '', 'url': 'https://api.github.com/users/bddppq', 'html_url': 'https://github.com/bddppq', 'followers_url': 'https://api.github.com/users/bddppq/followers', 'following_url': 'https://api.github.com/users/bddppq/following{/other_user}', 'gists_url': 'https://api.github.com/users/bddppq/gists{/gist_id}', 'starred_url': 'https://api.github.com/users/bddppq/starred{/owner}{/repo}', 'subscriptions_url': 'https://api.github.com/users/bddppq/subscriptions', 'organizations_url': 'https://api.github.com/users/bddppq/orgs', 'repos_url': 'https://api.github.com/users/bddppq/repos', 'events_url': 'https://api.github.com/users/bddppq/events{/privacy}', 'received_events_url': 'https://api.github.com/users/bddppq/received_events', 'type': 'User', 'site_admin': False}",referenced,cacac1c344e3afe2956961727b3670a959aa2445,https://api.github.com/repos/pytorch/pytorch/commits/cacac1c344e3afe2956961727b3670a959aa2445,2018-10-15T21:13:09Z,8,4,4
1256,1905231019,"{'login': 'bddppq', 'id': 9300575, 'node_id': 'MDQ6VXNlcjkzMDA1NzU=', 'avatar_url': 'https://avatars2.githubusercontent.com/u/9300575?v=4', 'gravatar_id': '', 'url': 'https://api.github.com/users/bddppq', 'html_url': 'https://github.com/bddppq', 'followers_url': 'https://api.github.com/users/bddppq/followers', 'following_url': 'https://api.github.com/users/bddppq/following{/other_user}', 'gists_url': 'https://api.github.com/users/bddppq/gists{/gist_id}', 'starred_url': 'https://api.github.com/users/bddppq/starred{/owner}{/repo}', 'subscriptions_url': 'https://api.github.com/users/bddppq/subscriptions', 'organizations_url': 'https://api.github.com/users/bddppq/orgs', 'repos_url': 'https://api.github.com/users/bddppq/repos', 'events_url': 'https://api.github.com/users/bddppq/events{/privacy}', 'received_events_url': 'https://api.github.com/users/bddppq/received_events', 'type': 'User', 'site_admin': False}",referenced,219aaf91f3ae62762628aff4f68d84412202bcac,https://api.github.com/repos/pytorch/pytorch/commits/219aaf91f3ae62762628aff4f68d84412202bcac,2018-10-15T21:13:09Z,73,53,20
1256,1905231027,"{'login': 'bddppq', 'id': 9300575, 'node_id': 'MDQ6VXNlcjkzMDA1NzU=', 'avatar_url': 'https://avatars2.githubusercontent.com/u/9300575?v=4', 'gravatar_id': '', 'url': 'https://api.github.com/users/bddppq', 'html_url': 'https://github.com/bddppq', 'followers_url': 'https://api.github.com/users/bddppq/followers', 'following_url': 'https://api.github.com/users/bddppq/following{/other_user}', 'gists_url': 'https://api.github.com/users/bddppq/gists{/gist_id}', 'starred_url': 'https://api.github.com/users/bddppq/starred{/owner}{/repo}', 'subscriptions_url': 'https://api.github.com/users/bddppq/subscriptions', 'organizations_url': 'https://api.github.com/users/bddppq/orgs', 'repos_url': 'https://api.github.com/users/bddppq/repos', 'events_url': 'https://api.github.com/users/bddppq/events{/privacy}', 'received_events_url': 'https://api.github.com/users/bddppq/received_events', 'type': 'User', 'site_admin': False}",referenced,554422b9eee18e050357711b64b23043cd9062d8,https://api.github.com/repos/pytorch/pytorch/commits/554422b9eee18e050357711b64b23043cd9062d8,2018-10-15T21:13:10Z,2,1,1
1255,1905231000,"{'login': 'bddppq', 'id': 9300575, 'node_id': 'MDQ6VXNlcjkzMDA1NzU=', 'avatar_url': 'https://avatars2.githubusercontent.com/u/9300575?v=4', 'gravatar_id': '', 'url': 'https://api.github.com/users/bddppq', 'html_url': 'https://github.com/bddppq', 'followers_url': 'https://api.github.com/users/bddppq/followers', 'following_url': 'https://api.github.com/users/bddppq/following{/other_user}', 'gists_url': 'https://api.github.com/users/bddppq/gists{/gist_id}', 'starred_url': 'https://api.github.com/users/bddppq/starred{/owner}{/repo}', 'subscriptions_url': 'https://api.github.com/users/bddppq/subscriptions', 'organizations_url': 'https://api.github.com/users/bddppq/orgs', 'repos_url': 'https://api.github.com/users/bddppq/repos', 'events_url': 'https://api.github.com/users/bddppq/events{/privacy}', 'received_events_url': 'https://api.github.com/users/bddppq/received_events', 'type': 'User', 'site_admin': False}",referenced,ad78b0d4753b3d10516a3d6506f5e5582b356857,https://api.github.com/repos/pytorch/pytorch/commits/ad78b0d4753b3d10516a3d6506f5e5582b356857,2018-10-15T21:13:09Z,64,63,1
1250,1905231022,"{'login': 'bddppq', 'id': 9300575, 'node_id': 'MDQ6VXNlcjkzMDA1NzU=', 'avatar_url': 'https://avatars2.githubusercontent.com/u/9300575?v=4', 'gravatar_id': '', 'url': 'https://api.github.com/users/bddppq', 'html_url': 'https://github.com/bddppq', 'followers_url': 'https://api.github.com/users/bddppq/followers', 'following_url': 'https://api.github.com/users/bddppq/following{/other_user}', 'gists_url': 'https://api.github.com/users/bddppq/gists{/gist_id}', 'starred_url': 'https://api.github.com/users/bddppq/starred{/owner}{/repo}', 'subscriptions_url': 'https://api.github.com/users/bddppq/subscriptions', 'organizations_url': 'https://api.github.com/users/bddppq/orgs', 'repos_url': 'https://api.github.com/users/bddppq/repos', 'events_url': 'https://api.github.com/users/bddppq/events{/privacy}', 'received_events_url': 'https://api.github.com/users/bddppq/received_events', 'type': 'User', 'site_admin': False}",referenced,9f2759c40ed731d29f4fd8a3c3436fa57a47cafd,https://api.github.com/repos/pytorch/pytorch/commits/9f2759c40ed731d29f4fd8a3c3436fa57a47cafd,2018-10-15T21:13:10Z,29,28,1
1247,1905230987,"{'login': 'bddppq', 'id': 9300575, 'node_id': 'MDQ6VXNlcjkzMDA1NzU=', 'avatar_url': 'https://avatars2.githubusercontent.com/u/9300575?v=4', 'gravatar_id': '', 'url': 'https://api.github.com/users/bddppq', 'html_url': 'https://github.com/bddppq', 'followers_url': 'https://api.github.com/users/bddppq/followers', 'following_url': 'https://api.github.com/users/bddppq/following{/other_user}', 'gists_url': 'https://api.github.com/users/bddppq/gists{/gist_id}', 'starred_url': 'https://api.github.com/users/bddppq/starred{/owner}{/repo}', 'subscriptions_url': 'https://api.github.com/users/bddppq/subscriptions', 'organizations_url': 'https://api.github.com/users/bddppq/orgs', 'repos_url': 'https://api.github.com/users/bddppq/repos', 'events_url': 'https://api.github.com/users/bddppq/events{/privacy}', 'received_events_url': 'https://api.github.com/users/bddppq/received_events', 'type': 'User', 'site_admin': False}",referenced,32ac71b1b9c1bd7f196eed3b311734ec6ab3c367,https://api.github.com/repos/pytorch/pytorch/commits/32ac71b1b9c1bd7f196eed3b311734ec6ab3c367,2018-10-15T21:13:09Z,2,1,1
1246,1831760194,"{'login': 'facebook-github-bot', 'id': 6422482, 'node_id': 'MDQ6VXNlcjY0MjI0ODI=', 'avatar_url': 'https://avatars3.githubusercontent.com/u/6422482?v=4', 'gravatar_id': '', 'url': 'https://api.github.com/users/facebook-github-bot', 'html_url': 'https://github.com/facebook-github-bot', 'followers_url': 'https://api.github.com/users/facebook-github-bot/followers', 'following_url': 'https://api.github.com/users/facebook-github-bot/following{/other_user}', 'gists_url': 'https://api.github.com/users/facebook-github-bot/gists{/gist_id}', 'starred_url': 'https://api.github.com/users/facebook-github-bot/starred{/owner}{/repo}', 'subscriptions_url': 'https://api.github.com/users/facebook-github-bot/subscriptions', 'organizations_url': 'https://api.github.com/users/facebook-github-bot/orgs', 'repos_url': 'https://api.github.com/users/facebook-github-bot/repos', 'events_url': 'https://api.github.com/users/facebook-github-bot/events{/privacy}', 'received_events_url': 'https://api.github.com/users/facebook-github-bot/received_events', 'type': 'User', 'site_admin': False}",referenced,c39216f8c49361456d7d827b6199ac54799ff2e2,https://api.github.com/repos/pytorch/pytorch/commits/c39216f8c49361456d7d827b6199ac54799ff2e2,2018-09-07T00:41:12Z,3,2,1
1246,1905231204,"{'login': 'bddppq', 'id': 9300575, 'node_id': 'MDQ6VXNlcjkzMDA1NzU=', 'avatar_url': 'https://avatars2.githubusercontent.com/u/9300575?v=4', 'gravatar_id': '', 'url': 'https://api.github.com/users/bddppq', 'html_url': 'https://github.com/bddppq', 'followers_url': 'https://api.github.com/users/bddppq/followers', 'following_url': 'https://api.github.com/users/bddppq/following{/other_user}', 'gists_url': 'https://api.github.com/users/bddppq/gists{/gist_id}', 'starred_url': 'https://api.github.com/users/bddppq/starred{/owner}{/repo}', 'subscriptions_url': 'https://api.github.com/users/bddppq/subscriptions', 'organizations_url': 'https://api.github.com/users/bddppq/orgs', 'repos_url': 'https://api.github.com/users/bddppq/repos', 'events_url': 'https://api.github.com/users/bddppq/events{/privacy}', 'received_events_url': 'https://api.github.com/users/bddppq/received_events', 'type': 'User', 'site_admin': False}",referenced,91a7b8e30a92bbd12f2b0643d881fd78bd105191,https://api.github.com/repos/pytorch/pytorch/commits/91a7b8e30a92bbd12f2b0643d881fd78bd105191,2018-10-15T21:13:13Z,824,814,10
1244,1905230983,"{'login': 'bddppq', 'id': 9300575, 'node_id': 'MDQ6VXNlcjkzMDA1NzU=', 'avatar_url': 'https://avatars2.githubusercontent.com/u/9300575?v=4', 'gravatar_id': '', 'url': 'https://api.github.com/users/bddppq', 'html_url': 'https://github.com/bddppq', 'followers_url': 'https://api.github.com/users/bddppq/followers', 'following_url': 'https://api.github.com/users/bddppq/following{/other_user}', 'gists_url': 'https://api.github.com/users/bddppq/gists{/gist_id}', 'starred_url': 'https://api.github.com/users/bddppq/starred{/owner}{/repo}', 'subscriptions_url': 'https://api.github.com/users/bddppq/subscriptions', 'organizations_url': 'https://api.github.com/users/bddppq/orgs', 'repos_url': 'https://api.github.com/users/bddppq/repos', 'events_url': 'https://api.github.com/users/bddppq/events{/privacy}', 'received_events_url': 'https://api.github.com/users/bddppq/received_events', 'type': 'User', 'site_admin': False}",referenced,7c5f1a93aa706e9925b28d0b7d4205f745aed203,https://api.github.com/repos/pytorch/pytorch/commits/7c5f1a93aa706e9925b28d0b7d4205f745aed203,2018-10-15T21:13:09Z,30,15,15
1241,1905230966,"{'login': 'bddppq', 'id': 9300575, 'node_id': 'MDQ6VXNlcjkzMDA1NzU=', 'avatar_url': 'https://avatars2.githubusercontent.com/u/9300575?v=4', 'gravatar_id': '', 'url': 'https://api.github.com/users/bddppq', 'html_url': 'https://github.com/bddppq', 'followers_url': 'https://api.github.com/users/bddppq/followers', 'following_url': 'https://api.github.com/users/bddppq/following{/other_user}', 'gists_url': 'https://api.github.com/users/bddppq/gists{/gist_id}', 'starred_url': 'https://api.github.com/users/bddppq/starred{/owner}{/repo}', 'subscriptions_url': 'https://api.github.com/users/bddppq/subscriptions', 'organizations_url': 'https://api.github.com/users/bddppq/orgs', 'repos_url': 'https://api.github.com/users/bddppq/repos', 'events_url': 'https://api.github.com/users/bddppq/events{/privacy}', 'received_events_url': 'https://api.github.com/users/bddppq/received_events', 'type': 'User', 'site_admin': False}",referenced,df01dbc00519067ba6d4e818421eccd1d2552e35,https://api.github.com/repos/pytorch/pytorch/commits/df01dbc00519067ba6d4e818421eccd1d2552e35,2018-10-15T21:13:09Z,7,2,5
1240,1905230964,"{'login': 'bddppq', 'id': 9300575, 'node_id': 'MDQ6VXNlcjkzMDA1NzU=', 'avatar_url': 'https://avatars2.githubusercontent.com/u/9300575?v=4', 'gravatar_id': '', 'url': 'https://api.github.com/users/bddppq', 'html_url': 'https://github.com/bddppq', 'followers_url': 'https://api.github.com/users/bddppq/followers', 'following_url': 'https://api.github.com/users/bddppq/following{/other_user}', 'gists_url': 'https://api.github.com/users/bddppq/gists{/gist_id}', 'starred_url': 'https://api.github.com/users/bddppq/starred{/owner}{/repo}', 'subscriptions_url': 'https://api.github.com/users/bddppq/subscriptions', 'organizations_url': 'https://api.github.com/users/bddppq/orgs', 'repos_url': 'https://api.github.com/users/bddppq/repos', 'events_url': 'https://api.github.com/users/bddppq/events{/privacy}', 'received_events_url': 'https://api.github.com/users/bddppq/received_events', 'type': 'User', 'site_admin': False}",referenced,f4274821c0bbeba76097009b95af1582fb4b1f78,https://api.github.com/repos/pytorch/pytorch/commits/f4274821c0bbeba76097009b95af1582fb4b1f78,2018-10-15T21:13:09Z,2,1,1
1237,1905230957,"{'login': 'bddppq', 'id': 9300575, 'node_id': 'MDQ6VXNlcjkzMDA1NzU=', 'avatar_url': 'https://avatars2.githubusercontent.com/u/9300575?v=4', 'gravatar_id': '', 'url': 'https://api.github.com/users/bddppq', 'html_url': 'https://github.com/bddppq', 'followers_url': 'https://api.github.com/users/bddppq/followers', 'following_url': 'https://api.github.com/users/bddppq/following{/other_user}', 'gists_url': 'https://api.github.com/users/bddppq/gists{/gist_id}', 'starred_url': 'https://api.github.com/users/bddppq/starred{/owner}{/repo}', 'subscriptions_url': 'https://api.github.com/users/bddppq/subscriptions', 'organizations_url': 'https://api.github.com/users/bddppq/orgs', 'repos_url': 'https://api.github.com/users/bddppq/repos', 'events_url': 'https://api.github.com/users/bddppq/events{/privacy}', 'received_events_url': 'https://api.github.com/users/bddppq/received_events', 'type': 'User', 'site_admin': False}",referenced,cc813cfe04016d8b73c01207afc40f4947d214c9,https://api.github.com/repos/pytorch/pytorch/commits/cc813cfe04016d8b73c01207afc40f4947d214c9,2018-10-15T21:13:09Z,8,4,4
1233,1905230950,"{'login': 'bddppq', 'id': 9300575, 'node_id': 'MDQ6VXNlcjkzMDA1NzU=', 'avatar_url': 'https://avatars2.githubusercontent.com/u/9300575?v=4', 'gravatar_id': '', 'url': 'https://api.github.com/users/bddppq', 'html_url': 'https://github.com/bddppq', 'followers_url': 'https://api.github.com/users/bddppq/followers', 'following_url': 'https://api.github.com/users/bddppq/following{/other_user}', 'gists_url': 'https://api.github.com/users/bddppq/gists{/gist_id}', 'starred_url': 'https://api.github.com/users/bddppq/starred{/owner}{/repo}', 'subscriptions_url': 'https://api.github.com/users/bddppq/subscriptions', 'organizations_url': 'https://api.github.com/users/bddppq/orgs', 'repos_url': 'https://api.github.com/users/bddppq/repos', 'events_url': 'https://api.github.com/users/bddppq/events{/privacy}', 'received_events_url': 'https://api.github.com/users/bddppq/received_events', 'type': 'User', 'site_admin': False}",referenced,c761845c7f6880ab7eb7e2866d673834c7149e89,https://api.github.com/repos/pytorch/pytorch/commits/c761845c7f6880ab7eb7e2866d673834c7149e89,2018-10-15T21:13:08Z,265,118,147
1229,1905230914,"{'login': 'bddppq', 'id': 9300575, 'node_id': 'MDQ6VXNlcjkzMDA1NzU=', 'avatar_url': 'https://avatars2.githubusercontent.com/u/9300575?v=4', 'gravatar_id': '', 'url': 'https://api.github.com/users/bddppq', 'html_url': 'https://github.com/bddppq', 'followers_url': 'https://api.github.com/users/bddppq/followers', 'following_url': 'https://api.github.com/users/bddppq/following{/other_user}', 'gists_url': 'https://api.github.com/users/bddppq/gists{/gist_id}', 'starred_url': 'https://api.github.com/users/bddppq/starred{/owner}{/repo}', 'subscriptions_url': 'https://api.github.com/users/bddppq/subscriptions', 'organizations_url': 'https://api.github.com/users/bddppq/orgs', 'repos_url': 'https://api.github.com/users/bddppq/repos', 'events_url': 'https://api.github.com/users/bddppq/events{/privacy}', 'received_events_url': 'https://api.github.com/users/bddppq/received_events', 'type': 'User', 'site_admin': False}",referenced,975360836f736f5b218a521bfc0e363979dfcdb2,https://api.github.com/repos/pytorch/pytorch/commits/975360836f736f5b218a521bfc0e363979dfcdb2,2018-10-15T21:13:08Z,8,5,3
1228,1905230917,"{'login': 'bddppq', 'id': 9300575, 'node_id': 'MDQ6VXNlcjkzMDA1NzU=', 'avatar_url': 'https://avatars2.githubusercontent.com/u/9300575?v=4', 'gravatar_id': '', 'url': 'https://api.github.com/users/bddppq', 'html_url': 'https://github.com/bddppq', 'followers_url': 'https://api.github.com/users/bddppq/followers', 'following_url': 'https://api.github.com/users/bddppq/following{/other_user}', 'gists_url': 'https://api.github.com/users/bddppq/gists{/gist_id}', 'starred_url': 'https://api.github.com/users/bddppq/starred{/owner}{/repo}', 'subscriptions_url': 'https://api.github.com/users/bddppq/subscriptions', 'organizations_url': 'https://api.github.com/users/bddppq/orgs', 'repos_url': 'https://api.github.com/users/bddppq/repos', 'events_url': 'https://api.github.com/users/bddppq/events{/privacy}', 'received_events_url': 'https://api.github.com/users/bddppq/received_events', 'type': 'User', 'site_admin': False}",referenced,1683cc0966d4d9acae052180945c9351b2e0fbf2,https://api.github.com/repos/pytorch/pytorch/commits/1683cc0966d4d9acae052180945c9351b2e0fbf2,2018-10-15T21:13:08Z,11,5,6
1227,1905230918,"{'login': 'bddppq', 'id': 9300575, 'node_id': 'MDQ6VXNlcjkzMDA1NzU=', 'avatar_url': 'https://avatars2.githubusercontent.com/u/9300575?v=4', 'gravatar_id': '', 'url': 'https://api.github.com/users/bddppq', 'html_url': 'https://github.com/bddppq', 'followers_url': 'https://api.github.com/users/bddppq/followers', 'following_url': 'https://api.github.com/users/bddppq/following{/other_user}', 'gists_url': 'https://api.github.com/users/bddppq/gists{/gist_id}', 'starred_url': 'https://api.github.com/users/bddppq/starred{/owner}{/repo}', 'subscriptions_url': 'https://api.github.com/users/bddppq/subscriptions', 'organizations_url': 'https://api.github.com/users/bddppq/orgs', 'repos_url': 'https://api.github.com/users/bddppq/repos', 'events_url': 'https://api.github.com/users/bddppq/events{/privacy}', 'received_events_url': 'https://api.github.com/users/bddppq/received_events', 'type': 'User', 'site_admin': False}",referenced,ff83856f24965ffe31d3951c7c53d79867fd58fd,https://api.github.com/repos/pytorch/pytorch/commits/ff83856f24965ffe31d3951c7c53d79867fd58fd,2018-10-15T21:13:08Z,20,17,3
1225,1047453829,"{'login': 'soumith', 'id': 1310570, 'node_id': 'MDQ6VXNlcjEzMTA1NzA=', 'avatar_url': 'https://avatars0.githubusercontent.com/u/1310570?v=4', 'gravatar_id': '', 'url': 'https://api.github.com/users/soumith', 'html_url': 'https://github.com/soumith', 'followers_url': 'https://api.github.com/users/soumith/followers', 'following_url': 'https://api.github.com/users/soumith/following{/other_user}', 'gists_url': 'https://api.github.com/users/soumith/gists{/gist_id}', 'starred_url': 'https://api.github.com/users/soumith/starred{/owner}{/repo}', 'subscriptions_url': 'https://api.github.com/users/soumith/subscriptions', 'organizations_url': 'https://api.github.com/users/soumith/orgs', 'repos_url': 'https://api.github.com/users/soumith/repos', 'events_url': 'https://api.github.com/users/soumith/events{/privacy}', 'received_events_url': 'https://api.github.com/users/soumith/received_events', 'type': 'User', 'site_admin': False}",referenced,34546f022aefdd1947107bcf9f8d8009d1031ea1,https://api.github.com/repos/pytorch/pytorch/commits/34546f022aefdd1947107bcf9f8d8009d1031ea1,2017-04-18T21:13:06Z,56,43,13
1225,1905230924,"{'login': 'bddppq', 'id': 9300575, 'node_id': 'MDQ6VXNlcjkzMDA1NzU=', 'avatar_url': 'https://avatars2.githubusercontent.com/u/9300575?v=4', 'gravatar_id': '', 'url': 'https://api.github.com/users/bddppq', 'html_url': 'https://github.com/bddppq', 'followers_url': 'https://api.github.com/users/bddppq/followers', 'following_url': 'https://api.github.com/users/bddppq/following{/other_user}', 'gists_url': 'https://api.github.com/users/bddppq/gists{/gist_id}', 'starred_url': 'https://api.github.com/users/bddppq/starred{/owner}{/repo}', 'subscriptions_url': 'https://api.github.com/users/bddppq/subscriptions', 'organizations_url': 'https://api.github.com/users/bddppq/orgs', 'repos_url': 'https://api.github.com/users/bddppq/repos', 'events_url': 'https://api.github.com/users/bddppq/events{/privacy}', 'received_events_url': 'https://api.github.com/users/bddppq/received_events', 'type': 'User', 'site_admin': False}",referenced,a6542a4b8e184981c19b9cb486401902e8bbaf41,https://api.github.com/repos/pytorch/pytorch/commits/a6542a4b8e184981c19b9cb486401902e8bbaf41,2018-10-15T21:13:08Z,43,43,0
1224,1905230933,"{'login': 'bddppq', 'id': 9300575, 'node_id': 'MDQ6VXNlcjkzMDA1NzU=', 'avatar_url': 'https://avatars2.githubusercontent.com/u/9300575?v=4', 'gravatar_id': '', 'url': 'https://api.github.com/users/bddppq', 'html_url': 'https://github.com/bddppq', 'followers_url': 'https://api.github.com/users/bddppq/followers', 'following_url': 'https://api.github.com/users/bddppq/following{/other_user}', 'gists_url': 'https://api.github.com/users/bddppq/gists{/gist_id}', 'starred_url': 'https://api.github.com/users/bddppq/starred{/owner}{/repo}', 'subscriptions_url': 'https://api.github.com/users/bddppq/subscriptions', 'organizations_url': 'https://api.github.com/users/bddppq/orgs', 'repos_url': 'https://api.github.com/users/bddppq/repos', 'events_url': 'https://api.github.com/users/bddppq/events{/privacy}', 'received_events_url': 'https://api.github.com/users/bddppq/received_events', 'type': 'User', 'site_admin': False}",referenced,16a85cc88c2bdac51a357a6b588f37a23dc9a565,https://api.github.com/repos/pytorch/pytorch/commits/16a85cc88c2bdac51a357a6b588f37a23dc9a565,2018-10-15T21:13:08Z,128,88,40
1221,1905230908,"{'login': 'bddppq', 'id': 9300575, 'node_id': 'MDQ6VXNlcjkzMDA1NzU=', 'avatar_url': 'https://avatars2.githubusercontent.com/u/9300575?v=4', 'gravatar_id': '', 'url': 'https://api.github.com/users/bddppq', 'html_url': 'https://github.com/bddppq', 'followers_url': 'https://api.github.com/users/bddppq/followers', 'following_url': 'https://api.github.com/users/bddppq/following{/other_user}', 'gists_url': 'https://api.github.com/users/bddppq/gists{/gist_id}', 'starred_url': 'https://api.github.com/users/bddppq/starred{/owner}{/repo}', 'subscriptions_url': 'https://api.github.com/users/bddppq/subscriptions', 'organizations_url': 'https://api.github.com/users/bddppq/orgs', 'repos_url': 'https://api.github.com/users/bddppq/repos', 'events_url': 'https://api.github.com/users/bddppq/events{/privacy}', 'received_events_url': 'https://api.github.com/users/bddppq/received_events', 'type': 'User', 'site_admin': False}",referenced,cffea63ba88547aa3eb9d9372612bd60d65a847d,https://api.github.com/repos/pytorch/pytorch/commits/cffea63ba88547aa3eb9d9372612bd60d65a847d,2018-10-15T21:13:08Z,282,266,16
1206,1905230903,"{'login': 'bddppq', 'id': 9300575, 'node_id': 'MDQ6VXNlcjkzMDA1NzU=', 'avatar_url': 'https://avatars2.githubusercontent.com/u/9300575?v=4', 'gravatar_id': '', 'url': 'https://api.github.com/users/bddppq', 'html_url': 'https://github.com/bddppq', 'followers_url': 'https://api.github.com/users/bddppq/followers', 'following_url': 'https://api.github.com/users/bddppq/following{/other_user}', 'gists_url': 'https://api.github.com/users/bddppq/gists{/gist_id}', 'starred_url': 'https://api.github.com/users/bddppq/starred{/owner}{/repo}', 'subscriptions_url': 'https://api.github.com/users/bddppq/subscriptions', 'organizations_url': 'https://api.github.com/users/bddppq/orgs', 'repos_url': 'https://api.github.com/users/bddppq/repos', 'events_url': 'https://api.github.com/users/bddppq/events{/privacy}', 'received_events_url': 'https://api.github.com/users/bddppq/received_events', 'type': 'User', 'site_admin': False}",referenced,486c5aa594de65397171b10345e9e2e714fd3c56,https://api.github.com/repos/pytorch/pytorch/commits/486c5aa594de65397171b10345e9e2e714fd3c56,2018-10-15T21:13:08Z,135,133,2
1204,1905230896,"{'login': 'bddppq', 'id': 9300575, 'node_id': 'MDQ6VXNlcjkzMDA1NzU=', 'avatar_url': 'https://avatars2.githubusercontent.com/u/9300575?v=4', 'gravatar_id': '', 'url': 'https://api.github.com/users/bddppq', 'html_url': 'https://github.com/bddppq', 'followers_url': 'https://api.github.com/users/bddppq/followers', 'following_url': 'https://api.github.com/users/bddppq/following{/other_user}', 'gists_url': 'https://api.github.com/users/bddppq/gists{/gist_id}', 'starred_url': 'https://api.github.com/users/bddppq/starred{/owner}{/repo}', 'subscriptions_url': 'https://api.github.com/users/bddppq/subscriptions', 'organizations_url': 'https://api.github.com/users/bddppq/orgs', 'repos_url': 'https://api.github.com/users/bddppq/repos', 'events_url': 'https://api.github.com/users/bddppq/events{/privacy}', 'received_events_url': 'https://api.github.com/users/bddppq/received_events', 'type': 'User', 'site_admin': False}",referenced,c47d3a61368686a6d1911d843027abcf88e35c00,https://api.github.com/repos/pytorch/pytorch/commits/c47d3a61368686a6d1911d843027abcf88e35c00,2018-10-15T21:13:07Z,9,7,2
1203,1905230899,"{'login': 'bddppq', 'id': 9300575, 'node_id': 'MDQ6VXNlcjkzMDA1NzU=', 'avatar_url': 'https://avatars2.githubusercontent.com/u/9300575?v=4', 'gravatar_id': '', 'url': 'https://api.github.com/users/bddppq', 'html_url': 'https://github.com/bddppq', 'followers_url': 'https://api.github.com/users/bddppq/followers', 'following_url': 'https://api.github.com/users/bddppq/following{/other_user}', 'gists_url': 'https://api.github.com/users/bddppq/gists{/gist_id}', 'starred_url': 'https://api.github.com/users/bddppq/starred{/owner}{/repo}', 'subscriptions_url': 'https://api.github.com/users/bddppq/subscriptions', 'organizations_url': 'https://api.github.com/users/bddppq/orgs', 'repos_url': 'https://api.github.com/users/bddppq/repos', 'events_url': 'https://api.github.com/users/bddppq/events{/privacy}', 'received_events_url': 'https://api.github.com/users/bddppq/received_events', 'type': 'User', 'site_admin': False}",referenced,0efd9f85c4e837e8d64a8ea4d2d5b7a59fab75bb,https://api.github.com/repos/pytorch/pytorch/commits/0efd9f85c4e837e8d64a8ea4d2d5b7a59fab75bb,2018-10-15T21:13:08Z,82,18,64
1164,1905230850,"{'login': 'bddppq', 'id': 9300575, 'node_id': 'MDQ6VXNlcjkzMDA1NzU=', 'avatar_url': 'https://avatars2.githubusercontent.com/u/9300575?v=4', 'gravatar_id': '', 'url': 'https://api.github.com/users/bddppq', 'html_url': 'https://github.com/bddppq', 'followers_url': 'https://api.github.com/users/bddppq/followers', 'following_url': 'https://api.github.com/users/bddppq/following{/other_user}', 'gists_url': 'https://api.github.com/users/bddppq/gists{/gist_id}', 'starred_url': 'https://api.github.com/users/bddppq/starred{/owner}{/repo}', 'subscriptions_url': 'https://api.github.com/users/bddppq/subscriptions', 'organizations_url': 'https://api.github.com/users/bddppq/orgs', 'repos_url': 'https://api.github.com/users/bddppq/repos', 'events_url': 'https://api.github.com/users/bddppq/events{/privacy}', 'received_events_url': 'https://api.github.com/users/bddppq/received_events', 'type': 'User', 'site_admin': False}",referenced,72a358d1a585f32f186f7b585e9b9ce31827364b,https://api.github.com/repos/pytorch/pytorch/commits/72a358d1a585f32f186f7b585e9b9ce31827364b,2018-10-15T21:13:07Z,1,1,0
1158,1905230857,"{'login': 'bddppq', 'id': 9300575, 'node_id': 'MDQ6VXNlcjkzMDA1NzU=', 'avatar_url': 'https://avatars2.githubusercontent.com/u/9300575?v=4', 'gravatar_id': '', 'url': 'https://api.github.com/users/bddppq', 'html_url': 'https://github.com/bddppq', 'followers_url': 'https://api.github.com/users/bddppq/followers', 'following_url': 'https://api.github.com/users/bddppq/following{/other_user}', 'gists_url': 'https://api.github.com/users/bddppq/gists{/gist_id}', 'starred_url': 'https://api.github.com/users/bddppq/starred{/owner}{/repo}', 'subscriptions_url': 'https://api.github.com/users/bddppq/subscriptions', 'organizations_url': 'https://api.github.com/users/bddppq/orgs', 'repos_url': 'https://api.github.com/users/bddppq/repos', 'events_url': 'https://api.github.com/users/bddppq/events{/privacy}', 'received_events_url': 'https://api.github.com/users/bddppq/received_events', 'type': 'User', 'site_admin': False}",referenced,8e47fb2ed3af8dc723a3dce25df9c363a007edcf,https://api.github.com/repos/pytorch/pytorch/commits/8e47fb2ed3af8dc723a3dce25df9c363a007edcf,2018-10-15T21:13:07Z,242,105,137
1155,1905230834,"{'login': 'bddppq', 'id': 9300575, 'node_id': 'MDQ6VXNlcjkzMDA1NzU=', 'avatar_url': 'https://avatars2.githubusercontent.com/u/9300575?v=4', 'gravatar_id': '', 'url': 'https://api.github.com/users/bddppq', 'html_url': 'https://github.com/bddppq', 'followers_url': 'https://api.github.com/users/bddppq/followers', 'following_url': 'https://api.github.com/users/bddppq/following{/other_user}', 'gists_url': 'https://api.github.com/users/bddppq/gists{/gist_id}', 'starred_url': 'https://api.github.com/users/bddppq/starred{/owner}{/repo}', 'subscriptions_url': 'https://api.github.com/users/bddppq/subscriptions', 'organizations_url': 'https://api.github.com/users/bddppq/orgs', 'repos_url': 'https://api.github.com/users/bddppq/repos', 'events_url': 'https://api.github.com/users/bddppq/events{/privacy}', 'received_events_url': 'https://api.github.com/users/bddppq/received_events', 'type': 'User', 'site_admin': False}",referenced,6c6df92c7fa7081e4176966fbae045f4a5de35c4,https://api.github.com/repos/pytorch/pytorch/commits/6c6df92c7fa7081e4176966fbae045f4a5de35c4,2018-10-15T21:13:06Z,5,4,1
1154,1905231123,"{'login': 'bddppq', 'id': 9300575, 'node_id': 'MDQ6VXNlcjkzMDA1NzU=', 'avatar_url': 'https://avatars2.githubusercontent.com/u/9300575?v=4', 'gravatar_id': '', 'url': 'https://api.github.com/users/bddppq', 'html_url': 'https://github.com/bddppq', 'followers_url': 'https://api.github.com/users/bddppq/followers', 'following_url': 'https://api.github.com/users/bddppq/following{/other_user}', 'gists_url': 'https://api.github.com/users/bddppq/gists{/gist_id}', 'starred_url': 'https://api.github.com/users/bddppq/starred{/owner}{/repo}', 'subscriptions_url': 'https://api.github.com/users/bddppq/subscriptions', 'organizations_url': 'https://api.github.com/users/bddppq/orgs', 'repos_url': 'https://api.github.com/users/bddppq/repos', 'events_url': 'https://api.github.com/users/bddppq/events{/privacy}', 'received_events_url': 'https://api.github.com/users/bddppq/received_events', 'type': 'User', 'site_admin': False}",referenced,780dcbc088686503c2d5d4e5c4203efc09ef4fa0,https://api.github.com/repos/pytorch/pytorch/commits/780dcbc088686503c2d5d4e5c4203efc09ef4fa0,2018-10-15T21:13:12Z,1005,1005,0
1151,1905230831,"{'login': 'bddppq', 'id': 9300575, 'node_id': 'MDQ6VXNlcjkzMDA1NzU=', 'avatar_url': 'https://avatars2.githubusercontent.com/u/9300575?v=4', 'gravatar_id': '', 'url': 'https://api.github.com/users/bddppq', 'html_url': 'https://github.com/bddppq', 'followers_url': 'https://api.github.com/users/bddppq/followers', 'following_url': 'https://api.github.com/users/bddppq/following{/other_user}', 'gists_url': 'https://api.github.com/users/bddppq/gists{/gist_id}', 'starred_url': 'https://api.github.com/users/bddppq/starred{/owner}{/repo}', 'subscriptions_url': 'https://api.github.com/users/bddppq/subscriptions', 'organizations_url': 'https://api.github.com/users/bddppq/orgs', 'repos_url': 'https://api.github.com/users/bddppq/repos', 'events_url': 'https://api.github.com/users/bddppq/events{/privacy}', 'received_events_url': 'https://api.github.com/users/bddppq/received_events', 'type': 'User', 'site_admin': False}",referenced,7537916872738fd47c12cebeb683f9e45f8066c2,https://api.github.com/repos/pytorch/pytorch/commits/7537916872738fd47c12cebeb683f9e45f8066c2,2018-10-15T21:13:06Z,5,3,2
1148,1905230953,"{'login': 'bddppq', 'id': 9300575, 'node_id': 'MDQ6VXNlcjkzMDA1NzU=', 'avatar_url': 'https://avatars2.githubusercontent.com/u/9300575?v=4', 'gravatar_id': '', 'url': 'https://api.github.com/users/bddppq', 'html_url': 'https://github.com/bddppq', 'followers_url': 'https://api.github.com/users/bddppq/followers', 'following_url': 'https://api.github.com/users/bddppq/following{/other_user}', 'gists_url': 'https://api.github.com/users/bddppq/gists{/gist_id}', 'starred_url': 'https://api.github.com/users/bddppq/starred{/owner}{/repo}', 'subscriptions_url': 'https://api.github.com/users/bddppq/subscriptions', 'organizations_url': 'https://api.github.com/users/bddppq/orgs', 'repos_url': 'https://api.github.com/users/bddppq/repos', 'events_url': 'https://api.github.com/users/bddppq/events{/privacy}', 'received_events_url': 'https://api.github.com/users/bddppq/received_events', 'type': 'User', 'site_admin': False}",referenced,13ee739b3d4f84d4f88690bad964d3a0c5ac183a,https://api.github.com/repos/pytorch/pytorch/commits/13ee739b3d4f84d4f88690bad964d3a0c5ac183a,2018-10-15T21:13:08Z,850,774,76
1144,1905230819,"{'login': 'bddppq', 'id': 9300575, 'node_id': 'MDQ6VXNlcjkzMDA1NzU=', 'avatar_url': 'https://avatars2.githubusercontent.com/u/9300575?v=4', 'gravatar_id': '', 'url': 'https://api.github.com/users/bddppq', 'html_url': 'https://github.com/bddppq', 'followers_url': 'https://api.github.com/users/bddppq/followers', 'following_url': 'https://api.github.com/users/bddppq/following{/other_user}', 'gists_url': 'https://api.github.com/users/bddppq/gists{/gist_id}', 'starred_url': 'https://api.github.com/users/bddppq/starred{/owner}{/repo}', 'subscriptions_url': 'https://api.github.com/users/bddppq/subscriptions', 'organizations_url': 'https://api.github.com/users/bddppq/orgs', 'repos_url': 'https://api.github.com/users/bddppq/repos', 'events_url': 'https://api.github.com/users/bddppq/events{/privacy}', 'received_events_url': 'https://api.github.com/users/bddppq/received_events', 'type': 'User', 'site_admin': False}",referenced,575b2401bdf81797d9af159469a1d27c923d2cfd,https://api.github.com/repos/pytorch/pytorch/commits/575b2401bdf81797d9af159469a1d27c923d2cfd,2018-10-15T21:13:06Z,186,48,138
1139,1090963158,"{'login': 'kylemcdonald', 'id': 157106, 'node_id': 'MDQ6VXNlcjE1NzEwNg==', 'avatar_url': 'https://avatars3.githubusercontent.com/u/157106?v=4', 'gravatar_id': '', 'url': 'https://api.github.com/users/kylemcdonald', 'html_url': 'https://github.com/kylemcdonald', 'followers_url': 'https://api.github.com/users/kylemcdonald/followers', 'following_url': 'https://api.github.com/users/kylemcdonald/following{/other_user}', 'gists_url': 'https://api.github.com/users/kylemcdonald/gists{/gist_id}', 'starred_url': 'https://api.github.com/users/kylemcdonald/starred{/owner}{/repo}', 'subscriptions_url': 'https://api.github.com/users/kylemcdonald/subscriptions', 'organizations_url': 'https://api.github.com/users/kylemcdonald/orgs', 'repos_url': 'https://api.github.com/users/kylemcdonald/repos', 'events_url': 'https://api.github.com/users/kylemcdonald/events{/privacy}', 'received_events_url': 'https://api.github.com/users/kylemcdonald/received_events', 'type': 'User', 'site_admin': False}",referenced,3b4bc721efbe92463fca2330ded918b086e17e7e,https://api.github.com/repos/pytorch/pytorch/commits/3b4bc721efbe92463fca2330ded918b086e17e7e,2017-05-21T21:17:18Z,5,3,2
1137,1905230813,"{'login': 'bddppq', 'id': 9300575, 'node_id': 'MDQ6VXNlcjkzMDA1NzU=', 'avatar_url': 'https://avatars2.githubusercontent.com/u/9300575?v=4', 'gravatar_id': '', 'url': 'https://api.github.com/users/bddppq', 'html_url': 'https://github.com/bddppq', 'followers_url': 'https://api.github.com/users/bddppq/followers', 'following_url': 'https://api.github.com/users/bddppq/following{/other_user}', 'gists_url': 'https://api.github.com/users/bddppq/gists{/gist_id}', 'starred_url': 'https://api.github.com/users/bddppq/starred{/owner}{/repo}', 'subscriptions_url': 'https://api.github.com/users/bddppq/subscriptions', 'organizations_url': 'https://api.github.com/users/bddppq/orgs', 'repos_url': 'https://api.github.com/users/bddppq/repos', 'events_url': 'https://api.github.com/users/bddppq/events{/privacy}', 'received_events_url': 'https://api.github.com/users/bddppq/received_events', 'type': 'User', 'site_admin': False}",referenced,410530e8c6ad7e7b66644a247dace2de11a724e3,https://api.github.com/repos/pytorch/pytorch/commits/410530e8c6ad7e7b66644a247dace2de11a724e3,2018-10-15T21:13:06Z,4,3,1
1136,1905230861,"{'login': 'bddppq', 'id': 9300575, 'node_id': 'MDQ6VXNlcjkzMDA1NzU=', 'avatar_url': 'https://avatars2.githubusercontent.com/u/9300575?v=4', 'gravatar_id': '', 'url': 'https://api.github.com/users/bddppq', 'html_url': 'https://github.com/bddppq', 'followers_url': 'https://api.github.com/users/bddppq/followers', 'following_url': 'https://api.github.com/users/bddppq/following{/other_user}', 'gists_url': 'https://api.github.com/users/bddppq/gists{/gist_id}', 'starred_url': 'https://api.github.com/users/bddppq/starred{/owner}{/repo}', 'subscriptions_url': 'https://api.github.com/users/bddppq/subscriptions', 'organizations_url': 'https://api.github.com/users/bddppq/orgs', 'repos_url': 'https://api.github.com/users/bddppq/repos', 'events_url': 'https://api.github.com/users/bddppq/events{/privacy}', 'received_events_url': 'https://api.github.com/users/bddppq/received_events', 'type': 'User', 'site_admin': False}",referenced,382a82e08a577d37e0dac50be4c597a0186efbb3,https://api.github.com/repos/pytorch/pytorch/commits/382a82e08a577d37e0dac50be4c597a0186efbb3,2018-10-15T21:13:07Z,118,112,6
1134,1905230828,"{'login': 'bddppq', 'id': 9300575, 'node_id': 'MDQ6VXNlcjkzMDA1NzU=', 'avatar_url': 'https://avatars2.githubusercontent.com/u/9300575?v=4', 'gravatar_id': '', 'url': 'https://api.github.com/users/bddppq', 'html_url': 'https://github.com/bddppq', 'followers_url': 'https://api.github.com/users/bddppq/followers', 'following_url': 'https://api.github.com/users/bddppq/following{/other_user}', 'gists_url': 'https://api.github.com/users/bddppq/gists{/gist_id}', 'starred_url': 'https://api.github.com/users/bddppq/starred{/owner}{/repo}', 'subscriptions_url': 'https://api.github.com/users/bddppq/subscriptions', 'organizations_url': 'https://api.github.com/users/bddppq/orgs', 'repos_url': 'https://api.github.com/users/bddppq/repos', 'events_url': 'https://api.github.com/users/bddppq/events{/privacy}', 'received_events_url': 'https://api.github.com/users/bddppq/received_events', 'type': 'User', 'site_admin': False}",referenced,7471c6a4b0fec50f61761e0c47e5334bf48da009,https://api.github.com/repos/pytorch/pytorch/commits/7471c6a4b0fec50f61761e0c47e5334bf48da009,2018-10-15T21:13:06Z,150,134,16
1129,1905230801,"{'login': 'bddppq', 'id': 9300575, 'node_id': 'MDQ6VXNlcjkzMDA1NzU=', 'avatar_url': 'https://avatars2.githubusercontent.com/u/9300575?v=4', 'gravatar_id': '', 'url': 'https://api.github.com/users/bddppq', 'html_url': 'https://github.com/bddppq', 'followers_url': 'https://api.github.com/users/bddppq/followers', 'following_url': 'https://api.github.com/users/bddppq/following{/other_user}', 'gists_url': 'https://api.github.com/users/bddppq/gists{/gist_id}', 'starred_url': 'https://api.github.com/users/bddppq/starred{/owner}{/repo}', 'subscriptions_url': 'https://api.github.com/users/bddppq/subscriptions', 'organizations_url': 'https://api.github.com/users/bddppq/orgs', 'repos_url': 'https://api.github.com/users/bddppq/repos', 'events_url': 'https://api.github.com/users/bddppq/events{/privacy}', 'received_events_url': 'https://api.github.com/users/bddppq/received_events', 'type': 'User', 'site_admin': False}",referenced,7558954ffd6b8b84d5c2a1859f853578076fae2e,https://api.github.com/repos/pytorch/pytorch/commits/7558954ffd6b8b84d5c2a1859f853578076fae2e,2018-10-15T21:13:06Z,2,1,1
1127,1124938265,"{'login': 'soumith', 'id': 1310570, 'node_id': 'MDQ6VXNlcjEzMTA1NzA=', 'avatar_url': 'https://avatars0.githubusercontent.com/u/1310570?v=4', 'gravatar_id': '', 'url': 'https://api.github.com/users/soumith', 'html_url': 'https://github.com/soumith', 'followers_url': 'https://api.github.com/users/soumith/followers', 'following_url': 'https://api.github.com/users/soumith/following{/other_user}', 'gists_url': 'https://api.github.com/users/soumith/gists{/gist_id}', 'starred_url': 'https://api.github.com/users/soumith/starred{/owner}{/repo}', 'subscriptions_url': 'https://api.github.com/users/soumith/subscriptions', 'organizations_url': 'https://api.github.com/users/soumith/orgs', 'repos_url': 'https://api.github.com/users/soumith/repos', 'events_url': 'https://api.github.com/users/soumith/events{/privacy}', 'received_events_url': 'https://api.github.com/users/soumith/received_events', 'type': 'User', 'site_admin': False}",closed,909f31764faf65c80f4d8eaeae8a12c67eb24c17,https://api.github.com/repos/pytorch/pytorch/commits/909f31764faf65c80f4d8eaeae8a12c67eb24c17,2017-06-15T11:41:45Z,158,152,6
1124,1905230814,"{'login': 'bddppq', 'id': 9300575, 'node_id': 'MDQ6VXNlcjkzMDA1NzU=', 'avatar_url': 'https://avatars2.githubusercontent.com/u/9300575?v=4', 'gravatar_id': '', 'url': 'https://api.github.com/users/bddppq', 'html_url': 'https://github.com/bddppq', 'followers_url': 'https://api.github.com/users/bddppq/followers', 'following_url': 'https://api.github.com/users/bddppq/following{/other_user}', 'gists_url': 'https://api.github.com/users/bddppq/gists{/gist_id}', 'starred_url': 'https://api.github.com/users/bddppq/starred{/owner}{/repo}', 'subscriptions_url': 'https://api.github.com/users/bddppq/subscriptions', 'organizations_url': 'https://api.github.com/users/bddppq/orgs', 'repos_url': 'https://api.github.com/users/bddppq/repos', 'events_url': 'https://api.github.com/users/bddppq/events{/privacy}', 'received_events_url': 'https://api.github.com/users/bddppq/received_events', 'type': 'User', 'site_admin': False}",referenced,6bedd27b0307c9295039bd847895a27275160a98,https://api.github.com/repos/pytorch/pytorch/commits/6bedd27b0307c9295039bd847895a27275160a98,2018-10-15T21:13:06Z,640,442,198
1112,1905230902,"{'login': 'bddppq', 'id': 9300575, 'node_id': 'MDQ6VXNlcjkzMDA1NzU=', 'avatar_url': 'https://avatars2.githubusercontent.com/u/9300575?v=4', 'gravatar_id': '', 'url': 'https://api.github.com/users/bddppq', 'html_url': 'https://github.com/bddppq', 'followers_url': 'https://api.github.com/users/bddppq/followers', 'following_url': 'https://api.github.com/users/bddppq/following{/other_user}', 'gists_url': 'https://api.github.com/users/bddppq/gists{/gist_id}', 'starred_url': 'https://api.github.com/users/bddppq/starred{/owner}{/repo}', 'subscriptions_url': 'https://api.github.com/users/bddppq/subscriptions', 'organizations_url': 'https://api.github.com/users/bddppq/orgs', 'repos_url': 'https://api.github.com/users/bddppq/repos', 'events_url': 'https://api.github.com/users/bddppq/events{/privacy}', 'received_events_url': 'https://api.github.com/users/bddppq/received_events', 'type': 'User', 'site_admin': False}",referenced,f09d8d6b15c4c46d8217b3e784d0217f839da75e,https://api.github.com/repos/pytorch/pytorch/commits/f09d8d6b15c4c46d8217b3e784d0217f839da75e,2018-10-15T21:13:08Z,664,632,32
1110,1905230767,"{'login': 'bddppq', 'id': 9300575, 'node_id': 'MDQ6VXNlcjkzMDA1NzU=', 'avatar_url': 'https://avatars2.githubusercontent.com/u/9300575?v=4', 'gravatar_id': '', 'url': 'https://api.github.com/users/bddppq', 'html_url': 'https://github.com/bddppq', 'followers_url': 'https://api.github.com/users/bddppq/followers', 'following_url': 'https://api.github.com/users/bddppq/following{/other_user}', 'gists_url': 'https://api.github.com/users/bddppq/gists{/gist_id}', 'starred_url': 'https://api.github.com/users/bddppq/starred{/owner}{/repo}', 'subscriptions_url': 'https://api.github.com/users/bddppq/subscriptions', 'organizations_url': 'https://api.github.com/users/bddppq/orgs', 'repos_url': 'https://api.github.com/users/bddppq/repos', 'events_url': 'https://api.github.com/users/bddppq/events{/privacy}', 'received_events_url': 'https://api.github.com/users/bddppq/received_events', 'type': 'User', 'site_admin': False}",referenced,b7d5a60f90e80a0114bf392d9a8655c149125c9c,https://api.github.com/repos/pytorch/pytorch/commits/b7d5a60f90e80a0114bf392d9a8655c149125c9c,2018-10-15T21:13:05Z,5537,5537,0
1107,1905230764,"{'login': 'bddppq', 'id': 9300575, 'node_id': 'MDQ6VXNlcjkzMDA1NzU=', 'avatar_url': 'https://avatars2.githubusercontent.com/u/9300575?v=4', 'gravatar_id': '', 'url': 'https://api.github.com/users/bddppq', 'html_url': 'https://github.com/bddppq', 'followers_url': 'https://api.github.com/users/bddppq/followers', 'following_url': 'https://api.github.com/users/bddppq/following{/other_user}', 'gists_url': 'https://api.github.com/users/bddppq/gists{/gist_id}', 'starred_url': 'https://api.github.com/users/bddppq/starred{/owner}{/repo}', 'subscriptions_url': 'https://api.github.com/users/bddppq/subscriptions', 'organizations_url': 'https://api.github.com/users/bddppq/orgs', 'repos_url': 'https://api.github.com/users/bddppq/repos', 'events_url': 'https://api.github.com/users/bddppq/events{/privacy}', 'received_events_url': 'https://api.github.com/users/bddppq/received_events', 'type': 'User', 'site_admin': False}",referenced,86999f90f030cf82eee153eb265a1303720772ed,https://api.github.com/repos/pytorch/pytorch/commits/86999f90f030cf82eee153eb265a1303720772ed,2018-10-15T21:13:05Z,6,3,3
1106,1905230796,"{'login': 'bddppq', 'id': 9300575, 'node_id': 'MDQ6VXNlcjkzMDA1NzU=', 'avatar_url': 'https://avatars2.githubusercontent.com/u/9300575?v=4', 'gravatar_id': '', 'url': 'https://api.github.com/users/bddppq', 'html_url': 'https://github.com/bddppq', 'followers_url': 'https://api.github.com/users/bddppq/followers', 'following_url': 'https://api.github.com/users/bddppq/following{/other_user}', 'gists_url': 'https://api.github.com/users/bddppq/gists{/gist_id}', 'starred_url': 'https://api.github.com/users/bddppq/starred{/owner}{/repo}', 'subscriptions_url': 'https://api.github.com/users/bddppq/subscriptions', 'organizations_url': 'https://api.github.com/users/bddppq/orgs', 'repos_url': 'https://api.github.com/users/bddppq/repos', 'events_url': 'https://api.github.com/users/bddppq/events{/privacy}', 'received_events_url': 'https://api.github.com/users/bddppq/received_events', 'type': 'User', 'site_admin': False}",referenced,068f1a4079f02fcbd6e17b74e55577369a6f56f8,https://api.github.com/repos/pytorch/pytorch/commits/068f1a4079f02fcbd6e17b74e55577369a6f56f8,2018-10-15T21:13:06Z,525,510,15
1098,1905230757,"{'login': 'bddppq', 'id': 9300575, 'node_id': 'MDQ6VXNlcjkzMDA1NzU=', 'avatar_url': 'https://avatars2.githubusercontent.com/u/9300575?v=4', 'gravatar_id': '', 'url': 'https://api.github.com/users/bddppq', 'html_url': 'https://github.com/bddppq', 'followers_url': 'https://api.github.com/users/bddppq/followers', 'following_url': 'https://api.github.com/users/bddppq/following{/other_user}', 'gists_url': 'https://api.github.com/users/bddppq/gists{/gist_id}', 'starred_url': 'https://api.github.com/users/bddppq/starred{/owner}{/repo}', 'subscriptions_url': 'https://api.github.com/users/bddppq/subscriptions', 'organizations_url': 'https://api.github.com/users/bddppq/orgs', 'repos_url': 'https://api.github.com/users/bddppq/repos', 'events_url': 'https://api.github.com/users/bddppq/events{/privacy}', 'received_events_url': 'https://api.github.com/users/bddppq/received_events', 'type': 'User', 'site_admin': False}",referenced,39e46687eafd34c78dd59a1218171371aa3679f1,https://api.github.com/repos/pytorch/pytorch/commits/39e46687eafd34c78dd59a1218171371aa3679f1,2018-10-15T21:13:05Z,2,1,1
1095,1905230777,"{'login': 'bddppq', 'id': 9300575, 'node_id': 'MDQ6VXNlcjkzMDA1NzU=', 'avatar_url': 'https://avatars2.githubusercontent.com/u/9300575?v=4', 'gravatar_id': '', 'url': 'https://api.github.com/users/bddppq', 'html_url': 'https://github.com/bddppq', 'followers_url': 'https://api.github.com/users/bddppq/followers', 'following_url': 'https://api.github.com/users/bddppq/following{/other_user}', 'gists_url': 'https://api.github.com/users/bddppq/gists{/gist_id}', 'starred_url': 'https://api.github.com/users/bddppq/starred{/owner}{/repo}', 'subscriptions_url': 'https://api.github.com/users/bddppq/subscriptions', 'organizations_url': 'https://api.github.com/users/bddppq/orgs', 'repos_url': 'https://api.github.com/users/bddppq/repos', 'events_url': 'https://api.github.com/users/bddppq/events{/privacy}', 'received_events_url': 'https://api.github.com/users/bddppq/received_events', 'type': 'User', 'site_admin': False}",referenced,c6479945bb0a02bd079867f260ee940df1332322,https://api.github.com/repos/pytorch/pytorch/commits/c6479945bb0a02bd079867f260ee940df1332322,2018-10-15T21:13:05Z,12,6,6
1088,1905230745,"{'login': 'bddppq', 'id': 9300575, 'node_id': 'MDQ6VXNlcjkzMDA1NzU=', 'avatar_url': 'https://avatars2.githubusercontent.com/u/9300575?v=4', 'gravatar_id': '', 'url': 'https://api.github.com/users/bddppq', 'html_url': 'https://github.com/bddppq', 'followers_url': 'https://api.github.com/users/bddppq/followers', 'following_url': 'https://api.github.com/users/bddppq/following{/other_user}', 'gists_url': 'https://api.github.com/users/bddppq/gists{/gist_id}', 'starred_url': 'https://api.github.com/users/bddppq/starred{/owner}{/repo}', 'subscriptions_url': 'https://api.github.com/users/bddppq/subscriptions', 'organizations_url': 'https://api.github.com/users/bddppq/orgs', 'repos_url': 'https://api.github.com/users/bddppq/repos', 'events_url': 'https://api.github.com/users/bddppq/events{/privacy}', 'received_events_url': 'https://api.github.com/users/bddppq/received_events', 'type': 'User', 'site_admin': False}",referenced,18d70ff5294953ccdf791b44ce5ccd9065584945,https://api.github.com/repos/pytorch/pytorch/commits/18d70ff5294953ccdf791b44ce5ccd9065584945,2018-10-15T21:13:04Z,37,21,16
1086,1014365140,"{'login': 'apaszke', 'id': 4583066, 'node_id': 'MDQ6VXNlcjQ1ODMwNjY=', 'avatar_url': 'https://avatars3.githubusercontent.com/u/4583066?v=4', 'gravatar_id': '', 'url': 'https://api.github.com/users/apaszke', 'html_url': 'https://github.com/apaszke', 'followers_url': 'https://api.github.com/users/apaszke/followers', 'following_url': 'https://api.github.com/users/apaszke/following{/other_user}', 'gists_url': 'https://api.github.com/users/apaszke/gists{/gist_id}', 'starred_url': 'https://api.github.com/users/apaszke/starred{/owner}{/repo}', 'subscriptions_url': 'https://api.github.com/users/apaszke/subscriptions', 'organizations_url': 'https://api.github.com/users/apaszke/orgs', 'repos_url': 'https://api.github.com/users/apaszke/repos', 'events_url': 'https://api.github.com/users/apaszke/events{/privacy}', 'received_events_url': 'https://api.github.com/users/apaszke/received_events', 'type': 'User', 'site_admin': False}",referenced,1d656b6769469a4e44373dbd8e2d5b41ade78770,https://api.github.com/repos/pytorch/pytorch/commits/1d656b6769469a4e44373dbd8e2d5b41ade78770,2017-03-24T14:21:56Z,2,1,1
1086,1905230822,"{'login': 'bddppq', 'id': 9300575, 'node_id': 'MDQ6VXNlcjkzMDA1NzU=', 'avatar_url': 'https://avatars2.githubusercontent.com/u/9300575?v=4', 'gravatar_id': '', 'url': 'https://api.github.com/users/bddppq', 'html_url': 'https://github.com/bddppq', 'followers_url': 'https://api.github.com/users/bddppq/followers', 'following_url': 'https://api.github.com/users/bddppq/following{/other_user}', 'gists_url': 'https://api.github.com/users/bddppq/gists{/gist_id}', 'starred_url': 'https://api.github.com/users/bddppq/starred{/owner}{/repo}', 'subscriptions_url': 'https://api.github.com/users/bddppq/subscriptions', 'organizations_url': 'https://api.github.com/users/bddppq/orgs', 'repos_url': 'https://api.github.com/users/bddppq/repos', 'events_url': 'https://api.github.com/users/bddppq/events{/privacy}', 'received_events_url': 'https://api.github.com/users/bddppq/received_events', 'type': 'User', 'site_admin': False}",referenced,f2584e8cdfa078ae0aa66cfaa6ad8212ee3f07b0,https://api.github.com/repos/pytorch/pytorch/commits/f2584e8cdfa078ae0aa66cfaa6ad8212ee3f07b0,2018-10-15T21:13:06Z,1,1,0
1046,1161116003,"{'login': 'soumith', 'id': 1310570, 'node_id': 'MDQ6VXNlcjEzMTA1NzA=', 'avatar_url': 'https://avatars0.githubusercontent.com/u/1310570?v=4', 'gravatar_id': '', 'url': 'https://api.github.com/users/soumith', 'html_url': 'https://github.com/soumith', 'followers_url': 'https://api.github.com/users/soumith/followers', 'following_url': 'https://api.github.com/users/soumith/following{/other_user}', 'gists_url': 'https://api.github.com/users/soumith/gists{/gist_id}', 'starred_url': 'https://api.github.com/users/soumith/starred{/owner}{/repo}', 'subscriptions_url': 'https://api.github.com/users/soumith/subscriptions', 'organizations_url': 'https://api.github.com/users/soumith/orgs', 'repos_url': 'https://api.github.com/users/soumith/repos', 'events_url': 'https://api.github.com/users/soumith/events{/privacy}', 'received_events_url': 'https://api.github.com/users/soumith/received_events', 'type': 'User', 'site_admin': False}",referenced,f483679425fc766660003569fcc9789ee6a6fb0d,https://api.github.com/repos/pytorch/pytorch/commits/f483679425fc766660003569fcc9789ee6a6fb0d,2017-07-12T16:58:07Z,112,112,0
1044,1905230672,"{'login': 'bddppq', 'id': 9300575, 'node_id': 'MDQ6VXNlcjkzMDA1NzU=', 'avatar_url': 'https://avatars2.githubusercontent.com/u/9300575?v=4', 'gravatar_id': '', 'url': 'https://api.github.com/users/bddppq', 'html_url': 'https://github.com/bddppq', 'followers_url': 'https://api.github.com/users/bddppq/followers', 'following_url': 'https://api.github.com/users/bddppq/following{/other_user}', 'gists_url': 'https://api.github.com/users/bddppq/gists{/gist_id}', 'starred_url': 'https://api.github.com/users/bddppq/starred{/owner}{/repo}', 'subscriptions_url': 'https://api.github.com/users/bddppq/subscriptions', 'organizations_url': 'https://api.github.com/users/bddppq/orgs', 'repos_url': 'https://api.github.com/users/bddppq/repos', 'events_url': 'https://api.github.com/users/bddppq/events{/privacy}', 'received_events_url': 'https://api.github.com/users/bddppq/received_events', 'type': 'User', 'site_admin': False}",referenced,7361eec59a2c0589125c0c5a4a90b43593b965c7,https://api.github.com/repos/pytorch/pytorch/commits/7361eec59a2c0589125c0c5a4a90b43593b965c7,2018-10-15T21:13:03Z,135,117,18
1041,1905230660,"{'login': 'bddppq', 'id': 9300575, 'node_id': 'MDQ6VXNlcjkzMDA1NzU=', 'avatar_url': 'https://avatars2.githubusercontent.com/u/9300575?v=4', 'gravatar_id': '', 'url': 'https://api.github.com/users/bddppq', 'html_url': 'https://github.com/bddppq', 'followers_url': 'https://api.github.com/users/bddppq/followers', 'following_url': 'https://api.github.com/users/bddppq/following{/other_user}', 'gists_url': 'https://api.github.com/users/bddppq/gists{/gist_id}', 'starred_url': 'https://api.github.com/users/bddppq/starred{/owner}{/repo}', 'subscriptions_url': 'https://api.github.com/users/bddppq/subscriptions', 'organizations_url': 'https://api.github.com/users/bddppq/orgs', 'repos_url': 'https://api.github.com/users/bddppq/repos', 'events_url': 'https://api.github.com/users/bddppq/events{/privacy}', 'received_events_url': 'https://api.github.com/users/bddppq/received_events', 'type': 'User', 'site_admin': False}",referenced,e5701271f05ce412edf646fed504ad8f4bcb0eca,https://api.github.com/repos/pytorch/pytorch/commits/e5701271f05ce412edf646fed504ad8f4bcb0eca,2018-10-15T21:13:03Z,2,1,1
1040,1905230657,"{'login': 'bddppq', 'id': 9300575, 'node_id': 'MDQ6VXNlcjkzMDA1NzU=', 'avatar_url': 'https://avatars2.githubusercontent.com/u/9300575?v=4', 'gravatar_id': '', 'url': 'https://api.github.com/users/bddppq', 'html_url': 'https://github.com/bddppq', 'followers_url': 'https://api.github.com/users/bddppq/followers', 'following_url': 'https://api.github.com/users/bddppq/following{/other_user}', 'gists_url': 'https://api.github.com/users/bddppq/gists{/gist_id}', 'starred_url': 'https://api.github.com/users/bddppq/starred{/owner}{/repo}', 'subscriptions_url': 'https://api.github.com/users/bddppq/subscriptions', 'organizations_url': 'https://api.github.com/users/bddppq/orgs', 'repos_url': 'https://api.github.com/users/bddppq/repos', 'events_url': 'https://api.github.com/users/bddppq/events{/privacy}', 'received_events_url': 'https://api.github.com/users/bddppq/received_events', 'type': 'User', 'site_admin': False}",referenced,789efb166d16b00c498cd789cc19c1c005e0e3aa,https://api.github.com/repos/pytorch/pytorch/commits/789efb166d16b00c498cd789cc19c1c005e0e3aa,2018-10-15T21:13:03Z,24,12,12
1038,1905230680,"{'login': 'bddppq', 'id': 9300575, 'node_id': 'MDQ6VXNlcjkzMDA1NzU=', 'avatar_url': 'https://avatars2.githubusercontent.com/u/9300575?v=4', 'gravatar_id': '', 'url': 'https://api.github.com/users/bddppq', 'html_url': 'https://github.com/bddppq', 'followers_url': 'https://api.github.com/users/bddppq/followers', 'following_url': 'https://api.github.com/users/bddppq/following{/other_user}', 'gists_url': 'https://api.github.com/users/bddppq/gists{/gist_id}', 'starred_url': 'https://api.github.com/users/bddppq/starred{/owner}{/repo}', 'subscriptions_url': 'https://api.github.com/users/bddppq/subscriptions', 'organizations_url': 'https://api.github.com/users/bddppq/orgs', 'repos_url': 'https://api.github.com/users/bddppq/repos', 'events_url': 'https://api.github.com/users/bddppq/events{/privacy}', 'received_events_url': 'https://api.github.com/users/bddppq/received_events', 'type': 'User', 'site_admin': False}",referenced,307995b1439e478122780ffc9d4e3ee8910fb7ad,https://api.github.com/repos/pytorch/pytorch/commits/307995b1439e478122780ffc9d4e3ee8910fb7ad,2018-10-15T21:13:03Z,42,22,20
1037,1905230653,"{'login': 'bddppq', 'id': 9300575, 'node_id': 'MDQ6VXNlcjkzMDA1NzU=', 'avatar_url': 'https://avatars2.githubusercontent.com/u/9300575?v=4', 'gravatar_id': '', 'url': 'https://api.github.com/users/bddppq', 'html_url': 'https://github.com/bddppq', 'followers_url': 'https://api.github.com/users/bddppq/followers', 'following_url': 'https://api.github.com/users/bddppq/following{/other_user}', 'gists_url': 'https://api.github.com/users/bddppq/gists{/gist_id}', 'starred_url': 'https://api.github.com/users/bddppq/starred{/owner}{/repo}', 'subscriptions_url': 'https://api.github.com/users/bddppq/subscriptions', 'organizations_url': 'https://api.github.com/users/bddppq/orgs', 'repos_url': 'https://api.github.com/users/bddppq/repos', 'events_url': 'https://api.github.com/users/bddppq/events{/privacy}', 'received_events_url': 'https://api.github.com/users/bddppq/received_events', 'type': 'User', 'site_admin': False}",referenced,ec3b6797b71663a42d5fe909845e4e25f246d43d,https://api.github.com/repos/pytorch/pytorch/commits/ec3b6797b71663a42d5fe909845e4e25f246d43d,2018-10-15T21:13:02Z,9,9,0
1035,1905230650,"{'login': 'bddppq', 'id': 9300575, 'node_id': 'MDQ6VXNlcjkzMDA1NzU=', 'avatar_url': 'https://avatars2.githubusercontent.com/u/9300575?v=4', 'gravatar_id': '', 'url': 'https://api.github.com/users/bddppq', 'html_url': 'https://github.com/bddppq', 'followers_url': 'https://api.github.com/users/bddppq/followers', 'following_url': 'https://api.github.com/users/bddppq/following{/other_user}', 'gists_url': 'https://api.github.com/users/bddppq/gists{/gist_id}', 'starred_url': 'https://api.github.com/users/bddppq/starred{/owner}{/repo}', 'subscriptions_url': 'https://api.github.com/users/bddppq/subscriptions', 'organizations_url': 'https://api.github.com/users/bddppq/orgs', 'repos_url': 'https://api.github.com/users/bddppq/repos', 'events_url': 'https://api.github.com/users/bddppq/events{/privacy}', 'received_events_url': 'https://api.github.com/users/bddppq/received_events', 'type': 'User', 'site_admin': False}",referenced,94dbb76747067c91a7eaa3980939b7bbe237e9a4,https://api.github.com/repos/pytorch/pytorch/commits/94dbb76747067c91a7eaa3980939b7bbe237e9a4,2018-10-15T21:13:02Z,24,12,12
1034,1905230659,"{'login': 'bddppq', 'id': 9300575, 'node_id': 'MDQ6VXNlcjkzMDA1NzU=', 'avatar_url': 'https://avatars2.githubusercontent.com/u/9300575?v=4', 'gravatar_id': '', 'url': 'https://api.github.com/users/bddppq', 'html_url': 'https://github.com/bddppq', 'followers_url': 'https://api.github.com/users/bddppq/followers', 'following_url': 'https://api.github.com/users/bddppq/following{/other_user}', 'gists_url': 'https://api.github.com/users/bddppq/gists{/gist_id}', 'starred_url': 'https://api.github.com/users/bddppq/starred{/owner}{/repo}', 'subscriptions_url': 'https://api.github.com/users/bddppq/subscriptions', 'organizations_url': 'https://api.github.com/users/bddppq/orgs', 'repos_url': 'https://api.github.com/users/bddppq/repos', 'events_url': 'https://api.github.com/users/bddppq/events{/privacy}', 'received_events_url': 'https://api.github.com/users/bddppq/received_events', 'type': 'User', 'site_admin': False}",referenced,e5701271f05ce412edf646fed504ad8f4bcb0eca,https://api.github.com/repos/pytorch/pytorch/commits/e5701271f05ce412edf646fed504ad8f4bcb0eca,2018-10-15T21:13:03Z,2,1,1
1032,1905230644,"{'login': 'bddppq', 'id': 9300575, 'node_id': 'MDQ6VXNlcjkzMDA1NzU=', 'avatar_url': 'https://avatars2.githubusercontent.com/u/9300575?v=4', 'gravatar_id': '', 'url': 'https://api.github.com/users/bddppq', 'html_url': 'https://github.com/bddppq', 'followers_url': 'https://api.github.com/users/bddppq/followers', 'following_url': 'https://api.github.com/users/bddppq/following{/other_user}', 'gists_url': 'https://api.github.com/users/bddppq/gists{/gist_id}', 'starred_url': 'https://api.github.com/users/bddppq/starred{/owner}{/repo}', 'subscriptions_url': 'https://api.github.com/users/bddppq/subscriptions', 'organizations_url': 'https://api.github.com/users/bddppq/orgs', 'repos_url': 'https://api.github.com/users/bddppq/repos', 'events_url': 'https://api.github.com/users/bddppq/events{/privacy}', 'received_events_url': 'https://api.github.com/users/bddppq/received_events', 'type': 'User', 'site_admin': False}",referenced,94dbb76747067c91a7eaa3980939b7bbe237e9a4,https://api.github.com/repos/pytorch/pytorch/commits/94dbb76747067c91a7eaa3980939b7bbe237e9a4,2018-10-15T21:13:02Z,24,12,12
1031,1905230643,"{'login': 'bddppq', 'id': 9300575, 'node_id': 'MDQ6VXNlcjkzMDA1NzU=', 'avatar_url': 'https://avatars2.githubusercontent.com/u/9300575?v=4', 'gravatar_id': '', 'url': 'https://api.github.com/users/bddppq', 'html_url': 'https://github.com/bddppq', 'followers_url': 'https://api.github.com/users/bddppq/followers', 'following_url': 'https://api.github.com/users/bddppq/following{/other_user}', 'gists_url': 'https://api.github.com/users/bddppq/gists{/gist_id}', 'starred_url': 'https://api.github.com/users/bddppq/starred{/owner}{/repo}', 'subscriptions_url': 'https://api.github.com/users/bddppq/subscriptions', 'organizations_url': 'https://api.github.com/users/bddppq/orgs', 'repos_url': 'https://api.github.com/users/bddppq/repos', 'events_url': 'https://api.github.com/users/bddppq/events{/privacy}', 'received_events_url': 'https://api.github.com/users/bddppq/received_events', 'type': 'User', 'site_admin': False}",referenced,b18cbd336403fce94b637207bec4c8f5f4c7f489,https://api.github.com/repos/pytorch/pytorch/commits/b18cbd336403fce94b637207bec4c8f5f4c7f489,2018-10-15T21:13:02Z,7,0,7
1031,1905230654,"{'login': 'bddppq', 'id': 9300575, 'node_id': 'MDQ6VXNlcjkzMDA1NzU=', 'avatar_url': 'https://avatars2.githubusercontent.com/u/9300575?v=4', 'gravatar_id': '', 'url': 'https://api.github.com/users/bddppq', 'html_url': 'https://github.com/bddppq', 'followers_url': 'https://api.github.com/users/bddppq/followers', 'following_url': 'https://api.github.com/users/bddppq/following{/other_user}', 'gists_url': 'https://api.github.com/users/bddppq/gists{/gist_id}', 'starred_url': 'https://api.github.com/users/bddppq/starred{/owner}{/repo}', 'subscriptions_url': 'https://api.github.com/users/bddppq/subscriptions', 'organizations_url': 'https://api.github.com/users/bddppq/orgs', 'repos_url': 'https://api.github.com/users/bddppq/repos', 'events_url': 'https://api.github.com/users/bddppq/events{/privacy}', 'received_events_url': 'https://api.github.com/users/bddppq/received_events', 'type': 'User', 'site_admin': False}",referenced,ec3b6797b71663a42d5fe909845e4e25f246d43d,https://api.github.com/repos/pytorch/pytorch/commits/ec3b6797b71663a42d5fe909845e4e25f246d43d,2018-10-15T21:13:02Z,9,9,0
1029,1905230641,"{'login': 'bddppq', 'id': 9300575, 'node_id': 'MDQ6VXNlcjkzMDA1NzU=', 'avatar_url': 'https://avatars2.githubusercontent.com/u/9300575?v=4', 'gravatar_id': '', 'url': 'https://api.github.com/users/bddppq', 'html_url': 'https://github.com/bddppq', 'followers_url': 'https://api.github.com/users/bddppq/followers', 'following_url': 'https://api.github.com/users/bddppq/following{/other_user}', 'gists_url': 'https://api.github.com/users/bddppq/gists{/gist_id}', 'starred_url': 'https://api.github.com/users/bddppq/starred{/owner}{/repo}', 'subscriptions_url': 'https://api.github.com/users/bddppq/subscriptions', 'organizations_url': 'https://api.github.com/users/bddppq/orgs', 'repos_url': 'https://api.github.com/users/bddppq/repos', 'events_url': 'https://api.github.com/users/bddppq/events{/privacy}', 'received_events_url': 'https://api.github.com/users/bddppq/received_events', 'type': 'User', 'site_admin': False}",referenced,8236f49124dc0a37b8c33da2b8f962183c2c393e,https://api.github.com/repos/pytorch/pytorch/commits/8236f49124dc0a37b8c33da2b8f962183c2c393e,2018-10-15T21:13:02Z,3,3,0
1022,1905230622,"{'login': 'bddppq', 'id': 9300575, 'node_id': 'MDQ6VXNlcjkzMDA1NzU=', 'avatar_url': 'https://avatars2.githubusercontent.com/u/9300575?v=4', 'gravatar_id': '', 'url': 'https://api.github.com/users/bddppq', 'html_url': 'https://github.com/bddppq', 'followers_url': 'https://api.github.com/users/bddppq/followers', 'following_url': 'https://api.github.com/users/bddppq/following{/other_user}', 'gists_url': 'https://api.github.com/users/bddppq/gists{/gist_id}', 'starred_url': 'https://api.github.com/users/bddppq/starred{/owner}{/repo}', 'subscriptions_url': 'https://api.github.com/users/bddppq/subscriptions', 'organizations_url': 'https://api.github.com/users/bddppq/orgs', 'repos_url': 'https://api.github.com/users/bddppq/repos', 'events_url': 'https://api.github.com/users/bddppq/events{/privacy}', 'received_events_url': 'https://api.github.com/users/bddppq/received_events', 'type': 'User', 'site_admin': False}",referenced,9e6e7e4282ca4cd53eef7a51f90760c45dfbf2a3,https://api.github.com/repos/pytorch/pytorch/commits/9e6e7e4282ca4cd53eef7a51f90760c45dfbf2a3,2018-10-15T21:13:01Z,15,11,4
1015,1905230577,"{'login': 'bddppq', 'id': 9300575, 'node_id': 'MDQ6VXNlcjkzMDA1NzU=', 'avatar_url': 'https://avatars2.githubusercontent.com/u/9300575?v=4', 'gravatar_id': '', 'url': 'https://api.github.com/users/bddppq', 'html_url': 'https://github.com/bddppq', 'followers_url': 'https://api.github.com/users/bddppq/followers', 'following_url': 'https://api.github.com/users/bddppq/following{/other_user}', 'gists_url': 'https://api.github.com/users/bddppq/gists{/gist_id}', 'starred_url': 'https://api.github.com/users/bddppq/starred{/owner}{/repo}', 'subscriptions_url': 'https://api.github.com/users/bddppq/subscriptions', 'organizations_url': 'https://api.github.com/users/bddppq/orgs', 'repos_url': 'https://api.github.com/users/bddppq/repos', 'events_url': 'https://api.github.com/users/bddppq/events{/privacy}', 'received_events_url': 'https://api.github.com/users/bddppq/received_events', 'type': 'User', 'site_admin': False}",referenced,2391a9ec0617d0eb729b9c292bcbcc7d2faa737c,https://api.github.com/repos/pytorch/pytorch/commits/2391a9ec0617d0eb729b9c292bcbcc7d2faa737c,2018-10-15T21:13:01Z,6,3,3
1014,1905230589,"{'login': 'bddppq', 'id': 9300575, 'node_id': 'MDQ6VXNlcjkzMDA1NzU=', 'avatar_url': 'https://avatars2.githubusercontent.com/u/9300575?v=4', 'gravatar_id': '', 'url': 'https://api.github.com/users/bddppq', 'html_url': 'https://github.com/bddppq', 'followers_url': 'https://api.github.com/users/bddppq/followers', 'following_url': 'https://api.github.com/users/bddppq/following{/other_user}', 'gists_url': 'https://api.github.com/users/bddppq/gists{/gist_id}', 'starred_url': 'https://api.github.com/users/bddppq/starred{/owner}{/repo}', 'subscriptions_url': 'https://api.github.com/users/bddppq/subscriptions', 'organizations_url': 'https://api.github.com/users/bddppq/orgs', 'repos_url': 'https://api.github.com/users/bddppq/repos', 'events_url': 'https://api.github.com/users/bddppq/events{/privacy}', 'received_events_url': 'https://api.github.com/users/bddppq/received_events', 'type': 'User', 'site_admin': False}",referenced,48e58287de83a61bcdf13620ff331af8a463ec86,https://api.github.com/repos/pytorch/pytorch/commits/48e58287de83a61bcdf13620ff331af8a463ec86,2018-10-15T21:13:01Z,337,279,58
1011,1905230604,"{'login': 'bddppq', 'id': 9300575, 'node_id': 'MDQ6VXNlcjkzMDA1NzU=', 'avatar_url': 'https://avatars2.githubusercontent.com/u/9300575?v=4', 'gravatar_id': '', 'url': 'https://api.github.com/users/bddppq', 'html_url': 'https://github.com/bddppq', 'followers_url': 'https://api.github.com/users/bddppq/followers', 'following_url': 'https://api.github.com/users/bddppq/following{/other_user}', 'gists_url': 'https://api.github.com/users/bddppq/gists{/gist_id}', 'starred_url': 'https://api.github.com/users/bddppq/starred{/owner}{/repo}', 'subscriptions_url': 'https://api.github.com/users/bddppq/subscriptions', 'organizations_url': 'https://api.github.com/users/bddppq/orgs', 'repos_url': 'https://api.github.com/users/bddppq/repos', 'events_url': 'https://api.github.com/users/bddppq/events{/privacy}', 'received_events_url': 'https://api.github.com/users/bddppq/received_events', 'type': 'User', 'site_admin': False}",referenced,00b586d35990942f9bfd03ad5e3af9eb4e129156,https://api.github.com/repos/pytorch/pytorch/commits/00b586d35990942f9bfd03ad5e3af9eb4e129156,2018-10-15T21:13:01Z,23,23,0
1008,1905230566,"{'login': 'bddppq', 'id': 9300575, 'node_id': 'MDQ6VXNlcjkzMDA1NzU=', 'avatar_url': 'https://avatars2.githubusercontent.com/u/9300575?v=4', 'gravatar_id': '', 'url': 'https://api.github.com/users/bddppq', 'html_url': 'https://github.com/bddppq', 'followers_url': 'https://api.github.com/users/bddppq/followers', 'following_url': 'https://api.github.com/users/bddppq/following{/other_user}', 'gists_url': 'https://api.github.com/users/bddppq/gists{/gist_id}', 'starred_url': 'https://api.github.com/users/bddppq/starred{/owner}{/repo}', 'subscriptions_url': 'https://api.github.com/users/bddppq/subscriptions', 'organizations_url': 'https://api.github.com/users/bddppq/orgs', 'repos_url': 'https://api.github.com/users/bddppq/repos', 'events_url': 'https://api.github.com/users/bddppq/events{/privacy}', 'received_events_url': 'https://api.github.com/users/bddppq/received_events', 'type': 'User', 'site_admin': False}",referenced,bcf0212ea78fa6ab0ca3823d66ba8aafa24e9745,https://api.github.com/repos/pytorch/pytorch/commits/bcf0212ea78fa6ab0ca3823d66ba8aafa24e9745,2018-10-15T21:13:00Z,100,98,2
1004,1905230533,"{'login': 'bddppq', 'id': 9300575, 'node_id': 'MDQ6VXNlcjkzMDA1NzU=', 'avatar_url': 'https://avatars2.githubusercontent.com/u/9300575?v=4', 'gravatar_id': '', 'url': 'https://api.github.com/users/bddppq', 'html_url': 'https://github.com/bddppq', 'followers_url': 'https://api.github.com/users/bddppq/followers', 'following_url': 'https://api.github.com/users/bddppq/following{/other_user}', 'gists_url': 'https://api.github.com/users/bddppq/gists{/gist_id}', 'starred_url': 'https://api.github.com/users/bddppq/starred{/owner}{/repo}', 'subscriptions_url': 'https://api.github.com/users/bddppq/subscriptions', 'organizations_url': 'https://api.github.com/users/bddppq/orgs', 'repos_url': 'https://api.github.com/users/bddppq/repos', 'events_url': 'https://api.github.com/users/bddppq/events{/privacy}', 'received_events_url': 'https://api.github.com/users/bddppq/received_events', 'type': 'User', 'site_admin': False}",referenced,c16830303166e442b1b77b3b3b6b4b97c258dd9a,https://api.github.com/repos/pytorch/pytorch/commits/c16830303166e442b1b77b3b3b6b4b97c258dd9a,2018-10-15T21:13:00Z,3,3,0
1000,1905230541,"{'login': 'bddppq', 'id': 9300575, 'node_id': 'MDQ6VXNlcjkzMDA1NzU=', 'avatar_url': 'https://avatars2.githubusercontent.com/u/9300575?v=4', 'gravatar_id': '', 'url': 'https://api.github.com/users/bddppq', 'html_url': 'https://github.com/bddppq', 'followers_url': 'https://api.github.com/users/bddppq/followers', 'following_url': 'https://api.github.com/users/bddppq/following{/other_user}', 'gists_url': 'https://api.github.com/users/bddppq/gists{/gist_id}', 'starred_url': 'https://api.github.com/users/bddppq/starred{/owner}{/repo}', 'subscriptions_url': 'https://api.github.com/users/bddppq/subscriptions', 'organizations_url': 'https://api.github.com/users/bddppq/orgs', 'repos_url': 'https://api.github.com/users/bddppq/repos', 'events_url': 'https://api.github.com/users/bddppq/events{/privacy}', 'received_events_url': 'https://api.github.com/users/bddppq/received_events', 'type': 'User', 'site_admin': False}",referenced,5dd68e634bb8a77a0bae051468e40171e5348478,https://api.github.com/repos/pytorch/pytorch/commits/5dd68e634bb8a77a0bae051468e40171e5348478,2018-10-15T21:13:00Z,64,64,0
998,1905230530,"{'login': 'bddppq', 'id': 9300575, 'node_id': 'MDQ6VXNlcjkzMDA1NzU=', 'avatar_url': 'https://avatars2.githubusercontent.com/u/9300575?v=4', 'gravatar_id': '', 'url': 'https://api.github.com/users/bddppq', 'html_url': 'https://github.com/bddppq', 'followers_url': 'https://api.github.com/users/bddppq/followers', 'following_url': 'https://api.github.com/users/bddppq/following{/other_user}', 'gists_url': 'https://api.github.com/users/bddppq/gists{/gist_id}', 'starred_url': 'https://api.github.com/users/bddppq/starred{/owner}{/repo}', 'subscriptions_url': 'https://api.github.com/users/bddppq/subscriptions', 'organizations_url': 'https://api.github.com/users/bddppq/orgs', 'repos_url': 'https://api.github.com/users/bddppq/repos', 'events_url': 'https://api.github.com/users/bddppq/events{/privacy}', 'received_events_url': 'https://api.github.com/users/bddppq/received_events', 'type': 'User', 'site_admin': False}",referenced,8bc4bae258366aeae787ca0aed90798697512511,https://api.github.com/repos/pytorch/pytorch/commits/8bc4bae258366aeae787ca0aed90798697512511,2018-10-15T21:13:00Z,4,2,2
992,1905230551,"{'login': 'bddppq', 'id': 9300575, 'node_id': 'MDQ6VXNlcjkzMDA1NzU=', 'avatar_url': 'https://avatars2.githubusercontent.com/u/9300575?v=4', 'gravatar_id': '', 'url': 'https://api.github.com/users/bddppq', 'html_url': 'https://github.com/bddppq', 'followers_url': 'https://api.github.com/users/bddppq/followers', 'following_url': 'https://api.github.com/users/bddppq/following{/other_user}', 'gists_url': 'https://api.github.com/users/bddppq/gists{/gist_id}', 'starred_url': 'https://api.github.com/users/bddppq/starred{/owner}{/repo}', 'subscriptions_url': 'https://api.github.com/users/bddppq/subscriptions', 'organizations_url': 'https://api.github.com/users/bddppq/orgs', 'repos_url': 'https://api.github.com/users/bddppq/repos', 'events_url': 'https://api.github.com/users/bddppq/events{/privacy}', 'received_events_url': 'https://api.github.com/users/bddppq/received_events', 'type': 'User', 'site_admin': False}",referenced,9065e0044ca5f7e50bf35c70ab51e5bf850c7a58,https://api.github.com/repos/pytorch/pytorch/commits/9065e0044ca5f7e50bf35c70ab51e5bf850c7a58,2018-10-15T21:13:00Z,16,4,12
991,1029317469,"{'login': 'soumith', 'id': 1310570, 'node_id': 'MDQ6VXNlcjEzMTA1NzA=', 'avatar_url': 'https://avatars0.githubusercontent.com/u/1310570?v=4', 'gravatar_id': '', 'url': 'https://api.github.com/users/soumith', 'html_url': 'https://github.com/soumith', 'followers_url': 'https://api.github.com/users/soumith/followers', 'following_url': 'https://api.github.com/users/soumith/following{/other_user}', 'gists_url': 'https://api.github.com/users/soumith/gists{/gist_id}', 'starred_url': 'https://api.github.com/users/soumith/starred{/owner}{/repo}', 'subscriptions_url': 'https://api.github.com/users/soumith/subscriptions', 'organizations_url': 'https://api.github.com/users/soumith/orgs', 'repos_url': 'https://api.github.com/users/soumith/repos', 'events_url': 'https://api.github.com/users/soumith/events{/privacy}', 'received_events_url': 'https://api.github.com/users/soumith/received_events', 'type': 'User', 'site_admin': False}",referenced,3abf2ef225081ac353a9a5512c1eaaafea02f3db,https://api.github.com/repos/pytorch/pytorch/commits/3abf2ef225081ac353a9a5512c1eaaafea02f3db,2017-04-04T22:39:58Z,8,4,4
991,1905230538,"{'login': 'bddppq', 'id': 9300575, 'node_id': 'MDQ6VXNlcjkzMDA1NzU=', 'avatar_url': 'https://avatars2.githubusercontent.com/u/9300575?v=4', 'gravatar_id': '', 'url': 'https://api.github.com/users/bddppq', 'html_url': 'https://github.com/bddppq', 'followers_url': 'https://api.github.com/users/bddppq/followers', 'following_url': 'https://api.github.com/users/bddppq/following{/other_user}', 'gists_url': 'https://api.github.com/users/bddppq/gists{/gist_id}', 'starred_url': 'https://api.github.com/users/bddppq/starred{/owner}{/repo}', 'subscriptions_url': 'https://api.github.com/users/bddppq/subscriptions', 'organizations_url': 'https://api.github.com/users/bddppq/orgs', 'repos_url': 'https://api.github.com/users/bddppq/repos', 'events_url': 'https://api.github.com/users/bddppq/events{/privacy}', 'received_events_url': 'https://api.github.com/users/bddppq/received_events', 'type': 'User', 'site_admin': False}",referenced,169b1561e9ce51fcb290a8341806267fcd2c3e7a,https://api.github.com/repos/pytorch/pytorch/commits/169b1561e9ce51fcb290a8341806267fcd2c3e7a,2018-10-15T21:13:00Z,45,27,18
987,1905230504,"{'login': 'bddppq', 'id': 9300575, 'node_id': 'MDQ6VXNlcjkzMDA1NzU=', 'avatar_url': 'https://avatars2.githubusercontent.com/u/9300575?v=4', 'gravatar_id': '', 'url': 'https://api.github.com/users/bddppq', 'html_url': 'https://github.com/bddppq', 'followers_url': 'https://api.github.com/users/bddppq/followers', 'following_url': 'https://api.github.com/users/bddppq/following{/other_user}', 'gists_url': 'https://api.github.com/users/bddppq/gists{/gist_id}', 'starred_url': 'https://api.github.com/users/bddppq/starred{/owner}{/repo}', 'subscriptions_url': 'https://api.github.com/users/bddppq/subscriptions', 'organizations_url': 'https://api.github.com/users/bddppq/orgs', 'repos_url': 'https://api.github.com/users/bddppq/repos', 'events_url': 'https://api.github.com/users/bddppq/events{/privacy}', 'received_events_url': 'https://api.github.com/users/bddppq/received_events', 'type': 'User', 'site_admin': False}",referenced,3fc5f43e913cf8b7304249d95dcb8ace7c4c933c,https://api.github.com/repos/pytorch/pytorch/commits/3fc5f43e913cf8b7304249d95dcb8ace7c4c933c,2018-10-15T21:12:59Z,4,1,3
986,1905230502,"{'login': 'bddppq', 'id': 9300575, 'node_id': 'MDQ6VXNlcjkzMDA1NzU=', 'avatar_url': 'https://avatars2.githubusercontent.com/u/9300575?v=4', 'gravatar_id': '', 'url': 'https://api.github.com/users/bddppq', 'html_url': 'https://github.com/bddppq', 'followers_url': 'https://api.github.com/users/bddppq/followers', 'following_url': 'https://api.github.com/users/bddppq/following{/other_user}', 'gists_url': 'https://api.github.com/users/bddppq/gists{/gist_id}', 'starred_url': 'https://api.github.com/users/bddppq/starred{/owner}{/repo}', 'subscriptions_url': 'https://api.github.com/users/bddppq/subscriptions', 'organizations_url': 'https://api.github.com/users/bddppq/orgs', 'repos_url': 'https://api.github.com/users/bddppq/repos', 'events_url': 'https://api.github.com/users/bddppq/events{/privacy}', 'received_events_url': 'https://api.github.com/users/bddppq/received_events', 'type': 'User', 'site_admin': False}",referenced,8d548e23617ec33a84ebdbc03abb4542640403d1,https://api.github.com/repos/pytorch/pytorch/commits/8d548e23617ec33a84ebdbc03abb4542640403d1,2018-10-15T21:12:59Z,93,47,46
977,1905230476,"{'login': 'bddppq', 'id': 9300575, 'node_id': 'MDQ6VXNlcjkzMDA1NzU=', 'avatar_url': 'https://avatars2.githubusercontent.com/u/9300575?v=4', 'gravatar_id': '', 'url': 'https://api.github.com/users/bddppq', 'html_url': 'https://github.com/bddppq', 'followers_url': 'https://api.github.com/users/bddppq/followers', 'following_url': 'https://api.github.com/users/bddppq/following{/other_user}', 'gists_url': 'https://api.github.com/users/bddppq/gists{/gist_id}', 'starred_url': 'https://api.github.com/users/bddppq/starred{/owner}{/repo}', 'subscriptions_url': 'https://api.github.com/users/bddppq/subscriptions', 'organizations_url': 'https://api.github.com/users/bddppq/orgs', 'repos_url': 'https://api.github.com/users/bddppq/repos', 'events_url': 'https://api.github.com/users/bddppq/events{/privacy}', 'received_events_url': 'https://api.github.com/users/bddppq/received_events', 'type': 'User', 'site_admin': False}",referenced,63234dbae66631462cb23f19b7228def5b371363,https://api.github.com/repos/pytorch/pytorch/commits/63234dbae66631462cb23f19b7228def5b371363,2018-10-15T21:12:58Z,172,0,172
976,1905230480,"{'login': 'bddppq', 'id': 9300575, 'node_id': 'MDQ6VXNlcjkzMDA1NzU=', 'avatar_url': 'https://avatars2.githubusercontent.com/u/9300575?v=4', 'gravatar_id': '', 'url': 'https://api.github.com/users/bddppq', 'html_url': 'https://github.com/bddppq', 'followers_url': 'https://api.github.com/users/bddppq/followers', 'following_url': 'https://api.github.com/users/bddppq/following{/other_user}', 'gists_url': 'https://api.github.com/users/bddppq/gists{/gist_id}', 'starred_url': 'https://api.github.com/users/bddppq/starred{/owner}{/repo}', 'subscriptions_url': 'https://api.github.com/users/bddppq/subscriptions', 'organizations_url': 'https://api.github.com/users/bddppq/orgs', 'repos_url': 'https://api.github.com/users/bddppq/repos', 'events_url': 'https://api.github.com/users/bddppq/events{/privacy}', 'received_events_url': 'https://api.github.com/users/bddppq/received_events', 'type': 'User', 'site_admin': False}",referenced,01745b28fa7af3ad59badc3a7830e47b30fb9148,https://api.github.com/repos/pytorch/pytorch/commits/01745b28fa7af3ad59badc3a7830e47b30fb9148,2018-10-15T21:12:59Z,6,6,0
947,1905230451,"{'login': 'bddppq', 'id': 9300575, 'node_id': 'MDQ6VXNlcjkzMDA1NzU=', 'avatar_url': 'https://avatars2.githubusercontent.com/u/9300575?v=4', 'gravatar_id': '', 'url': 'https://api.github.com/users/bddppq', 'html_url': 'https://github.com/bddppq', 'followers_url': 'https://api.github.com/users/bddppq/followers', 'following_url': 'https://api.github.com/users/bddppq/following{/other_user}', 'gists_url': 'https://api.github.com/users/bddppq/gists{/gist_id}', 'starred_url': 'https://api.github.com/users/bddppq/starred{/owner}{/repo}', 'subscriptions_url': 'https://api.github.com/users/bddppq/subscriptions', 'organizations_url': 'https://api.github.com/users/bddppq/orgs', 'repos_url': 'https://api.github.com/users/bddppq/repos', 'events_url': 'https://api.github.com/users/bddppq/events{/privacy}', 'received_events_url': 'https://api.github.com/users/bddppq/received_events', 'type': 'User', 'site_admin': False}",referenced,c918b4be91990e36ffa03483d511582886d91e6c,https://api.github.com/repos/pytorch/pytorch/commits/c918b4be91990e36ffa03483d511582886d91e6c,2018-10-15T21:12:58Z,20,10,10
946,1905230418,"{'login': 'bddppq', 'id': 9300575, 'node_id': 'MDQ6VXNlcjkzMDA1NzU=', 'avatar_url': 'https://avatars2.githubusercontent.com/u/9300575?v=4', 'gravatar_id': '', 'url': 'https://api.github.com/users/bddppq', 'html_url': 'https://github.com/bddppq', 'followers_url': 'https://api.github.com/users/bddppq/followers', 'following_url': 'https://api.github.com/users/bddppq/following{/other_user}', 'gists_url': 'https://api.github.com/users/bddppq/gists{/gist_id}', 'starred_url': 'https://api.github.com/users/bddppq/starred{/owner}{/repo}', 'subscriptions_url': 'https://api.github.com/users/bddppq/subscriptions', 'organizations_url': 'https://api.github.com/users/bddppq/orgs', 'repos_url': 'https://api.github.com/users/bddppq/repos', 'events_url': 'https://api.github.com/users/bddppq/events{/privacy}', 'received_events_url': 'https://api.github.com/users/bddppq/received_events', 'type': 'User', 'site_admin': False}",referenced,330fd0f73e490a75149f5a9c8a8bf78c702ef968,https://api.github.com/repos/pytorch/pytorch/commits/330fd0f73e490a75149f5a9c8a8bf78c702ef968,2018-10-15T21:12:57Z,67,59,8
944,1905230408,"{'login': 'bddppq', 'id': 9300575, 'node_id': 'MDQ6VXNlcjkzMDA1NzU=', 'avatar_url': 'https://avatars2.githubusercontent.com/u/9300575?v=4', 'gravatar_id': '', 'url': 'https://api.github.com/users/bddppq', 'html_url': 'https://github.com/bddppq', 'followers_url': 'https://api.github.com/users/bddppq/followers', 'following_url': 'https://api.github.com/users/bddppq/following{/other_user}', 'gists_url': 'https://api.github.com/users/bddppq/gists{/gist_id}', 'starred_url': 'https://api.github.com/users/bddppq/starred{/owner}{/repo}', 'subscriptions_url': 'https://api.github.com/users/bddppq/subscriptions', 'organizations_url': 'https://api.github.com/users/bddppq/orgs', 'repos_url': 'https://api.github.com/users/bddppq/repos', 'events_url': 'https://api.github.com/users/bddppq/events{/privacy}', 'received_events_url': 'https://api.github.com/users/bddppq/received_events', 'type': 'User', 'site_admin': False}",referenced,0a6076eae6498ce33ad79a62c5fb03889f7f1d2c,https://api.github.com/repos/pytorch/pytorch/commits/0a6076eae6498ce33ad79a62c5fb03889f7f1d2c,2018-10-15T21:12:57Z,4,2,2
943,1905230412,"{'login': 'bddppq', 'id': 9300575, 'node_id': 'MDQ6VXNlcjkzMDA1NzU=', 'avatar_url': 'https://avatars2.githubusercontent.com/u/9300575?v=4', 'gravatar_id': '', 'url': 'https://api.github.com/users/bddppq', 'html_url': 'https://github.com/bddppq', 'followers_url': 'https://api.github.com/users/bddppq/followers', 'following_url': 'https://api.github.com/users/bddppq/following{/other_user}', 'gists_url': 'https://api.github.com/users/bddppq/gists{/gist_id}', 'starred_url': 'https://api.github.com/users/bddppq/starred{/owner}{/repo}', 'subscriptions_url': 'https://api.github.com/users/bddppq/subscriptions', 'organizations_url': 'https://api.github.com/users/bddppq/orgs', 'repos_url': 'https://api.github.com/users/bddppq/repos', 'events_url': 'https://api.github.com/users/bddppq/events{/privacy}', 'received_events_url': 'https://api.github.com/users/bddppq/received_events', 'type': 'User', 'site_admin': False}",referenced,c50f329dcde038aa364082e0942764d36fcd1448,https://api.github.com/repos/pytorch/pytorch/commits/c50f329dcde038aa364082e0942764d36fcd1448,2018-10-15T21:12:57Z,91,71,20
940,995007583,"{'login': 'soumith', 'id': 1310570, 'node_id': 'MDQ6VXNlcjEzMTA1NzA=', 'avatar_url': 'https://avatars0.githubusercontent.com/u/1310570?v=4', 'gravatar_id': '', 'url': 'https://api.github.com/users/soumith', 'html_url': 'https://github.com/soumith', 'followers_url': 'https://api.github.com/users/soumith/followers', 'following_url': 'https://api.github.com/users/soumith/following{/other_user}', 'gists_url': 'https://api.github.com/users/soumith/gists{/gist_id}', 'starred_url': 'https://api.github.com/users/soumith/starred{/owner}{/repo}', 'subscriptions_url': 'https://api.github.com/users/soumith/subscriptions', 'organizations_url': 'https://api.github.com/users/soumith/orgs', 'repos_url': 'https://api.github.com/users/soumith/repos', 'events_url': 'https://api.github.com/users/soumith/events{/privacy}', 'received_events_url': 'https://api.github.com/users/soumith/received_events', 'type': 'User', 'site_admin': False}",referenced,c7c4778af633d5ba4c22a5b1552f174d6cd9e68b,https://api.github.com/repos/pytorch/pytorch/commits/c7c4778af633d5ba4c22a5b1552f174d6cd9e68b,2017-03-10T14:54:45Z,8,6,2
926,1905230389,"{'login': 'bddppq', 'id': 9300575, 'node_id': 'MDQ6VXNlcjkzMDA1NzU=', 'avatar_url': 'https://avatars2.githubusercontent.com/u/9300575?v=4', 'gravatar_id': '', 'url': 'https://api.github.com/users/bddppq', 'html_url': 'https://github.com/bddppq', 'followers_url': 'https://api.github.com/users/bddppq/followers', 'following_url': 'https://api.github.com/users/bddppq/following{/other_user}', 'gists_url': 'https://api.github.com/users/bddppq/gists{/gist_id}', 'starred_url': 'https://api.github.com/users/bddppq/starred{/owner}{/repo}', 'subscriptions_url': 'https://api.github.com/users/bddppq/subscriptions', 'organizations_url': 'https://api.github.com/users/bddppq/orgs', 'repos_url': 'https://api.github.com/users/bddppq/repos', 'events_url': 'https://api.github.com/users/bddppq/events{/privacy}', 'received_events_url': 'https://api.github.com/users/bddppq/received_events', 'type': 'User', 'site_admin': False}",referenced,008a8054fdddf7ed0209d27f3f3c1aea87f44b8a,https://api.github.com/repos/pytorch/pytorch/commits/008a8054fdddf7ed0209d27f3f3c1aea87f44b8a,2018-10-15T21:12:57Z,0,0,0
925,1905230386,"{'login': 'bddppq', 'id': 9300575, 'node_id': 'MDQ6VXNlcjkzMDA1NzU=', 'avatar_url': 'https://avatars2.githubusercontent.com/u/9300575?v=4', 'gravatar_id': '', 'url': 'https://api.github.com/users/bddppq', 'html_url': 'https://github.com/bddppq', 'followers_url': 'https://api.github.com/users/bddppq/followers', 'following_url': 'https://api.github.com/users/bddppq/following{/other_user}', 'gists_url': 'https://api.github.com/users/bddppq/gists{/gist_id}', 'starred_url': 'https://api.github.com/users/bddppq/starred{/owner}{/repo}', 'subscriptions_url': 'https://api.github.com/users/bddppq/subscriptions', 'organizations_url': 'https://api.github.com/users/bddppq/orgs', 'repos_url': 'https://api.github.com/users/bddppq/repos', 'events_url': 'https://api.github.com/users/bddppq/events{/privacy}', 'received_events_url': 'https://api.github.com/users/bddppq/received_events', 'type': 'User', 'site_admin': False}",referenced,ecdcba06beace3e12e36aee658e916ffdf97950e,https://api.github.com/repos/pytorch/pytorch/commits/ecdcba06beace3e12e36aee658e916ffdf97950e,2018-10-15T21:12:57Z,12,11,1
923,1905230489,"{'login': 'bddppq', 'id': 9300575, 'node_id': 'MDQ6VXNlcjkzMDA1NzU=', 'avatar_url': 'https://avatars2.githubusercontent.com/u/9300575?v=4', 'gravatar_id': '', 'url': 'https://api.github.com/users/bddppq', 'html_url': 'https://github.com/bddppq', 'followers_url': 'https://api.github.com/users/bddppq/followers', 'following_url': 'https://api.github.com/users/bddppq/following{/other_user}', 'gists_url': 'https://api.github.com/users/bddppq/gists{/gist_id}', 'starred_url': 'https://api.github.com/users/bddppq/starred{/owner}{/repo}', 'subscriptions_url': 'https://api.github.com/users/bddppq/subscriptions', 'organizations_url': 'https://api.github.com/users/bddppq/orgs', 'repos_url': 'https://api.github.com/users/bddppq/repos', 'events_url': 'https://api.github.com/users/bddppq/events{/privacy}', 'received_events_url': 'https://api.github.com/users/bddppq/received_events', 'type': 'User', 'site_admin': False}",referenced,321d87457ff2b11691e3d106503c0eb41dbe8a90,https://api.github.com/repos/pytorch/pytorch/commits/321d87457ff2b11691e3d106503c0eb41dbe8a90,2018-10-15T21:12:59Z,123,65,58
920,1905230618,"{'login': 'bddppq', 'id': 9300575, 'node_id': 'MDQ6VXNlcjkzMDA1NzU=', 'avatar_url': 'https://avatars2.githubusercontent.com/u/9300575?v=4', 'gravatar_id': '', 'url': 'https://api.github.com/users/bddppq', 'html_url': 'https://github.com/bddppq', 'followers_url': 'https://api.github.com/users/bddppq/followers', 'following_url': 'https://api.github.com/users/bddppq/following{/other_user}', 'gists_url': 'https://api.github.com/users/bddppq/gists{/gist_id}', 'starred_url': 'https://api.github.com/users/bddppq/starred{/owner}{/repo}', 'subscriptions_url': 'https://api.github.com/users/bddppq/subscriptions', 'organizations_url': 'https://api.github.com/users/bddppq/orgs', 'repos_url': 'https://api.github.com/users/bddppq/repos', 'events_url': 'https://api.github.com/users/bddppq/events{/privacy}', 'received_events_url': 'https://api.github.com/users/bddppq/received_events', 'type': 'User', 'site_admin': False}",referenced,d2a46da13b0b0e9d3ed7a1da34e015b4bc8fe0de,https://api.github.com/repos/pytorch/pytorch/commits/d2a46da13b0b0e9d3ed7a1da34e015b4bc8fe0de,2018-10-15T21:13:01Z,451,302,149
918,2031659251,"{'login': 'facebook-github-bot', 'id': 6422482, 'node_id': 'MDQ6VXNlcjY0MjI0ODI=', 'avatar_url': 'https://avatars3.githubusercontent.com/u/6422482?v=4', 'gravatar_id': '', 'url': 'https://api.github.com/users/facebook-github-bot', 'html_url': 'https://github.com/facebook-github-bot', 'followers_url': 'https://api.github.com/users/facebook-github-bot/followers', 'following_url': 'https://api.github.com/users/facebook-github-bot/following{/other_user}', 'gists_url': 'https://api.github.com/users/facebook-github-bot/gists{/gist_id}', 'starred_url': 'https://api.github.com/users/facebook-github-bot/starred{/owner}{/repo}', 'subscriptions_url': 'https://api.github.com/users/facebook-github-bot/subscriptions', 'organizations_url': 'https://api.github.com/users/facebook-github-bot/orgs', 'repos_url': 'https://api.github.com/users/facebook-github-bot/repos', 'events_url': 'https://api.github.com/users/facebook-github-bot/events{/privacy}', 'received_events_url': 'https://api.github.com/users/facebook-github-bot/received_events', 'type': 'User', 'site_admin': False}",referenced,59d71b9664b57b0ea0de0d87cea87b21daa4dd7b,https://api.github.com/repos/pytorch/pytorch/commits/59d71b9664b57b0ea0de0d87cea87b21daa4dd7b,2018-12-17T23:33:12Z,1075,949,126
917,1905230377,"{'login': 'bddppq', 'id': 9300575, 'node_id': 'MDQ6VXNlcjkzMDA1NzU=', 'avatar_url': 'https://avatars2.githubusercontent.com/u/9300575?v=4', 'gravatar_id': '', 'url': 'https://api.github.com/users/bddppq', 'html_url': 'https://github.com/bddppq', 'followers_url': 'https://api.github.com/users/bddppq/followers', 'following_url': 'https://api.github.com/users/bddppq/following{/other_user}', 'gists_url': 'https://api.github.com/users/bddppq/gists{/gist_id}', 'starred_url': 'https://api.github.com/users/bddppq/starred{/owner}{/repo}', 'subscriptions_url': 'https://api.github.com/users/bddppq/subscriptions', 'organizations_url': 'https://api.github.com/users/bddppq/orgs', 'repos_url': 'https://api.github.com/users/bddppq/repos', 'events_url': 'https://api.github.com/users/bddppq/events{/privacy}', 'received_events_url': 'https://api.github.com/users/bddppq/received_events', 'type': 'User', 'site_admin': False}",referenced,6fab13736b03f78b77d1f1901f60310a8e351383,https://api.github.com/repos/pytorch/pytorch/commits/6fab13736b03f78b77d1f1901f60310a8e351383,2018-10-15T21:12:56Z,14,13,1
913,1905230393,"{'login': 'bddppq', 'id': 9300575, 'node_id': 'MDQ6VXNlcjkzMDA1NzU=', 'avatar_url': 'https://avatars2.githubusercontent.com/u/9300575?v=4', 'gravatar_id': '', 'url': 'https://api.github.com/users/bddppq', 'html_url': 'https://github.com/bddppq', 'followers_url': 'https://api.github.com/users/bddppq/followers', 'following_url': 'https://api.github.com/users/bddppq/following{/other_user}', 'gists_url': 'https://api.github.com/users/bddppq/gists{/gist_id}', 'starred_url': 'https://api.github.com/users/bddppq/starred{/owner}{/repo}', 'subscriptions_url': 'https://api.github.com/users/bddppq/subscriptions', 'organizations_url': 'https://api.github.com/users/bddppq/orgs', 'repos_url': 'https://api.github.com/users/bddppq/repos', 'events_url': 'https://api.github.com/users/bddppq/events{/privacy}', 'received_events_url': 'https://api.github.com/users/bddppq/received_events', 'type': 'User', 'site_admin': False}",referenced,7c8b3d2c7542dcbc87a21e5fdf7474d310d175c1,https://api.github.com/repos/pytorch/pytorch/commits/7c8b3d2c7542dcbc87a21e5fdf7474d310d175c1,2018-10-15T21:12:57Z,398,229,169
911,1905230376,"{'login': 'bddppq', 'id': 9300575, 'node_id': 'MDQ6VXNlcjkzMDA1NzU=', 'avatar_url': 'https://avatars2.githubusercontent.com/u/9300575?v=4', 'gravatar_id': '', 'url': 'https://api.github.com/users/bddppq', 'html_url': 'https://github.com/bddppq', 'followers_url': 'https://api.github.com/users/bddppq/followers', 'following_url': 'https://api.github.com/users/bddppq/following{/other_user}', 'gists_url': 'https://api.github.com/users/bddppq/gists{/gist_id}', 'starred_url': 'https://api.github.com/users/bddppq/starred{/owner}{/repo}', 'subscriptions_url': 'https://api.github.com/users/bddppq/subscriptions', 'organizations_url': 'https://api.github.com/users/bddppq/orgs', 'repos_url': 'https://api.github.com/users/bddppq/repos', 'events_url': 'https://api.github.com/users/bddppq/events{/privacy}', 'received_events_url': 'https://api.github.com/users/bddppq/received_events', 'type': 'User', 'site_admin': False}",referenced,72e15ac46f0503afb3111f4ffae78295ff6a59fe,https://api.github.com/repos/pytorch/pytorch/commits/72e15ac46f0503afb3111f4ffae78295ff6a59fe,2018-10-15T21:12:56Z,46,26,20
910,1905230375,"{'login': 'bddppq', 'id': 9300575, 'node_id': 'MDQ6VXNlcjkzMDA1NzU=', 'avatar_url': 'https://avatars2.githubusercontent.com/u/9300575?v=4', 'gravatar_id': '', 'url': 'https://api.github.com/users/bddppq', 'html_url': 'https://github.com/bddppq', 'followers_url': 'https://api.github.com/users/bddppq/followers', 'following_url': 'https://api.github.com/users/bddppq/following{/other_user}', 'gists_url': 'https://api.github.com/users/bddppq/gists{/gist_id}', 'starred_url': 'https://api.github.com/users/bddppq/starred{/owner}{/repo}', 'subscriptions_url': 'https://api.github.com/users/bddppq/subscriptions', 'organizations_url': 'https://api.github.com/users/bddppq/orgs', 'repos_url': 'https://api.github.com/users/bddppq/repos', 'events_url': 'https://api.github.com/users/bddppq/events{/privacy}', 'received_events_url': 'https://api.github.com/users/bddppq/received_events', 'type': 'User', 'site_admin': False}",referenced,ee7f97c2b16e7e770792a01d17939ea52412df03,https://api.github.com/repos/pytorch/pytorch/commits/ee7f97c2b16e7e770792a01d17939ea52412df03,2018-10-15T21:12:56Z,39,21,18
909,1905230391,"{'login': 'bddppq', 'id': 9300575, 'node_id': 'MDQ6VXNlcjkzMDA1NzU=', 'avatar_url': 'https://avatars2.githubusercontent.com/u/9300575?v=4', 'gravatar_id': '', 'url': 'https://api.github.com/users/bddppq', 'html_url': 'https://github.com/bddppq', 'followers_url': 'https://api.github.com/users/bddppq/followers', 'following_url': 'https://api.github.com/users/bddppq/following{/other_user}', 'gists_url': 'https://api.github.com/users/bddppq/gists{/gist_id}', 'starred_url': 'https://api.github.com/users/bddppq/starred{/owner}{/repo}', 'subscriptions_url': 'https://api.github.com/users/bddppq/subscriptions', 'organizations_url': 'https://api.github.com/users/bddppq/orgs', 'repos_url': 'https://api.github.com/users/bddppq/repos', 'events_url': 'https://api.github.com/users/bddppq/events{/privacy}', 'received_events_url': 'https://api.github.com/users/bddppq/received_events', 'type': 'User', 'site_admin': False}",referenced,9dd2533ee3d7612412c39c830e4f1a2bb363b80a,https://api.github.com/repos/pytorch/pytorch/commits/9dd2533ee3d7612412c39c830e4f1a2bb363b80a,2018-10-15T21:12:57Z,20,10,10
907,1905230602,"{'login': 'bddppq', 'id': 9300575, 'node_id': 'MDQ6VXNlcjkzMDA1NzU=', 'avatar_url': 'https://avatars2.githubusercontent.com/u/9300575?v=4', 'gravatar_id': '', 'url': 'https://api.github.com/users/bddppq', 'html_url': 'https://github.com/bddppq', 'followers_url': 'https://api.github.com/users/bddppq/followers', 'following_url': 'https://api.github.com/users/bddppq/following{/other_user}', 'gists_url': 'https://api.github.com/users/bddppq/gists{/gist_id}', 'starred_url': 'https://api.github.com/users/bddppq/starred{/owner}{/repo}', 'subscriptions_url': 'https://api.github.com/users/bddppq/subscriptions', 'organizations_url': 'https://api.github.com/users/bddppq/orgs', 'repos_url': 'https://api.github.com/users/bddppq/repos', 'events_url': 'https://api.github.com/users/bddppq/events{/privacy}', 'received_events_url': 'https://api.github.com/users/bddppq/received_events', 'type': 'User', 'site_admin': False}",referenced,0892069c7f4ed27992b2bc06bb86e86df4b85225,https://api.github.com/repos/pytorch/pytorch/commits/0892069c7f4ed27992b2bc06bb86e86df4b85225,2018-10-15T21:13:01Z,2349,1229,1120
899,1905230370,"{'login': 'bddppq', 'id': 9300575, 'node_id': 'MDQ6VXNlcjkzMDA1NzU=', 'avatar_url': 'https://avatars2.githubusercontent.com/u/9300575?v=4', 'gravatar_id': '', 'url': 'https://api.github.com/users/bddppq', 'html_url': 'https://github.com/bddppq', 'followers_url': 'https://api.github.com/users/bddppq/followers', 'following_url': 'https://api.github.com/users/bddppq/following{/other_user}', 'gists_url': 'https://api.github.com/users/bddppq/gists{/gist_id}', 'starred_url': 'https://api.github.com/users/bddppq/starred{/owner}{/repo}', 'subscriptions_url': 'https://api.github.com/users/bddppq/subscriptions', 'organizations_url': 'https://api.github.com/users/bddppq/orgs', 'repos_url': 'https://api.github.com/users/bddppq/repos', 'events_url': 'https://api.github.com/users/bddppq/events{/privacy}', 'received_events_url': 'https://api.github.com/users/bddppq/received_events', 'type': 'User', 'site_admin': False}",referenced,328ed3e679d67c6f9e9efe134fb9dcf17f7fb51f,https://api.github.com/repos/pytorch/pytorch/commits/328ed3e679d67c6f9e9efe134fb9dcf17f7fb51f,2018-10-15T21:12:56Z,46,44,2
897,1905230511,"{'login': 'bddppq', 'id': 9300575, 'node_id': 'MDQ6VXNlcjkzMDA1NzU=', 'avatar_url': 'https://avatars2.githubusercontent.com/u/9300575?v=4', 'gravatar_id': '', 'url': 'https://api.github.com/users/bddppq', 'html_url': 'https://github.com/bddppq', 'followers_url': 'https://api.github.com/users/bddppq/followers', 'following_url': 'https://api.github.com/users/bddppq/following{/other_user}', 'gists_url': 'https://api.github.com/users/bddppq/gists{/gist_id}', 'starred_url': 'https://api.github.com/users/bddppq/starred{/owner}{/repo}', 'subscriptions_url': 'https://api.github.com/users/bddppq/subscriptions', 'organizations_url': 'https://api.github.com/users/bddppq/orgs', 'repos_url': 'https://api.github.com/users/bddppq/repos', 'events_url': 'https://api.github.com/users/bddppq/events{/privacy}', 'received_events_url': 'https://api.github.com/users/bddppq/received_events', 'type': 'User', 'site_admin': False}",referenced,e050bccacbfafe62882a7ef2870198d80976cc82,https://api.github.com/repos/pytorch/pytorch/commits/e050bccacbfafe62882a7ef2870198d80976cc82,2018-10-15T21:12:59Z,154,154,0
896,1905230366,"{'login': 'bddppq', 'id': 9300575, 'node_id': 'MDQ6VXNlcjkzMDA1NzU=', 'avatar_url': 'https://avatars2.githubusercontent.com/u/9300575?v=4', 'gravatar_id': '', 'url': 'https://api.github.com/users/bddppq', 'html_url': 'https://github.com/bddppq', 'followers_url': 'https://api.github.com/users/bddppq/followers', 'following_url': 'https://api.github.com/users/bddppq/following{/other_user}', 'gists_url': 'https://api.github.com/users/bddppq/gists{/gist_id}', 'starred_url': 'https://api.github.com/users/bddppq/starred{/owner}{/repo}', 'subscriptions_url': 'https://api.github.com/users/bddppq/subscriptions', 'organizations_url': 'https://api.github.com/users/bddppq/orgs', 'repos_url': 'https://api.github.com/users/bddppq/repos', 'events_url': 'https://api.github.com/users/bddppq/events{/privacy}', 'received_events_url': 'https://api.github.com/users/bddppq/received_events', 'type': 'User', 'site_admin': False}",referenced,5be6d8665425dfeff6d7eee2f6918f9f0d560074,https://api.github.com/repos/pytorch/pytorch/commits/5be6d8665425dfeff6d7eee2f6918f9f0d560074,2018-10-15T21:12:56Z,18,9,9
891,983716756,"{'login': 'soumith', 'id': 1310570, 'node_id': 'MDQ6VXNlcjEzMTA1NzA=', 'avatar_url': 'https://avatars0.githubusercontent.com/u/1310570?v=4', 'gravatar_id': '', 'url': 'https://api.github.com/users/soumith', 'html_url': 'https://github.com/soumith', 'followers_url': 'https://api.github.com/users/soumith/followers', 'following_url': 'https://api.github.com/users/soumith/following{/other_user}', 'gists_url': 'https://api.github.com/users/soumith/gists{/gist_id}', 'starred_url': 'https://api.github.com/users/soumith/starred{/owner}{/repo}', 'subscriptions_url': 'https://api.github.com/users/soumith/subscriptions', 'organizations_url': 'https://api.github.com/users/soumith/orgs', 'repos_url': 'https://api.github.com/users/soumith/repos', 'events_url': 'https://api.github.com/users/soumith/events{/privacy}', 'received_events_url': 'https://api.github.com/users/soumith/received_events', 'type': 'User', 'site_admin': False}",referenced,f366e5fc81eb43e518fb1a461f3c42d776a252e0,https://api.github.com/repos/pytorch/pytorch/commits/f366e5fc81eb43e518fb1a461f3c42d776a252e0,2017-03-02T14:16:00Z,6,6,0
891,1610835456,"{'login': 'onnxbot', 'id': 33637430, 'node_id': 'MDQ6VXNlcjMzNjM3NDMw', 'avatar_url': 'https://avatars3.githubusercontent.com/u/33637430?v=4', 'gravatar_id': '', 'url': 'https://api.github.com/users/onnxbot', 'html_url': 'https://github.com/onnxbot', 'followers_url': 'https://api.github.com/users/onnxbot/followers', 'following_url': 'https://api.github.com/users/onnxbot/following{/other_user}', 'gists_url': 'https://api.github.com/users/onnxbot/gists{/gist_id}', 'starred_url': 'https://api.github.com/users/onnxbot/starred{/owner}{/repo}', 'subscriptions_url': 'https://api.github.com/users/onnxbot/subscriptions', 'organizations_url': 'https://api.github.com/users/onnxbot/orgs', 'repos_url': 'https://api.github.com/users/onnxbot/repos', 'events_url': 'https://api.github.com/users/onnxbot/events{/privacy}', 'received_events_url': 'https://api.github.com/users/onnxbot/received_events', 'type': 'User', 'site_admin': False}",referenced,e1c7e6dce2c159cc5180ed993ea455efd7977c7c,https://api.github.com/repos/pytorch/pytorch/commits/e1c7e6dce2c159cc5180ed993ea455efd7977c7c,2018-05-04T21:05:24Z,2,1,1
891,1905230344,"{'login': 'bddppq', 'id': 9300575, 'node_id': 'MDQ6VXNlcjkzMDA1NzU=', 'avatar_url': 'https://avatars2.githubusercontent.com/u/9300575?v=4', 'gravatar_id': '', 'url': 'https://api.github.com/users/bddppq', 'html_url': 'https://github.com/bddppq', 'followers_url': 'https://api.github.com/users/bddppq/followers', 'following_url': 'https://api.github.com/users/bddppq/following{/other_user}', 'gists_url': 'https://api.github.com/users/bddppq/gists{/gist_id}', 'starred_url': 'https://api.github.com/users/bddppq/starred{/owner}{/repo}', 'subscriptions_url': 'https://api.github.com/users/bddppq/subscriptions', 'organizations_url': 'https://api.github.com/users/bddppq/orgs', 'repos_url': 'https://api.github.com/users/bddppq/repos', 'events_url': 'https://api.github.com/users/bddppq/events{/privacy}', 'received_events_url': 'https://api.github.com/users/bddppq/received_events', 'type': 'User', 'site_admin': False}",referenced,38eea57313d5ffdf1aea39b83cee0cad28435bc3,https://api.github.com/repos/pytorch/pytorch/commits/38eea57313d5ffdf1aea39b83cee0cad28435bc3,2018-10-15T21:12:56Z,1,1,0
890,1610899096,"{'login': 'onnxbot', 'id': 33637430, 'node_id': 'MDQ6VXNlcjMzNjM3NDMw', 'avatar_url': 'https://avatars3.githubusercontent.com/u/33637430?v=4', 'gravatar_id': '', 'url': 'https://api.github.com/users/onnxbot', 'html_url': 'https://github.com/onnxbot', 'followers_url': 'https://api.github.com/users/onnxbot/followers', 'following_url': 'https://api.github.com/users/onnxbot/following{/other_user}', 'gists_url': 'https://api.github.com/users/onnxbot/gists{/gist_id}', 'starred_url': 'https://api.github.com/users/onnxbot/starred{/owner}{/repo}', 'subscriptions_url': 'https://api.github.com/users/onnxbot/subscriptions', 'organizations_url': 'https://api.github.com/users/onnxbot/orgs', 'repos_url': 'https://api.github.com/users/onnxbot/repos', 'events_url': 'https://api.github.com/users/onnxbot/events{/privacy}', 'received_events_url': 'https://api.github.com/users/onnxbot/received_events', 'type': 'User', 'site_admin': False}",referenced,56ed857f1bfc46aa0faec8125a4506d4c97bd980,https://api.github.com/repos/pytorch/pytorch/commits/56ed857f1bfc46aa0faec8125a4506d4c97bd980,2018-05-04T21:50:38Z,2,1,1
890,1905230347,"{'login': 'bddppq', 'id': 9300575, 'node_id': 'MDQ6VXNlcjkzMDA1NzU=', 'avatar_url': 'https://avatars2.githubusercontent.com/u/9300575?v=4', 'gravatar_id': '', 'url': 'https://api.github.com/users/bddppq', 'html_url': 'https://github.com/bddppq', 'followers_url': 'https://api.github.com/users/bddppq/followers', 'following_url': 'https://api.github.com/users/bddppq/following{/other_user}', 'gists_url': 'https://api.github.com/users/bddppq/gists{/gist_id}', 'starred_url': 'https://api.github.com/users/bddppq/starred{/owner}{/repo}', 'subscriptions_url': 'https://api.github.com/users/bddppq/subscriptions', 'organizations_url': 'https://api.github.com/users/bddppq/orgs', 'repos_url': 'https://api.github.com/users/bddppq/repos', 'events_url': 'https://api.github.com/users/bddppq/events{/privacy}', 'received_events_url': 'https://api.github.com/users/bddppq/received_events', 'type': 'User', 'site_admin': False}",referenced,f708d41fea187f05393c2b15885e396c268641a5,https://api.github.com/repos/pytorch/pytorch/commits/f708d41fea187f05393c2b15885e396c268641a5,2018-10-15T21:12:56Z,106,94,12
885,1905230522,"{'login': 'bddppq', 'id': 9300575, 'node_id': 'MDQ6VXNlcjkzMDA1NzU=', 'avatar_url': 'https://avatars2.githubusercontent.com/u/9300575?v=4', 'gravatar_id': '', 'url': 'https://api.github.com/users/bddppq', 'html_url': 'https://github.com/bddppq', 'followers_url': 'https://api.github.com/users/bddppq/followers', 'following_url': 'https://api.github.com/users/bddppq/following{/other_user}', 'gists_url': 'https://api.github.com/users/bddppq/gists{/gist_id}', 'starred_url': 'https://api.github.com/users/bddppq/starred{/owner}{/repo}', 'subscriptions_url': 'https://api.github.com/users/bddppq/subscriptions', 'organizations_url': 'https://api.github.com/users/bddppq/orgs', 'repos_url': 'https://api.github.com/users/bddppq/repos', 'events_url': 'https://api.github.com/users/bddppq/events{/privacy}', 'received_events_url': 'https://api.github.com/users/bddppq/received_events', 'type': 'User', 'site_admin': False}",referenced,6f4b1b12e56cea736a31411c5f151305f211a729,https://api.github.com/repos/pytorch/pytorch/commits/6f4b1b12e56cea736a31411c5f151305f211a729,2018-10-15T21:13:00Z,106,106,0
884,1905230399,"{'login': 'bddppq', 'id': 9300575, 'node_id': 'MDQ6VXNlcjkzMDA1NzU=', 'avatar_url': 'https://avatars2.githubusercontent.com/u/9300575?v=4', 'gravatar_id': '', 'url': 'https://api.github.com/users/bddppq', 'html_url': 'https://github.com/bddppq', 'followers_url': 'https://api.github.com/users/bddppq/followers', 'following_url': 'https://api.github.com/users/bddppq/following{/other_user}', 'gists_url': 'https://api.github.com/users/bddppq/gists{/gist_id}', 'starred_url': 'https://api.github.com/users/bddppq/starred{/owner}{/repo}', 'subscriptions_url': 'https://api.github.com/users/bddppq/subscriptions', 'organizations_url': 'https://api.github.com/users/bddppq/orgs', 'repos_url': 'https://api.github.com/users/bddppq/repos', 'events_url': 'https://api.github.com/users/bddppq/events{/privacy}', 'received_events_url': 'https://api.github.com/users/bddppq/received_events', 'type': 'User', 'site_admin': False}",referenced,25b8845a142b29389d33abaef539c66202d6897b,https://api.github.com/repos/pytorch/pytorch/commits/25b8845a142b29389d33abaef539c66202d6897b,2018-10-15T21:12:57Z,85,83,2
882,1609196711,"{'login': 'onnxbot', 'id': 33637430, 'node_id': 'MDQ6VXNlcjMzNjM3NDMw', 'avatar_url': 'https://avatars3.githubusercontent.com/u/33637430?v=4', 'gravatar_id': '', 'url': 'https://api.github.com/users/onnxbot', 'html_url': 'https://github.com/onnxbot', 'followers_url': 'https://api.github.com/users/onnxbot/followers', 'following_url': 'https://api.github.com/users/onnxbot/following{/other_user}', 'gists_url': 'https://api.github.com/users/onnxbot/gists{/gist_id}', 'starred_url': 'https://api.github.com/users/onnxbot/starred{/owner}{/repo}', 'subscriptions_url': 'https://api.github.com/users/onnxbot/subscriptions', 'organizations_url': 'https://api.github.com/users/onnxbot/orgs', 'repos_url': 'https://api.github.com/users/onnxbot/repos', 'events_url': 'https://api.github.com/users/onnxbot/events{/privacy}', 'received_events_url': 'https://api.github.com/users/onnxbot/received_events', 'type': 'User', 'site_admin': False}",referenced,d856bfc1bf0751a95f2cec3a501e196ac8718b97,https://api.github.com/repos/pytorch/pytorch/commits/d856bfc1bf0751a95f2cec3a501e196ac8718b97,2018-05-04T06:47:45Z,2,1,1
882,1609291928,"{'login': 'onnxbot', 'id': 33637430, 'node_id': 'MDQ6VXNlcjMzNjM3NDMw', 'avatar_url': 'https://avatars3.githubusercontent.com/u/33637430?v=4', 'gravatar_id': '', 'url': 'https://api.github.com/users/onnxbot', 'html_url': 'https://github.com/onnxbot', 'followers_url': 'https://api.github.com/users/onnxbot/followers', 'following_url': 'https://api.github.com/users/onnxbot/following{/other_user}', 'gists_url': 'https://api.github.com/users/onnxbot/gists{/gist_id}', 'starred_url': 'https://api.github.com/users/onnxbot/starred{/owner}{/repo}', 'subscriptions_url': 'https://api.github.com/users/onnxbot/subscriptions', 'organizations_url': 'https://api.github.com/users/onnxbot/orgs', 'repos_url': 'https://api.github.com/users/onnxbot/repos', 'events_url': 'https://api.github.com/users/onnxbot/events{/privacy}', 'received_events_url': 'https://api.github.com/users/onnxbot/received_events', 'type': 'User', 'site_admin': False}",referenced,159c75a2ca3612eb255cfec20c8848b395565c46,https://api.github.com/repos/pytorch/pytorch/commits/159c75a2ca3612eb255cfec20c8848b395565c46,2018-05-04T08:03:41Z,2,1,1
882,1905230330,"{'login': 'bddppq', 'id': 9300575, 'node_id': 'MDQ6VXNlcjkzMDA1NzU=', 'avatar_url': 'https://avatars2.githubusercontent.com/u/9300575?v=4', 'gravatar_id': '', 'url': 'https://api.github.com/users/bddppq', 'html_url': 'https://github.com/bddppq', 'followers_url': 'https://api.github.com/users/bddppq/followers', 'following_url': 'https://api.github.com/users/bddppq/following{/other_user}', 'gists_url': 'https://api.github.com/users/bddppq/gists{/gist_id}', 'starred_url': 'https://api.github.com/users/bddppq/starred{/owner}{/repo}', 'subscriptions_url': 'https://api.github.com/users/bddppq/subscriptions', 'organizations_url': 'https://api.github.com/users/bddppq/orgs', 'repos_url': 'https://api.github.com/users/bddppq/repos', 'events_url': 'https://api.github.com/users/bddppq/events{/privacy}', 'received_events_url': 'https://api.github.com/users/bddppq/received_events', 'type': 'User', 'site_admin': False}",referenced,e35126bc4b42b80c3b7f4091efb02e2f5d53dcdd,https://api.github.com/repos/pytorch/pytorch/commits/e35126bc4b42b80c3b7f4091efb02e2f5d53dcdd,2018-10-15T21:12:55Z,74,55,19
878,1905230325,"{'login': 'bddppq', 'id': 9300575, 'node_id': 'MDQ6VXNlcjkzMDA1NzU=', 'avatar_url': 'https://avatars2.githubusercontent.com/u/9300575?v=4', 'gravatar_id': '', 'url': 'https://api.github.com/users/bddppq', 'html_url': 'https://github.com/bddppq', 'followers_url': 'https://api.github.com/users/bddppq/followers', 'following_url': 'https://api.github.com/users/bddppq/following{/other_user}', 'gists_url': 'https://api.github.com/users/bddppq/gists{/gist_id}', 'starred_url': 'https://api.github.com/users/bddppq/starred{/owner}{/repo}', 'subscriptions_url': 'https://api.github.com/users/bddppq/subscriptions', 'organizations_url': 'https://api.github.com/users/bddppq/orgs', 'repos_url': 'https://api.github.com/users/bddppq/repos', 'events_url': 'https://api.github.com/users/bddppq/events{/privacy}', 'received_events_url': 'https://api.github.com/users/bddppq/received_events', 'type': 'User', 'site_admin': False}",referenced,984b707e5bcd93e1051d3e65816feb24d7685546,https://api.github.com/repos/pytorch/pytorch/commits/984b707e5bcd93e1051d3e65816feb24d7685546,2018-10-15T21:12:55Z,2,1,1
871,1606664875,"{'login': 'onnxbot', 'id': 33637430, 'node_id': 'MDQ6VXNlcjMzNjM3NDMw', 'avatar_url': 'https://avatars3.githubusercontent.com/u/33637430?v=4', 'gravatar_id': '', 'url': 'https://api.github.com/users/onnxbot', 'html_url': 'https://github.com/onnxbot', 'followers_url': 'https://api.github.com/users/onnxbot/followers', 'following_url': 'https://api.github.com/users/onnxbot/following{/other_user}', 'gists_url': 'https://api.github.com/users/onnxbot/gists{/gist_id}', 'starred_url': 'https://api.github.com/users/onnxbot/starred{/owner}{/repo}', 'subscriptions_url': 'https://api.github.com/users/onnxbot/subscriptions', 'organizations_url': 'https://api.github.com/users/onnxbot/orgs', 'repos_url': 'https://api.github.com/users/onnxbot/repos', 'events_url': 'https://api.github.com/users/onnxbot/events{/privacy}', 'received_events_url': 'https://api.github.com/users/onnxbot/received_events', 'type': 'User', 'site_admin': False}",referenced,a10870a2d11d428e4b301755efff0e16fddef88e,https://api.github.com/repos/pytorch/pytorch/commits/a10870a2d11d428e4b301755efff0e16fddef88e,2018-05-02T23:37:02Z,2,1,1
869,1905230405,"{'login': 'bddppq', 'id': 9300575, 'node_id': 'MDQ6VXNlcjkzMDA1NzU=', 'avatar_url': 'https://avatars2.githubusercontent.com/u/9300575?v=4', 'gravatar_id': '', 'url': 'https://api.github.com/users/bddppq', 'html_url': 'https://github.com/bddppq', 'followers_url': 'https://api.github.com/users/bddppq/followers', 'following_url': 'https://api.github.com/users/bddppq/following{/other_user}', 'gists_url': 'https://api.github.com/users/bddppq/gists{/gist_id}', 'starred_url': 'https://api.github.com/users/bddppq/starred{/owner}{/repo}', 'subscriptions_url': 'https://api.github.com/users/bddppq/subscriptions', 'organizations_url': 'https://api.github.com/users/bddppq/orgs', 'repos_url': 'https://api.github.com/users/bddppq/repos', 'events_url': 'https://api.github.com/users/bddppq/events{/privacy}', 'received_events_url': 'https://api.github.com/users/bddppq/received_events', 'type': 'User', 'site_admin': False}",referenced,4e98b038d15b2f46fead975eb2acd1827f5f2a45,https://api.github.com/repos/pytorch/pytorch/commits/4e98b038d15b2f46fead975eb2acd1827f5f2a45,2018-10-15T21:12:57Z,966,966,0
863,1603037253,"{'login': 'onnxbot', 'id': 33637430, 'node_id': 'MDQ6VXNlcjMzNjM3NDMw', 'avatar_url': 'https://avatars3.githubusercontent.com/u/33637430?v=4', 'gravatar_id': '', 'url': 'https://api.github.com/users/onnxbot', 'html_url': 'https://github.com/onnxbot', 'followers_url': 'https://api.github.com/users/onnxbot/followers', 'following_url': 'https://api.github.com/users/onnxbot/following{/other_user}', 'gists_url': 'https://api.github.com/users/onnxbot/gists{/gist_id}', 'starred_url': 'https://api.github.com/users/onnxbot/starred{/owner}{/repo}', 'subscriptions_url': 'https://api.github.com/users/onnxbot/subscriptions', 'organizations_url': 'https://api.github.com/users/onnxbot/orgs', 'repos_url': 'https://api.github.com/users/onnxbot/repos', 'events_url': 'https://api.github.com/users/onnxbot/events{/privacy}', 'received_events_url': 'https://api.github.com/users/onnxbot/received_events', 'type': 'User', 'site_admin': False}",referenced,23a5ddd3c86b9aab916707b6ac6aaa35050b5b3f,https://api.github.com/repos/pytorch/pytorch/commits/23a5ddd3c86b9aab916707b6ac6aaa35050b5b3f,2018-05-01T08:22:12Z,2,1,1
863,1621259676,"{'login': 'pjh5', 'id': 6456020, 'node_id': 'MDQ6VXNlcjY0NTYwMjA=', 'avatar_url': 'https://avatars1.githubusercontent.com/u/6456020?v=4', 'gravatar_id': '', 'url': 'https://api.github.com/users/pjh5', 'html_url': 'https://github.com/pjh5', 'followers_url': 'https://api.github.com/users/pjh5/followers', 'following_url': 'https://api.github.com/users/pjh5/following{/other_user}', 'gists_url': 'https://api.github.com/users/pjh5/gists{/gist_id}', 'starred_url': 'https://api.github.com/users/pjh5/starred{/owner}{/repo}', 'subscriptions_url': 'https://api.github.com/users/pjh5/subscriptions', 'organizations_url': 'https://api.github.com/users/pjh5/orgs', 'repos_url': 'https://api.github.com/users/pjh5/repos', 'events_url': 'https://api.github.com/users/pjh5/events{/privacy}', 'received_events_url': 'https://api.github.com/users/pjh5/received_events', 'type': 'User', 'site_admin': False}",referenced,b875fb281c92dbe88da279a0ff7ad342e7b28b9e,https://api.github.com/repos/pytorch/pytorch/commits/b875fb281c92dbe88da279a0ff7ad342e7b28b9e,2018-05-11T06:14:54Z,3328,2549,779
863,1905230298,"{'login': 'bddppq', 'id': 9300575, 'node_id': 'MDQ6VXNlcjkzMDA1NzU=', 'avatar_url': 'https://avatars2.githubusercontent.com/u/9300575?v=4', 'gravatar_id': '', 'url': 'https://api.github.com/users/bddppq', 'html_url': 'https://github.com/bddppq', 'followers_url': 'https://api.github.com/users/bddppq/followers', 'following_url': 'https://api.github.com/users/bddppq/following{/other_user}', 'gists_url': 'https://api.github.com/users/bddppq/gists{/gist_id}', 'starred_url': 'https://api.github.com/users/bddppq/starred{/owner}{/repo}', 'subscriptions_url': 'https://api.github.com/users/bddppq/subscriptions', 'organizations_url': 'https://api.github.com/users/bddppq/orgs', 'repos_url': 'https://api.github.com/users/bddppq/repos', 'events_url': 'https://api.github.com/users/bddppq/events{/privacy}', 'received_events_url': 'https://api.github.com/users/bddppq/received_events', 'type': 'User', 'site_admin': False}",referenced,b7d8dc8fa63965148f34e8513d167f5cbfc08914,https://api.github.com/repos/pytorch/pytorch/commits/b7d8dc8fa63965148f34e8513d167f5cbfc08914,2018-10-15T21:12:55Z,5,4,1
853,1601781901,"{'login': 'onnxbot', 'id': 33637430, 'node_id': 'MDQ6VXNlcjMzNjM3NDMw', 'avatar_url': 'https://avatars3.githubusercontent.com/u/33637430?v=4', 'gravatar_id': '', 'url': 'https://api.github.com/users/onnxbot', 'html_url': 'https://github.com/onnxbot', 'followers_url': 'https://api.github.com/users/onnxbot/followers', 'following_url': 'https://api.github.com/users/onnxbot/following{/other_user}', 'gists_url': 'https://api.github.com/users/onnxbot/gists{/gist_id}', 'starred_url': 'https://api.github.com/users/onnxbot/starred{/owner}{/repo}', 'subscriptions_url': 'https://api.github.com/users/onnxbot/subscriptions', 'organizations_url': 'https://api.github.com/users/onnxbot/orgs', 'repos_url': 'https://api.github.com/users/onnxbot/repos', 'events_url': 'https://api.github.com/users/onnxbot/events{/privacy}', 'received_events_url': 'https://api.github.com/users/onnxbot/received_events', 'type': 'User', 'site_admin': False}",referenced,c5978db0944800afa2b5cd3a8644e48762baa126,https://api.github.com/repos/pytorch/pytorch/commits/c5978db0944800afa2b5cd3a8644e48762baa126,2018-04-30T15:37:33Z,2,1,1
853,1621259689,"{'login': 'pjh5', 'id': 6456020, 'node_id': 'MDQ6VXNlcjY0NTYwMjA=', 'avatar_url': 'https://avatars1.githubusercontent.com/u/6456020?v=4', 'gravatar_id': '', 'url': 'https://api.github.com/users/pjh5', 'html_url': 'https://github.com/pjh5', 'followers_url': 'https://api.github.com/users/pjh5/followers', 'following_url': 'https://api.github.com/users/pjh5/following{/other_user}', 'gists_url': 'https://api.github.com/users/pjh5/gists{/gist_id}', 'starred_url': 'https://api.github.com/users/pjh5/starred{/owner}{/repo}', 'subscriptions_url': 'https://api.github.com/users/pjh5/subscriptions', 'organizations_url': 'https://api.github.com/users/pjh5/orgs', 'repos_url': 'https://api.github.com/users/pjh5/repos', 'events_url': 'https://api.github.com/users/pjh5/events{/privacy}', 'received_events_url': 'https://api.github.com/users/pjh5/received_events', 'type': 'User', 'site_admin': False}",referenced,b875fb281c92dbe88da279a0ff7ad342e7b28b9e,https://api.github.com/repos/pytorch/pytorch/commits/b875fb281c92dbe88da279a0ff7ad342e7b28b9e,2018-05-11T06:14:54Z,3328,2549,779
823,1599642691,"{'login': 'onnxbot', 'id': 33637430, 'node_id': 'MDQ6VXNlcjMzNjM3NDMw', 'avatar_url': 'https://avatars3.githubusercontent.com/u/33637430?v=4', 'gravatar_id': '', 'url': 'https://api.github.com/users/onnxbot', 'html_url': 'https://github.com/onnxbot', 'followers_url': 'https://api.github.com/users/onnxbot/followers', 'following_url': 'https://api.github.com/users/onnxbot/following{/other_user}', 'gists_url': 'https://api.github.com/users/onnxbot/gists{/gist_id}', 'starred_url': 'https://api.github.com/users/onnxbot/starred{/owner}{/repo}', 'subscriptions_url': 'https://api.github.com/users/onnxbot/subscriptions', 'organizations_url': 'https://api.github.com/users/onnxbot/orgs', 'repos_url': 'https://api.github.com/users/onnxbot/repos', 'events_url': 'https://api.github.com/users/onnxbot/events{/privacy}', 'received_events_url': 'https://api.github.com/users/onnxbot/received_events', 'type': 'User', 'site_admin': False}",referenced,6ce376fee374de52554987adf2ed701d509dea9b,https://api.github.com/repos/pytorch/pytorch/commits/6ce376fee374de52554987adf2ed701d509dea9b,2018-04-27T21:02:30Z,2,1,1
823,1621259696,"{'login': 'pjh5', 'id': 6456020, 'node_id': 'MDQ6VXNlcjY0NTYwMjA=', 'avatar_url': 'https://avatars1.githubusercontent.com/u/6456020?v=4', 'gravatar_id': '', 'url': 'https://api.github.com/users/pjh5', 'html_url': 'https://github.com/pjh5', 'followers_url': 'https://api.github.com/users/pjh5/followers', 'following_url': 'https://api.github.com/users/pjh5/following{/other_user}', 'gists_url': 'https://api.github.com/users/pjh5/gists{/gist_id}', 'starred_url': 'https://api.github.com/users/pjh5/starred{/owner}{/repo}', 'subscriptions_url': 'https://api.github.com/users/pjh5/subscriptions', 'organizations_url': 'https://api.github.com/users/pjh5/orgs', 'repos_url': 'https://api.github.com/users/pjh5/repos', 'events_url': 'https://api.github.com/users/pjh5/events{/privacy}', 'received_events_url': 'https://api.github.com/users/pjh5/received_events', 'type': 'User', 'site_admin': False}",referenced,b875fb281c92dbe88da279a0ff7ad342e7b28b9e,https://api.github.com/repos/pytorch/pytorch/commits/b875fb281c92dbe88da279a0ff7ad342e7b28b9e,2018-05-11T06:14:54Z,3328,2549,779
823,1905230278,"{'login': 'bddppq', 'id': 9300575, 'node_id': 'MDQ6VXNlcjkzMDA1NzU=', 'avatar_url': 'https://avatars2.githubusercontent.com/u/9300575?v=4', 'gravatar_id': '', 'url': 'https://api.github.com/users/bddppq', 'html_url': 'https://github.com/bddppq', 'followers_url': 'https://api.github.com/users/bddppq/followers', 'following_url': 'https://api.github.com/users/bddppq/following{/other_user}', 'gists_url': 'https://api.github.com/users/bddppq/gists{/gist_id}', 'starred_url': 'https://api.github.com/users/bddppq/starred{/owner}{/repo}', 'subscriptions_url': 'https://api.github.com/users/bddppq/subscriptions', 'organizations_url': 'https://api.github.com/users/bddppq/orgs', 'repos_url': 'https://api.github.com/users/bddppq/repos', 'events_url': 'https://api.github.com/users/bddppq/events{/privacy}', 'received_events_url': 'https://api.github.com/users/bddppq/received_events', 'type': 'User', 'site_admin': False}",referenced,ebac0463a0553948f043d0def33078c3932760a4,https://api.github.com/repos/pytorch/pytorch/commits/ebac0463a0553948f043d0def33078c3932760a4,2018-10-15T21:12:54Z,159,159,0
821,1594971505,"{'login': 'onnxbot', 'id': 33637430, 'node_id': 'MDQ6VXNlcjMzNjM3NDMw', 'avatar_url': 'https://avatars3.githubusercontent.com/u/33637430?v=4', 'gravatar_id': '', 'url': 'https://api.github.com/users/onnxbot', 'html_url': 'https://github.com/onnxbot', 'followers_url': 'https://api.github.com/users/onnxbot/followers', 'following_url': 'https://api.github.com/users/onnxbot/following{/other_user}', 'gists_url': 'https://api.github.com/users/onnxbot/gists{/gist_id}', 'starred_url': 'https://api.github.com/users/onnxbot/starred{/owner}{/repo}', 'subscriptions_url': 'https://api.github.com/users/onnxbot/subscriptions', 'organizations_url': 'https://api.github.com/users/onnxbot/orgs', 'repos_url': 'https://api.github.com/users/onnxbot/repos', 'events_url': 'https://api.github.com/users/onnxbot/events{/privacy}', 'received_events_url': 'https://api.github.com/users/onnxbot/received_events', 'type': 'User', 'site_admin': False}",referenced,075ca76c26d07876a4f2b8fe20900a07ea9357d0,https://api.github.com/repos/pytorch/pytorch/commits/075ca76c26d07876a4f2b8fe20900a07ea9357d0,2018-04-25T19:57:47Z,2,1,1
821,1621259720,"{'login': 'pjh5', 'id': 6456020, 'node_id': 'MDQ6VXNlcjY0NTYwMjA=', 'avatar_url': 'https://avatars1.githubusercontent.com/u/6456020?v=4', 'gravatar_id': '', 'url': 'https://api.github.com/users/pjh5', 'html_url': 'https://github.com/pjh5', 'followers_url': 'https://api.github.com/users/pjh5/followers', 'following_url': 'https://api.github.com/users/pjh5/following{/other_user}', 'gists_url': 'https://api.github.com/users/pjh5/gists{/gist_id}', 'starred_url': 'https://api.github.com/users/pjh5/starred{/owner}{/repo}', 'subscriptions_url': 'https://api.github.com/users/pjh5/subscriptions', 'organizations_url': 'https://api.github.com/users/pjh5/orgs', 'repos_url': 'https://api.github.com/users/pjh5/repos', 'events_url': 'https://api.github.com/users/pjh5/events{/privacy}', 'received_events_url': 'https://api.github.com/users/pjh5/received_events', 'type': 'User', 'site_admin': False}",referenced,b875fb281c92dbe88da279a0ff7ad342e7b28b9e,https://api.github.com/repos/pytorch/pytorch/commits/b875fb281c92dbe88da279a0ff7ad342e7b28b9e,2018-05-11T06:14:55Z,3328,2549,779
821,1905230231,"{'login': 'bddppq', 'id': 9300575, 'node_id': 'MDQ6VXNlcjkzMDA1NzU=', 'avatar_url': 'https://avatars2.githubusercontent.com/u/9300575?v=4', 'gravatar_id': '', 'url': 'https://api.github.com/users/bddppq', 'html_url': 'https://github.com/bddppq', 'followers_url': 'https://api.github.com/users/bddppq/followers', 'following_url': 'https://api.github.com/users/bddppq/following{/other_user}', 'gists_url': 'https://api.github.com/users/bddppq/gists{/gist_id}', 'starred_url': 'https://api.github.com/users/bddppq/starred{/owner}{/repo}', 'subscriptions_url': 'https://api.github.com/users/bddppq/subscriptions', 'organizations_url': 'https://api.github.com/users/bddppq/orgs', 'repos_url': 'https://api.github.com/users/bddppq/repos', 'events_url': 'https://api.github.com/users/bddppq/events{/privacy}', 'received_events_url': 'https://api.github.com/users/bddppq/received_events', 'type': 'User', 'site_admin': False}",referenced,3769a983624cf552ee89743eb714b23684e3a27d,https://api.github.com/repos/pytorch/pytorch/commits/3769a983624cf552ee89743eb714b23684e3a27d,2018-10-15T21:12:53Z,8,4,4
818,1594434672,"{'login': 'onnxbot', 'id': 33637430, 'node_id': 'MDQ6VXNlcjMzNjM3NDMw', 'avatar_url': 'https://avatars3.githubusercontent.com/u/33637430?v=4', 'gravatar_id': '', 'url': 'https://api.github.com/users/onnxbot', 'html_url': 'https://github.com/onnxbot', 'followers_url': 'https://api.github.com/users/onnxbot/followers', 'following_url': 'https://api.github.com/users/onnxbot/following{/other_user}', 'gists_url': 'https://api.github.com/users/onnxbot/gists{/gist_id}', 'starred_url': 'https://api.github.com/users/onnxbot/starred{/owner}{/repo}', 'subscriptions_url': 'https://api.github.com/users/onnxbot/subscriptions', 'organizations_url': 'https://api.github.com/users/onnxbot/orgs', 'repos_url': 'https://api.github.com/users/onnxbot/repos', 'events_url': 'https://api.github.com/users/onnxbot/events{/privacy}', 'received_events_url': 'https://api.github.com/users/onnxbot/received_events', 'type': 'User', 'site_admin': False}",referenced,138d69c688af40bdef1982d4c0ef5846bc3cae1c,https://api.github.com/repos/pytorch/pytorch/commits/138d69c688af40bdef1982d4c0ef5846bc3cae1c,2018-04-25T15:49:13Z,2,1,1
818,1905230224,"{'login': 'bddppq', 'id': 9300575, 'node_id': 'MDQ6VXNlcjkzMDA1NzU=', 'avatar_url': 'https://avatars2.githubusercontent.com/u/9300575?v=4', 'gravatar_id': '', 'url': 'https://api.github.com/users/bddppq', 'html_url': 'https://github.com/bddppq', 'followers_url': 'https://api.github.com/users/bddppq/followers', 'following_url': 'https://api.github.com/users/bddppq/following{/other_user}', 'gists_url': 'https://api.github.com/users/bddppq/gists{/gist_id}', 'starred_url': 'https://api.github.com/users/bddppq/starred{/owner}{/repo}', 'subscriptions_url': 'https://api.github.com/users/bddppq/subscriptions', 'organizations_url': 'https://api.github.com/users/bddppq/orgs', 'repos_url': 'https://api.github.com/users/bddppq/repos', 'events_url': 'https://api.github.com/users/bddppq/events{/privacy}', 'received_events_url': 'https://api.github.com/users/bddppq/received_events', 'type': 'User', 'site_admin': False}",referenced,403ccfbd0161c38f0834413d790bad0874afbf9a,https://api.github.com/repos/pytorch/pytorch/commits/403ccfbd0161c38f0834413d790bad0874afbf9a,2018-10-15T21:12:53Z,6,3,3
815,1592765695,"{'login': 'onnxbot', 'id': 33637430, 'node_id': 'MDQ6VXNlcjMzNjM3NDMw', 'avatar_url': 'https://avatars3.githubusercontent.com/u/33637430?v=4', 'gravatar_id': '', 'url': 'https://api.github.com/users/onnxbot', 'html_url': 'https://github.com/onnxbot', 'followers_url': 'https://api.github.com/users/onnxbot/followers', 'following_url': 'https://api.github.com/users/onnxbot/following{/other_user}', 'gists_url': 'https://api.github.com/users/onnxbot/gists{/gist_id}', 'starred_url': 'https://api.github.com/users/onnxbot/starred{/owner}{/repo}', 'subscriptions_url': 'https://api.github.com/users/onnxbot/subscriptions', 'organizations_url': 'https://api.github.com/users/onnxbot/orgs', 'repos_url': 'https://api.github.com/users/onnxbot/repos', 'events_url': 'https://api.github.com/users/onnxbot/events{/privacy}', 'received_events_url': 'https://api.github.com/users/onnxbot/received_events', 'type': 'User', 'site_admin': False}",referenced,53a8158d6d8e9a6de269f5e53ea078e669ea0ec7,https://api.github.com/repos/pytorch/pytorch/commits/53a8158d6d8e9a6de269f5e53ea078e669ea0ec7,2018-04-24T22:23:53Z,2,1,1
815,1905230217,"{'login': 'bddppq', 'id': 9300575, 'node_id': 'MDQ6VXNlcjkzMDA1NzU=', 'avatar_url': 'https://avatars2.githubusercontent.com/u/9300575?v=4', 'gravatar_id': '', 'url': 'https://api.github.com/users/bddppq', 'html_url': 'https://github.com/bddppq', 'followers_url': 'https://api.github.com/users/bddppq/followers', 'following_url': 'https://api.github.com/users/bddppq/following{/other_user}', 'gists_url': 'https://api.github.com/users/bddppq/gists{/gist_id}', 'starred_url': 'https://api.github.com/users/bddppq/starred{/owner}{/repo}', 'subscriptions_url': 'https://api.github.com/users/bddppq/subscriptions', 'organizations_url': 'https://api.github.com/users/bddppq/orgs', 'repos_url': 'https://api.github.com/users/bddppq/repos', 'events_url': 'https://api.github.com/users/bddppq/events{/privacy}', 'received_events_url': 'https://api.github.com/users/bddppq/received_events', 'type': 'User', 'site_admin': False}",referenced,0eaf45ff89c1041cd9b1d9697b7fa7156bc06fe4,https://api.github.com/repos/pytorch/pytorch/commits/0eaf45ff89c1041cd9b1d9697b7fa7156bc06fe4,2018-10-15T21:12:53Z,8,4,4
812,1597994178,"{'login': 'onnxbot', 'id': 33637430, 'node_id': 'MDQ6VXNlcjMzNjM3NDMw', 'avatar_url': 'https://avatars3.githubusercontent.com/u/33637430?v=4', 'gravatar_id': '', 'url': 'https://api.github.com/users/onnxbot', 'html_url': 'https://github.com/onnxbot', 'followers_url': 'https://api.github.com/users/onnxbot/followers', 'following_url': 'https://api.github.com/users/onnxbot/following{/other_user}', 'gists_url': 'https://api.github.com/users/onnxbot/gists{/gist_id}', 'starred_url': 'https://api.github.com/users/onnxbot/starred{/owner}{/repo}', 'subscriptions_url': 'https://api.github.com/users/onnxbot/subscriptions', 'organizations_url': 'https://api.github.com/users/onnxbot/orgs', 'repos_url': 'https://api.github.com/users/onnxbot/repos', 'events_url': 'https://api.github.com/users/onnxbot/events{/privacy}', 'received_events_url': 'https://api.github.com/users/onnxbot/received_events', 'type': 'User', 'site_admin': False}",referenced,9db779f3314e91cb2ac3ca4b4f0016e37d2457f0,https://api.github.com/repos/pytorch/pytorch/commits/9db779f3314e91cb2ac3ca4b4f0016e37d2457f0,2018-04-27T04:51:31Z,2,1,1
812,1621259702,"{'login': 'pjh5', 'id': 6456020, 'node_id': 'MDQ6VXNlcjY0NTYwMjA=', 'avatar_url': 'https://avatars1.githubusercontent.com/u/6456020?v=4', 'gravatar_id': '', 'url': 'https://api.github.com/users/pjh5', 'html_url': 'https://github.com/pjh5', 'followers_url': 'https://api.github.com/users/pjh5/followers', 'following_url': 'https://api.github.com/users/pjh5/following{/other_user}', 'gists_url': 'https://api.github.com/users/pjh5/gists{/gist_id}', 'starred_url': 'https://api.github.com/users/pjh5/starred{/owner}{/repo}', 'subscriptions_url': 'https://api.github.com/users/pjh5/subscriptions', 'organizations_url': 'https://api.github.com/users/pjh5/orgs', 'repos_url': 'https://api.github.com/users/pjh5/repos', 'events_url': 'https://api.github.com/users/pjh5/events{/privacy}', 'received_events_url': 'https://api.github.com/users/pjh5/received_events', 'type': 'User', 'site_admin': False}",referenced,b875fb281c92dbe88da279a0ff7ad342e7b28b9e,https://api.github.com/repos/pytorch/pytorch/commits/b875fb281c92dbe88da279a0ff7ad342e7b28b9e,2018-05-11T06:14:55Z,3328,2549,779
812,1905230263,"{'login': 'bddppq', 'id': 9300575, 'node_id': 'MDQ6VXNlcjkzMDA1NzU=', 'avatar_url': 'https://avatars2.githubusercontent.com/u/9300575?v=4', 'gravatar_id': '', 'url': 'https://api.github.com/users/bddppq', 'html_url': 'https://github.com/bddppq', 'followers_url': 'https://api.github.com/users/bddppq/followers', 'following_url': 'https://api.github.com/users/bddppq/following{/other_user}', 'gists_url': 'https://api.github.com/users/bddppq/gists{/gist_id}', 'starred_url': 'https://api.github.com/users/bddppq/starred{/owner}{/repo}', 'subscriptions_url': 'https://api.github.com/users/bddppq/subscriptions', 'organizations_url': 'https://api.github.com/users/bddppq/orgs', 'repos_url': 'https://api.github.com/users/bddppq/repos', 'events_url': 'https://api.github.com/users/bddppq/events{/privacy}', 'received_events_url': 'https://api.github.com/users/bddppq/received_events', 'type': 'User', 'site_admin': False}",referenced,45ceb5523a56b7b91d6e08d403aee03da57a4dc5,https://api.github.com/repos/pytorch/pytorch/commits/45ceb5523a56b7b91d6e08d403aee03da57a4dc5,2018-10-15T21:12:54Z,12,6,6
804,1592880032,"{'login': 'onnxbot', 'id': 33637430, 'node_id': 'MDQ6VXNlcjMzNjM3NDMw', 'avatar_url': 'https://avatars3.githubusercontent.com/u/33637430?v=4', 'gravatar_id': '', 'url': 'https://api.github.com/users/onnxbot', 'html_url': 'https://github.com/onnxbot', 'followers_url': 'https://api.github.com/users/onnxbot/followers', 'following_url': 'https://api.github.com/users/onnxbot/following{/other_user}', 'gists_url': 'https://api.github.com/users/onnxbot/gists{/gist_id}', 'starred_url': 'https://api.github.com/users/onnxbot/starred{/owner}{/repo}', 'subscriptions_url': 'https://api.github.com/users/onnxbot/subscriptions', 'organizations_url': 'https://api.github.com/users/onnxbot/orgs', 'repos_url': 'https://api.github.com/users/onnxbot/repos', 'events_url': 'https://api.github.com/users/onnxbot/events{/privacy}', 'received_events_url': 'https://api.github.com/users/onnxbot/received_events', 'type': 'User', 'site_admin': False}",referenced,e28508afa5e8d8c966325db06d09e246f22835a5,https://api.github.com/repos/pytorch/pytorch/commits/e28508afa5e8d8c966325db06d09e246f22835a5,2018-04-24T23:53:50Z,2,1,1
804,1593426100,"{'login': 'onnxbot', 'id': 33637430, 'node_id': 'MDQ6VXNlcjMzNjM3NDMw', 'avatar_url': 'https://avatars3.githubusercontent.com/u/33637430?v=4', 'gravatar_id': '', 'url': 'https://api.github.com/users/onnxbot', 'html_url': 'https://github.com/onnxbot', 'followers_url': 'https://api.github.com/users/onnxbot/followers', 'following_url': 'https://api.github.com/users/onnxbot/following{/other_user}', 'gists_url': 'https://api.github.com/users/onnxbot/gists{/gist_id}', 'starred_url': 'https://api.github.com/users/onnxbot/starred{/owner}{/repo}', 'subscriptions_url': 'https://api.github.com/users/onnxbot/subscriptions', 'organizations_url': 'https://api.github.com/users/onnxbot/orgs', 'repos_url': 'https://api.github.com/users/onnxbot/repos', 'events_url': 'https://api.github.com/users/onnxbot/events{/privacy}', 'received_events_url': 'https://api.github.com/users/onnxbot/received_events', 'type': 'User', 'site_admin': False}",referenced,c820fda180346a6062c89171450806836f558f6d,https://api.github.com/repos/pytorch/pytorch/commits/c820fda180346a6062c89171450806836f558f6d,2018-04-25T08:16:12Z,2,1,1
804,1905230218,"{'login': 'bddppq', 'id': 9300575, 'node_id': 'MDQ6VXNlcjkzMDA1NzU=', 'avatar_url': 'https://avatars2.githubusercontent.com/u/9300575?v=4', 'gravatar_id': '', 'url': 'https://api.github.com/users/bddppq', 'html_url': 'https://github.com/bddppq', 'followers_url': 'https://api.github.com/users/bddppq/followers', 'following_url': 'https://api.github.com/users/bddppq/following{/other_user}', 'gists_url': 'https://api.github.com/users/bddppq/gists{/gist_id}', 'starred_url': 'https://api.github.com/users/bddppq/starred{/owner}{/repo}', 'subscriptions_url': 'https://api.github.com/users/bddppq/subscriptions', 'organizations_url': 'https://api.github.com/users/bddppq/orgs', 'repos_url': 'https://api.github.com/users/bddppq/repos', 'events_url': 'https://api.github.com/users/bddppq/events{/privacy}', 'received_events_url': 'https://api.github.com/users/bddppq/received_events', 'type': 'User', 'site_admin': False}",referenced,42207c60d89727f5ae229fb3a66a0708fec70cda,https://api.github.com/repos/pytorch/pytorch/commits/42207c60d89727f5ae229fb3a66a0708fec70cda,2018-10-15T21:12:53Z,260,251,9
795,1587200917,"{'login': 'onnxbot', 'id': 33637430, 'node_id': 'MDQ6VXNlcjMzNjM3NDMw', 'avatar_url': 'https://avatars3.githubusercontent.com/u/33637430?v=4', 'gravatar_id': '', 'url': 'https://api.github.com/users/onnxbot', 'html_url': 'https://github.com/onnxbot', 'followers_url': 'https://api.github.com/users/onnxbot/followers', 'following_url': 'https://api.github.com/users/onnxbot/following{/other_user}', 'gists_url': 'https://api.github.com/users/onnxbot/gists{/gist_id}', 'starred_url': 'https://api.github.com/users/onnxbot/starred{/owner}{/repo}', 'subscriptions_url': 'https://api.github.com/users/onnxbot/subscriptions', 'organizations_url': 'https://api.github.com/users/onnxbot/orgs', 'repos_url': 'https://api.github.com/users/onnxbot/repos', 'events_url': 'https://api.github.com/users/onnxbot/events{/privacy}', 'received_events_url': 'https://api.github.com/users/onnxbot/received_events', 'type': 'User', 'site_admin': False}",referenced,afea1331133819c930e879a2d0de97112643c1d6,https://api.github.com/repos/pytorch/pytorch/commits/afea1331133819c930e879a2d0de97112643c1d6,2018-04-20T23:24:44Z,2,1,1
795,1905230197,"{'login': 'bddppq', 'id': 9300575, 'node_id': 'MDQ6VXNlcjkzMDA1NzU=', 'avatar_url': 'https://avatars2.githubusercontent.com/u/9300575?v=4', 'gravatar_id': '', 'url': 'https://api.github.com/users/bddppq', 'html_url': 'https://github.com/bddppq', 'followers_url': 'https://api.github.com/users/bddppq/followers', 'following_url': 'https://api.github.com/users/bddppq/following{/other_user}', 'gists_url': 'https://api.github.com/users/bddppq/gists{/gist_id}', 'starred_url': 'https://api.github.com/users/bddppq/starred{/owner}{/repo}', 'subscriptions_url': 'https://api.github.com/users/bddppq/subscriptions', 'organizations_url': 'https://api.github.com/users/bddppq/orgs', 'repos_url': 'https://api.github.com/users/bddppq/repos', 'events_url': 'https://api.github.com/users/bddppq/events{/privacy}', 'received_events_url': 'https://api.github.com/users/bddppq/received_events', 'type': 'User', 'site_admin': False}",referenced,b20fae02876265f6c8f6ff1dbf8b7afe53789c87,https://api.github.com/repos/pytorch/pytorch/commits/b20fae02876265f6c8f6ff1dbf8b7afe53789c87,2018-10-15T21:12:53Z,2,1,1
791,1586453914,"{'login': 'onnxbot', 'id': 33637430, 'node_id': 'MDQ6VXNlcjMzNjM3NDMw', 'avatar_url': 'https://avatars3.githubusercontent.com/u/33637430?v=4', 'gravatar_id': '', 'url': 'https://api.github.com/users/onnxbot', 'html_url': 'https://github.com/onnxbot', 'followers_url': 'https://api.github.com/users/onnxbot/followers', 'following_url': 'https://api.github.com/users/onnxbot/following{/other_user}', 'gists_url': 'https://api.github.com/users/onnxbot/gists{/gist_id}', 'starred_url': 'https://api.github.com/users/onnxbot/starred{/owner}{/repo}', 'subscriptions_url': 'https://api.github.com/users/onnxbot/subscriptions', 'organizations_url': 'https://api.github.com/users/onnxbot/orgs', 'repos_url': 'https://api.github.com/users/onnxbot/repos', 'events_url': 'https://api.github.com/users/onnxbot/events{/privacy}', 'received_events_url': 'https://api.github.com/users/onnxbot/received_events', 'type': 'User', 'site_admin': False}",referenced,378f742792a8e11971f89a06846391f0db546e7b,https://api.github.com/repos/pytorch/pytorch/commits/378f742792a8e11971f89a06846391f0db546e7b,2018-04-20T15:36:53Z,2,1,1
791,1905230185,"{'login': 'bddppq', 'id': 9300575, 'node_id': 'MDQ6VXNlcjkzMDA1NzU=', 'avatar_url': 'https://avatars2.githubusercontent.com/u/9300575?v=4', 'gravatar_id': '', 'url': 'https://api.github.com/users/bddppq', 'html_url': 'https://github.com/bddppq', 'followers_url': 'https://api.github.com/users/bddppq/followers', 'following_url': 'https://api.github.com/users/bddppq/following{/other_user}', 'gists_url': 'https://api.github.com/users/bddppq/gists{/gist_id}', 'starred_url': 'https://api.github.com/users/bddppq/starred{/owner}{/repo}', 'subscriptions_url': 'https://api.github.com/users/bddppq/subscriptions', 'organizations_url': 'https://api.github.com/users/bddppq/orgs', 'repos_url': 'https://api.github.com/users/bddppq/repos', 'events_url': 'https://api.github.com/users/bddppq/events{/privacy}', 'received_events_url': 'https://api.github.com/users/bddppq/received_events', 'type': 'User', 'site_admin': False}",referenced,8dafe889010aa957574faf793a5036ccc84d9eaf,https://api.github.com/repos/pytorch/pytorch/commits/8dafe889010aa957574faf793a5036ccc84d9eaf,2018-10-15T21:12:53Z,16,0,16
790,973932570,"{'login': 'apaszke', 'id': 4583066, 'node_id': 'MDQ6VXNlcjQ1ODMwNjY=', 'avatar_url': 'https://avatars3.githubusercontent.com/u/4583066?v=4', 'gravatar_id': '', 'url': 'https://api.github.com/users/apaszke', 'html_url': 'https://github.com/apaszke', 'followers_url': 'https://api.github.com/users/apaszke/followers', 'following_url': 'https://api.github.com/users/apaszke/following{/other_user}', 'gists_url': 'https://api.github.com/users/apaszke/gists{/gist_id}', 'starred_url': 'https://api.github.com/users/apaszke/starred{/owner}{/repo}', 'subscriptions_url': 'https://api.github.com/users/apaszke/subscriptions', 'organizations_url': 'https://api.github.com/users/apaszke/orgs', 'repos_url': 'https://api.github.com/users/apaszke/repos', 'events_url': 'https://api.github.com/users/apaszke/events{/privacy}', 'received_events_url': 'https://api.github.com/users/apaszke/received_events', 'type': 'User', 'site_admin': False}",referenced,838842d4b26ef341ca8d0e3fe9866d79a417e998,https://api.github.com/repos/pytorch/pytorch/commits/838842d4b26ef341ca8d0e3fe9866d79a417e998,2017-02-23T07:59:31Z,4,2,2
789,1585345520,"{'login': 'onnxbot', 'id': 33637430, 'node_id': 'MDQ6VXNlcjMzNjM3NDMw', 'avatar_url': 'https://avatars3.githubusercontent.com/u/33637430?v=4', 'gravatar_id': '', 'url': 'https://api.github.com/users/onnxbot', 'html_url': 'https://github.com/onnxbot', 'followers_url': 'https://api.github.com/users/onnxbot/followers', 'following_url': 'https://api.github.com/users/onnxbot/following{/other_user}', 'gists_url': 'https://api.github.com/users/onnxbot/gists{/gist_id}', 'starred_url': 'https://api.github.com/users/onnxbot/starred{/owner}{/repo}', 'subscriptions_url': 'https://api.github.com/users/onnxbot/subscriptions', 'organizations_url': 'https://api.github.com/users/onnxbot/orgs', 'repos_url': 'https://api.github.com/users/onnxbot/repos', 'events_url': 'https://api.github.com/users/onnxbot/events{/privacy}', 'received_events_url': 'https://api.github.com/users/onnxbot/received_events', 'type': 'User', 'site_admin': False}",referenced,945cb0fabc75e07b40a2f8ca821c49f1e113e869,https://api.github.com/repos/pytorch/pytorch/commits/945cb0fabc75e07b40a2f8ca821c49f1e113e869,2018-04-20T05:03:22Z,2,1,1
789,1905230178,"{'login': 'bddppq', 'id': 9300575, 'node_id': 'MDQ6VXNlcjkzMDA1NzU=', 'avatar_url': 'https://avatars2.githubusercontent.com/u/9300575?v=4', 'gravatar_id': '', 'url': 'https://api.github.com/users/bddppq', 'html_url': 'https://github.com/bddppq', 'followers_url': 'https://api.github.com/users/bddppq/followers', 'following_url': 'https://api.github.com/users/bddppq/following{/other_user}', 'gists_url': 'https://api.github.com/users/bddppq/gists{/gist_id}', 'starred_url': 'https://api.github.com/users/bddppq/starred{/owner}{/repo}', 'subscriptions_url': 'https://api.github.com/users/bddppq/subscriptions', 'organizations_url': 'https://api.github.com/users/bddppq/orgs', 'repos_url': 'https://api.github.com/users/bddppq/repos', 'events_url': 'https://api.github.com/users/bddppq/events{/privacy}', 'received_events_url': 'https://api.github.com/users/bddppq/received_events', 'type': 'User', 'site_admin': False}",referenced,45be0fe73650daed60107c06c900343cfdc6ed0d,https://api.github.com/repos/pytorch/pytorch/commits/45be0fe73650daed60107c06c900343cfdc6ed0d,2018-10-15T21:12:53Z,3,1,2
788,1585321497,"{'login': 'onnxbot', 'id': 33637430, 'node_id': 'MDQ6VXNlcjMzNjM3NDMw', 'avatar_url': 'https://avatars3.githubusercontent.com/u/33637430?v=4', 'gravatar_id': '', 'url': 'https://api.github.com/users/onnxbot', 'html_url': 'https://github.com/onnxbot', 'followers_url': 'https://api.github.com/users/onnxbot/followers', 'following_url': 'https://api.github.com/users/onnxbot/following{/other_user}', 'gists_url': 'https://api.github.com/users/onnxbot/gists{/gist_id}', 'starred_url': 'https://api.github.com/users/onnxbot/starred{/owner}{/repo}', 'subscriptions_url': 'https://api.github.com/users/onnxbot/subscriptions', 'organizations_url': 'https://api.github.com/users/onnxbot/orgs', 'repos_url': 'https://api.github.com/users/onnxbot/repos', 'events_url': 'https://api.github.com/users/onnxbot/events{/privacy}', 'received_events_url': 'https://api.github.com/users/onnxbot/received_events', 'type': 'User', 'site_admin': False}",referenced,503be98d610b464fd1fd9213ce336cfea22671c9,https://api.github.com/repos/pytorch/pytorch/commits/503be98d610b464fd1fd9213ce336cfea22671c9,2018-04-20T04:36:09Z,2,1,1
788,1905230174,"{'login': 'bddppq', 'id': 9300575, 'node_id': 'MDQ6VXNlcjkzMDA1NzU=', 'avatar_url': 'https://avatars2.githubusercontent.com/u/9300575?v=4', 'gravatar_id': '', 'url': 'https://api.github.com/users/bddppq', 'html_url': 'https://github.com/bddppq', 'followers_url': 'https://api.github.com/users/bddppq/followers', 'following_url': 'https://api.github.com/users/bddppq/following{/other_user}', 'gists_url': 'https://api.github.com/users/bddppq/gists{/gist_id}', 'starred_url': 'https://api.github.com/users/bddppq/starred{/owner}{/repo}', 'subscriptions_url': 'https://api.github.com/users/bddppq/subscriptions', 'organizations_url': 'https://api.github.com/users/bddppq/orgs', 'repos_url': 'https://api.github.com/users/bddppq/repos', 'events_url': 'https://api.github.com/users/bddppq/events{/privacy}', 'received_events_url': 'https://api.github.com/users/bddppq/received_events', 'type': 'User', 'site_admin': False}",referenced,d01e4afc4eb4cb472b91625fac2d94e31b204787,https://api.github.com/repos/pytorch/pytorch/commits/d01e4afc4eb4cb472b91625fac2d94e31b204787,2018-10-15T21:12:52Z,551,434,117
786,1585038956,"{'login': 'onnxbot', 'id': 33637430, 'node_id': 'MDQ6VXNlcjMzNjM3NDMw', 'avatar_url': 'https://avatars3.githubusercontent.com/u/33637430?v=4', 'gravatar_id': '', 'url': 'https://api.github.com/users/onnxbot', 'html_url': 'https://github.com/onnxbot', 'followers_url': 'https://api.github.com/users/onnxbot/followers', 'following_url': 'https://api.github.com/users/onnxbot/following{/other_user}', 'gists_url': 'https://api.github.com/users/onnxbot/gists{/gist_id}', 'starred_url': 'https://api.github.com/users/onnxbot/starred{/owner}{/repo}', 'subscriptions_url': 'https://api.github.com/users/onnxbot/subscriptions', 'organizations_url': 'https://api.github.com/users/onnxbot/orgs', 'repos_url': 'https://api.github.com/users/onnxbot/repos', 'events_url': 'https://api.github.com/users/onnxbot/events{/privacy}', 'received_events_url': 'https://api.github.com/users/onnxbot/received_events', 'type': 'User', 'site_admin': False}",referenced,1a53e45558127755a151a8925be25c1f696b07e3,https://api.github.com/repos/pytorch/pytorch/commits/1a53e45558127755a151a8925be25c1f696b07e3,2018-04-19T23:50:07Z,2,1,1
786,1905230169,"{'login': 'bddppq', 'id': 9300575, 'node_id': 'MDQ6VXNlcjkzMDA1NzU=', 'avatar_url': 'https://avatars2.githubusercontent.com/u/9300575?v=4', 'gravatar_id': '', 'url': 'https://api.github.com/users/bddppq', 'html_url': 'https://github.com/bddppq', 'followers_url': 'https://api.github.com/users/bddppq/followers', 'following_url': 'https://api.github.com/users/bddppq/following{/other_user}', 'gists_url': 'https://api.github.com/users/bddppq/gists{/gist_id}', 'starred_url': 'https://api.github.com/users/bddppq/starred{/owner}{/repo}', 'subscriptions_url': 'https://api.github.com/users/bddppq/subscriptions', 'organizations_url': 'https://api.github.com/users/bddppq/orgs', 'repos_url': 'https://api.github.com/users/bddppq/repos', 'events_url': 'https://api.github.com/users/bddppq/events{/privacy}', 'received_events_url': 'https://api.github.com/users/bddppq/received_events', 'type': 'User', 'site_admin': False}",referenced,abe285e987bb502f871093bf42dcd718bf34a5da,https://api.github.com/repos/pytorch/pytorch/commits/abe285e987bb502f871093bf42dcd718bf34a5da,2018-10-15T21:12:52Z,14,7,7
785,1147522126,"{'login': 'soumith', 'id': 1310570, 'node_id': 'MDQ6VXNlcjEzMTA1NzA=', 'avatar_url': 'https://avatars0.githubusercontent.com/u/1310570?v=4', 'gravatar_id': '', 'url': 'https://api.github.com/users/soumith', 'html_url': 'https://github.com/soumith', 'followers_url': 'https://api.github.com/users/soumith/followers', 'following_url': 'https://api.github.com/users/soumith/following{/other_user}', 'gists_url': 'https://api.github.com/users/soumith/gists{/gist_id}', 'starred_url': 'https://api.github.com/users/soumith/starred{/owner}{/repo}', 'subscriptions_url': 'https://api.github.com/users/soumith/subscriptions', 'organizations_url': 'https://api.github.com/users/soumith/orgs', 'repos_url': 'https://api.github.com/users/soumith/repos', 'events_url': 'https://api.github.com/users/soumith/events{/privacy}', 'received_events_url': 'https://api.github.com/users/soumith/received_events', 'type': 'User', 'site_admin': False}",referenced,bfaddc0a19ad390988932903268267f05e0e1504,https://api.github.com/repos/pytorch/pytorch/commits/bfaddc0a19ad390988932903268267f05e0e1504,2017-07-03T05:04:47Z,69,65,4
784,1161116006,"{'login': 'soumith', 'id': 1310570, 'node_id': 'MDQ6VXNlcjEzMTA1NzA=', 'avatar_url': 'https://avatars0.githubusercontent.com/u/1310570?v=4', 'gravatar_id': '', 'url': 'https://api.github.com/users/soumith', 'html_url': 'https://github.com/soumith', 'followers_url': 'https://api.github.com/users/soumith/followers', 'following_url': 'https://api.github.com/users/soumith/following{/other_user}', 'gists_url': 'https://api.github.com/users/soumith/gists{/gist_id}', 'starred_url': 'https://api.github.com/users/soumith/starred{/owner}{/repo}', 'subscriptions_url': 'https://api.github.com/users/soumith/subscriptions', 'organizations_url': 'https://api.github.com/users/soumith/orgs', 'repos_url': 'https://api.github.com/users/soumith/repos', 'events_url': 'https://api.github.com/users/soumith/events{/privacy}', 'received_events_url': 'https://api.github.com/users/soumith/received_events', 'type': 'User', 'site_admin': False}",referenced,78ecc2d3b1b8f0e9b0d696a8d3e09424d1d34628,https://api.github.com/repos/pytorch/pytorch/commits/78ecc2d3b1b8f0e9b0d696a8d3e09424d1d34628,2017-07-12T16:58:07Z,157,157,0
784,1584943270,"{'login': 'onnxbot', 'id': 33637430, 'node_id': 'MDQ6VXNlcjMzNjM3NDMw', 'avatar_url': 'https://avatars3.githubusercontent.com/u/33637430?v=4', 'gravatar_id': '', 'url': 'https://api.github.com/users/onnxbot', 'html_url': 'https://github.com/onnxbot', 'followers_url': 'https://api.github.com/users/onnxbot/followers', 'following_url': 'https://api.github.com/users/onnxbot/following{/other_user}', 'gists_url': 'https://api.github.com/users/onnxbot/gists{/gist_id}', 'starred_url': 'https://api.github.com/users/onnxbot/starred{/owner}{/repo}', 'subscriptions_url': 'https://api.github.com/users/onnxbot/subscriptions', 'organizations_url': 'https://api.github.com/users/onnxbot/orgs', 'repos_url': 'https://api.github.com/users/onnxbot/repos', 'events_url': 'https://api.github.com/users/onnxbot/events{/privacy}', 'received_events_url': 'https://api.github.com/users/onnxbot/received_events', 'type': 'User', 'site_admin': False}",referenced,264ffd143c3694df6f39a16ca0c5df3ba34a0d32,https://api.github.com/repos/pytorch/pytorch/commits/264ffd143c3694df6f39a16ca0c5df3ba34a0d32,2018-04-19T22:28:30Z,2,1,1
784,1905230168,"{'login': 'bddppq', 'id': 9300575, 'node_id': 'MDQ6VXNlcjkzMDA1NzU=', 'avatar_url': 'https://avatars2.githubusercontent.com/u/9300575?v=4', 'gravatar_id': '', 'url': 'https://api.github.com/users/bddppq', 'html_url': 'https://github.com/bddppq', 'followers_url': 'https://api.github.com/users/bddppq/followers', 'following_url': 'https://api.github.com/users/bddppq/following{/other_user}', 'gists_url': 'https://api.github.com/users/bddppq/gists{/gist_id}', 'starred_url': 'https://api.github.com/users/bddppq/starred{/owner}{/repo}', 'subscriptions_url': 'https://api.github.com/users/bddppq/subscriptions', 'organizations_url': 'https://api.github.com/users/bddppq/orgs', 'repos_url': 'https://api.github.com/users/bddppq/repos', 'events_url': 'https://api.github.com/users/bddppq/events{/privacy}', 'received_events_url': 'https://api.github.com/users/bddppq/received_events', 'type': 'User', 'site_admin': False}",referenced,5ef9c6ee28830697ab93afce8672330b26963963,https://api.github.com/repos/pytorch/pytorch/commits/5ef9c6ee28830697ab93afce8672330b26963963,2018-10-15T21:12:52Z,4,3,1
782,1584617240,"{'login': 'onnxbot', 'id': 33637430, 'node_id': 'MDQ6VXNlcjMzNjM3NDMw', 'avatar_url': 'https://avatars3.githubusercontent.com/u/33637430?v=4', 'gravatar_id': '', 'url': 'https://api.github.com/users/onnxbot', 'html_url': 'https://github.com/onnxbot', 'followers_url': 'https://api.github.com/users/onnxbot/followers', 'following_url': 'https://api.github.com/users/onnxbot/following{/other_user}', 'gists_url': 'https://api.github.com/users/onnxbot/gists{/gist_id}', 'starred_url': 'https://api.github.com/users/onnxbot/starred{/owner}{/repo}', 'subscriptions_url': 'https://api.github.com/users/onnxbot/subscriptions', 'organizations_url': 'https://api.github.com/users/onnxbot/orgs', 'repos_url': 'https://api.github.com/users/onnxbot/repos', 'events_url': 'https://api.github.com/users/onnxbot/events{/privacy}', 'received_events_url': 'https://api.github.com/users/onnxbot/received_events', 'type': 'User', 'site_admin': False}",referenced,6fed2341e9ce71151ca283f23f09db0c6b84d50e,https://api.github.com/repos/pytorch/pytorch/commits/6fed2341e9ce71151ca283f23f09db0c6b84d50e,2018-04-19T19:26:07Z,2,1,1
782,1905230166,"{'login': 'bddppq', 'id': 9300575, 'node_id': 'MDQ6VXNlcjkzMDA1NzU=', 'avatar_url': 'https://avatars2.githubusercontent.com/u/9300575?v=4', 'gravatar_id': '', 'url': 'https://api.github.com/users/bddppq', 'html_url': 'https://github.com/bddppq', 'followers_url': 'https://api.github.com/users/bddppq/followers', 'following_url': 'https://api.github.com/users/bddppq/following{/other_user}', 'gists_url': 'https://api.github.com/users/bddppq/gists{/gist_id}', 'starred_url': 'https://api.github.com/users/bddppq/starred{/owner}{/repo}', 'subscriptions_url': 'https://api.github.com/users/bddppq/subscriptions', 'organizations_url': 'https://api.github.com/users/bddppq/orgs', 'repos_url': 'https://api.github.com/users/bddppq/repos', 'events_url': 'https://api.github.com/users/bddppq/events{/privacy}', 'received_events_url': 'https://api.github.com/users/bddppq/received_events', 'type': 'User', 'site_admin': False}",referenced,3b27cc8faa801460b8154870516fedc5717eacc0,https://api.github.com/repos/pytorch/pytorch/commits/3b27cc8faa801460b8154870516fedc5717eacc0,2018-10-15T21:12:52Z,5,4,1
781,1587300413,"{'login': 'onnxbot', 'id': 33637430, 'node_id': 'MDQ6VXNlcjMzNjM3NDMw', 'avatar_url': 'https://avatars3.githubusercontent.com/u/33637430?v=4', 'gravatar_id': '', 'url': 'https://api.github.com/users/onnxbot', 'html_url': 'https://github.com/onnxbot', 'followers_url': 'https://api.github.com/users/onnxbot/followers', 'following_url': 'https://api.github.com/users/onnxbot/following{/other_user}', 'gists_url': 'https://api.github.com/users/onnxbot/gists{/gist_id}', 'starred_url': 'https://api.github.com/users/onnxbot/starred{/owner}{/repo}', 'subscriptions_url': 'https://api.github.com/users/onnxbot/subscriptions', 'organizations_url': 'https://api.github.com/users/onnxbot/orgs', 'repos_url': 'https://api.github.com/users/onnxbot/repos', 'events_url': 'https://api.github.com/users/onnxbot/events{/privacy}', 'received_events_url': 'https://api.github.com/users/onnxbot/received_events', 'type': 'User', 'site_admin': False}",referenced,5945f3a7b40da2732cfe998b7747d6b4e42686a8,https://api.github.com/repos/pytorch/pytorch/commits/5945f3a7b40da2732cfe998b7747d6b4e42686a8,2018-04-21T03:29:37Z,2,1,1
781,1905230207,"{'login': 'bddppq', 'id': 9300575, 'node_id': 'MDQ6VXNlcjkzMDA1NzU=', 'avatar_url': 'https://avatars2.githubusercontent.com/u/9300575?v=4', 'gravatar_id': '', 'url': 'https://api.github.com/users/bddppq', 'html_url': 'https://github.com/bddppq', 'followers_url': 'https://api.github.com/users/bddppq/followers', 'following_url': 'https://api.github.com/users/bddppq/following{/other_user}', 'gists_url': 'https://api.github.com/users/bddppq/gists{/gist_id}', 'starred_url': 'https://api.github.com/users/bddppq/starred{/owner}{/repo}', 'subscriptions_url': 'https://api.github.com/users/bddppq/subscriptions', 'organizations_url': 'https://api.github.com/users/bddppq/orgs', 'repos_url': 'https://api.github.com/users/bddppq/repos', 'events_url': 'https://api.github.com/users/bddppq/events{/privacy}', 'received_events_url': 'https://api.github.com/users/bddppq/received_events', 'type': 'User', 'site_admin': False}",referenced,e3da0f9babe700fde5b70c998b3104a91cacbca5,https://api.github.com/repos/pytorch/pytorch/commits/e3da0f9babe700fde5b70c998b3104a91cacbca5,2018-10-15T21:12:53Z,43,28,15
779,1586943230,"{'login': 'onnxbot', 'id': 33637430, 'node_id': 'MDQ6VXNlcjMzNjM3NDMw', 'avatar_url': 'https://avatars3.githubusercontent.com/u/33637430?v=4', 'gravatar_id': '', 'url': 'https://api.github.com/users/onnxbot', 'html_url': 'https://github.com/onnxbot', 'followers_url': 'https://api.github.com/users/onnxbot/followers', 'following_url': 'https://api.github.com/users/onnxbot/following{/other_user}', 'gists_url': 'https://api.github.com/users/onnxbot/gists{/gist_id}', 'starred_url': 'https://api.github.com/users/onnxbot/starred{/owner}{/repo}', 'subscriptions_url': 'https://api.github.com/users/onnxbot/subscriptions', 'organizations_url': 'https://api.github.com/users/onnxbot/orgs', 'repos_url': 'https://api.github.com/users/onnxbot/repos', 'events_url': 'https://api.github.com/users/onnxbot/events{/privacy}', 'received_events_url': 'https://api.github.com/users/onnxbot/received_events', 'type': 'User', 'site_admin': False}",referenced,02544f44728fbd6db07350a20bbe26998c4ead84,https://api.github.com/repos/pytorch/pytorch/commits/02544f44728fbd6db07350a20bbe26998c4ead84,2018-04-20T20:06:12Z,2,1,1
779,1905230192,"{'login': 'bddppq', 'id': 9300575, 'node_id': 'MDQ6VXNlcjkzMDA1NzU=', 'avatar_url': 'https://avatars2.githubusercontent.com/u/9300575?v=4', 'gravatar_id': '', 'url': 'https://api.github.com/users/bddppq', 'html_url': 'https://github.com/bddppq', 'followers_url': 'https://api.github.com/users/bddppq/followers', 'following_url': 'https://api.github.com/users/bddppq/following{/other_user}', 'gists_url': 'https://api.github.com/users/bddppq/gists{/gist_id}', 'starred_url': 'https://api.github.com/users/bddppq/starred{/owner}{/repo}', 'subscriptions_url': 'https://api.github.com/users/bddppq/subscriptions', 'organizations_url': 'https://api.github.com/users/bddppq/orgs', 'repos_url': 'https://api.github.com/users/bddppq/repos', 'events_url': 'https://api.github.com/users/bddppq/events{/privacy}', 'received_events_url': 'https://api.github.com/users/bddppq/received_events', 'type': 'User', 'site_admin': False}",referenced,7d1e102e73ffd0479a87d62c8aa950e03cfdda95,https://api.github.com/repos/pytorch/pytorch/commits/7d1e102e73ffd0479a87d62c8aa950e03cfdda95,2018-10-15T21:12:53Z,577,338,239
776,1582927087,"{'login': 'onnxbot', 'id': 33637430, 'node_id': 'MDQ6VXNlcjMzNjM3NDMw', 'avatar_url': 'https://avatars3.githubusercontent.com/u/33637430?v=4', 'gravatar_id': '', 'url': 'https://api.github.com/users/onnxbot', 'html_url': 'https://github.com/onnxbot', 'followers_url': 'https://api.github.com/users/onnxbot/followers', 'following_url': 'https://api.github.com/users/onnxbot/following{/other_user}', 'gists_url': 'https://api.github.com/users/onnxbot/gists{/gist_id}', 'starred_url': 'https://api.github.com/users/onnxbot/starred{/owner}{/repo}', 'subscriptions_url': 'https://api.github.com/users/onnxbot/subscriptions', 'organizations_url': 'https://api.github.com/users/onnxbot/orgs', 'repos_url': 'https://api.github.com/users/onnxbot/repos', 'events_url': 'https://api.github.com/users/onnxbot/events{/privacy}', 'received_events_url': 'https://api.github.com/users/onnxbot/received_events', 'type': 'User', 'site_admin': False}",referenced,fff80c2c1f81095785963b4fe4315fb36b0a0deb,https://api.github.com/repos/pytorch/pytorch/commits/fff80c2c1f81095785963b4fe4315fb36b0a0deb,2018-04-19T04:53:42Z,2,1,1
776,1905230164,"{'login': 'bddppq', 'id': 9300575, 'node_id': 'MDQ6VXNlcjkzMDA1NzU=', 'avatar_url': 'https://avatars2.githubusercontent.com/u/9300575?v=4', 'gravatar_id': '', 'url': 'https://api.github.com/users/bddppq', 'html_url': 'https://github.com/bddppq', 'followers_url': 'https://api.github.com/users/bddppq/followers', 'following_url': 'https://api.github.com/users/bddppq/following{/other_user}', 'gists_url': 'https://api.github.com/users/bddppq/gists{/gist_id}', 'starred_url': 'https://api.github.com/users/bddppq/starred{/owner}{/repo}', 'subscriptions_url': 'https://api.github.com/users/bddppq/subscriptions', 'organizations_url': 'https://api.github.com/users/bddppq/orgs', 'repos_url': 'https://api.github.com/users/bddppq/repos', 'events_url': 'https://api.github.com/users/bddppq/events{/privacy}', 'received_events_url': 'https://api.github.com/users/bddppq/received_events', 'type': 'User', 'site_admin': False}",referenced,1439eab5542c625bb3da49860f0cd68c3eafdc18,https://api.github.com/repos/pytorch/pytorch/commits/1439eab5542c625bb3da49860f0cd68c3eafdc18,2018-10-15T21:12:52Z,2,1,1
771,977092174,"{'login': 'soumith', 'id': 1310570, 'node_id': 'MDQ6VXNlcjEzMTA1NzA=', 'avatar_url': 'https://avatars0.githubusercontent.com/u/1310570?v=4', 'gravatar_id': '', 'url': 'https://api.github.com/users/soumith', 'html_url': 'https://github.com/soumith', 'followers_url': 'https://api.github.com/users/soumith/followers', 'following_url': 'https://api.github.com/users/soumith/following{/other_user}', 'gists_url': 'https://api.github.com/users/soumith/gists{/gist_id}', 'starred_url': 'https://api.github.com/users/soumith/starred{/owner}{/repo}', 'subscriptions_url': 'https://api.github.com/users/soumith/subscriptions', 'organizations_url': 'https://api.github.com/users/soumith/orgs', 'repos_url': 'https://api.github.com/users/soumith/repos', 'events_url': 'https://api.github.com/users/soumith/events{/privacy}', 'received_events_url': 'https://api.github.com/users/soumith/received_events', 'type': 'User', 'site_admin': False}",referenced,13a5090695fd5ed89c4005ff03d7359d5739e7f1,https://api.github.com/repos/pytorch/pytorch/commits/13a5090695fd5ed89c4005ff03d7359d5739e7f1,2017-02-25T13:53:32Z,53,32,21
771,1586514934,"{'login': 'onnxbot', 'id': 33637430, 'node_id': 'MDQ6VXNlcjMzNjM3NDMw', 'avatar_url': 'https://avatars3.githubusercontent.com/u/33637430?v=4', 'gravatar_id': '', 'url': 'https://api.github.com/users/onnxbot', 'html_url': 'https://github.com/onnxbot', 'followers_url': 'https://api.github.com/users/onnxbot/followers', 'following_url': 'https://api.github.com/users/onnxbot/following{/other_user}', 'gists_url': 'https://api.github.com/users/onnxbot/gists{/gist_id}', 'starred_url': 'https://api.github.com/users/onnxbot/starred{/owner}{/repo}', 'subscriptions_url': 'https://api.github.com/users/onnxbot/subscriptions', 'organizations_url': 'https://api.github.com/users/onnxbot/orgs', 'repos_url': 'https://api.github.com/users/onnxbot/repos', 'events_url': 'https://api.github.com/users/onnxbot/events{/privacy}', 'received_events_url': 'https://api.github.com/users/onnxbot/received_events', 'type': 'User', 'site_admin': False}",referenced,188b6e934653b42c0e625dd7226dd036c497125a,https://api.github.com/repos/pytorch/pytorch/commits/188b6e934653b42c0e625dd7226dd036c497125a,2018-04-20T16:06:13Z,2,1,1
771,1905230189,"{'login': 'bddppq', 'id': 9300575, 'node_id': 'MDQ6VXNlcjkzMDA1NzU=', 'avatar_url': 'https://avatars2.githubusercontent.com/u/9300575?v=4', 'gravatar_id': '', 'url': 'https://api.github.com/users/bddppq', 'html_url': 'https://github.com/bddppq', 'followers_url': 'https://api.github.com/users/bddppq/followers', 'following_url': 'https://api.github.com/users/bddppq/following{/other_user}', 'gists_url': 'https://api.github.com/users/bddppq/gists{/gist_id}', 'starred_url': 'https://api.github.com/users/bddppq/starred{/owner}{/repo}', 'subscriptions_url': 'https://api.github.com/users/bddppq/subscriptions', 'organizations_url': 'https://api.github.com/users/bddppq/orgs', 'repos_url': 'https://api.github.com/users/bddppq/repos', 'events_url': 'https://api.github.com/users/bddppq/events{/privacy}', 'received_events_url': 'https://api.github.com/users/bddppq/received_events', 'type': 'User', 'site_admin': False}",referenced,6953eff49a7a6d1cf5c04f3a67260a5c798e5e7b,https://api.github.com/repos/pytorch/pytorch/commits/6953eff49a7a6d1cf5c04f3a67260a5c798e5e7b,2018-10-15T21:12:53Z,279,141,138
768,1147522129,"{'login': 'soumith', 'id': 1310570, 'node_id': 'MDQ6VXNlcjEzMTA1NzA=', 'avatar_url': 'https://avatars0.githubusercontent.com/u/1310570?v=4', 'gravatar_id': '', 'url': 'https://api.github.com/users/soumith', 'html_url': 'https://github.com/soumith', 'followers_url': 'https://api.github.com/users/soumith/followers', 'following_url': 'https://api.github.com/users/soumith/following{/other_user}', 'gists_url': 'https://api.github.com/users/soumith/gists{/gist_id}', 'starred_url': 'https://api.github.com/users/soumith/starred{/owner}{/repo}', 'subscriptions_url': 'https://api.github.com/users/soumith/subscriptions', 'organizations_url': 'https://api.github.com/users/soumith/orgs', 'repos_url': 'https://api.github.com/users/soumith/repos', 'events_url': 'https://api.github.com/users/soumith/events{/privacy}', 'received_events_url': 'https://api.github.com/users/soumith/received_events', 'type': 'User', 'site_admin': False}",referenced,c691fc6dc711814a06107d4a9b763f34bff5afca,https://api.github.com/repos/pytorch/pytorch/commits/c691fc6dc711814a06107d4a9b763f34bff5afca,2017-07-03T05:04:47Z,132,126,6
764,1580220205,"{'login': 'onnxbot', 'id': 33637430, 'node_id': 'MDQ6VXNlcjMzNjM3NDMw', 'avatar_url': 'https://avatars3.githubusercontent.com/u/33637430?v=4', 'gravatar_id': '', 'url': 'https://api.github.com/users/onnxbot', 'html_url': 'https://github.com/onnxbot', 'followers_url': 'https://api.github.com/users/onnxbot/followers', 'following_url': 'https://api.github.com/users/onnxbot/following{/other_user}', 'gists_url': 'https://api.github.com/users/onnxbot/gists{/gist_id}', 'starred_url': 'https://api.github.com/users/onnxbot/starred{/owner}{/repo}', 'subscriptions_url': 'https://api.github.com/users/onnxbot/subscriptions', 'organizations_url': 'https://api.github.com/users/onnxbot/orgs', 'repos_url': 'https://api.github.com/users/onnxbot/repos', 'events_url': 'https://api.github.com/users/onnxbot/events{/privacy}', 'received_events_url': 'https://api.github.com/users/onnxbot/received_events', 'type': 'User', 'site_admin': False}",referenced,f50f1769eca84a1e4eb46c2f10fc471e6fdca034,https://api.github.com/repos/pytorch/pytorch/commits/f50f1769eca84a1e4eb46c2f10fc471e6fdca034,2018-04-17T23:33:39Z,2,1,1
764,1905230153,"{'login': 'bddppq', 'id': 9300575, 'node_id': 'MDQ6VXNlcjkzMDA1NzU=', 'avatar_url': 'https://avatars2.githubusercontent.com/u/9300575?v=4', 'gravatar_id': '', 'url': 'https://api.github.com/users/bddppq', 'html_url': 'https://github.com/bddppq', 'followers_url': 'https://api.github.com/users/bddppq/followers', 'following_url': 'https://api.github.com/users/bddppq/following{/other_user}', 'gists_url': 'https://api.github.com/users/bddppq/gists{/gist_id}', 'starred_url': 'https://api.github.com/users/bddppq/starred{/owner}{/repo}', 'subscriptions_url': 'https://api.github.com/users/bddppq/subscriptions', 'organizations_url': 'https://api.github.com/users/bddppq/orgs', 'repos_url': 'https://api.github.com/users/bddppq/repos', 'events_url': 'https://api.github.com/users/bddppq/events{/privacy}', 'received_events_url': 'https://api.github.com/users/bddppq/received_events', 'type': 'User', 'site_admin': False}",referenced,844bbc214265f7a51a0770a05436fa07db8ecfe8,https://api.github.com/repos/pytorch/pytorch/commits/844bbc214265f7a51a0770a05436fa07db8ecfe8,2018-10-15T21:12:52Z,36,20,16
763,1905230499,"{'login': 'bddppq', 'id': 9300575, 'node_id': 'MDQ6VXNlcjkzMDA1NzU=', 'avatar_url': 'https://avatars2.githubusercontent.com/u/9300575?v=4', 'gravatar_id': '', 'url': 'https://api.github.com/users/bddppq', 'html_url': 'https://github.com/bddppq', 'followers_url': 'https://api.github.com/users/bddppq/followers', 'following_url': 'https://api.github.com/users/bddppq/following{/other_user}', 'gists_url': 'https://api.github.com/users/bddppq/gists{/gist_id}', 'starred_url': 'https://api.github.com/users/bddppq/starred{/owner}{/repo}', 'subscriptions_url': 'https://api.github.com/users/bddppq/subscriptions', 'organizations_url': 'https://api.github.com/users/bddppq/orgs', 'repos_url': 'https://api.github.com/users/bddppq/repos', 'events_url': 'https://api.github.com/users/bddppq/events{/privacy}', 'received_events_url': 'https://api.github.com/users/bddppq/received_events', 'type': 'User', 'site_admin': False}",referenced,8356ad54e9173cfb8dfae6d25a67278e6d48bbb2,https://api.github.com/repos/pytorch/pytorch/commits/8356ad54e9173cfb8dfae6d25a67278e6d48bbb2,2018-10-15T21:12:59Z,178,175,3
760,1574725737,"{'login': 'onnxbot', 'id': 33637430, 'node_id': 'MDQ6VXNlcjMzNjM3NDMw', 'avatar_url': 'https://avatars3.githubusercontent.com/u/33637430?v=4', 'gravatar_id': '', 'url': 'https://api.github.com/users/onnxbot', 'html_url': 'https://github.com/onnxbot', 'followers_url': 'https://api.github.com/users/onnxbot/followers', 'following_url': 'https://api.github.com/users/onnxbot/following{/other_user}', 'gists_url': 'https://api.github.com/users/onnxbot/gists{/gist_id}', 'starred_url': 'https://api.github.com/users/onnxbot/starred{/owner}{/repo}', 'subscriptions_url': 'https://api.github.com/users/onnxbot/subscriptions', 'organizations_url': 'https://api.github.com/users/onnxbot/orgs', 'repos_url': 'https://api.github.com/users/onnxbot/repos', 'events_url': 'https://api.github.com/users/onnxbot/events{/privacy}', 'received_events_url': 'https://api.github.com/users/onnxbot/received_events', 'type': 'User', 'site_admin': False}",referenced,caadc9301f0534001f9726866cb9db2e2b0e2758,https://api.github.com/repos/pytorch/pytorch/commits/caadc9301f0534001f9726866cb9db2e2b0e2758,2018-04-14T22:28:28Z,2,1,1
760,1905230143,"{'login': 'bddppq', 'id': 9300575, 'node_id': 'MDQ6VXNlcjkzMDA1NzU=', 'avatar_url': 'https://avatars2.githubusercontent.com/u/9300575?v=4', 'gravatar_id': '', 'url': 'https://api.github.com/users/bddppq', 'html_url': 'https://github.com/bddppq', 'followers_url': 'https://api.github.com/users/bddppq/followers', 'following_url': 'https://api.github.com/users/bddppq/following{/other_user}', 'gists_url': 'https://api.github.com/users/bddppq/gists{/gist_id}', 'starred_url': 'https://api.github.com/users/bddppq/starred{/owner}{/repo}', 'subscriptions_url': 'https://api.github.com/users/bddppq/subscriptions', 'organizations_url': 'https://api.github.com/users/bddppq/orgs', 'repos_url': 'https://api.github.com/users/bddppq/repos', 'events_url': 'https://api.github.com/users/bddppq/events{/privacy}', 'received_events_url': 'https://api.github.com/users/bddppq/received_events', 'type': 'User', 'site_admin': False}",referenced,ff7b3b4c856bc6476d6398a191a2cfe24035806b,https://api.github.com/repos/pytorch/pytorch/commits/ff7b3b4c856bc6476d6398a191a2cfe24035806b,2018-10-15T21:12:52Z,91,18,73
759,1062535906,"{'login': 'soumith', 'id': 1310570, 'node_id': 'MDQ6VXNlcjEzMTA1NzA=', 'avatar_url': 'https://avatars0.githubusercontent.com/u/1310570?v=4', 'gravatar_id': '', 'url': 'https://api.github.com/users/soumith', 'html_url': 'https://github.com/soumith', 'followers_url': 'https://api.github.com/users/soumith/followers', 'following_url': 'https://api.github.com/users/soumith/following{/other_user}', 'gists_url': 'https://api.github.com/users/soumith/gists{/gist_id}', 'starred_url': 'https://api.github.com/users/soumith/starred{/owner}{/repo}', 'subscriptions_url': 'https://api.github.com/users/soumith/subscriptions', 'organizations_url': 'https://api.github.com/users/soumith/orgs', 'repos_url': 'https://api.github.com/users/soumith/repos', 'events_url': 'https://api.github.com/users/soumith/events{/privacy}', 'received_events_url': 'https://api.github.com/users/soumith/received_events', 'type': 'User', 'site_admin': False}",referenced,c26f6877a001809a5fd3bde1240abd733cde9c02,https://api.github.com/repos/pytorch/pytorch/commits/c26f6877a001809a5fd3bde1240abd733cde9c02,2017-04-28T17:48:16Z,12,12,0
759,1574369441,"{'login': 'onnxbot', 'id': 33637430, 'node_id': 'MDQ6VXNlcjMzNjM3NDMw', 'avatar_url': 'https://avatars3.githubusercontent.com/u/33637430?v=4', 'gravatar_id': '', 'url': 'https://api.github.com/users/onnxbot', 'html_url': 'https://github.com/onnxbot', 'followers_url': 'https://api.github.com/users/onnxbot/followers', 'following_url': 'https://api.github.com/users/onnxbot/following{/other_user}', 'gists_url': 'https://api.github.com/users/onnxbot/gists{/gist_id}', 'starred_url': 'https://api.github.com/users/onnxbot/starred{/owner}{/repo}', 'subscriptions_url': 'https://api.github.com/users/onnxbot/subscriptions', 'organizations_url': 'https://api.github.com/users/onnxbot/orgs', 'repos_url': 'https://api.github.com/users/onnxbot/repos', 'events_url': 'https://api.github.com/users/onnxbot/events{/privacy}', 'received_events_url': 'https://api.github.com/users/onnxbot/received_events', 'type': 'User', 'site_admin': False}",referenced,0e246305aba027a0cc4bac888aa9245cd93f2592,https://api.github.com/repos/pytorch/pytorch/commits/0e246305aba027a0cc4bac888aa9245cd93f2592,2018-04-14T01:41:26Z,2,1,1
759,1905230141,"{'login': 'bddppq', 'id': 9300575, 'node_id': 'MDQ6VXNlcjkzMDA1NzU=', 'avatar_url': 'https://avatars2.githubusercontent.com/u/9300575?v=4', 'gravatar_id': '', 'url': 'https://api.github.com/users/bddppq', 'html_url': 'https://github.com/bddppq', 'followers_url': 'https://api.github.com/users/bddppq/followers', 'following_url': 'https://api.github.com/users/bddppq/following{/other_user}', 'gists_url': 'https://api.github.com/users/bddppq/gists{/gist_id}', 'starred_url': 'https://api.github.com/users/bddppq/starred{/owner}{/repo}', 'subscriptions_url': 'https://api.github.com/users/bddppq/subscriptions', 'organizations_url': 'https://api.github.com/users/bddppq/orgs', 'repos_url': 'https://api.github.com/users/bddppq/repos', 'events_url': 'https://api.github.com/users/bddppq/events{/privacy}', 'received_events_url': 'https://api.github.com/users/bddppq/received_events', 'type': 'User', 'site_admin': False}",referenced,97d3ae6ddd83ddc26883c4f77ef91311391c1063,https://api.github.com/repos/pytorch/pytorch/commits/97d3ae6ddd83ddc26883c4f77ef91311391c1063,2018-10-15T21:12:52Z,284,147,137
758,1582110303,"{'login': 'onnxbot', 'id': 33637430, 'node_id': 'MDQ6VXNlcjMzNjM3NDMw', 'avatar_url': 'https://avatars3.githubusercontent.com/u/33637430?v=4', 'gravatar_id': '', 'url': 'https://api.github.com/users/onnxbot', 'html_url': 'https://github.com/onnxbot', 'followers_url': 'https://api.github.com/users/onnxbot/followers', 'following_url': 'https://api.github.com/users/onnxbot/following{/other_user}', 'gists_url': 'https://api.github.com/users/onnxbot/gists{/gist_id}', 'starred_url': 'https://api.github.com/users/onnxbot/starred{/owner}{/repo}', 'subscriptions_url': 'https://api.github.com/users/onnxbot/subscriptions', 'organizations_url': 'https://api.github.com/users/onnxbot/orgs', 'repos_url': 'https://api.github.com/users/onnxbot/repos', 'events_url': 'https://api.github.com/users/onnxbot/events{/privacy}', 'received_events_url': 'https://api.github.com/users/onnxbot/received_events', 'type': 'User', 'site_admin': False}",referenced,530e1e89f0ecd3e2d79062ccd9d32f1d3c2f56ad,https://api.github.com/repos/pytorch/pytorch/commits/530e1e89f0ecd3e2d79062ccd9d32f1d3c2f56ad,2018-04-18T18:20:44Z,2,1,1
758,1905230161,"{'login': 'bddppq', 'id': 9300575, 'node_id': 'MDQ6VXNlcjkzMDA1NzU=', 'avatar_url': 'https://avatars2.githubusercontent.com/u/9300575?v=4', 'gravatar_id': '', 'url': 'https://api.github.com/users/bddppq', 'html_url': 'https://github.com/bddppq', 'followers_url': 'https://api.github.com/users/bddppq/followers', 'following_url': 'https://api.github.com/users/bddppq/following{/other_user}', 'gists_url': 'https://api.github.com/users/bddppq/gists{/gist_id}', 'starred_url': 'https://api.github.com/users/bddppq/starred{/owner}{/repo}', 'subscriptions_url': 'https://api.github.com/users/bddppq/subscriptions', 'organizations_url': 'https://api.github.com/users/bddppq/orgs', 'repos_url': 'https://api.github.com/users/bddppq/repos', 'events_url': 'https://api.github.com/users/bddppq/events{/privacy}', 'received_events_url': 'https://api.github.com/users/bddppq/received_events', 'type': 'User', 'site_admin': False}",referenced,5509f70b80810ddaefccf797a561eeb575744683,https://api.github.com/repos/pytorch/pytorch/commits/5509f70b80810ddaefccf797a561eeb575744683,2018-10-15T21:12:52Z,78,76,2
757,1593213174,"{'login': 'onnxbot', 'id': 33637430, 'node_id': 'MDQ6VXNlcjMzNjM3NDMw', 'avatar_url': 'https://avatars3.githubusercontent.com/u/33637430?v=4', 'gravatar_id': '', 'url': 'https://api.github.com/users/onnxbot', 'html_url': 'https://github.com/onnxbot', 'followers_url': 'https://api.github.com/users/onnxbot/followers', 'following_url': 'https://api.github.com/users/onnxbot/following{/other_user}', 'gists_url': 'https://api.github.com/users/onnxbot/gists{/gist_id}', 'starred_url': 'https://api.github.com/users/onnxbot/starred{/owner}{/repo}', 'subscriptions_url': 'https://api.github.com/users/onnxbot/subscriptions', 'organizations_url': 'https://api.github.com/users/onnxbot/orgs', 'repos_url': 'https://api.github.com/users/onnxbot/repos', 'events_url': 'https://api.github.com/users/onnxbot/events{/privacy}', 'received_events_url': 'https://api.github.com/users/onnxbot/received_events', 'type': 'User', 'site_admin': False}",referenced,40301c3be7aeab68f9cdb5b9468fc7bc77ed14fb,https://api.github.com/repos/pytorch/pytorch/commits/40301c3be7aeab68f9cdb5b9468fc7bc77ed14fb,2018-04-25T06:06:17Z,2,1,1
757,1593427560,"{'login': 'onnxbot', 'id': 33637430, 'node_id': 'MDQ6VXNlcjMzNjM3NDMw', 'avatar_url': 'https://avatars3.githubusercontent.com/u/33637430?v=4', 'gravatar_id': '', 'url': 'https://api.github.com/users/onnxbot', 'html_url': 'https://github.com/onnxbot', 'followers_url': 'https://api.github.com/users/onnxbot/followers', 'following_url': 'https://api.github.com/users/onnxbot/following{/other_user}', 'gists_url': 'https://api.github.com/users/onnxbot/gists{/gist_id}', 'starred_url': 'https://api.github.com/users/onnxbot/starred{/owner}{/repo}', 'subscriptions_url': 'https://api.github.com/users/onnxbot/subscriptions', 'organizations_url': 'https://api.github.com/users/onnxbot/orgs', 'repos_url': 'https://api.github.com/users/onnxbot/repos', 'events_url': 'https://api.github.com/users/onnxbot/events{/privacy}', 'received_events_url': 'https://api.github.com/users/onnxbot/received_events', 'type': 'User', 'site_admin': False}",referenced,241a1e0f52bd0bff05b548674fa3e4d635195528,https://api.github.com/repos/pytorch/pytorch/commits/241a1e0f52bd0bff05b548674fa3e4d635195528,2018-04-25T08:17:01Z,2,1,1
757,1905230221,"{'login': 'bddppq', 'id': 9300575, 'node_id': 'MDQ6VXNlcjkzMDA1NzU=', 'avatar_url': 'https://avatars2.githubusercontent.com/u/9300575?v=4', 'gravatar_id': '', 'url': 'https://api.github.com/users/bddppq', 'html_url': 'https://github.com/bddppq', 'followers_url': 'https://api.github.com/users/bddppq/followers', 'following_url': 'https://api.github.com/users/bddppq/following{/other_user}', 'gists_url': 'https://api.github.com/users/bddppq/gists{/gist_id}', 'starred_url': 'https://api.github.com/users/bddppq/starred{/owner}{/repo}', 'subscriptions_url': 'https://api.github.com/users/bddppq/subscriptions', 'organizations_url': 'https://api.github.com/users/bddppq/orgs', 'repos_url': 'https://api.github.com/users/bddppq/repos', 'events_url': 'https://api.github.com/users/bddppq/events{/privacy}', 'received_events_url': 'https://api.github.com/users/bddppq/received_events', 'type': 'User', 'site_admin': False}",referenced,15289e3d77a9014f70c413c757a5805261dd94ec,https://api.github.com/repos/pytorch/pytorch/commits/15289e3d77a9014f70c413c757a5805261dd94ec,2018-10-15T21:12:53Z,84,45,39
751,1573706466,"{'login': 'onnxbot', 'id': 33637430, 'node_id': 'MDQ6VXNlcjMzNjM3NDMw', 'avatar_url': 'https://avatars3.githubusercontent.com/u/33637430?v=4', 'gravatar_id': '', 'url': 'https://api.github.com/users/onnxbot', 'html_url': 'https://github.com/onnxbot', 'followers_url': 'https://api.github.com/users/onnxbot/followers', 'following_url': 'https://api.github.com/users/onnxbot/following{/other_user}', 'gists_url': 'https://api.github.com/users/onnxbot/gists{/gist_id}', 'starred_url': 'https://api.github.com/users/onnxbot/starred{/owner}{/repo}', 'subscriptions_url': 'https://api.github.com/users/onnxbot/subscriptions', 'organizations_url': 'https://api.github.com/users/onnxbot/orgs', 'repos_url': 'https://api.github.com/users/onnxbot/repos', 'events_url': 'https://api.github.com/users/onnxbot/events{/privacy}', 'received_events_url': 'https://api.github.com/users/onnxbot/received_events', 'type': 'User', 'site_admin': False}",referenced,3140fe0ed19d6db4a0e5fb08fd6a9d72fbffbb98,https://api.github.com/repos/pytorch/pytorch/commits/3140fe0ed19d6db4a0e5fb08fd6a9d72fbffbb98,2018-04-13T16:52:48Z,2,1,1
751,1905230137,"{'login': 'bddppq', 'id': 9300575, 'node_id': 'MDQ6VXNlcjkzMDA1NzU=', 'avatar_url': 'https://avatars2.githubusercontent.com/u/9300575?v=4', 'gravatar_id': '', 'url': 'https://api.github.com/users/bddppq', 'html_url': 'https://github.com/bddppq', 'followers_url': 'https://api.github.com/users/bddppq/followers', 'following_url': 'https://api.github.com/users/bddppq/following{/other_user}', 'gists_url': 'https://api.github.com/users/bddppq/gists{/gist_id}', 'starred_url': 'https://api.github.com/users/bddppq/starred{/owner}{/repo}', 'subscriptions_url': 'https://api.github.com/users/bddppq/subscriptions', 'organizations_url': 'https://api.github.com/users/bddppq/orgs', 'repos_url': 'https://api.github.com/users/bddppq/repos', 'events_url': 'https://api.github.com/users/bddppq/events{/privacy}', 'received_events_url': 'https://api.github.com/users/bddppq/received_events', 'type': 'User', 'site_admin': False}",referenced,7b33c37ae59fedeee2946c9c3833b4c65d48c71f,https://api.github.com/repos/pytorch/pytorch/commits/7b33c37ae59fedeee2946c9c3833b4c65d48c71f,2018-10-15T21:12:52Z,20,10,10
749,963991878,"{'login': 'Atcold', 'id': 2119355, 'node_id': 'MDQ6VXNlcjIxMTkzNTU=', 'avatar_url': 'https://avatars2.githubusercontent.com/u/2119355?v=4', 'gravatar_id': '', 'url': 'https://api.github.com/users/Atcold', 'html_url': 'https://github.com/Atcold', 'followers_url': 'https://api.github.com/users/Atcold/followers', 'following_url': 'https://api.github.com/users/Atcold/following{/other_user}', 'gists_url': 'https://api.github.com/users/Atcold/gists{/gist_id}', 'starred_url': 'https://api.github.com/users/Atcold/starred{/owner}{/repo}', 'subscriptions_url': 'https://api.github.com/users/Atcold/subscriptions', 'organizations_url': 'https://api.github.com/users/Atcold/orgs', 'repos_url': 'https://api.github.com/users/Atcold/repos', 'events_url': 'https://api.github.com/users/Atcold/events{/privacy}', 'received_events_url': 'https://api.github.com/users/Atcold/received_events', 'type': 'User', 'site_admin': False}",referenced,46bc43a80f2b5a4fc20c729fb0c65cd595de5f38,https://api.github.com/repos/pytorch/pytorch/commits/46bc43a80f2b5a4fc20c729fb0c65cd595de5f38,2017-02-15T22:55:26Z,197,118,79
718,986020669,"{'login': 'soumith', 'id': 1310570, 'node_id': 'MDQ6VXNlcjEzMTA1NzA=', 'avatar_url': 'https://avatars0.githubusercontent.com/u/1310570?v=4', 'gravatar_id': '', 'url': 'https://api.github.com/users/soumith', 'html_url': 'https://github.com/soumith', 'followers_url': 'https://api.github.com/users/soumith/followers', 'following_url': 'https://api.github.com/users/soumith/following{/other_user}', 'gists_url': 'https://api.github.com/users/soumith/gists{/gist_id}', 'starred_url': 'https://api.github.com/users/soumith/starred{/owner}{/repo}', 'subscriptions_url': 'https://api.github.com/users/soumith/subscriptions', 'organizations_url': 'https://api.github.com/users/soumith/orgs', 'repos_url': 'https://api.github.com/users/soumith/repos', 'events_url': 'https://api.github.com/users/soumith/events{/privacy}', 'received_events_url': 'https://api.github.com/users/soumith/received_events', 'type': 'User', 'site_admin': False}",referenced,98775b6bb4e4d3f9d8a934fc7192119f6ae167e1,https://api.github.com/repos/pytorch/pytorch/commits/98775b6bb4e4d3f9d8a934fc7192119f6ae167e1,2017-03-03T20:41:00Z,33,17,16
718,1559357153,"{'login': 'onnxbot', 'id': 33637430, 'node_id': 'MDQ6VXNlcjMzNjM3NDMw', 'avatar_url': 'https://avatars3.githubusercontent.com/u/33637430?v=4', 'gravatar_id': '', 'url': 'https://api.github.com/users/onnxbot', 'html_url': 'https://github.com/onnxbot', 'followers_url': 'https://api.github.com/users/onnxbot/followers', 'following_url': 'https://api.github.com/users/onnxbot/following{/other_user}', 'gists_url': 'https://api.github.com/users/onnxbot/gists{/gist_id}', 'starred_url': 'https://api.github.com/users/onnxbot/starred{/owner}{/repo}', 'subscriptions_url': 'https://api.github.com/users/onnxbot/subscriptions', 'organizations_url': 'https://api.github.com/users/onnxbot/orgs', 'repos_url': 'https://api.github.com/users/onnxbot/repos', 'events_url': 'https://api.github.com/users/onnxbot/events{/privacy}', 'received_events_url': 'https://api.github.com/users/onnxbot/received_events', 'type': 'User', 'site_admin': False}",referenced,d33ec12d1e3f4739e10cacf1436764bc54ff89a3,https://api.github.com/repos/pytorch/pytorch/commits/d33ec12d1e3f4739e10cacf1436764bc54ff89a3,2018-04-05T17:57:54Z,2,1,1
718,1559457721,"{'login': 'ezyang', 'id': 13564, 'node_id': 'MDQ6VXNlcjEzNTY0', 'avatar_url': 'https://avatars0.githubusercontent.com/u/13564?v=4', 'gravatar_id': '', 'url': 'https://api.github.com/users/ezyang', 'html_url': 'https://github.com/ezyang', 'followers_url': 'https://api.github.com/users/ezyang/followers', 'following_url': 'https://api.github.com/users/ezyang/following{/other_user}', 'gists_url': 'https://api.github.com/users/ezyang/gists{/gist_id}', 'starred_url': 'https://api.github.com/users/ezyang/starred{/owner}{/repo}', 'subscriptions_url': 'https://api.github.com/users/ezyang/subscriptions', 'organizations_url': 'https://api.github.com/users/ezyang/orgs', 'repos_url': 'https://api.github.com/users/ezyang/repos', 'events_url': 'https://api.github.com/users/ezyang/events{/privacy}', 'received_events_url': 'https://api.github.com/users/ezyang/received_events', 'type': 'User', 'site_admin': False}",referenced,6ea4890b207ae45bb2f40924a753ad09b3816e1e,https://api.github.com/repos/pytorch/pytorch/commits/6ea4890b207ae45bb2f40924a753ad09b3816e1e,2018-04-05T18:49:23Z,0,0,0
718,1559601600,"{'login': 'soumith', 'id': 1310570, 'node_id': 'MDQ6VXNlcjEzMTA1NzA=', 'avatar_url': 'https://avatars0.githubusercontent.com/u/1310570?v=4', 'gravatar_id': '', 'url': 'https://api.github.com/users/soumith', 'html_url': 'https://github.com/soumith', 'followers_url': 'https://api.github.com/users/soumith/followers', 'following_url': 'https://api.github.com/users/soumith/following{/other_user}', 'gists_url': 'https://api.github.com/users/soumith/gists{/gist_id}', 'starred_url': 'https://api.github.com/users/soumith/starred{/owner}{/repo}', 'subscriptions_url': 'https://api.github.com/users/soumith/subscriptions', 'organizations_url': 'https://api.github.com/users/soumith/orgs', 'repos_url': 'https://api.github.com/users/soumith/repos', 'events_url': 'https://api.github.com/users/soumith/events{/privacy}', 'received_events_url': 'https://api.github.com/users/soumith/received_events', 'type': 'User', 'site_admin': False}",referenced,482e1511ff1626f1e028d27bc04c2bf9d4464bca,https://api.github.com/repos/pytorch/pytorch/commits/482e1511ff1626f1e028d27bc04c2bf9d4464bca,2018-04-05T20:06:50Z,6,3,3
718,1905230075,"{'login': 'bddppq', 'id': 9300575, 'node_id': 'MDQ6VXNlcjkzMDA1NzU=', 'avatar_url': 'https://avatars2.githubusercontent.com/u/9300575?v=4', 'gravatar_id': '', 'url': 'https://api.github.com/users/bddppq', 'html_url': 'https://github.com/bddppq', 'followers_url': 'https://api.github.com/users/bddppq/followers', 'following_url': 'https://api.github.com/users/bddppq/following{/other_user}', 'gists_url': 'https://api.github.com/users/bddppq/gists{/gist_id}', 'starred_url': 'https://api.github.com/users/bddppq/starred{/owner}{/repo}', 'subscriptions_url': 'https://api.github.com/users/bddppq/subscriptions', 'organizations_url': 'https://api.github.com/users/bddppq/orgs', 'repos_url': 'https://api.github.com/users/bddppq/repos', 'events_url': 'https://api.github.com/users/bddppq/events{/privacy}', 'received_events_url': 'https://api.github.com/users/bddppq/received_events', 'type': 'User', 'site_admin': False}",referenced,54be8fad1e8e617d7c24b823de65fe9ebdb1f342,https://api.github.com/repos/pytorch/pytorch/commits/54be8fad1e8e617d7c24b823de65fe9ebdb1f342,2018-10-15T21:12:50Z,2,1,1
716,1560186983,"{'login': 'onnxbot', 'id': 33637430, 'node_id': 'MDQ6VXNlcjMzNjM3NDMw', 'avatar_url': 'https://avatars3.githubusercontent.com/u/33637430?v=4', 'gravatar_id': '', 'url': 'https://api.github.com/users/onnxbot', 'html_url': 'https://github.com/onnxbot', 'followers_url': 'https://api.github.com/users/onnxbot/followers', 'following_url': 'https://api.github.com/users/onnxbot/following{/other_user}', 'gists_url': 'https://api.github.com/users/onnxbot/gists{/gist_id}', 'starred_url': 'https://api.github.com/users/onnxbot/starred{/owner}{/repo}', 'subscriptions_url': 'https://api.github.com/users/onnxbot/subscriptions', 'organizations_url': 'https://api.github.com/users/onnxbot/orgs', 'repos_url': 'https://api.github.com/users/onnxbot/repos', 'events_url': 'https://api.github.com/users/onnxbot/events{/privacy}', 'received_events_url': 'https://api.github.com/users/onnxbot/received_events', 'type': 'User', 'site_admin': False}",referenced,81676d8554fe6ae37a1b5e9c637caef8ad2d5f30,https://api.github.com/repos/pytorch/pytorch/commits/81676d8554fe6ae37a1b5e9c637caef8ad2d5f30,2018-04-06T05:18:22Z,2,1,1
716,1905230095,"{'login': 'bddppq', 'id': 9300575, 'node_id': 'MDQ6VXNlcjkzMDA1NzU=', 'avatar_url': 'https://avatars2.githubusercontent.com/u/9300575?v=4', 'gravatar_id': '', 'url': 'https://api.github.com/users/bddppq', 'html_url': 'https://github.com/bddppq', 'followers_url': 'https://api.github.com/users/bddppq/followers', 'following_url': 'https://api.github.com/users/bddppq/following{/other_user}', 'gists_url': 'https://api.github.com/users/bddppq/gists{/gist_id}', 'starred_url': 'https://api.github.com/users/bddppq/starred{/owner}{/repo}', 'subscriptions_url': 'https://api.github.com/users/bddppq/subscriptions', 'organizations_url': 'https://api.github.com/users/bddppq/orgs', 'repos_url': 'https://api.github.com/users/bddppq/repos', 'events_url': 'https://api.github.com/users/bddppq/events{/privacy}', 'received_events_url': 'https://api.github.com/users/bddppq/received_events', 'type': 'User', 'site_admin': False}",referenced,c61506f9f473769705e5f09b4181e12a35a22a69,https://api.github.com/repos/pytorch/pytorch/commits/c61506f9f473769705e5f09b4181e12a35a22a69,2018-10-15T21:12:51Z,35,18,17
712,1905230070,"{'login': 'bddppq', 'id': 9300575, 'node_id': 'MDQ6VXNlcjkzMDA1NzU=', 'avatar_url': 'https://avatars2.githubusercontent.com/u/9300575?v=4', 'gravatar_id': '', 'url': 'https://api.github.com/users/bddppq', 'html_url': 'https://github.com/bddppq', 'followers_url': 'https://api.github.com/users/bddppq/followers', 'following_url': 'https://api.github.com/users/bddppq/following{/other_user}', 'gists_url': 'https://api.github.com/users/bddppq/gists{/gist_id}', 'starred_url': 'https://api.github.com/users/bddppq/starred{/owner}{/repo}', 'subscriptions_url': 'https://api.github.com/users/bddppq/subscriptions', 'organizations_url': 'https://api.github.com/users/bddppq/orgs', 'repos_url': 'https://api.github.com/users/bddppq/repos', 'events_url': 'https://api.github.com/users/bddppq/events{/privacy}', 'received_events_url': 'https://api.github.com/users/bddppq/received_events', 'type': 'User', 'site_admin': False}",referenced,e177493be4eb51143b9a4ee23be40ceb8cbeba46,https://api.github.com/repos/pytorch/pytorch/commits/e177493be4eb51143b9a4ee23be40ceb8cbeba46,2018-10-15T21:12:50Z,18,0,18
707,1574281382,"{'login': 'onnxbot', 'id': 33637430, 'node_id': 'MDQ6VXNlcjMzNjM3NDMw', 'avatar_url': 'https://avatars3.githubusercontent.com/u/33637430?v=4', 'gravatar_id': '', 'url': 'https://api.github.com/users/onnxbot', 'html_url': 'https://github.com/onnxbot', 'followers_url': 'https://api.github.com/users/onnxbot/followers', 'following_url': 'https://api.github.com/users/onnxbot/following{/other_user}', 'gists_url': 'https://api.github.com/users/onnxbot/gists{/gist_id}', 'starred_url': 'https://api.github.com/users/onnxbot/starred{/owner}{/repo}', 'subscriptions_url': 'https://api.github.com/users/onnxbot/subscriptions', 'organizations_url': 'https://api.github.com/users/onnxbot/orgs', 'repos_url': 'https://api.github.com/users/onnxbot/repos', 'events_url': 'https://api.github.com/users/onnxbot/events{/privacy}', 'received_events_url': 'https://api.github.com/users/onnxbot/received_events', 'type': 'User', 'site_admin': False}",referenced,11b9180563705639d96f2bbe0dff5c51b9174e13,https://api.github.com/repos/pytorch/pytorch/commits/11b9180563705639d96f2bbe0dff5c51b9174e13,2018-04-13T23:04:11Z,2,1,1
707,1905230140,"{'login': 'bddppq', 'id': 9300575, 'node_id': 'MDQ6VXNlcjkzMDA1NzU=', 'avatar_url': 'https://avatars2.githubusercontent.com/u/9300575?v=4', 'gravatar_id': '', 'url': 'https://api.github.com/users/bddppq', 'html_url': 'https://github.com/bddppq', 'followers_url': 'https://api.github.com/users/bddppq/followers', 'following_url': 'https://api.github.com/users/bddppq/following{/other_user}', 'gists_url': 'https://api.github.com/users/bddppq/gists{/gist_id}', 'starred_url': 'https://api.github.com/users/bddppq/starred{/owner}{/repo}', 'subscriptions_url': 'https://api.github.com/users/bddppq/subscriptions', 'organizations_url': 'https://api.github.com/users/bddppq/orgs', 'repos_url': 'https://api.github.com/users/bddppq/repos', 'events_url': 'https://api.github.com/users/bddppq/events{/privacy}', 'received_events_url': 'https://api.github.com/users/bddppq/received_events', 'type': 'User', 'site_admin': False}",referenced,5355440f5a4b00a94870f0d4620c1046b40dbffa,https://api.github.com/repos/pytorch/pytorch/commits/5355440f5a4b00a94870f0d4620c1046b40dbffa,2018-10-15T21:12:52Z,311,309,2
701,1905230041,"{'login': 'bddppq', 'id': 9300575, 'node_id': 'MDQ6VXNlcjkzMDA1NzU=', 'avatar_url': 'https://avatars2.githubusercontent.com/u/9300575?v=4', 'gravatar_id': '', 'url': 'https://api.github.com/users/bddppq', 'html_url': 'https://github.com/bddppq', 'followers_url': 'https://api.github.com/users/bddppq/followers', 'following_url': 'https://api.github.com/users/bddppq/following{/other_user}', 'gists_url': 'https://api.github.com/users/bddppq/gists{/gist_id}', 'starred_url': 'https://api.github.com/users/bddppq/starred{/owner}{/repo}', 'subscriptions_url': 'https://api.github.com/users/bddppq/subscriptions', 'organizations_url': 'https://api.github.com/users/bddppq/orgs', 'repos_url': 'https://api.github.com/users/bddppq/repos', 'events_url': 'https://api.github.com/users/bddppq/events{/privacy}', 'received_events_url': 'https://api.github.com/users/bddppq/received_events', 'type': 'User', 'site_admin': False}",referenced,c970f0c8c8a7276a6569e211b33d6efa4ed5634c,https://api.github.com/repos/pytorch/pytorch/commits/c970f0c8c8a7276a6569e211b33d6efa4ed5634c,2018-10-15T21:12:50Z,23,21,2
700,1905230034,"{'login': 'bddppq', 'id': 9300575, 'node_id': 'MDQ6VXNlcjkzMDA1NzU=', 'avatar_url': 'https://avatars2.githubusercontent.com/u/9300575?v=4', 'gravatar_id': '', 'url': 'https://api.github.com/users/bddppq', 'html_url': 'https://github.com/bddppq', 'followers_url': 'https://api.github.com/users/bddppq/followers', 'following_url': 'https://api.github.com/users/bddppq/following{/other_user}', 'gists_url': 'https://api.github.com/users/bddppq/gists{/gist_id}', 'starred_url': 'https://api.github.com/users/bddppq/starred{/owner}{/repo}', 'subscriptions_url': 'https://api.github.com/users/bddppq/subscriptions', 'organizations_url': 'https://api.github.com/users/bddppq/orgs', 'repos_url': 'https://api.github.com/users/bddppq/repos', 'events_url': 'https://api.github.com/users/bddppq/events{/privacy}', 'received_events_url': 'https://api.github.com/users/bddppq/received_events', 'type': 'User', 'site_admin': False}",referenced,accfc74b9d0b14ef33c114e1cde1478ff5d0f033,https://api.github.com/repos/pytorch/pytorch/commits/accfc74b9d0b14ef33c114e1cde1478ff5d0f033,2018-10-15T21:12:50Z,16,0,16
691,1905230018,"{'login': 'bddppq', 'id': 9300575, 'node_id': 'MDQ6VXNlcjkzMDA1NzU=', 'avatar_url': 'https://avatars2.githubusercontent.com/u/9300575?v=4', 'gravatar_id': '', 'url': 'https://api.github.com/users/bddppq', 'html_url': 'https://github.com/bddppq', 'followers_url': 'https://api.github.com/users/bddppq/followers', 'following_url': 'https://api.github.com/users/bddppq/following{/other_user}', 'gists_url': 'https://api.github.com/users/bddppq/gists{/gist_id}', 'starred_url': 'https://api.github.com/users/bddppq/starred{/owner}{/repo}', 'subscriptions_url': 'https://api.github.com/users/bddppq/subscriptions', 'organizations_url': 'https://api.github.com/users/bddppq/orgs', 'repos_url': 'https://api.github.com/users/bddppq/repos', 'events_url': 'https://api.github.com/users/bddppq/events{/privacy}', 'received_events_url': 'https://api.github.com/users/bddppq/received_events', 'type': 'User', 'site_admin': False}",referenced,21eaf9bb9b1a2b72f140b5d6ec93cd959908c690,https://api.github.com/repos/pytorch/pytorch/commits/21eaf9bb9b1a2b72f140b5d6ec93cd959908c690,2018-10-15T21:12:49Z,2954,585,2369
689,1905230011,"{'login': 'bddppq', 'id': 9300575, 'node_id': 'MDQ6VXNlcjkzMDA1NzU=', 'avatar_url': 'https://avatars2.githubusercontent.com/u/9300575?v=4', 'gravatar_id': '', 'url': 'https://api.github.com/users/bddppq', 'html_url': 'https://github.com/bddppq', 'followers_url': 'https://api.github.com/users/bddppq/followers', 'following_url': 'https://api.github.com/users/bddppq/following{/other_user}', 'gists_url': 'https://api.github.com/users/bddppq/gists{/gist_id}', 'starred_url': 'https://api.github.com/users/bddppq/starred{/owner}{/repo}', 'subscriptions_url': 'https://api.github.com/users/bddppq/subscriptions', 'organizations_url': 'https://api.github.com/users/bddppq/orgs', 'repos_url': 'https://api.github.com/users/bddppq/repos', 'events_url': 'https://api.github.com/users/bddppq/events{/privacy}', 'received_events_url': 'https://api.github.com/users/bddppq/received_events', 'type': 'User', 'site_admin': False}",referenced,641f1262c78ab1d0f7bd2cde7ce50f17bc2ef94f,https://api.github.com/repos/pytorch/pytorch/commits/641f1262c78ab1d0f7bd2cde7ce50f17bc2ef94f,2018-10-15T21:12:49Z,12,6,6
686,1162580238,"{'login': 'qbx2', 'id': 5977817, 'node_id': 'MDQ6VXNlcjU5Nzc4MTc=', 'avatar_url': 'https://avatars1.githubusercontent.com/u/5977817?v=4', 'gravatar_id': '', 'url': 'https://api.github.com/users/qbx2', 'html_url': 'https://github.com/qbx2', 'followers_url': 'https://api.github.com/users/qbx2/followers', 'following_url': 'https://api.github.com/users/qbx2/following{/other_user}', 'gists_url': 'https://api.github.com/users/qbx2/gists{/gist_id}', 'starred_url': 'https://api.github.com/users/qbx2/starred{/owner}{/repo}', 'subscriptions_url': 'https://api.github.com/users/qbx2/subscriptions', 'organizations_url': 'https://api.github.com/users/qbx2/orgs', 'repos_url': 'https://api.github.com/users/qbx2/repos', 'events_url': 'https://api.github.com/users/qbx2/events{/privacy}', 'received_events_url': 'https://api.github.com/users/qbx2/received_events', 'type': 'User', 'site_admin': False}",referenced,8a65ef1098bc56cbf0b5141b703bf29fb32bae08,https://api.github.com/repos/pytorch/pytorch/commits/8a65ef1098bc56cbf0b5141b703bf29fb32bae08,2017-07-13T13:36:56Z,2,1,1
682,1905230046,"{'login': 'bddppq', 'id': 9300575, 'node_id': 'MDQ6VXNlcjkzMDA1NzU=', 'avatar_url': 'https://avatars2.githubusercontent.com/u/9300575?v=4', 'gravatar_id': '', 'url': 'https://api.github.com/users/bddppq', 'html_url': 'https://github.com/bddppq', 'followers_url': 'https://api.github.com/users/bddppq/followers', 'following_url': 'https://api.github.com/users/bddppq/following{/other_user}', 'gists_url': 'https://api.github.com/users/bddppq/gists{/gist_id}', 'starred_url': 'https://api.github.com/users/bddppq/starred{/owner}{/repo}', 'subscriptions_url': 'https://api.github.com/users/bddppq/subscriptions', 'organizations_url': 'https://api.github.com/users/bddppq/orgs', 'repos_url': 'https://api.github.com/users/bddppq/repos', 'events_url': 'https://api.github.com/users/bddppq/events{/privacy}', 'received_events_url': 'https://api.github.com/users/bddppq/received_events', 'type': 'User', 'site_admin': False}",referenced,7f6a4fd3ad8d1a4624ad44cc06124fef6822ff5a,https://api.github.com/repos/pytorch/pytorch/commits/7f6a4fd3ad8d1a4624ad44cc06124fef6822ff5a,2018-10-15T21:12:50Z,1099,1099,0
680,1062535910,"{'login': 'soumith', 'id': 1310570, 'node_id': 'MDQ6VXNlcjEzMTA1NzA=', 'avatar_url': 'https://avatars0.githubusercontent.com/u/1310570?v=4', 'gravatar_id': '', 'url': 'https://api.github.com/users/soumith', 'html_url': 'https://github.com/soumith', 'followers_url': 'https://api.github.com/users/soumith/followers', 'following_url': 'https://api.github.com/users/soumith/following{/other_user}', 'gists_url': 'https://api.github.com/users/soumith/gists{/gist_id}', 'starred_url': 'https://api.github.com/users/soumith/starred{/owner}{/repo}', 'subscriptions_url': 'https://api.github.com/users/soumith/subscriptions', 'organizations_url': 'https://api.github.com/users/soumith/orgs', 'repos_url': 'https://api.github.com/users/soumith/repos', 'events_url': 'https://api.github.com/users/soumith/events{/privacy}', 'received_events_url': 'https://api.github.com/users/soumith/received_events', 'type': 'User', 'site_admin': False}",referenced,224f5eabf5cfb3a19abc1819f7dac230500b6bdb,https://api.github.com/repos/pytorch/pytorch/commits/224f5eabf5cfb3a19abc1819f7dac230500b6bdb,2017-04-28T17:48:16Z,107,17,90
677,1905230004,"{'login': 'bddppq', 'id': 9300575, 'node_id': 'MDQ6VXNlcjkzMDA1NzU=', 'avatar_url': 'https://avatars2.githubusercontent.com/u/9300575?v=4', 'gravatar_id': '', 'url': 'https://api.github.com/users/bddppq', 'html_url': 'https://github.com/bddppq', 'followers_url': 'https://api.github.com/users/bddppq/followers', 'following_url': 'https://api.github.com/users/bddppq/following{/other_user}', 'gists_url': 'https://api.github.com/users/bddppq/gists{/gist_id}', 'starred_url': 'https://api.github.com/users/bddppq/starred{/owner}{/repo}', 'subscriptions_url': 'https://api.github.com/users/bddppq/subscriptions', 'organizations_url': 'https://api.github.com/users/bddppq/orgs', 'repos_url': 'https://api.github.com/users/bddppq/repos', 'events_url': 'https://api.github.com/users/bddppq/events{/privacy}', 'received_events_url': 'https://api.github.com/users/bddppq/received_events', 'type': 'User', 'site_admin': False}",referenced,1d7dee4e2154f01a2cfe5f2026590cc97e063424,https://api.github.com/repos/pytorch/pytorch/commits/1d7dee4e2154f01a2cfe5f2026590cc97e063424,2018-10-15T21:12:49Z,3,3,0
675,1905230543,"{'login': 'bddppq', 'id': 9300575, 'node_id': 'MDQ6VXNlcjkzMDA1NzU=', 'avatar_url': 'https://avatars2.githubusercontent.com/u/9300575?v=4', 'gravatar_id': '', 'url': 'https://api.github.com/users/bddppq', 'html_url': 'https://github.com/bddppq', 'followers_url': 'https://api.github.com/users/bddppq/followers', 'following_url': 'https://api.github.com/users/bddppq/following{/other_user}', 'gists_url': 'https://api.github.com/users/bddppq/gists{/gist_id}', 'starred_url': 'https://api.github.com/users/bddppq/starred{/owner}{/repo}', 'subscriptions_url': 'https://api.github.com/users/bddppq/subscriptions', 'organizations_url': 'https://api.github.com/users/bddppq/orgs', 'repos_url': 'https://api.github.com/users/bddppq/repos', 'events_url': 'https://api.github.com/users/bddppq/events{/privacy}', 'received_events_url': 'https://api.github.com/users/bddppq/received_events', 'type': 'User', 'site_admin': False}",referenced,ea1aa139b208b92f34a1501a0406705d83399897,https://api.github.com/repos/pytorch/pytorch/commits/ea1aa139b208b92f34a1501a0406705d83399897,2018-10-15T21:13:00Z,2448,2448,0
674,1905229999,"{'login': 'bddppq', 'id': 9300575, 'node_id': 'MDQ6VXNlcjkzMDA1NzU=', 'avatar_url': 'https://avatars2.githubusercontent.com/u/9300575?v=4', 'gravatar_id': '', 'url': 'https://api.github.com/users/bddppq', 'html_url': 'https://github.com/bddppq', 'followers_url': 'https://api.github.com/users/bddppq/followers', 'following_url': 'https://api.github.com/users/bddppq/following{/other_user}', 'gists_url': 'https://api.github.com/users/bddppq/gists{/gist_id}', 'starred_url': 'https://api.github.com/users/bddppq/starred{/owner}{/repo}', 'subscriptions_url': 'https://api.github.com/users/bddppq/subscriptions', 'organizations_url': 'https://api.github.com/users/bddppq/orgs', 'repos_url': 'https://api.github.com/users/bddppq/repos', 'events_url': 'https://api.github.com/users/bddppq/events{/privacy}', 'received_events_url': 'https://api.github.com/users/bddppq/received_events', 'type': 'User', 'site_admin': False}",referenced,053686607dbebb17edf0251686339683817fde8a,https://api.github.com/repos/pytorch/pytorch/commits/053686607dbebb17edf0251686339683817fde8a,2018-10-15T21:12:49Z,1,1,0
671,1905230002,"{'login': 'bddppq', 'id': 9300575, 'node_id': 'MDQ6VXNlcjkzMDA1NzU=', 'avatar_url': 'https://avatars2.githubusercontent.com/u/9300575?v=4', 'gravatar_id': '', 'url': 'https://api.github.com/users/bddppq', 'html_url': 'https://github.com/bddppq', 'followers_url': 'https://api.github.com/users/bddppq/followers', 'following_url': 'https://api.github.com/users/bddppq/following{/other_user}', 'gists_url': 'https://api.github.com/users/bddppq/gists{/gist_id}', 'starred_url': 'https://api.github.com/users/bddppq/starred{/owner}{/repo}', 'subscriptions_url': 'https://api.github.com/users/bddppq/subscriptions', 'organizations_url': 'https://api.github.com/users/bddppq/orgs', 'repos_url': 'https://api.github.com/users/bddppq/repos', 'events_url': 'https://api.github.com/users/bddppq/events{/privacy}', 'received_events_url': 'https://api.github.com/users/bddppq/received_events', 'type': 'User', 'site_admin': False}",referenced,36d7fffaf3f9a52b12c5dc8733045bcccfc27c34,https://api.github.com/repos/pytorch/pytorch/commits/36d7fffaf3f9a52b12c5dc8733045bcccfc27c34,2018-10-15T21:12:49Z,25,23,2
666,1562221150,"{'login': 'onnxbot', 'id': 33637430, 'node_id': 'MDQ6VXNlcjMzNjM3NDMw', 'avatar_url': 'https://avatars3.githubusercontent.com/u/33637430?v=4', 'gravatar_id': '', 'url': 'https://api.github.com/users/onnxbot', 'html_url': 'https://github.com/onnxbot', 'followers_url': 'https://api.github.com/users/onnxbot/followers', 'following_url': 'https://api.github.com/users/onnxbot/following{/other_user}', 'gists_url': 'https://api.github.com/users/onnxbot/gists{/gist_id}', 'starred_url': 'https://api.github.com/users/onnxbot/starred{/owner}{/repo}', 'subscriptions_url': 'https://api.github.com/users/onnxbot/subscriptions', 'organizations_url': 'https://api.github.com/users/onnxbot/orgs', 'repos_url': 'https://api.github.com/users/onnxbot/repos', 'events_url': 'https://api.github.com/users/onnxbot/events{/privacy}', 'received_events_url': 'https://api.github.com/users/onnxbot/received_events', 'type': 'User', 'site_admin': False}",referenced,aecec8b4121bd791236d227bc1d2dfef849fc1ec,https://api.github.com/repos/pytorch/pytorch/commits/aecec8b4121bd791236d227bc1d2dfef849fc1ec,2018-04-07T15:00:01Z,2,1,1
666,1905230108,"{'login': 'bddppq', 'id': 9300575, 'node_id': 'MDQ6VXNlcjkzMDA1NzU=', 'avatar_url': 'https://avatars2.githubusercontent.com/u/9300575?v=4', 'gravatar_id': '', 'url': 'https://api.github.com/users/bddppq', 'html_url': 'https://github.com/bddppq', 'followers_url': 'https://api.github.com/users/bddppq/followers', 'following_url': 'https://api.github.com/users/bddppq/following{/other_user}', 'gists_url': 'https://api.github.com/users/bddppq/gists{/gist_id}', 'starred_url': 'https://api.github.com/users/bddppq/starred{/owner}{/repo}', 'subscriptions_url': 'https://api.github.com/users/bddppq/subscriptions', 'organizations_url': 'https://api.github.com/users/bddppq/orgs', 'repos_url': 'https://api.github.com/users/bddppq/repos', 'events_url': 'https://api.github.com/users/bddppq/events{/privacy}', 'received_events_url': 'https://api.github.com/users/bddppq/received_events', 'type': 'User', 'site_admin': False}",referenced,c9f825fc68b96b6a8c8895f4f2102f8630f75bf0,https://api.github.com/repos/pytorch/pytorch/commits/c9f825fc68b96b6a8c8895f4f2102f8630f75bf0,2018-10-15T21:12:51Z,360,192,168
657,1905229978,"{'login': 'bddppq', 'id': 9300575, 'node_id': 'MDQ6VXNlcjkzMDA1NzU=', 'avatar_url': 'https://avatars2.githubusercontent.com/u/9300575?v=4', 'gravatar_id': '', 'url': 'https://api.github.com/users/bddppq', 'html_url': 'https://github.com/bddppq', 'followers_url': 'https://api.github.com/users/bddppq/followers', 'following_url': 'https://api.github.com/users/bddppq/following{/other_user}', 'gists_url': 'https://api.github.com/users/bddppq/gists{/gist_id}', 'starred_url': 'https://api.github.com/users/bddppq/starred{/owner}{/repo}', 'subscriptions_url': 'https://api.github.com/users/bddppq/subscriptions', 'organizations_url': 'https://api.github.com/users/bddppq/orgs', 'repos_url': 'https://api.github.com/users/bddppq/repos', 'events_url': 'https://api.github.com/users/bddppq/events{/privacy}', 'received_events_url': 'https://api.github.com/users/bddppq/received_events', 'type': 'User', 'site_admin': False}",referenced,ecac1c162485b3d6072eff73dbbc79fd5376c8ff,https://api.github.com/repos/pytorch/pytorch/commits/ecac1c162485b3d6072eff73dbbc79fd5376c8ff,2018-10-15T21:12:49Z,2,1,1
656,1905229963,"{'login': 'bddppq', 'id': 9300575, 'node_id': 'MDQ6VXNlcjkzMDA1NzU=', 'avatar_url': 'https://avatars2.githubusercontent.com/u/9300575?v=4', 'gravatar_id': '', 'url': 'https://api.github.com/users/bddppq', 'html_url': 'https://github.com/bddppq', 'followers_url': 'https://api.github.com/users/bddppq/followers', 'following_url': 'https://api.github.com/users/bddppq/following{/other_user}', 'gists_url': 'https://api.github.com/users/bddppq/gists{/gist_id}', 'starred_url': 'https://api.github.com/users/bddppq/starred{/owner}{/repo}', 'subscriptions_url': 'https://api.github.com/users/bddppq/subscriptions', 'organizations_url': 'https://api.github.com/users/bddppq/orgs', 'repos_url': 'https://api.github.com/users/bddppq/repos', 'events_url': 'https://api.github.com/users/bddppq/events{/privacy}', 'received_events_url': 'https://api.github.com/users/bddppq/received_events', 'type': 'User', 'site_admin': False}",referenced,7c009fe8dff7f616180a612266ba0ec4259732cf,https://api.github.com/repos/pytorch/pytorch/commits/7c009fe8dff7f616180a612266ba0ec4259732cf,2018-10-15T21:12:48Z,1,1,0
653,1905229977,"{'login': 'bddppq', 'id': 9300575, 'node_id': 'MDQ6VXNlcjkzMDA1NzU=', 'avatar_url': 'https://avatars2.githubusercontent.com/u/9300575?v=4', 'gravatar_id': '', 'url': 'https://api.github.com/users/bddppq', 'html_url': 'https://github.com/bddppq', 'followers_url': 'https://api.github.com/users/bddppq/followers', 'following_url': 'https://api.github.com/users/bddppq/following{/other_user}', 'gists_url': 'https://api.github.com/users/bddppq/gists{/gist_id}', 'starred_url': 'https://api.github.com/users/bddppq/starred{/owner}{/repo}', 'subscriptions_url': 'https://api.github.com/users/bddppq/subscriptions', 'organizations_url': 'https://api.github.com/users/bddppq/orgs', 'repos_url': 'https://api.github.com/users/bddppq/repos', 'events_url': 'https://api.github.com/users/bddppq/events{/privacy}', 'received_events_url': 'https://api.github.com/users/bddppq/received_events', 'type': 'User', 'site_admin': False}",referenced,5cb999ddc13efbe9a29346a620834bae6b2c764e,https://api.github.com/repos/pytorch/pytorch/commits/5cb999ddc13efbe9a29346a620834bae6b2c764e,2018-10-15T21:12:49Z,34,16,18
651,1905229986,"{'login': 'bddppq', 'id': 9300575, 'node_id': 'MDQ6VXNlcjkzMDA1NzU=', 'avatar_url': 'https://avatars2.githubusercontent.com/u/9300575?v=4', 'gravatar_id': '', 'url': 'https://api.github.com/users/bddppq', 'html_url': 'https://github.com/bddppq', 'followers_url': 'https://api.github.com/users/bddppq/followers', 'following_url': 'https://api.github.com/users/bddppq/following{/other_user}', 'gists_url': 'https://api.github.com/users/bddppq/gists{/gist_id}', 'starred_url': 'https://api.github.com/users/bddppq/starred{/owner}{/repo}', 'subscriptions_url': 'https://api.github.com/users/bddppq/subscriptions', 'organizations_url': 'https://api.github.com/users/bddppq/orgs', 'repos_url': 'https://api.github.com/users/bddppq/repos', 'events_url': 'https://api.github.com/users/bddppq/events{/privacy}', 'received_events_url': 'https://api.github.com/users/bddppq/received_events', 'type': 'User', 'site_admin': False}",referenced,5716e2076b445b6c5bd017aaadc05d59ac43bdc3,https://api.github.com/repos/pytorch/pytorch/commits/5716e2076b445b6c5bd017aaadc05d59ac43bdc3,2018-10-15T21:12:49Z,3364,2710,654
640,1905229938,"{'login': 'bddppq', 'id': 9300575, 'node_id': 'MDQ6VXNlcjkzMDA1NzU=', 'avatar_url': 'https://avatars2.githubusercontent.com/u/9300575?v=4', 'gravatar_id': '', 'url': 'https://api.github.com/users/bddppq', 'html_url': 'https://github.com/bddppq', 'followers_url': 'https://api.github.com/users/bddppq/followers', 'following_url': 'https://api.github.com/users/bddppq/following{/other_user}', 'gists_url': 'https://api.github.com/users/bddppq/gists{/gist_id}', 'starred_url': 'https://api.github.com/users/bddppq/starred{/owner}{/repo}', 'subscriptions_url': 'https://api.github.com/users/bddppq/subscriptions', 'organizations_url': 'https://api.github.com/users/bddppq/orgs', 'repos_url': 'https://api.github.com/users/bddppq/repos', 'events_url': 'https://api.github.com/users/bddppq/events{/privacy}', 'received_events_url': 'https://api.github.com/users/bddppq/received_events', 'type': 'User', 'site_admin': False}",referenced,5f69c37628002efa8c03d70d652db03c9d5ffca7,https://api.github.com/repos/pytorch/pytorch/commits/5f69c37628002efa8c03d70d652db03c9d5ffca7,2018-10-15T21:12:48Z,179,161,18
638,1905229930,"{'login': 'bddppq', 'id': 9300575, 'node_id': 'MDQ6VXNlcjkzMDA1NzU=', 'avatar_url': 'https://avatars2.githubusercontent.com/u/9300575?v=4', 'gravatar_id': '', 'url': 'https://api.github.com/users/bddppq', 'html_url': 'https://github.com/bddppq', 'followers_url': 'https://api.github.com/users/bddppq/followers', 'following_url': 'https://api.github.com/users/bddppq/following{/other_user}', 'gists_url': 'https://api.github.com/users/bddppq/gists{/gist_id}', 'starred_url': 'https://api.github.com/users/bddppq/starred{/owner}{/repo}', 'subscriptions_url': 'https://api.github.com/users/bddppq/subscriptions', 'organizations_url': 'https://api.github.com/users/bddppq/orgs', 'repos_url': 'https://api.github.com/users/bddppq/repos', 'events_url': 'https://api.github.com/users/bddppq/events{/privacy}', 'received_events_url': 'https://api.github.com/users/bddppq/received_events', 'type': 'User', 'site_admin': False}",referenced,caf9256a9dc128b610ca07dc8bde04f7d53a91eb,https://api.github.com/repos/pytorch/pytorch/commits/caf9256a9dc128b610ca07dc8bde04f7d53a91eb,2018-10-15T21:12:48Z,155,77,78
635,1905229928,"{'login': 'bddppq', 'id': 9300575, 'node_id': 'MDQ6VXNlcjkzMDA1NzU=', 'avatar_url': 'https://avatars2.githubusercontent.com/u/9300575?v=4', 'gravatar_id': '', 'url': 'https://api.github.com/users/bddppq', 'html_url': 'https://github.com/bddppq', 'followers_url': 'https://api.github.com/users/bddppq/followers', 'following_url': 'https://api.github.com/users/bddppq/following{/other_user}', 'gists_url': 'https://api.github.com/users/bddppq/gists{/gist_id}', 'starred_url': 'https://api.github.com/users/bddppq/starred{/owner}{/repo}', 'subscriptions_url': 'https://api.github.com/users/bddppq/subscriptions', 'organizations_url': 'https://api.github.com/users/bddppq/orgs', 'repos_url': 'https://api.github.com/users/bddppq/repos', 'events_url': 'https://api.github.com/users/bddppq/events{/privacy}', 'received_events_url': 'https://api.github.com/users/bddppq/received_events', 'type': 'User', 'site_admin': False}",referenced,1a067bac0350b12d0e55ddfc42025fec3474972e,https://api.github.com/repos/pytorch/pytorch/commits/1a067bac0350b12d0e55ddfc42025fec3474972e,2018-10-15T21:12:48Z,1097,420,677
597,1905229909,"{'login': 'bddppq', 'id': 9300575, 'node_id': 'MDQ6VXNlcjkzMDA1NzU=', 'avatar_url': 'https://avatars2.githubusercontent.com/u/9300575?v=4', 'gravatar_id': '', 'url': 'https://api.github.com/users/bddppq', 'html_url': 'https://github.com/bddppq', 'followers_url': 'https://api.github.com/users/bddppq/followers', 'following_url': 'https://api.github.com/users/bddppq/following{/other_user}', 'gists_url': 'https://api.github.com/users/bddppq/gists{/gist_id}', 'starred_url': 'https://api.github.com/users/bddppq/starred{/owner}{/repo}', 'subscriptions_url': 'https://api.github.com/users/bddppq/subscriptions', 'organizations_url': 'https://api.github.com/users/bddppq/orgs', 'repos_url': 'https://api.github.com/users/bddppq/repos', 'events_url': 'https://api.github.com/users/bddppq/events{/privacy}', 'received_events_url': 'https://api.github.com/users/bddppq/received_events', 'type': 'User', 'site_admin': False}",referenced,5516ebb49f65598b2425840e15c5562b676fce85,https://api.github.com/repos/pytorch/pytorch/commits/5516ebb49f65598b2425840e15c5562b676fce85,2018-10-15T21:12:47Z,17,15,2
596,1905229896,"{'login': 'bddppq', 'id': 9300575, 'node_id': 'MDQ6VXNlcjkzMDA1NzU=', 'avatar_url': 'https://avatars2.githubusercontent.com/u/9300575?v=4', 'gravatar_id': '', 'url': 'https://api.github.com/users/bddppq', 'html_url': 'https://github.com/bddppq', 'followers_url': 'https://api.github.com/users/bddppq/followers', 'following_url': 'https://api.github.com/users/bddppq/following{/other_user}', 'gists_url': 'https://api.github.com/users/bddppq/gists{/gist_id}', 'starred_url': 'https://api.github.com/users/bddppq/starred{/owner}{/repo}', 'subscriptions_url': 'https://api.github.com/users/bddppq/subscriptions', 'organizations_url': 'https://api.github.com/users/bddppq/orgs', 'repos_url': 'https://api.github.com/users/bddppq/repos', 'events_url': 'https://api.github.com/users/bddppq/events{/privacy}', 'received_events_url': 'https://api.github.com/users/bddppq/received_events', 'type': 'User', 'site_admin': False}",referenced,b052feffabbb935d13c62c622790d05fc5f20941,https://api.github.com/repos/pytorch/pytorch/commits/b052feffabbb935d13c62c622790d05fc5f20941,2018-10-15T21:12:47Z,4,2,2
592,1905229886,"{'login': 'bddppq', 'id': 9300575, 'node_id': 'MDQ6VXNlcjkzMDA1NzU=', 'avatar_url': 'https://avatars2.githubusercontent.com/u/9300575?v=4', 'gravatar_id': '', 'url': 'https://api.github.com/users/bddppq', 'html_url': 'https://github.com/bddppq', 'followers_url': 'https://api.github.com/users/bddppq/followers', 'following_url': 'https://api.github.com/users/bddppq/following{/other_user}', 'gists_url': 'https://api.github.com/users/bddppq/gists{/gist_id}', 'starred_url': 'https://api.github.com/users/bddppq/starred{/owner}{/repo}', 'subscriptions_url': 'https://api.github.com/users/bddppq/subscriptions', 'organizations_url': 'https://api.github.com/users/bddppq/orgs', 'repos_url': 'https://api.github.com/users/bddppq/repos', 'events_url': 'https://api.github.com/users/bddppq/events{/privacy}', 'received_events_url': 'https://api.github.com/users/bddppq/received_events', 'type': 'User', 'site_admin': False}",referenced,2edc1e727bde0ebedd642c9153615e65ce0ffa16,https://api.github.com/repos/pytorch/pytorch/commits/2edc1e727bde0ebedd642c9153615e65ce0ffa16,2018-10-15T21:12:47Z,86,49,37
588,1905229902,"{'login': 'bddppq', 'id': 9300575, 'node_id': 'MDQ6VXNlcjkzMDA1NzU=', 'avatar_url': 'https://avatars2.githubusercontent.com/u/9300575?v=4', 'gravatar_id': '', 'url': 'https://api.github.com/users/bddppq', 'html_url': 'https://github.com/bddppq', 'followers_url': 'https://api.github.com/users/bddppq/followers', 'following_url': 'https://api.github.com/users/bddppq/following{/other_user}', 'gists_url': 'https://api.github.com/users/bddppq/gists{/gist_id}', 'starred_url': 'https://api.github.com/users/bddppq/starred{/owner}{/repo}', 'subscriptions_url': 'https://api.github.com/users/bddppq/subscriptions', 'organizations_url': 'https://api.github.com/users/bddppq/orgs', 'repos_url': 'https://api.github.com/users/bddppq/repos', 'events_url': 'https://api.github.com/users/bddppq/events{/privacy}', 'received_events_url': 'https://api.github.com/users/bddppq/received_events', 'type': 'User', 'site_admin': False}",referenced,728cc987af39412eec099106a2a4cb397ea1024f,https://api.github.com/repos/pytorch/pytorch/commits/728cc987af39412eec099106a2a4cb397ea1024f,2018-10-15T21:12:47Z,29,23,6
587,1905229879,"{'login': 'bddppq', 'id': 9300575, 'node_id': 'MDQ6VXNlcjkzMDA1NzU=', 'avatar_url': 'https://avatars2.githubusercontent.com/u/9300575?v=4', 'gravatar_id': '', 'url': 'https://api.github.com/users/bddppq', 'html_url': 'https://github.com/bddppq', 'followers_url': 'https://api.github.com/users/bddppq/followers', 'following_url': 'https://api.github.com/users/bddppq/following{/other_user}', 'gists_url': 'https://api.github.com/users/bddppq/gists{/gist_id}', 'starred_url': 'https://api.github.com/users/bddppq/starred{/owner}{/repo}', 'subscriptions_url': 'https://api.github.com/users/bddppq/subscriptions', 'organizations_url': 'https://api.github.com/users/bddppq/orgs', 'repos_url': 'https://api.github.com/users/bddppq/repos', 'events_url': 'https://api.github.com/users/bddppq/events{/privacy}', 'received_events_url': 'https://api.github.com/users/bddppq/received_events', 'type': 'User', 'site_admin': False}",referenced,8bcecad91c3045e6e30db464b03d7796579a92fa,https://api.github.com/repos/pytorch/pytorch/commits/8bcecad91c3045e6e30db464b03d7796579a92fa,2018-10-15T21:12:46Z,366,223,143
584,1905229872,"{'login': 'bddppq', 'id': 9300575, 'node_id': 'MDQ6VXNlcjkzMDA1NzU=', 'avatar_url': 'https://avatars2.githubusercontent.com/u/9300575?v=4', 'gravatar_id': '', 'url': 'https://api.github.com/users/bddppq', 'html_url': 'https://github.com/bddppq', 'followers_url': 'https://api.github.com/users/bddppq/followers', 'following_url': 'https://api.github.com/users/bddppq/following{/other_user}', 'gists_url': 'https://api.github.com/users/bddppq/gists{/gist_id}', 'starred_url': 'https://api.github.com/users/bddppq/starred{/owner}{/repo}', 'subscriptions_url': 'https://api.github.com/users/bddppq/subscriptions', 'organizations_url': 'https://api.github.com/users/bddppq/orgs', 'repos_url': 'https://api.github.com/users/bddppq/repos', 'events_url': 'https://api.github.com/users/bddppq/events{/privacy}', 'received_events_url': 'https://api.github.com/users/bddppq/received_events', 'type': 'User', 'site_admin': False}",referenced,4e9d21b68e89cbb24f4a5465c5e1910ef5e58269,https://api.github.com/repos/pytorch/pytorch/commits/4e9d21b68e89cbb24f4a5465c5e1910ef5e58269,2018-10-15T21:12:46Z,193,134,59
580,1905230620,"{'login': 'bddppq', 'id': 9300575, 'node_id': 'MDQ6VXNlcjkzMDA1NzU=', 'avatar_url': 'https://avatars2.githubusercontent.com/u/9300575?v=4', 'gravatar_id': '', 'url': 'https://api.github.com/users/bddppq', 'html_url': 'https://github.com/bddppq', 'followers_url': 'https://api.github.com/users/bddppq/followers', 'following_url': 'https://api.github.com/users/bddppq/following{/other_user}', 'gists_url': 'https://api.github.com/users/bddppq/gists{/gist_id}', 'starred_url': 'https://api.github.com/users/bddppq/starred{/owner}{/repo}', 'subscriptions_url': 'https://api.github.com/users/bddppq/subscriptions', 'organizations_url': 'https://api.github.com/users/bddppq/orgs', 'repos_url': 'https://api.github.com/users/bddppq/repos', 'events_url': 'https://api.github.com/users/bddppq/events{/privacy}', 'received_events_url': 'https://api.github.com/users/bddppq/received_events', 'type': 'User', 'site_admin': False}",referenced,9a37d4daf537532ffbd94af896ee58a70dd72fd3,https://api.github.com/repos/pytorch/pytorch/commits/9a37d4daf537532ffbd94af896ee58a70dd72fd3,2018-10-15T21:13:01Z,138,134,4
573,1905229948,"{'login': 'bddppq', 'id': 9300575, 'node_id': 'MDQ6VXNlcjkzMDA1NzU=', 'avatar_url': 'https://avatars2.githubusercontent.com/u/9300575?v=4', 'gravatar_id': '', 'url': 'https://api.github.com/users/bddppq', 'html_url': 'https://github.com/bddppq', 'followers_url': 'https://api.github.com/users/bddppq/followers', 'following_url': 'https://api.github.com/users/bddppq/following{/other_user}', 'gists_url': 'https://api.github.com/users/bddppq/gists{/gist_id}', 'starred_url': 'https://api.github.com/users/bddppq/starred{/owner}{/repo}', 'subscriptions_url': 'https://api.github.com/users/bddppq/subscriptions', 'organizations_url': 'https://api.github.com/users/bddppq/orgs', 'repos_url': 'https://api.github.com/users/bddppq/repos', 'events_url': 'https://api.github.com/users/bddppq/events{/privacy}', 'received_events_url': 'https://api.github.com/users/bddppq/received_events', 'type': 'User', 'site_admin': False}",referenced,8c90dc1dd9cb9a8d9c5baf3540bb4b56c4cacd2e,https://api.github.com/repos/pytorch/pytorch/commits/8c90dc1dd9cb9a8d9c5baf3540bb4b56c4cacd2e,2018-10-15T21:12:48Z,696,674,22
561,1905229847,"{'login': 'bddppq', 'id': 9300575, 'node_id': 'MDQ6VXNlcjkzMDA1NzU=', 'avatar_url': 'https://avatars2.githubusercontent.com/u/9300575?v=4', 'gravatar_id': '', 'url': 'https://api.github.com/users/bddppq', 'html_url': 'https://github.com/bddppq', 'followers_url': 'https://api.github.com/users/bddppq/followers', 'following_url': 'https://api.github.com/users/bddppq/following{/other_user}', 'gists_url': 'https://api.github.com/users/bddppq/gists{/gist_id}', 'starred_url': 'https://api.github.com/users/bddppq/starred{/owner}{/repo}', 'subscriptions_url': 'https://api.github.com/users/bddppq/subscriptions', 'organizations_url': 'https://api.github.com/users/bddppq/orgs', 'repos_url': 'https://api.github.com/users/bddppq/repos', 'events_url': 'https://api.github.com/users/bddppq/events{/privacy}', 'received_events_url': 'https://api.github.com/users/bddppq/received_events', 'type': 'User', 'site_admin': False}",referenced,8dc7369bb9c3c1b63056211339987b0ad015faba,https://api.github.com/repos/pytorch/pytorch/commits/8dc7369bb9c3c1b63056211339987b0ad015faba,2018-10-15T21:12:46Z,73,65,8
556,1905230794,"{'login': 'bddppq', 'id': 9300575, 'node_id': 'MDQ6VXNlcjkzMDA1NzU=', 'avatar_url': 'https://avatars2.githubusercontent.com/u/9300575?v=4', 'gravatar_id': '', 'url': 'https://api.github.com/users/bddppq', 'html_url': 'https://github.com/bddppq', 'followers_url': 'https://api.github.com/users/bddppq/followers', 'following_url': 'https://api.github.com/users/bddppq/following{/other_user}', 'gists_url': 'https://api.github.com/users/bddppq/gists{/gist_id}', 'starred_url': 'https://api.github.com/users/bddppq/starred{/owner}{/repo}', 'subscriptions_url': 'https://api.github.com/users/bddppq/subscriptions', 'organizations_url': 'https://api.github.com/users/bddppq/orgs', 'repos_url': 'https://api.github.com/users/bddppq/repos', 'events_url': 'https://api.github.com/users/bddppq/events{/privacy}', 'received_events_url': 'https://api.github.com/users/bddppq/received_events', 'type': 'User', 'site_admin': False}",referenced,b1571d829f7eda1691c7de762ef9a7bbc0750bca,https://api.github.com/repos/pytorch/pytorch/commits/b1571d829f7eda1691c7de762ef9a7bbc0750bca,2018-10-15T21:13:05Z,352,352,0
555,1905229850,"{'login': 'bddppq', 'id': 9300575, 'node_id': 'MDQ6VXNlcjkzMDA1NzU=', 'avatar_url': 'https://avatars2.githubusercontent.com/u/9300575?v=4', 'gravatar_id': '', 'url': 'https://api.github.com/users/bddppq', 'html_url': 'https://github.com/bddppq', 'followers_url': 'https://api.github.com/users/bddppq/followers', 'following_url': 'https://api.github.com/users/bddppq/following{/other_user}', 'gists_url': 'https://api.github.com/users/bddppq/gists{/gist_id}', 'starred_url': 'https://api.github.com/users/bddppq/starred{/owner}{/repo}', 'subscriptions_url': 'https://api.github.com/users/bddppq/subscriptions', 'organizations_url': 'https://api.github.com/users/bddppq/orgs', 'repos_url': 'https://api.github.com/users/bddppq/repos', 'events_url': 'https://api.github.com/users/bddppq/events{/privacy}', 'received_events_url': 'https://api.github.com/users/bddppq/received_events', 'type': 'User', 'site_admin': False}",referenced,4f00542fc1c80c489535e99a5ab7d3b6f40061b9,https://api.github.com/repos/pytorch/pytorch/commits/4f00542fc1c80c489535e99a5ab7d3b6f40061b9,2018-10-15T21:12:46Z,187,127,60
551,1595150711,"{'login': 'onnxbot', 'id': 33637430, 'node_id': 'MDQ6VXNlcjMzNjM3NDMw', 'avatar_url': 'https://avatars3.githubusercontent.com/u/33637430?v=4', 'gravatar_id': '', 'url': 'https://api.github.com/users/onnxbot', 'html_url': 'https://github.com/onnxbot', 'followers_url': 'https://api.github.com/users/onnxbot/followers', 'following_url': 'https://api.github.com/users/onnxbot/following{/other_user}', 'gists_url': 'https://api.github.com/users/onnxbot/gists{/gist_id}', 'starred_url': 'https://api.github.com/users/onnxbot/starred{/owner}{/repo}', 'subscriptions_url': 'https://api.github.com/users/onnxbot/subscriptions', 'organizations_url': 'https://api.github.com/users/onnxbot/orgs', 'repos_url': 'https://api.github.com/users/onnxbot/repos', 'events_url': 'https://api.github.com/users/onnxbot/events{/privacy}', 'received_events_url': 'https://api.github.com/users/onnxbot/received_events', 'type': 'User', 'site_admin': False}",referenced,5aed120bc38c753753770e712f9ee1843741b27e,https://api.github.com/repos/pytorch/pytorch/commits/5aed120bc38c753753770e712f9ee1843741b27e,2018-04-25T21:29:09Z,2,1,1
551,1621259719,"{'login': 'pjh5', 'id': 6456020, 'node_id': 'MDQ6VXNlcjY0NTYwMjA=', 'avatar_url': 'https://avatars1.githubusercontent.com/u/6456020?v=4', 'gravatar_id': '', 'url': 'https://api.github.com/users/pjh5', 'html_url': 'https://github.com/pjh5', 'followers_url': 'https://api.github.com/users/pjh5/followers', 'following_url': 'https://api.github.com/users/pjh5/following{/other_user}', 'gists_url': 'https://api.github.com/users/pjh5/gists{/gist_id}', 'starred_url': 'https://api.github.com/users/pjh5/starred{/owner}{/repo}', 'subscriptions_url': 'https://api.github.com/users/pjh5/subscriptions', 'organizations_url': 'https://api.github.com/users/pjh5/orgs', 'repos_url': 'https://api.github.com/users/pjh5/repos', 'events_url': 'https://api.github.com/users/pjh5/events{/privacy}', 'received_events_url': 'https://api.github.com/users/pjh5/received_events', 'type': 'User', 'site_admin': False}",referenced,b875fb281c92dbe88da279a0ff7ad342e7b28b9e,https://api.github.com/repos/pytorch/pytorch/commits/b875fb281c92dbe88da279a0ff7ad342e7b28b9e,2018-05-11T06:14:55Z,3328,2549,779
551,1905230234,"{'login': 'bddppq', 'id': 9300575, 'node_id': 'MDQ6VXNlcjkzMDA1NzU=', 'avatar_url': 'https://avatars2.githubusercontent.com/u/9300575?v=4', 'gravatar_id': '', 'url': 'https://api.github.com/users/bddppq', 'html_url': 'https://github.com/bddppq', 'followers_url': 'https://api.github.com/users/bddppq/followers', 'following_url': 'https://api.github.com/users/bddppq/following{/other_user}', 'gists_url': 'https://api.github.com/users/bddppq/gists{/gist_id}', 'starred_url': 'https://api.github.com/users/bddppq/starred{/owner}{/repo}', 'subscriptions_url': 'https://api.github.com/users/bddppq/subscriptions', 'organizations_url': 'https://api.github.com/users/bddppq/orgs', 'repos_url': 'https://api.github.com/users/bddppq/repos', 'events_url': 'https://api.github.com/users/bddppq/events{/privacy}', 'received_events_url': 'https://api.github.com/users/bddppq/received_events', 'type': 'User', 'site_admin': False}",referenced,1c03a5a42e815a25419f35af33b4de4014187d3f,https://api.github.com/repos/pytorch/pytorch/commits/1c03a5a42e815a25419f35af33b4de4014187d3f,2018-10-15T21:12:53Z,1571,1571,0
550,1905229821,"{'login': 'bddppq', 'id': 9300575, 'node_id': 'MDQ6VXNlcjkzMDA1NzU=', 'avatar_url': 'https://avatars2.githubusercontent.com/u/9300575?v=4', 'gravatar_id': '', 'url': 'https://api.github.com/users/bddppq', 'html_url': 'https://github.com/bddppq', 'followers_url': 'https://api.github.com/users/bddppq/followers', 'following_url': 'https://api.github.com/users/bddppq/following{/other_user}', 'gists_url': 'https://api.github.com/users/bddppq/gists{/gist_id}', 'starred_url': 'https://api.github.com/users/bddppq/starred{/owner}{/repo}', 'subscriptions_url': 'https://api.github.com/users/bddppq/subscriptions', 'organizations_url': 'https://api.github.com/users/bddppq/orgs', 'repos_url': 'https://api.github.com/users/bddppq/repos', 'events_url': 'https://api.github.com/users/bddppq/events{/privacy}', 'received_events_url': 'https://api.github.com/users/bddppq/received_events', 'type': 'User', 'site_admin': False}",referenced,5641b4abd364d32710ec19d22f3ae321282fda9b,https://api.github.com/repos/pytorch/pytorch/commits/5641b4abd364d32710ec19d22f3ae321282fda9b,2018-10-15T21:12:45Z,6,5,1
547,1905229831,"{'login': 'bddppq', 'id': 9300575, 'node_id': 'MDQ6VXNlcjkzMDA1NzU=', 'avatar_url': 'https://avatars2.githubusercontent.com/u/9300575?v=4', 'gravatar_id': '', 'url': 'https://api.github.com/users/bddppq', 'html_url': 'https://github.com/bddppq', 'followers_url': 'https://api.github.com/users/bddppq/followers', 'following_url': 'https://api.github.com/users/bddppq/following{/other_user}', 'gists_url': 'https://api.github.com/users/bddppq/gists{/gist_id}', 'starred_url': 'https://api.github.com/users/bddppq/starred{/owner}{/repo}', 'subscriptions_url': 'https://api.github.com/users/bddppq/subscriptions', 'organizations_url': 'https://api.github.com/users/bddppq/orgs', 'repos_url': 'https://api.github.com/users/bddppq/repos', 'events_url': 'https://api.github.com/users/bddppq/events{/privacy}', 'received_events_url': 'https://api.github.com/users/bddppq/received_events', 'type': 'User', 'site_admin': False}",referenced,e78c068008c97d88a41ff926916225487b0aa205,https://api.github.com/repos/pytorch/pytorch/commits/e78c068008c97d88a41ff926916225487b0aa205,2018-10-15T21:12:46Z,27,16,11
545,1905229815,"{'login': 'bddppq', 'id': 9300575, 'node_id': 'MDQ6VXNlcjkzMDA1NzU=', 'avatar_url': 'https://avatars2.githubusercontent.com/u/9300575?v=4', 'gravatar_id': '', 'url': 'https://api.github.com/users/bddppq', 'html_url': 'https://github.com/bddppq', 'followers_url': 'https://api.github.com/users/bddppq/followers', 'following_url': 'https://api.github.com/users/bddppq/following{/other_user}', 'gists_url': 'https://api.github.com/users/bddppq/gists{/gist_id}', 'starred_url': 'https://api.github.com/users/bddppq/starred{/owner}{/repo}', 'subscriptions_url': 'https://api.github.com/users/bddppq/subscriptions', 'organizations_url': 'https://api.github.com/users/bddppq/orgs', 'repos_url': 'https://api.github.com/users/bddppq/repos', 'events_url': 'https://api.github.com/users/bddppq/events{/privacy}', 'received_events_url': 'https://api.github.com/users/bddppq/received_events', 'type': 'User', 'site_admin': False}",referenced,bb612237191b7205625ffc36e3b4b2e24ce80985,https://api.github.com/repos/pytorch/pytorch/commits/bb612237191b7205625ffc36e3b4b2e24ce80985,2018-10-15T21:12:45Z,12,11,1
543,1905229834,"{'login': 'bddppq', 'id': 9300575, 'node_id': 'MDQ6VXNlcjkzMDA1NzU=', 'avatar_url': 'https://avatars2.githubusercontent.com/u/9300575?v=4', 'gravatar_id': '', 'url': 'https://api.github.com/users/bddppq', 'html_url': 'https://github.com/bddppq', 'followers_url': 'https://api.github.com/users/bddppq/followers', 'following_url': 'https://api.github.com/users/bddppq/following{/other_user}', 'gists_url': 'https://api.github.com/users/bddppq/gists{/gist_id}', 'starred_url': 'https://api.github.com/users/bddppq/starred{/owner}{/repo}', 'subscriptions_url': 'https://api.github.com/users/bddppq/subscriptions', 'organizations_url': 'https://api.github.com/users/bddppq/orgs', 'repos_url': 'https://api.github.com/users/bddppq/repos', 'events_url': 'https://api.github.com/users/bddppq/events{/privacy}', 'received_events_url': 'https://api.github.com/users/bddppq/received_events', 'type': 'User', 'site_admin': False}",referenced,176e3575ea15db994a84702470da90ee90a0dbf6,https://api.github.com/repos/pytorch/pytorch/commits/176e3575ea15db994a84702470da90ee90a0dbf6,2018-10-15T21:12:46Z,103,103,0
542,1905229843,"{'login': 'bddppq', 'id': 9300575, 'node_id': 'MDQ6VXNlcjkzMDA1NzU=', 'avatar_url': 'https://avatars2.githubusercontent.com/u/9300575?v=4', 'gravatar_id': '', 'url': 'https://api.github.com/users/bddppq', 'html_url': 'https://github.com/bddppq', 'followers_url': 'https://api.github.com/users/bddppq/followers', 'following_url': 'https://api.github.com/users/bddppq/following{/other_user}', 'gists_url': 'https://api.github.com/users/bddppq/gists{/gist_id}', 'starred_url': 'https://api.github.com/users/bddppq/starred{/owner}{/repo}', 'subscriptions_url': 'https://api.github.com/users/bddppq/subscriptions', 'organizations_url': 'https://api.github.com/users/bddppq/orgs', 'repos_url': 'https://api.github.com/users/bddppq/repos', 'events_url': 'https://api.github.com/users/bddppq/events{/privacy}', 'received_events_url': 'https://api.github.com/users/bddppq/received_events', 'type': 'User', 'site_admin': False}",referenced,296953db87b79c0137c5d9c1a8f26dfaa2495afc,https://api.github.com/repos/pytorch/pytorch/commits/296953db87b79c0137c5d9c1a8f26dfaa2495afc,2018-10-15T21:12:46Z,34,17,17
541,1905229802,"{'login': 'bddppq', 'id': 9300575, 'node_id': 'MDQ6VXNlcjkzMDA1NzU=', 'avatar_url': 'https://avatars2.githubusercontent.com/u/9300575?v=4', 'gravatar_id': '', 'url': 'https://api.github.com/users/bddppq', 'html_url': 'https://github.com/bddppq', 'followers_url': 'https://api.github.com/users/bddppq/followers', 'following_url': 'https://api.github.com/users/bddppq/following{/other_user}', 'gists_url': 'https://api.github.com/users/bddppq/gists{/gist_id}', 'starred_url': 'https://api.github.com/users/bddppq/starred{/owner}{/repo}', 'subscriptions_url': 'https://api.github.com/users/bddppq/subscriptions', 'organizations_url': 'https://api.github.com/users/bddppq/orgs', 'repos_url': 'https://api.github.com/users/bddppq/repos', 'events_url': 'https://api.github.com/users/bddppq/events{/privacy}', 'received_events_url': 'https://api.github.com/users/bddppq/received_events', 'type': 'User', 'site_admin': False}",referenced,cc9b6e6a591c8374f31c5e044fa7ab8f25c94654,https://api.github.com/repos/pytorch/pytorch/commits/cc9b6e6a591c8374f31c5e044fa7ab8f25c94654,2018-10-15T21:12:45Z,6,3,3
538,1905229794,"{'login': 'bddppq', 'id': 9300575, 'node_id': 'MDQ6VXNlcjkzMDA1NzU=', 'avatar_url': 'https://avatars2.githubusercontent.com/u/9300575?v=4', 'gravatar_id': '', 'url': 'https://api.github.com/users/bddppq', 'html_url': 'https://github.com/bddppq', 'followers_url': 'https://api.github.com/users/bddppq/followers', 'following_url': 'https://api.github.com/users/bddppq/following{/other_user}', 'gists_url': 'https://api.github.com/users/bddppq/gists{/gist_id}', 'starred_url': 'https://api.github.com/users/bddppq/starred{/owner}{/repo}', 'subscriptions_url': 'https://api.github.com/users/bddppq/subscriptions', 'organizations_url': 'https://api.github.com/users/bddppq/orgs', 'repos_url': 'https://api.github.com/users/bddppq/repos', 'events_url': 'https://api.github.com/users/bddppq/events{/privacy}', 'received_events_url': 'https://api.github.com/users/bddppq/received_events', 'type': 'User', 'site_admin': False}",referenced,a0b3b15300c9c0ee9e37459caf97f3f1d27c4e80,https://api.github.com/repos/pytorch/pytorch/commits/a0b3b15300c9c0ee9e37459caf97f3f1d27c4e80,2018-10-15T21:12:45Z,43,30,13
537,1905229796,"{'login': 'bddppq', 'id': 9300575, 'node_id': 'MDQ6VXNlcjkzMDA1NzU=', 'avatar_url': 'https://avatars2.githubusercontent.com/u/9300575?v=4', 'gravatar_id': '', 'url': 'https://api.github.com/users/bddppq', 'html_url': 'https://github.com/bddppq', 'followers_url': 'https://api.github.com/users/bddppq/followers', 'following_url': 'https://api.github.com/users/bddppq/following{/other_user}', 'gists_url': 'https://api.github.com/users/bddppq/gists{/gist_id}', 'starred_url': 'https://api.github.com/users/bddppq/starred{/owner}{/repo}', 'subscriptions_url': 'https://api.github.com/users/bddppq/subscriptions', 'organizations_url': 'https://api.github.com/users/bddppq/orgs', 'repos_url': 'https://api.github.com/users/bddppq/repos', 'events_url': 'https://api.github.com/users/bddppq/events{/privacy}', 'received_events_url': 'https://api.github.com/users/bddppq/received_events', 'type': 'User', 'site_admin': False}",referenced,938ce339fd3e7dc5eb6a8f6332f77762ff5eaaaf,https://api.github.com/repos/pytorch/pytorch/commits/938ce339fd3e7dc5eb6a8f6332f77762ff5eaaaf,2018-10-15T21:12:45Z,104,101,3
532,1905229806,"{'login': 'bddppq', 'id': 9300575, 'node_id': 'MDQ6VXNlcjkzMDA1NzU=', 'avatar_url': 'https://avatars2.githubusercontent.com/u/9300575?v=4', 'gravatar_id': '', 'url': 'https://api.github.com/users/bddppq', 'html_url': 'https://github.com/bddppq', 'followers_url': 'https://api.github.com/users/bddppq/followers', 'following_url': 'https://api.github.com/users/bddppq/following{/other_user}', 'gists_url': 'https://api.github.com/users/bddppq/gists{/gist_id}', 'starred_url': 'https://api.github.com/users/bddppq/starred{/owner}{/repo}', 'subscriptions_url': 'https://api.github.com/users/bddppq/subscriptions', 'organizations_url': 'https://api.github.com/users/bddppq/orgs', 'repos_url': 'https://api.github.com/users/bddppq/repos', 'events_url': 'https://api.github.com/users/bddppq/events{/privacy}', 'received_events_url': 'https://api.github.com/users/bddppq/received_events', 'type': 'User', 'site_admin': False}",referenced,fe54d88ff4d40696ce8b00d34fde4308d3e3721e,https://api.github.com/repos/pytorch/pytorch/commits/fe54d88ff4d40696ce8b00d34fde4308d3e3721e,2018-10-15T21:12:45Z,330,330,0
524,1905229767,"{'login': 'bddppq', 'id': 9300575, 'node_id': 'MDQ6VXNlcjkzMDA1NzU=', 'avatar_url': 'https://avatars2.githubusercontent.com/u/9300575?v=4', 'gravatar_id': '', 'url': 'https://api.github.com/users/bddppq', 'html_url': 'https://github.com/bddppq', 'followers_url': 'https://api.github.com/users/bddppq/followers', 'following_url': 'https://api.github.com/users/bddppq/following{/other_user}', 'gists_url': 'https://api.github.com/users/bddppq/gists{/gist_id}', 'starred_url': 'https://api.github.com/users/bddppq/starred{/owner}{/repo}', 'subscriptions_url': 'https://api.github.com/users/bddppq/subscriptions', 'organizations_url': 'https://api.github.com/users/bddppq/orgs', 'repos_url': 'https://api.github.com/users/bddppq/repos', 'events_url': 'https://api.github.com/users/bddppq/events{/privacy}', 'received_events_url': 'https://api.github.com/users/bddppq/received_events', 'type': 'User', 'site_admin': False}",referenced,4ce42f834ffbf2d779a3417cc7938446546cb010,https://api.github.com/repos/pytorch/pytorch/commits/4ce42f834ffbf2d779a3417cc7938446546cb010,2018-10-15T21:12:44Z,109,109,0
496,1905229768,"{'login': 'bddppq', 'id': 9300575, 'node_id': 'MDQ6VXNlcjkzMDA1NzU=', 'avatar_url': 'https://avatars2.githubusercontent.com/u/9300575?v=4', 'gravatar_id': '', 'url': 'https://api.github.com/users/bddppq', 'html_url': 'https://github.com/bddppq', 'followers_url': 'https://api.github.com/users/bddppq/followers', 'following_url': 'https://api.github.com/users/bddppq/following{/other_user}', 'gists_url': 'https://api.github.com/users/bddppq/gists{/gist_id}', 'starred_url': 'https://api.github.com/users/bddppq/starred{/owner}{/repo}', 'subscriptions_url': 'https://api.github.com/users/bddppq/subscriptions', 'organizations_url': 'https://api.github.com/users/bddppq/orgs', 'repos_url': 'https://api.github.com/users/bddppq/repos', 'events_url': 'https://api.github.com/users/bddppq/events{/privacy}', 'received_events_url': 'https://api.github.com/users/bddppq/received_events', 'type': 'User', 'site_admin': False}",referenced,efc64f1b90b8f4dac4c8c7e657893ea2fa2ab8e2,https://api.github.com/repos/pytorch/pytorch/commits/efc64f1b90b8f4dac4c8c7e657893ea2fa2ab8e2,2018-10-15T21:12:44Z,228,228,0
491,1905229762,"{'login': 'bddppq', 'id': 9300575, 'node_id': 'MDQ6VXNlcjkzMDA1NzU=', 'avatar_url': 'https://avatars2.githubusercontent.com/u/9300575?v=4', 'gravatar_id': '', 'url': 'https://api.github.com/users/bddppq', 'html_url': 'https://github.com/bddppq', 'followers_url': 'https://api.github.com/users/bddppq/followers', 'following_url': 'https://api.github.com/users/bddppq/following{/other_user}', 'gists_url': 'https://api.github.com/users/bddppq/gists{/gist_id}', 'starred_url': 'https://api.github.com/users/bddppq/starred{/owner}{/repo}', 'subscriptions_url': 'https://api.github.com/users/bddppq/subscriptions', 'organizations_url': 'https://api.github.com/users/bddppq/orgs', 'repos_url': 'https://api.github.com/users/bddppq/repos', 'events_url': 'https://api.github.com/users/bddppq/events{/privacy}', 'received_events_url': 'https://api.github.com/users/bddppq/received_events', 'type': 'User', 'site_admin': False}",referenced,bb9338a8e22ac1c157db74f0545924972f713b5b,https://api.github.com/repos/pytorch/pytorch/commits/bb9338a8e22ac1c157db74f0545924972f713b5b,2018-10-15T21:12:44Z,86,45,41
484,1905229747,"{'login': 'bddppq', 'id': 9300575, 'node_id': 'MDQ6VXNlcjkzMDA1NzU=', 'avatar_url': 'https://avatars2.githubusercontent.com/u/9300575?v=4', 'gravatar_id': '', 'url': 'https://api.github.com/users/bddppq', 'html_url': 'https://github.com/bddppq', 'followers_url': 'https://api.github.com/users/bddppq/followers', 'following_url': 'https://api.github.com/users/bddppq/following{/other_user}', 'gists_url': 'https://api.github.com/users/bddppq/gists{/gist_id}', 'starred_url': 'https://api.github.com/users/bddppq/starred{/owner}{/repo}', 'subscriptions_url': 'https://api.github.com/users/bddppq/subscriptions', 'organizations_url': 'https://api.github.com/users/bddppq/orgs', 'repos_url': 'https://api.github.com/users/bddppq/repos', 'events_url': 'https://api.github.com/users/bddppq/events{/privacy}', 'received_events_url': 'https://api.github.com/users/bddppq/received_events', 'type': 'User', 'site_admin': False}",referenced,043688bc5946cfd133d01923af7884b68b00d528,https://api.github.com/repos/pytorch/pytorch/commits/043688bc5946cfd133d01923af7884b68b00d528,2018-10-15T21:12:44Z,427,218,209
483,1905229732,"{'login': 'bddppq', 'id': 9300575, 'node_id': 'MDQ6VXNlcjkzMDA1NzU=', 'avatar_url': 'https://avatars2.githubusercontent.com/u/9300575?v=4', 'gravatar_id': '', 'url': 'https://api.github.com/users/bddppq', 'html_url': 'https://github.com/bddppq', 'followers_url': 'https://api.github.com/users/bddppq/followers', 'following_url': 'https://api.github.com/users/bddppq/following{/other_user}', 'gists_url': 'https://api.github.com/users/bddppq/gists{/gist_id}', 'starred_url': 'https://api.github.com/users/bddppq/starred{/owner}{/repo}', 'subscriptions_url': 'https://api.github.com/users/bddppq/subscriptions', 'organizations_url': 'https://api.github.com/users/bddppq/orgs', 'repos_url': 'https://api.github.com/users/bddppq/repos', 'events_url': 'https://api.github.com/users/bddppq/events{/privacy}', 'received_events_url': 'https://api.github.com/users/bddppq/received_events', 'type': 'User', 'site_admin': False}",referenced,f3e909e49c686a61e17e999f83fa05e3cdc16e1c,https://api.github.com/repos/pytorch/pytorch/commits/f3e909e49c686a61e17e999f83fa05e3cdc16e1c,2018-10-15T21:12:43Z,62,53,9
477,1190657563,"{'login': 'soumith', 'id': 1310570, 'node_id': 'MDQ6VXNlcjEzMTA1NzA=', 'avatar_url': 'https://avatars0.githubusercontent.com/u/1310570?v=4', 'gravatar_id': '', 'url': 'https://api.github.com/users/soumith', 'html_url': 'https://github.com/soumith', 'followers_url': 'https://api.github.com/users/soumith/followers', 'following_url': 'https://api.github.com/users/soumith/following{/other_user}', 'gists_url': 'https://api.github.com/users/soumith/gists{/gist_id}', 'starred_url': 'https://api.github.com/users/soumith/starred{/owner}{/repo}', 'subscriptions_url': 'https://api.github.com/users/soumith/subscriptions', 'organizations_url': 'https://api.github.com/users/soumith/orgs', 'repos_url': 'https://api.github.com/users/soumith/repos', 'events_url': 'https://api.github.com/users/soumith/events{/privacy}', 'received_events_url': 'https://api.github.com/users/soumith/received_events', 'type': 'User', 'site_admin': False}",referenced,f194ac1e09fe3b9888d32dfb1e74690e44c5e24b,https://api.github.com/repos/pytorch/pytorch/commits/f194ac1e09fe3b9888d32dfb1e74690e44c5e24b,2017-08-03T02:52:17Z,940,940,0
469,1905229748,"{'login': 'bddppq', 'id': 9300575, 'node_id': 'MDQ6VXNlcjkzMDA1NzU=', 'avatar_url': 'https://avatars2.githubusercontent.com/u/9300575?v=4', 'gravatar_id': '', 'url': 'https://api.github.com/users/bddppq', 'html_url': 'https://github.com/bddppq', 'followers_url': 'https://api.github.com/users/bddppq/followers', 'following_url': 'https://api.github.com/users/bddppq/following{/other_user}', 'gists_url': 'https://api.github.com/users/bddppq/gists{/gist_id}', 'starred_url': 'https://api.github.com/users/bddppq/starred{/owner}{/repo}', 'subscriptions_url': 'https://api.github.com/users/bddppq/subscriptions', 'organizations_url': 'https://api.github.com/users/bddppq/orgs', 'repos_url': 'https://api.github.com/users/bddppq/repos', 'events_url': 'https://api.github.com/users/bddppq/events{/privacy}', 'received_events_url': 'https://api.github.com/users/bddppq/received_events', 'type': 'User', 'site_admin': False}",referenced,0a271296a6dbb084a69a41fe5d0921723515261d,https://api.github.com/repos/pytorch/pytorch/commits/0a271296a6dbb084a69a41fe5d0921723515261d,2018-10-15T21:12:44Z,197,173,24
467,1905229708,"{'login': 'bddppq', 'id': 9300575, 'node_id': 'MDQ6VXNlcjkzMDA1NzU=', 'avatar_url': 'https://avatars2.githubusercontent.com/u/9300575?v=4', 'gravatar_id': '', 'url': 'https://api.github.com/users/bddppq', 'html_url': 'https://github.com/bddppq', 'followers_url': 'https://api.github.com/users/bddppq/followers', 'following_url': 'https://api.github.com/users/bddppq/following{/other_user}', 'gists_url': 'https://api.github.com/users/bddppq/gists{/gist_id}', 'starred_url': 'https://api.github.com/users/bddppq/starred{/owner}{/repo}', 'subscriptions_url': 'https://api.github.com/users/bddppq/subscriptions', 'organizations_url': 'https://api.github.com/users/bddppq/orgs', 'repos_url': 'https://api.github.com/users/bddppq/repos', 'events_url': 'https://api.github.com/users/bddppq/events{/privacy}', 'received_events_url': 'https://api.github.com/users/bddppq/received_events', 'type': 'User', 'site_admin': False}",referenced,d49c17c574d71071fbb542e5ddbf2c0f867467d5,https://api.github.com/repos/pytorch/pytorch/commits/d49c17c574d71071fbb542e5ddbf2c0f867467d5,2018-10-15T21:12:43Z,54,54,0
458,1112951809,"{'login': 'soumith', 'id': 1310570, 'node_id': 'MDQ6VXNlcjEzMTA1NzA=', 'avatar_url': 'https://avatars0.githubusercontent.com/u/1310570?v=4', 'gravatar_id': '', 'url': 'https://api.github.com/users/soumith', 'html_url': 'https://github.com/soumith', 'followers_url': 'https://api.github.com/users/soumith/followers', 'following_url': 'https://api.github.com/users/soumith/following{/other_user}', 'gists_url': 'https://api.github.com/users/soumith/gists{/gist_id}', 'starred_url': 'https://api.github.com/users/soumith/starred{/owner}{/repo}', 'subscriptions_url': 'https://api.github.com/users/soumith/subscriptions', 'organizations_url': 'https://api.github.com/users/soumith/orgs', 'repos_url': 'https://api.github.com/users/soumith/repos', 'events_url': 'https://api.github.com/users/soumith/events{/privacy}', 'received_events_url': 'https://api.github.com/users/soumith/received_events', 'type': 'User', 'site_admin': False}",referenced,78abf0134db4ec884fae0aec793eb2770343ad6c,https://api.github.com/repos/pytorch/pytorch/commits/78abf0134db4ec884fae0aec793eb2770343ad6c,2017-06-07T04:20:29Z,36,22,14
458,1905229703,"{'login': 'bddppq', 'id': 9300575, 'node_id': 'MDQ6VXNlcjkzMDA1NzU=', 'avatar_url': 'https://avatars2.githubusercontent.com/u/9300575?v=4', 'gravatar_id': '', 'url': 'https://api.github.com/users/bddppq', 'html_url': 'https://github.com/bddppq', 'followers_url': 'https://api.github.com/users/bddppq/followers', 'following_url': 'https://api.github.com/users/bddppq/following{/other_user}', 'gists_url': 'https://api.github.com/users/bddppq/gists{/gist_id}', 'starred_url': 'https://api.github.com/users/bddppq/starred{/owner}{/repo}', 'subscriptions_url': 'https://api.github.com/users/bddppq/subscriptions', 'organizations_url': 'https://api.github.com/users/bddppq/orgs', 'repos_url': 'https://api.github.com/users/bddppq/repos', 'events_url': 'https://api.github.com/users/bddppq/events{/privacy}', 'received_events_url': 'https://api.github.com/users/bddppq/received_events', 'type': 'User', 'site_admin': False}",referenced,9f8fd479cf1a46729af10dff735c7d1b3be6cbf9,https://api.github.com/repos/pytorch/pytorch/commits/9f8fd479cf1a46729af10dff735c7d1b3be6cbf9,2018-10-15T21:12:43Z,65,65,0
441,1905229688,"{'login': 'bddppq', 'id': 9300575, 'node_id': 'MDQ6VXNlcjkzMDA1NzU=', 'avatar_url': 'https://avatars2.githubusercontent.com/u/9300575?v=4', 'gravatar_id': '', 'url': 'https://api.github.com/users/bddppq', 'html_url': 'https://github.com/bddppq', 'followers_url': 'https://api.github.com/users/bddppq/followers', 'following_url': 'https://api.github.com/users/bddppq/following{/other_user}', 'gists_url': 'https://api.github.com/users/bddppq/gists{/gist_id}', 'starred_url': 'https://api.github.com/users/bddppq/starred{/owner}{/repo}', 'subscriptions_url': 'https://api.github.com/users/bddppq/subscriptions', 'organizations_url': 'https://api.github.com/users/bddppq/orgs', 'repos_url': 'https://api.github.com/users/bddppq/repos', 'events_url': 'https://api.github.com/users/bddppq/events{/privacy}', 'received_events_url': 'https://api.github.com/users/bddppq/received_events', 'type': 'User', 'site_admin': False}",referenced,5560e1d6e6123353de6cd05785299bd1cb7d410d,https://api.github.com/repos/pytorch/pytorch/commits/5560e1d6e6123353de6cd05785299bd1cb7d410d,2018-10-15T21:12:42Z,102,51,51
438,922659424,"{'login': 'colesbury', 'id': 655866, 'node_id': 'MDQ6VXNlcjY1NTg2Ng==', 'avatar_url': 'https://avatars1.githubusercontent.com/u/655866?v=4', 'gravatar_id': '', 'url': 'https://api.github.com/users/colesbury', 'html_url': 'https://github.com/colesbury', 'followers_url': 'https://api.github.com/users/colesbury/followers', 'following_url': 'https://api.github.com/users/colesbury/following{/other_user}', 'gists_url': 'https://api.github.com/users/colesbury/gists{/gist_id}', 'starred_url': 'https://api.github.com/users/colesbury/starred{/owner}{/repo}', 'subscriptions_url': 'https://api.github.com/users/colesbury/subscriptions', 'organizations_url': 'https://api.github.com/users/colesbury/orgs', 'repos_url': 'https://api.github.com/users/colesbury/repos', 'events_url': 'https://api.github.com/users/colesbury/events{/privacy}', 'received_events_url': 'https://api.github.com/users/colesbury/received_events', 'type': 'User', 'site_admin': False}",referenced,4f4bd81228257cfbb6e9894dd8bb2b0fa61f7039,https://api.github.com/repos/pytorch/pytorch/commits/4f4bd81228257cfbb6e9894dd8bb2b0fa61f7039,2017-01-13T18:51:49Z,64,55,9
436,1905229736,"{'login': 'bddppq', 'id': 9300575, 'node_id': 'MDQ6VXNlcjkzMDA1NzU=', 'avatar_url': 'https://avatars2.githubusercontent.com/u/9300575?v=4', 'gravatar_id': '', 'url': 'https://api.github.com/users/bddppq', 'html_url': 'https://github.com/bddppq', 'followers_url': 'https://api.github.com/users/bddppq/followers', 'following_url': 'https://api.github.com/users/bddppq/following{/other_user}', 'gists_url': 'https://api.github.com/users/bddppq/gists{/gist_id}', 'starred_url': 'https://api.github.com/users/bddppq/starred{/owner}{/repo}', 'subscriptions_url': 'https://api.github.com/users/bddppq/subscriptions', 'organizations_url': 'https://api.github.com/users/bddppq/orgs', 'repos_url': 'https://api.github.com/users/bddppq/repos', 'events_url': 'https://api.github.com/users/bddppq/events{/privacy}', 'received_events_url': 'https://api.github.com/users/bddppq/received_events', 'type': 'User', 'site_admin': False}",referenced,b2f2b8b507e4b348371e69c537c878b1915f4618,https://api.github.com/repos/pytorch/pytorch/commits/b2f2b8b507e4b348371e69c537c878b1915f4618,2018-10-15T21:12:44Z,1114,961,153
435,1905229670,"{'login': 'bddppq', 'id': 9300575, 'node_id': 'MDQ6VXNlcjkzMDA1NzU=', 'avatar_url': 'https://avatars2.githubusercontent.com/u/9300575?v=4', 'gravatar_id': '', 'url': 'https://api.github.com/users/bddppq', 'html_url': 'https://github.com/bddppq', 'followers_url': 'https://api.github.com/users/bddppq/followers', 'following_url': 'https://api.github.com/users/bddppq/following{/other_user}', 'gists_url': 'https://api.github.com/users/bddppq/gists{/gist_id}', 'starred_url': 'https://api.github.com/users/bddppq/starred{/owner}{/repo}', 'subscriptions_url': 'https://api.github.com/users/bddppq/subscriptions', 'organizations_url': 'https://api.github.com/users/bddppq/orgs', 'repos_url': 'https://api.github.com/users/bddppq/repos', 'events_url': 'https://api.github.com/users/bddppq/events{/privacy}', 'received_events_url': 'https://api.github.com/users/bddppq/received_events', 'type': 'User', 'site_admin': False}",referenced,4e71be6404a6755ce419de7b462f4eb8a9115ab6,https://api.github.com/repos/pytorch/pytorch/commits/4e71be6404a6755ce419de7b462f4eb8a9115ab6,2018-10-15T21:12:42Z,10,8,2
434,940517904,"{'login': 'apaszke', 'id': 4583066, 'node_id': 'MDQ6VXNlcjQ1ODMwNjY=', 'avatar_url': 'https://avatars3.githubusercontent.com/u/4583066?v=4', 'gravatar_id': '', 'url': 'https://api.github.com/users/apaszke', 'html_url': 'https://github.com/apaszke', 'followers_url': 'https://api.github.com/users/apaszke/followers', 'following_url': 'https://api.github.com/users/apaszke/following{/other_user}', 'gists_url': 'https://api.github.com/users/apaszke/gists{/gist_id}', 'starred_url': 'https://api.github.com/users/apaszke/starred{/owner}{/repo}', 'subscriptions_url': 'https://api.github.com/users/apaszke/subscriptions', 'organizations_url': 'https://api.github.com/users/apaszke/orgs', 'repos_url': 'https://api.github.com/users/apaszke/repos', 'events_url': 'https://api.github.com/users/apaszke/events{/privacy}', 'received_events_url': 'https://api.github.com/users/apaszke/received_events', 'type': 'User', 'site_admin': False}",closed,956d946c25ece0051931a023f45d4ee7d39997f1,https://api.github.com/repos/pytorch/pytorch/commits/956d946c25ece0051931a023f45d4ee7d39997f1,2017-01-29T11:38:58Z,24,23,1
434,1366198620,"{'login': 'apaszke', 'id': 4583066, 'node_id': 'MDQ6VXNlcjQ1ODMwNjY=', 'avatar_url': 'https://avatars3.githubusercontent.com/u/4583066?v=4', 'gravatar_id': '', 'url': 'https://api.github.com/users/apaszke', 'html_url': 'https://github.com/apaszke', 'followers_url': 'https://api.github.com/users/apaszke/followers', 'following_url': 'https://api.github.com/users/apaszke/following{/other_user}', 'gists_url': 'https://api.github.com/users/apaszke/gists{/gist_id}', 'starred_url': 'https://api.github.com/users/apaszke/starred{/owner}{/repo}', 'subscriptions_url': 'https://api.github.com/users/apaszke/subscriptions', 'organizations_url': 'https://api.github.com/users/apaszke/orgs', 'repos_url': 'https://api.github.com/users/apaszke/repos', 'events_url': 'https://api.github.com/users/apaszke/events{/privacy}', 'received_events_url': 'https://api.github.com/users/apaszke/received_events', 'type': 'User', 'site_admin': False}",referenced,8cb32ba630238f8de15695c9b0492ca02d1a9518,https://api.github.com/repos/pytorch/pytorch/commits/8cb32ba630238f8de15695c9b0492ca02d1a9518,2017-11-30T18:06:36Z,4,4,0
434,1463382636,"{'login': 'soumith', 'id': 1310570, 'node_id': 'MDQ6VXNlcjEzMTA1NzA=', 'avatar_url': 'https://avatars0.githubusercontent.com/u/1310570?v=4', 'gravatar_id': '', 'url': 'https://api.github.com/users/soumith', 'html_url': 'https://github.com/soumith', 'followers_url': 'https://api.github.com/users/soumith/followers', 'following_url': 'https://api.github.com/users/soumith/following{/other_user}', 'gists_url': 'https://api.github.com/users/soumith/gists{/gist_id}', 'starred_url': 'https://api.github.com/users/soumith/starred{/owner}{/repo}', 'subscriptions_url': 'https://api.github.com/users/soumith/subscriptions', 'organizations_url': 'https://api.github.com/users/soumith/orgs', 'repos_url': 'https://api.github.com/users/soumith/repos', 'events_url': 'https://api.github.com/users/soumith/events{/privacy}', 'received_events_url': 'https://api.github.com/users/soumith/received_events', 'type': 'User', 'site_admin': False}",referenced,1a5a28dc340b8d88236624c3765437687c184e62,https://api.github.com/repos/pytorch/pytorch/commits/1a5a28dc340b8d88236624c3765437687c184e62,2018-02-07T21:58:21Z,4,4,0
434,1584437245,"{'login': 'SsnL', 'id': 5674597, 'node_id': 'MDQ6VXNlcjU2NzQ1OTc=', 'avatar_url': 'https://avatars2.githubusercontent.com/u/5674597?v=4', 'gravatar_id': '', 'url': 'https://api.github.com/users/SsnL', 'html_url': 'https://github.com/SsnL', 'followers_url': 'https://api.github.com/users/SsnL/followers', 'following_url': 'https://api.github.com/users/SsnL/following{/other_user}', 'gists_url': 'https://api.github.com/users/SsnL/gists{/gist_id}', 'starred_url': 'https://api.github.com/users/SsnL/starred{/owner}{/repo}', 'subscriptions_url': 'https://api.github.com/users/SsnL/subscriptions', 'organizations_url': 'https://api.github.com/users/SsnL/orgs', 'repos_url': 'https://api.github.com/users/SsnL/repos', 'events_url': 'https://api.github.com/users/SsnL/events{/privacy}', 'received_events_url': 'https://api.github.com/users/SsnL/received_events', 'type': 'User', 'site_admin': False}",referenced,e169465672fd59e7675be25e87b0f2b89a5aa276,https://api.github.com/repos/pytorch/pytorch/commits/e169465672fd59e7675be25e87b0f2b89a5aa276,2018-04-19T17:54:34Z,4,4,0
434,1905229669,"{'login': 'bddppq', 'id': 9300575, 'node_id': 'MDQ6VXNlcjkzMDA1NzU=', 'avatar_url': 'https://avatars2.githubusercontent.com/u/9300575?v=4', 'gravatar_id': '', 'url': 'https://api.github.com/users/bddppq', 'html_url': 'https://github.com/bddppq', 'followers_url': 'https://api.github.com/users/bddppq/followers', 'following_url': 'https://api.github.com/users/bddppq/following{/other_user}', 'gists_url': 'https://api.github.com/users/bddppq/gists{/gist_id}', 'starred_url': 'https://api.github.com/users/bddppq/starred{/owner}{/repo}', 'subscriptions_url': 'https://api.github.com/users/bddppq/subscriptions', 'organizations_url': 'https://api.github.com/users/bddppq/orgs', 'repos_url': 'https://api.github.com/users/bddppq/repos', 'events_url': 'https://api.github.com/users/bddppq/events{/privacy}', 'received_events_url': 'https://api.github.com/users/bddppq/received_events', 'type': 'User', 'site_admin': False}",referenced,12ac9bff6aff2ea5aa391a01bcf66353b9ae6845,https://api.github.com/repos/pytorch/pytorch/commits/12ac9bff6aff2ea5aa391a01bcf66353b9ae6845,2018-10-15T21:12:42Z,2,1,1
431,1905229656,"{'login': 'bddppq', 'id': 9300575, 'node_id': 'MDQ6VXNlcjkzMDA1NzU=', 'avatar_url': 'https://avatars2.githubusercontent.com/u/9300575?v=4', 'gravatar_id': '', 'url': 'https://api.github.com/users/bddppq', 'html_url': 'https://github.com/bddppq', 'followers_url': 'https://api.github.com/users/bddppq/followers', 'following_url': 'https://api.github.com/users/bddppq/following{/other_user}', 'gists_url': 'https://api.github.com/users/bddppq/gists{/gist_id}', 'starred_url': 'https://api.github.com/users/bddppq/starred{/owner}{/repo}', 'subscriptions_url': 'https://api.github.com/users/bddppq/subscriptions', 'organizations_url': 'https://api.github.com/users/bddppq/orgs', 'repos_url': 'https://api.github.com/users/bddppq/repos', 'events_url': 'https://api.github.com/users/bddppq/events{/privacy}', 'received_events_url': 'https://api.github.com/users/bddppq/received_events', 'type': 'User', 'site_admin': False}",referenced,6b4b4caa28a5c4ef02f6b20cdac5e29f71466da4,https://api.github.com/repos/pytorch/pytorch/commits/6b4b4caa28a5c4ef02f6b20cdac5e29f71466da4,2018-10-15T21:12:42Z,356,355,1
426,1905229945,"{'login': 'bddppq', 'id': 9300575, 'node_id': 'MDQ6VXNlcjkzMDA1NzU=', 'avatar_url': 'https://avatars2.githubusercontent.com/u/9300575?v=4', 'gravatar_id': '', 'url': 'https://api.github.com/users/bddppq', 'html_url': 'https://github.com/bddppq', 'followers_url': 'https://api.github.com/users/bddppq/followers', 'following_url': 'https://api.github.com/users/bddppq/following{/other_user}', 'gists_url': 'https://api.github.com/users/bddppq/gists{/gist_id}', 'starred_url': 'https://api.github.com/users/bddppq/starred{/owner}{/repo}', 'subscriptions_url': 'https://api.github.com/users/bddppq/subscriptions', 'organizations_url': 'https://api.github.com/users/bddppq/orgs', 'repos_url': 'https://api.github.com/users/bddppq/repos', 'events_url': 'https://api.github.com/users/bddppq/events{/privacy}', 'received_events_url': 'https://api.github.com/users/bddppq/received_events', 'type': 'User', 'site_admin': False}",referenced,1e613b5d4ebbaf930f29201e635a1c9b47180278,https://api.github.com/repos/pytorch/pytorch/commits/1e613b5d4ebbaf930f29201e635a1c9b47180278,2018-10-15T21:12:48Z,121,121,0
419,1905229646,"{'login': 'bddppq', 'id': 9300575, 'node_id': 'MDQ6VXNlcjkzMDA1NzU=', 'avatar_url': 'https://avatars2.githubusercontent.com/u/9300575?v=4', 'gravatar_id': '', 'url': 'https://api.github.com/users/bddppq', 'html_url': 'https://github.com/bddppq', 'followers_url': 'https://api.github.com/users/bddppq/followers', 'following_url': 'https://api.github.com/users/bddppq/following{/other_user}', 'gists_url': 'https://api.github.com/users/bddppq/gists{/gist_id}', 'starred_url': 'https://api.github.com/users/bddppq/starred{/owner}{/repo}', 'subscriptions_url': 'https://api.github.com/users/bddppq/subscriptions', 'organizations_url': 'https://api.github.com/users/bddppq/orgs', 'repos_url': 'https://api.github.com/users/bddppq/repos', 'events_url': 'https://api.github.com/users/bddppq/events{/privacy}', 'received_events_url': 'https://api.github.com/users/bddppq/received_events', 'type': 'User', 'site_admin': False}",referenced,fa31270baf1a593278df1570c01540af4d2fb8b5,https://api.github.com/repos/pytorch/pytorch/commits/fa31270baf1a593278df1570c01540af4d2fb8b5,2018-10-15T21:12:42Z,43,20,23
415,1905229631,"{'login': 'bddppq', 'id': 9300575, 'node_id': 'MDQ6VXNlcjkzMDA1NzU=', 'avatar_url': 'https://avatars2.githubusercontent.com/u/9300575?v=4', 'gravatar_id': '', 'url': 'https://api.github.com/users/bddppq', 'html_url': 'https://github.com/bddppq', 'followers_url': 'https://api.github.com/users/bddppq/followers', 'following_url': 'https://api.github.com/users/bddppq/following{/other_user}', 'gists_url': 'https://api.github.com/users/bddppq/gists{/gist_id}', 'starred_url': 'https://api.github.com/users/bddppq/starred{/owner}{/repo}', 'subscriptions_url': 'https://api.github.com/users/bddppq/subscriptions', 'organizations_url': 'https://api.github.com/users/bddppq/orgs', 'repos_url': 'https://api.github.com/users/bddppq/repos', 'events_url': 'https://api.github.com/users/bddppq/events{/privacy}', 'received_events_url': 'https://api.github.com/users/bddppq/received_events', 'type': 'User', 'site_admin': False}",referenced,93090527a7ae5cb7863f078b70ca99983a1a0f0d,https://api.github.com/repos/pytorch/pytorch/commits/93090527a7ae5cb7863f078b70ca99983a1a0f0d,2018-10-15T21:12:41Z,6,3,3
414,1905229629,"{'login': 'bddppq', 'id': 9300575, 'node_id': 'MDQ6VXNlcjkzMDA1NzU=', 'avatar_url': 'https://avatars2.githubusercontent.com/u/9300575?v=4', 'gravatar_id': '', 'url': 'https://api.github.com/users/bddppq', 'html_url': 'https://github.com/bddppq', 'followers_url': 'https://api.github.com/users/bddppq/followers', 'following_url': 'https://api.github.com/users/bddppq/following{/other_user}', 'gists_url': 'https://api.github.com/users/bddppq/gists{/gist_id}', 'starred_url': 'https://api.github.com/users/bddppq/starred{/owner}{/repo}', 'subscriptions_url': 'https://api.github.com/users/bddppq/subscriptions', 'organizations_url': 'https://api.github.com/users/bddppq/orgs', 'repos_url': 'https://api.github.com/users/bddppq/repos', 'events_url': 'https://api.github.com/users/bddppq/events{/privacy}', 'received_events_url': 'https://api.github.com/users/bddppq/received_events', 'type': 'User', 'site_admin': False}",referenced,44c8bdff5fcf54a71324e7d6170422ed7a38e7a2,https://api.github.com/repos/pytorch/pytorch/commits/44c8bdff5fcf54a71324e7d6170422ed7a38e7a2,2018-10-15T21:12:41Z,2,1,1
411,921808540,"{'login': 'soumith', 'id': 1310570, 'node_id': 'MDQ6VXNlcjEzMTA1NzA=', 'avatar_url': 'https://avatars0.githubusercontent.com/u/1310570?v=4', 'gravatar_id': '', 'url': 'https://api.github.com/users/soumith', 'html_url': 'https://github.com/soumith', 'followers_url': 'https://api.github.com/users/soumith/followers', 'following_url': 'https://api.github.com/users/soumith/following{/other_user}', 'gists_url': 'https://api.github.com/users/soumith/gists{/gist_id}', 'starred_url': 'https://api.github.com/users/soumith/starred{/owner}{/repo}', 'subscriptions_url': 'https://api.github.com/users/soumith/subscriptions', 'organizations_url': 'https://api.github.com/users/soumith/orgs', 'repos_url': 'https://api.github.com/users/soumith/repos', 'events_url': 'https://api.github.com/users/soumith/events{/privacy}', 'received_events_url': 'https://api.github.com/users/soumith/received_events', 'type': 'User', 'site_admin': False}",referenced,8c14630e35675d1c55d893bf5e49234061235adb,https://api.github.com/repos/pytorch/pytorch/commits/8c14630e35675d1c55d893bf5e49234061235adb,2017-01-13T05:51:20Z,8,7,1
411,1905229696,"{'login': 'bddppq', 'id': 9300575, 'node_id': 'MDQ6VXNlcjkzMDA1NzU=', 'avatar_url': 'https://avatars2.githubusercontent.com/u/9300575?v=4', 'gravatar_id': '', 'url': 'https://api.github.com/users/bddppq', 'html_url': 'https://github.com/bddppq', 'followers_url': 'https://api.github.com/users/bddppq/followers', 'following_url': 'https://api.github.com/users/bddppq/following{/other_user}', 'gists_url': 'https://api.github.com/users/bddppq/gists{/gist_id}', 'starred_url': 'https://api.github.com/users/bddppq/starred{/owner}{/repo}', 'subscriptions_url': 'https://api.github.com/users/bddppq/subscriptions', 'organizations_url': 'https://api.github.com/users/bddppq/orgs', 'repos_url': 'https://api.github.com/users/bddppq/repos', 'events_url': 'https://api.github.com/users/bddppq/events{/privacy}', 'received_events_url': 'https://api.github.com/users/bddppq/received_events', 'type': 'User', 'site_admin': False}",referenced,93d8fd4a6d8d634831e0fc49bb3f19aa0a705d60,https://api.github.com/repos/pytorch/pytorch/commits/93d8fd4a6d8d634831e0fc49bb3f19aa0a705d60,2018-10-15T21:12:43Z,30,28,2
410,1905229624,"{'login': 'bddppq', 'id': 9300575, 'node_id': 'MDQ6VXNlcjkzMDA1NzU=', 'avatar_url': 'https://avatars2.githubusercontent.com/u/9300575?v=4', 'gravatar_id': '', 'url': 'https://api.github.com/users/bddppq', 'html_url': 'https://github.com/bddppq', 'followers_url': 'https://api.github.com/users/bddppq/followers', 'following_url': 'https://api.github.com/users/bddppq/following{/other_user}', 'gists_url': 'https://api.github.com/users/bddppq/gists{/gist_id}', 'starred_url': 'https://api.github.com/users/bddppq/starred{/owner}{/repo}', 'subscriptions_url': 'https://api.github.com/users/bddppq/subscriptions', 'organizations_url': 'https://api.github.com/users/bddppq/orgs', 'repos_url': 'https://api.github.com/users/bddppq/repos', 'events_url': 'https://api.github.com/users/bddppq/events{/privacy}', 'received_events_url': 'https://api.github.com/users/bddppq/received_events', 'type': 'User', 'site_admin': False}",referenced,6792c49bfa0f146eff729e46dbab62dbe576dac9,https://api.github.com/repos/pytorch/pytorch/commits/6792c49bfa0f146eff729e46dbab62dbe576dac9,2018-10-15T21:12:41Z,37,32,5
409,1905229620,"{'login': 'bddppq', 'id': 9300575, 'node_id': 'MDQ6VXNlcjkzMDA1NzU=', 'avatar_url': 'https://avatars2.githubusercontent.com/u/9300575?v=4', 'gravatar_id': '', 'url': 'https://api.github.com/users/bddppq', 'html_url': 'https://github.com/bddppq', 'followers_url': 'https://api.github.com/users/bddppq/followers', 'following_url': 'https://api.github.com/users/bddppq/following{/other_user}', 'gists_url': 'https://api.github.com/users/bddppq/gists{/gist_id}', 'starred_url': 'https://api.github.com/users/bddppq/starred{/owner}{/repo}', 'subscriptions_url': 'https://api.github.com/users/bddppq/subscriptions', 'organizations_url': 'https://api.github.com/users/bddppq/orgs', 'repos_url': 'https://api.github.com/users/bddppq/repos', 'events_url': 'https://api.github.com/users/bddppq/events{/privacy}', 'received_events_url': 'https://api.github.com/users/bddppq/received_events', 'type': 'User', 'site_admin': False}",referenced,6792c49bfa0f146eff729e46dbab62dbe576dac9,https://api.github.com/repos/pytorch/pytorch/commits/6792c49bfa0f146eff729e46dbab62dbe576dac9,2018-10-15T21:12:41Z,37,32,5
403,1905229608,"{'login': 'bddppq', 'id': 9300575, 'node_id': 'MDQ6VXNlcjkzMDA1NzU=', 'avatar_url': 'https://avatars2.githubusercontent.com/u/9300575?v=4', 'gravatar_id': '', 'url': 'https://api.github.com/users/bddppq', 'html_url': 'https://github.com/bddppq', 'followers_url': 'https://api.github.com/users/bddppq/followers', 'following_url': 'https://api.github.com/users/bddppq/following{/other_user}', 'gists_url': 'https://api.github.com/users/bddppq/gists{/gist_id}', 'starred_url': 'https://api.github.com/users/bddppq/starred{/owner}{/repo}', 'subscriptions_url': 'https://api.github.com/users/bddppq/subscriptions', 'organizations_url': 'https://api.github.com/users/bddppq/orgs', 'repos_url': 'https://api.github.com/users/bddppq/repos', 'events_url': 'https://api.github.com/users/bddppq/events{/privacy}', 'received_events_url': 'https://api.github.com/users/bddppq/received_events', 'type': 'User', 'site_admin': False}",referenced,b631bdbf9fe4246318b3db36fe262960f8c12e8e,https://api.github.com/repos/pytorch/pytorch/commits/b631bdbf9fe4246318b3db36fe262960f8c12e8e,2018-10-15T21:12:41Z,4,4,0
399,1905229599,"{'login': 'bddppq', 'id': 9300575, 'node_id': 'MDQ6VXNlcjkzMDA1NzU=', 'avatar_url': 'https://avatars2.githubusercontent.com/u/9300575?v=4', 'gravatar_id': '', 'url': 'https://api.github.com/users/bddppq', 'html_url': 'https://github.com/bddppq', 'followers_url': 'https://api.github.com/users/bddppq/followers', 'following_url': 'https://api.github.com/users/bddppq/following{/other_user}', 'gists_url': 'https://api.github.com/users/bddppq/gists{/gist_id}', 'starred_url': 'https://api.github.com/users/bddppq/starred{/owner}{/repo}', 'subscriptions_url': 'https://api.github.com/users/bddppq/subscriptions', 'organizations_url': 'https://api.github.com/users/bddppq/orgs', 'repos_url': 'https://api.github.com/users/bddppq/repos', 'events_url': 'https://api.github.com/users/bddppq/events{/privacy}', 'received_events_url': 'https://api.github.com/users/bddppq/received_events', 'type': 'User', 'site_admin': False}",referenced,e5b729d6fb656aae871f46920714a480607362aa,https://api.github.com/repos/pytorch/pytorch/commits/e5b729d6fb656aae871f46920714a480607362aa,2018-10-15T21:12:41Z,21,15,6
384,1905229595,"{'login': 'bddppq', 'id': 9300575, 'node_id': 'MDQ6VXNlcjkzMDA1NzU=', 'avatar_url': 'https://avatars2.githubusercontent.com/u/9300575?v=4', 'gravatar_id': '', 'url': 'https://api.github.com/users/bddppq', 'html_url': 'https://github.com/bddppq', 'followers_url': 'https://api.github.com/users/bddppq/followers', 'following_url': 'https://api.github.com/users/bddppq/following{/other_user}', 'gists_url': 'https://api.github.com/users/bddppq/gists{/gist_id}', 'starred_url': 'https://api.github.com/users/bddppq/starred{/owner}{/repo}', 'subscriptions_url': 'https://api.github.com/users/bddppq/subscriptions', 'organizations_url': 'https://api.github.com/users/bddppq/orgs', 'repos_url': 'https://api.github.com/users/bddppq/repos', 'events_url': 'https://api.github.com/users/bddppq/events{/privacy}', 'received_events_url': 'https://api.github.com/users/bddppq/received_events', 'type': 'User', 'site_admin': False}",referenced,f0f327f9817a7219d6e2e1c562187dd228b41b03,https://api.github.com/repos/pytorch/pytorch/commits/f0f327f9817a7219d6e2e1c562187dd228b41b03,2018-10-15T21:12:41Z,13,0,13
381,1905229636,"{'login': 'bddppq', 'id': 9300575, 'node_id': 'MDQ6VXNlcjkzMDA1NzU=', 'avatar_url': 'https://avatars2.githubusercontent.com/u/9300575?v=4', 'gravatar_id': '', 'url': 'https://api.github.com/users/bddppq', 'html_url': 'https://github.com/bddppq', 'followers_url': 'https://api.github.com/users/bddppq/followers', 'following_url': 'https://api.github.com/users/bddppq/following{/other_user}', 'gists_url': 'https://api.github.com/users/bddppq/gists{/gist_id}', 'starred_url': 'https://api.github.com/users/bddppq/starred{/owner}{/repo}', 'subscriptions_url': 'https://api.github.com/users/bddppq/subscriptions', 'organizations_url': 'https://api.github.com/users/bddppq/orgs', 'repos_url': 'https://api.github.com/users/bddppq/repos', 'events_url': 'https://api.github.com/users/bddppq/events{/privacy}', 'received_events_url': 'https://api.github.com/users/bddppq/received_events', 'type': 'User', 'site_admin': False}",referenced,9df6b68d59082436629f2664494cfd1afd282c0a,https://api.github.com/repos/pytorch/pytorch/commits/9df6b68d59082436629f2664494cfd1afd282c0a,2018-10-15T21:12:41Z,38,22,16
336,1905229500,"{'login': 'bddppq', 'id': 9300575, 'node_id': 'MDQ6VXNlcjkzMDA1NzU=', 'avatar_url': 'https://avatars2.githubusercontent.com/u/9300575?v=4', 'gravatar_id': '', 'url': 'https://api.github.com/users/bddppq', 'html_url': 'https://github.com/bddppq', 'followers_url': 'https://api.github.com/users/bddppq/followers', 'following_url': 'https://api.github.com/users/bddppq/following{/other_user}', 'gists_url': 'https://api.github.com/users/bddppq/gists{/gist_id}', 'starred_url': 'https://api.github.com/users/bddppq/starred{/owner}{/repo}', 'subscriptions_url': 'https://api.github.com/users/bddppq/subscriptions', 'organizations_url': 'https://api.github.com/users/bddppq/orgs', 'repos_url': 'https://api.github.com/users/bddppq/repos', 'events_url': 'https://api.github.com/users/bddppq/events{/privacy}', 'received_events_url': 'https://api.github.com/users/bddppq/received_events', 'type': 'User', 'site_admin': False}",referenced,bafe24fc76ce780d16adad5eaa35844ed59064a7,https://api.github.com/repos/pytorch/pytorch/commits/bafe24fc76ce780d16adad5eaa35844ed59064a7,2018-10-15T21:12:39Z,10,5,5
335,1905229498,"{'login': 'bddppq', 'id': 9300575, 'node_id': 'MDQ6VXNlcjkzMDA1NzU=', 'avatar_url': 'https://avatars2.githubusercontent.com/u/9300575?v=4', 'gravatar_id': '', 'url': 'https://api.github.com/users/bddppq', 'html_url': 'https://github.com/bddppq', 'followers_url': 'https://api.github.com/users/bddppq/followers', 'following_url': 'https://api.github.com/users/bddppq/following{/other_user}', 'gists_url': 'https://api.github.com/users/bddppq/gists{/gist_id}', 'starred_url': 'https://api.github.com/users/bddppq/starred{/owner}{/repo}', 'subscriptions_url': 'https://api.github.com/users/bddppq/subscriptions', 'organizations_url': 'https://api.github.com/users/bddppq/orgs', 'repos_url': 'https://api.github.com/users/bddppq/repos', 'events_url': 'https://api.github.com/users/bddppq/events{/privacy}', 'received_events_url': 'https://api.github.com/users/bddppq/received_events', 'type': 'User', 'site_admin': False}",referenced,21c59ad794c290061ac078e16c15ec2c5dde0c8e,https://api.github.com/repos/pytorch/pytorch/commits/21c59ad794c290061ac078e16c15ec2c5dde0c8e,2018-10-15T21:12:39Z,18,17,1
330,1905229480,"{'login': 'bddppq', 'id': 9300575, 'node_id': 'MDQ6VXNlcjkzMDA1NzU=', 'avatar_url': 'https://avatars2.githubusercontent.com/u/9300575?v=4', 'gravatar_id': '', 'url': 'https://api.github.com/users/bddppq', 'html_url': 'https://github.com/bddppq', 'followers_url': 'https://api.github.com/users/bddppq/followers', 'following_url': 'https://api.github.com/users/bddppq/following{/other_user}', 'gists_url': 'https://api.github.com/users/bddppq/gists{/gist_id}', 'starred_url': 'https://api.github.com/users/bddppq/starred{/owner}{/repo}', 'subscriptions_url': 'https://api.github.com/users/bddppq/subscriptions', 'organizations_url': 'https://api.github.com/users/bddppq/orgs', 'repos_url': 'https://api.github.com/users/bddppq/repos', 'events_url': 'https://api.github.com/users/bddppq/events{/privacy}', 'received_events_url': 'https://api.github.com/users/bddppq/received_events', 'type': 'User', 'site_admin': False}",referenced,ace128f4ed86e49cfa9f5a6686be0e2aa26a1963,https://api.github.com/repos/pytorch/pytorch/commits/ace128f4ed86e49cfa9f5a6686be0e2aa26a1963,2018-10-15T21:12:39Z,42,28,14
327,1905229472,"{'login': 'bddppq', 'id': 9300575, 'node_id': 'MDQ6VXNlcjkzMDA1NzU=', 'avatar_url': 'https://avatars2.githubusercontent.com/u/9300575?v=4', 'gravatar_id': '', 'url': 'https://api.github.com/users/bddppq', 'html_url': 'https://github.com/bddppq', 'followers_url': 'https://api.github.com/users/bddppq/followers', 'following_url': 'https://api.github.com/users/bddppq/following{/other_user}', 'gists_url': 'https://api.github.com/users/bddppq/gists{/gist_id}', 'starred_url': 'https://api.github.com/users/bddppq/starred{/owner}{/repo}', 'subscriptions_url': 'https://api.github.com/users/bddppq/subscriptions', 'organizations_url': 'https://api.github.com/users/bddppq/orgs', 'repos_url': 'https://api.github.com/users/bddppq/repos', 'events_url': 'https://api.github.com/users/bddppq/events{/privacy}', 'received_events_url': 'https://api.github.com/users/bddppq/received_events', 'type': 'User', 'site_admin': False}",referenced,948d58ecfdda53b8b065749624cee8ca65d2c527,https://api.github.com/repos/pytorch/pytorch/commits/948d58ecfdda53b8b065749624cee8ca65d2c527,2018-10-15T21:12:39Z,6,4,2
326,1905229463,"{'login': 'bddppq', 'id': 9300575, 'node_id': 'MDQ6VXNlcjkzMDA1NzU=', 'avatar_url': 'https://avatars2.githubusercontent.com/u/9300575?v=4', 'gravatar_id': '', 'url': 'https://api.github.com/users/bddppq', 'html_url': 'https://github.com/bddppq', 'followers_url': 'https://api.github.com/users/bddppq/followers', 'following_url': 'https://api.github.com/users/bddppq/following{/other_user}', 'gists_url': 'https://api.github.com/users/bddppq/gists{/gist_id}', 'starred_url': 'https://api.github.com/users/bddppq/starred{/owner}{/repo}', 'subscriptions_url': 'https://api.github.com/users/bddppq/subscriptions', 'organizations_url': 'https://api.github.com/users/bddppq/orgs', 'repos_url': 'https://api.github.com/users/bddppq/repos', 'events_url': 'https://api.github.com/users/bddppq/events{/privacy}', 'received_events_url': 'https://api.github.com/users/bddppq/received_events', 'type': 'User', 'site_admin': False}",referenced,e640879266e199f800c9819705e1b184e8c7ab6b,https://api.github.com/repos/pytorch/pytorch/commits/e640879266e199f800c9819705e1b184e8c7ab6b,2018-10-15T21:12:39Z,18,9,9
324,1905229462,"{'login': 'bddppq', 'id': 9300575, 'node_id': 'MDQ6VXNlcjkzMDA1NzU=', 'avatar_url': 'https://avatars2.githubusercontent.com/u/9300575?v=4', 'gravatar_id': '', 'url': 'https://api.github.com/users/bddppq', 'html_url': 'https://github.com/bddppq', 'followers_url': 'https://api.github.com/users/bddppq/followers', 'following_url': 'https://api.github.com/users/bddppq/following{/other_user}', 'gists_url': 'https://api.github.com/users/bddppq/gists{/gist_id}', 'starred_url': 'https://api.github.com/users/bddppq/starred{/owner}{/repo}', 'subscriptions_url': 'https://api.github.com/users/bddppq/subscriptions', 'organizations_url': 'https://api.github.com/users/bddppq/orgs', 'repos_url': 'https://api.github.com/users/bddppq/repos', 'events_url': 'https://api.github.com/users/bddppq/events{/privacy}', 'received_events_url': 'https://api.github.com/users/bddppq/received_events', 'type': 'User', 'site_admin': False}",referenced,8d683544ed55ca662fbf5d99016cf248cfc32a5f,https://api.github.com/repos/pytorch/pytorch/commits/8d683544ed55ca662fbf5d99016cf248cfc32a5f,2018-10-15T21:12:39Z,8,4,4
320,1905229455,"{'login': 'bddppq', 'id': 9300575, 'node_id': 'MDQ6VXNlcjkzMDA1NzU=', 'avatar_url': 'https://avatars2.githubusercontent.com/u/9300575?v=4', 'gravatar_id': '', 'url': 'https://api.github.com/users/bddppq', 'html_url': 'https://github.com/bddppq', 'followers_url': 'https://api.github.com/users/bddppq/followers', 'following_url': 'https://api.github.com/users/bddppq/following{/other_user}', 'gists_url': 'https://api.github.com/users/bddppq/gists{/gist_id}', 'starred_url': 'https://api.github.com/users/bddppq/starred{/owner}{/repo}', 'subscriptions_url': 'https://api.github.com/users/bddppq/subscriptions', 'organizations_url': 'https://api.github.com/users/bddppq/orgs', 'repos_url': 'https://api.github.com/users/bddppq/repos', 'events_url': 'https://api.github.com/users/bddppq/events{/privacy}', 'received_events_url': 'https://api.github.com/users/bddppq/received_events', 'type': 'User', 'site_admin': False}",referenced,a8bd1facd321ea52f0a6f88600138606711b7a96,https://api.github.com/repos/pytorch/pytorch/commits/a8bd1facd321ea52f0a6f88600138606711b7a96,2018-10-15T21:12:39Z,2,2,0
318,1905229442,"{'login': 'bddppq', 'id': 9300575, 'node_id': 'MDQ6VXNlcjkzMDA1NzU=', 'avatar_url': 'https://avatars2.githubusercontent.com/u/9300575?v=4', 'gravatar_id': '', 'url': 'https://api.github.com/users/bddppq', 'html_url': 'https://github.com/bddppq', 'followers_url': 'https://api.github.com/users/bddppq/followers', 'following_url': 'https://api.github.com/users/bddppq/following{/other_user}', 'gists_url': 'https://api.github.com/users/bddppq/gists{/gist_id}', 'starred_url': 'https://api.github.com/users/bddppq/starred{/owner}{/repo}', 'subscriptions_url': 'https://api.github.com/users/bddppq/subscriptions', 'organizations_url': 'https://api.github.com/users/bddppq/orgs', 'repos_url': 'https://api.github.com/users/bddppq/repos', 'events_url': 'https://api.github.com/users/bddppq/events{/privacy}', 'received_events_url': 'https://api.github.com/users/bddppq/received_events', 'type': 'User', 'site_admin': False}",referenced,f614b9350b345863b8bc900d55b057b394a43c9d,https://api.github.com/repos/pytorch/pytorch/commits/f614b9350b345863b8bc900d55b057b394a43c9d,2018-10-15T21:12:38Z,18,9,9
315,1905229452,"{'login': 'bddppq', 'id': 9300575, 'node_id': 'MDQ6VXNlcjkzMDA1NzU=', 'avatar_url': 'https://avatars2.githubusercontent.com/u/9300575?v=4', 'gravatar_id': '', 'url': 'https://api.github.com/users/bddppq', 'html_url': 'https://github.com/bddppq', 'followers_url': 'https://api.github.com/users/bddppq/followers', 'following_url': 'https://api.github.com/users/bddppq/following{/other_user}', 'gists_url': 'https://api.github.com/users/bddppq/gists{/gist_id}', 'starred_url': 'https://api.github.com/users/bddppq/starred{/owner}{/repo}', 'subscriptions_url': 'https://api.github.com/users/bddppq/subscriptions', 'organizations_url': 'https://api.github.com/users/bddppq/orgs', 'repos_url': 'https://api.github.com/users/bddppq/repos', 'events_url': 'https://api.github.com/users/bddppq/events{/privacy}', 'received_events_url': 'https://api.github.com/users/bddppq/received_events', 'type': 'User', 'site_admin': False}",referenced,185078e21cbf7987af595b01f8da6d531c71ca87,https://api.github.com/repos/pytorch/pytorch/commits/185078e21cbf7987af595b01f8da6d531c71ca87,2018-10-15T21:12:38Z,5,3,2
315,1936146464,"{'login': 'facebook-github-bot', 'id': 6422482, 'node_id': 'MDQ6VXNlcjY0MjI0ODI=', 'avatar_url': 'https://avatars3.githubusercontent.com/u/6422482?v=4', 'gravatar_id': '', 'url': 'https://api.github.com/users/facebook-github-bot', 'html_url': 'https://github.com/facebook-github-bot', 'followers_url': 'https://api.github.com/users/facebook-github-bot/followers', 'following_url': 'https://api.github.com/users/facebook-github-bot/following{/other_user}', 'gists_url': 'https://api.github.com/users/facebook-github-bot/gists{/gist_id}', 'starred_url': 'https://api.github.com/users/facebook-github-bot/starred{/owner}{/repo}', 'subscriptions_url': 'https://api.github.com/users/facebook-github-bot/subscriptions', 'organizations_url': 'https://api.github.com/users/facebook-github-bot/orgs', 'repos_url': 'https://api.github.com/users/facebook-github-bot/repos', 'events_url': 'https://api.github.com/users/facebook-github-bot/events{/privacy}', 'received_events_url': 'https://api.github.com/users/facebook-github-bot/received_events', 'type': 'User', 'site_admin': False}",closed,3cb2470bb33305921b92ae4417d1364a5177a44e,https://api.github.com/repos/pytorch/pytorch/commits/3cb2470bb33305921b92ae4417d1364a5177a44e,2018-10-30T19:57:59Z,19,19,0
311,898669317,"{'login': 'apaszke', 'id': 4583066, 'node_id': 'MDQ6VXNlcjQ1ODMwNjY=', 'avatar_url': 'https://avatars3.githubusercontent.com/u/4583066?v=4', 'gravatar_id': '', 'url': 'https://api.github.com/users/apaszke', 'html_url': 'https://github.com/apaszke', 'followers_url': 'https://api.github.com/users/apaszke/followers', 'following_url': 'https://api.github.com/users/apaszke/following{/other_user}', 'gists_url': 'https://api.github.com/users/apaszke/gists{/gist_id}', 'starred_url': 'https://api.github.com/users/apaszke/starred{/owner}{/repo}', 'subscriptions_url': 'https://api.github.com/users/apaszke/subscriptions', 'organizations_url': 'https://api.github.com/users/apaszke/orgs', 'repos_url': 'https://api.github.com/users/apaszke/repos', 'events_url': 'https://api.github.com/users/apaszke/events{/privacy}', 'received_events_url': 'https://api.github.com/users/apaszke/received_events', 'type': 'User', 'site_admin': False}",referenced,20fffc8bb7fecdd218057745c7076075df2ab034,https://api.github.com/repos/pytorch/pytorch/commits/20fffc8bb7fecdd218057745c7076075df2ab034,2016-12-19T14:27:48Z,16,12,4
311,1905229434,"{'login': 'bddppq', 'id': 9300575, 'node_id': 'MDQ6VXNlcjkzMDA1NzU=', 'avatar_url': 'https://avatars2.githubusercontent.com/u/9300575?v=4', 'gravatar_id': '', 'url': 'https://api.github.com/users/bddppq', 'html_url': 'https://github.com/bddppq', 'followers_url': 'https://api.github.com/users/bddppq/followers', 'following_url': 'https://api.github.com/users/bddppq/following{/other_user}', 'gists_url': 'https://api.github.com/users/bddppq/gists{/gist_id}', 'starred_url': 'https://api.github.com/users/bddppq/starred{/owner}{/repo}', 'subscriptions_url': 'https://api.github.com/users/bddppq/subscriptions', 'organizations_url': 'https://api.github.com/users/bddppq/orgs', 'repos_url': 'https://api.github.com/users/bddppq/repos', 'events_url': 'https://api.github.com/users/bddppq/events{/privacy}', 'received_events_url': 'https://api.github.com/users/bddppq/received_events', 'type': 'User', 'site_admin': False}",referenced,1c97d06dde742671a734fee6c2b5cf5893fc21ae,https://api.github.com/repos/pytorch/pytorch/commits/1c97d06dde742671a734fee6c2b5cf5893fc21ae,2018-10-15T21:12:38Z,8,4,4
309,1905229427,"{'login': 'bddppq', 'id': 9300575, 'node_id': 'MDQ6VXNlcjkzMDA1NzU=', 'avatar_url': 'https://avatars2.githubusercontent.com/u/9300575?v=4', 'gravatar_id': '', 'url': 'https://api.github.com/users/bddppq', 'html_url': 'https://github.com/bddppq', 'followers_url': 'https://api.github.com/users/bddppq/followers', 'following_url': 'https://api.github.com/users/bddppq/following{/other_user}', 'gists_url': 'https://api.github.com/users/bddppq/gists{/gist_id}', 'starred_url': 'https://api.github.com/users/bddppq/starred{/owner}{/repo}', 'subscriptions_url': 'https://api.github.com/users/bddppq/subscriptions', 'organizations_url': 'https://api.github.com/users/bddppq/orgs', 'repos_url': 'https://api.github.com/users/bddppq/repos', 'events_url': 'https://api.github.com/users/bddppq/events{/privacy}', 'received_events_url': 'https://api.github.com/users/bddppq/received_events', 'type': 'User', 'site_admin': False}",referenced,b829dbe307f83ccf40ba294fe3fff387014e26ce,https://api.github.com/repos/pytorch/pytorch/commits/b829dbe307f83ccf40ba294fe3fff387014e26ce,2018-10-15T21:12:38Z,102,32,70
309,2117984565,"{'login': 'facebook-github-bot', 'id': 6422482, 'node_id': 'MDQ6VXNlcjY0MjI0ODI=', 'avatar_url': 'https://avatars3.githubusercontent.com/u/6422482?v=4', 'gravatar_id': '', 'url': 'https://api.github.com/users/facebook-github-bot', 'html_url': 'https://github.com/facebook-github-bot', 'followers_url': 'https://api.github.com/users/facebook-github-bot/followers', 'following_url': 'https://api.github.com/users/facebook-github-bot/following{/other_user}', 'gists_url': 'https://api.github.com/users/facebook-github-bot/gists{/gist_id}', 'starred_url': 'https://api.github.com/users/facebook-github-bot/starred{/owner}{/repo}', 'subscriptions_url': 'https://api.github.com/users/facebook-github-bot/subscriptions', 'organizations_url': 'https://api.github.com/users/facebook-github-bot/orgs', 'repos_url': 'https://api.github.com/users/facebook-github-bot/repos', 'events_url': 'https://api.github.com/users/facebook-github-bot/events{/privacy}', 'received_events_url': 'https://api.github.com/users/facebook-github-bot/received_events', 'type': 'User', 'site_admin': False}",referenced,29827e19711ce5a73adcd54f4b0ec694d0b21e79,https://api.github.com/repos/pytorch/pytorch/commits/29827e19711ce5a73adcd54f4b0ec694d0b21e79,2019-02-05T09:56:34Z,4,4,0
307,1905229441,"{'login': 'bddppq', 'id': 9300575, 'node_id': 'MDQ6VXNlcjkzMDA1NzU=', 'avatar_url': 'https://avatars2.githubusercontent.com/u/9300575?v=4', 'gravatar_id': '', 'url': 'https://api.github.com/users/bddppq', 'html_url': 'https://github.com/bddppq', 'followers_url': 'https://api.github.com/users/bddppq/followers', 'following_url': 'https://api.github.com/users/bddppq/following{/other_user}', 'gists_url': 'https://api.github.com/users/bddppq/gists{/gist_id}', 'starred_url': 'https://api.github.com/users/bddppq/starred{/owner}{/repo}', 'subscriptions_url': 'https://api.github.com/users/bddppq/subscriptions', 'organizations_url': 'https://api.github.com/users/bddppq/orgs', 'repos_url': 'https://api.github.com/users/bddppq/repos', 'events_url': 'https://api.github.com/users/bddppq/events{/privacy}', 'received_events_url': 'https://api.github.com/users/bddppq/received_events', 'type': 'User', 'site_admin': False}",referenced,bdfee1c0ded056ca7b071a8b85b683027a3b0253,https://api.github.com/repos/pytorch/pytorch/commits/bdfee1c0ded056ca7b071a8b85b683027a3b0253,2018-10-15T21:12:38Z,3,3,0
302,1905229419,"{'login': 'bddppq', 'id': 9300575, 'node_id': 'MDQ6VXNlcjkzMDA1NzU=', 'avatar_url': 'https://avatars2.githubusercontent.com/u/9300575?v=4', 'gravatar_id': '', 'url': 'https://api.github.com/users/bddppq', 'html_url': 'https://github.com/bddppq', 'followers_url': 'https://api.github.com/users/bddppq/followers', 'following_url': 'https://api.github.com/users/bddppq/following{/other_user}', 'gists_url': 'https://api.github.com/users/bddppq/gists{/gist_id}', 'starred_url': 'https://api.github.com/users/bddppq/starred{/owner}{/repo}', 'subscriptions_url': 'https://api.github.com/users/bddppq/subscriptions', 'organizations_url': 'https://api.github.com/users/bddppq/orgs', 'repos_url': 'https://api.github.com/users/bddppq/repos', 'events_url': 'https://api.github.com/users/bddppq/events{/privacy}', 'received_events_url': 'https://api.github.com/users/bddppq/received_events', 'type': 'User', 'site_admin': False}",referenced,77599cc7c6ca12339c33541b2efd172638bce7f5,https://api.github.com/repos/pytorch/pytorch/commits/77599cc7c6ca12339c33541b2efd172638bce7f5,2018-10-15T21:12:38Z,5473,0,5473
301,1905229421,"{'login': 'bddppq', 'id': 9300575, 'node_id': 'MDQ6VXNlcjkzMDA1NzU=', 'avatar_url': 'https://avatars2.githubusercontent.com/u/9300575?v=4', 'gravatar_id': '', 'url': 'https://api.github.com/users/bddppq', 'html_url': 'https://github.com/bddppq', 'followers_url': 'https://api.github.com/users/bddppq/followers', 'following_url': 'https://api.github.com/users/bddppq/following{/other_user}', 'gists_url': 'https://api.github.com/users/bddppq/gists{/gist_id}', 'starred_url': 'https://api.github.com/users/bddppq/starred{/owner}{/repo}', 'subscriptions_url': 'https://api.github.com/users/bddppq/subscriptions', 'organizations_url': 'https://api.github.com/users/bddppq/orgs', 'repos_url': 'https://api.github.com/users/bddppq/repos', 'events_url': 'https://api.github.com/users/bddppq/events{/privacy}', 'received_events_url': 'https://api.github.com/users/bddppq/received_events', 'type': 'User', 'site_admin': False}",referenced,29da88f0c7dbb43e4a3996f94f3bcd325b50a652,https://api.github.com/repos/pytorch/pytorch/commits/29da88f0c7dbb43e4a3996f94f3bcd325b50a652,2018-10-15T21:12:38Z,8,4,4
300,3129098701,"{'login': 'ZolotukhinM', 'id': 4588111, 'node_id': 'MDQ6VXNlcjQ1ODgxMTE=', 'avatar_url': 'https://avatars1.githubusercontent.com/u/4588111?v=4', 'gravatar_id': '', 'url': 'https://api.github.com/users/ZolotukhinM', 'html_url': 'https://github.com/ZolotukhinM', 'followers_url': 'https://api.github.com/users/ZolotukhinM/followers', 'following_url': 'https://api.github.com/users/ZolotukhinM/following{/other_user}', 'gists_url': 'https://api.github.com/users/ZolotukhinM/gists{/gist_id}', 'starred_url': 'https://api.github.com/users/ZolotukhinM/starred{/owner}{/repo}', 'subscriptions_url': 'https://api.github.com/users/ZolotukhinM/subscriptions', 'organizations_url': 'https://api.github.com/users/ZolotukhinM/orgs', 'repos_url': 'https://api.github.com/users/ZolotukhinM/repos', 'events_url': 'https://api.github.com/users/ZolotukhinM/events{/privacy}', 'received_events_url': 'https://api.github.com/users/ZolotukhinM/received_events', 'type': 'User', 'site_admin': False}",referenced,49d63da4c459e8bca32f04e1d305856acbe1b410,https://api.github.com/repos/pytorch/pytorch/commits/49d63da4c459e8bca32f04e1d305856acbe1b410,2020-03-14T08:01:26Z,1316,838,478
300,3129098708,"{'login': 'ZolotukhinM', 'id': 4588111, 'node_id': 'MDQ6VXNlcjQ1ODgxMTE=', 'avatar_url': 'https://avatars1.githubusercontent.com/u/4588111?v=4', 'gravatar_id': '', 'url': 'https://api.github.com/users/ZolotukhinM', 'html_url': 'https://github.com/ZolotukhinM', 'followers_url': 'https://api.github.com/users/ZolotukhinM/followers', 'following_url': 'https://api.github.com/users/ZolotukhinM/following{/other_user}', 'gists_url': 'https://api.github.com/users/ZolotukhinM/gists{/gist_id}', 'starred_url': 'https://api.github.com/users/ZolotukhinM/starred{/owner}{/repo}', 'subscriptions_url': 'https://api.github.com/users/ZolotukhinM/subscriptions', 'organizations_url': 'https://api.github.com/users/ZolotukhinM/orgs', 'repos_url': 'https://api.github.com/users/ZolotukhinM/repos', 'events_url': 'https://api.github.com/users/ZolotukhinM/events{/privacy}', 'received_events_url': 'https://api.github.com/users/ZolotukhinM/received_events', 'type': 'User', 'site_admin': False}",referenced,e75b03d9633f108020743ed2e28aebd5bab96737,https://api.github.com/repos/pytorch/pytorch/commits/e75b03d9633f108020743ed2e28aebd5bab96737,2020-03-14T08:01:26Z,19466,17744,1722
300,3130246301,"{'login': 'ZolotukhinM', 'id': 4588111, 'node_id': 'MDQ6VXNlcjQ1ODgxMTE=', 'avatar_url': 'https://avatars1.githubusercontent.com/u/4588111?v=4', 'gravatar_id': '', 'url': 'https://api.github.com/users/ZolotukhinM', 'html_url': 'https://github.com/ZolotukhinM', 'followers_url': 'https://api.github.com/users/ZolotukhinM/followers', 'following_url': 'https://api.github.com/users/ZolotukhinM/following{/other_user}', 'gists_url': 'https://api.github.com/users/ZolotukhinM/gists{/gist_id}', 'starred_url': 'https://api.github.com/users/ZolotukhinM/starred{/owner}{/repo}', 'subscriptions_url': 'https://api.github.com/users/ZolotukhinM/subscriptions', 'organizations_url': 'https://api.github.com/users/ZolotukhinM/orgs', 'repos_url': 'https://api.github.com/users/ZolotukhinM/repos', 'events_url': 'https://api.github.com/users/ZolotukhinM/events{/privacy}', 'received_events_url': 'https://api.github.com/users/ZolotukhinM/received_events', 'type': 'User', 'site_admin': False}",referenced,ea379c7789b552aefe038c965b987a46ec5ad407,https://api.github.com/repos/pytorch/pytorch/commits/ea379c7789b552aefe038c965b987a46ec5ad407,2020-03-15T08:01:19Z,0,0,0
300,3130246345,"{'login': 'ZolotukhinM', 'id': 4588111, 'node_id': 'MDQ6VXNlcjQ1ODgxMTE=', 'avatar_url': 'https://avatars1.githubusercontent.com/u/4588111?v=4', 'gravatar_id': '', 'url': 'https://api.github.com/users/ZolotukhinM', 'html_url': 'https://github.com/ZolotukhinM', 'followers_url': 'https://api.github.com/users/ZolotukhinM/followers', 'following_url': 'https://api.github.com/users/ZolotukhinM/following{/other_user}', 'gists_url': 'https://api.github.com/users/ZolotukhinM/gists{/gist_id}', 'starred_url': 'https://api.github.com/users/ZolotukhinM/starred{/owner}{/repo}', 'subscriptions_url': 'https://api.github.com/users/ZolotukhinM/subscriptions', 'organizations_url': 'https://api.github.com/users/ZolotukhinM/orgs', 'repos_url': 'https://api.github.com/users/ZolotukhinM/repos', 'events_url': 'https://api.github.com/users/ZolotukhinM/events{/privacy}', 'received_events_url': 'https://api.github.com/users/ZolotukhinM/received_events', 'type': 'User', 'site_admin': False}",referenced,7cb62ea9bf327aebc706e9f1c6aeea5b4862c311,https://api.github.com/repos/pytorch/pytorch/commits/7cb62ea9bf327aebc706e9f1c6aeea5b4862c311,2020-03-15T08:01:24Z,19466,17744,1722
293,1905229408,"{'login': 'bddppq', 'id': 9300575, 'node_id': 'MDQ6VXNlcjkzMDA1NzU=', 'avatar_url': 'https://avatars2.githubusercontent.com/u/9300575?v=4', 'gravatar_id': '', 'url': 'https://api.github.com/users/bddppq', 'html_url': 'https://github.com/bddppq', 'followers_url': 'https://api.github.com/users/bddppq/followers', 'following_url': 'https://api.github.com/users/bddppq/following{/other_user}', 'gists_url': 'https://api.github.com/users/bddppq/gists{/gist_id}', 'starred_url': 'https://api.github.com/users/bddppq/starred{/owner}{/repo}', 'subscriptions_url': 'https://api.github.com/users/bddppq/subscriptions', 'organizations_url': 'https://api.github.com/users/bddppq/orgs', 'repos_url': 'https://api.github.com/users/bddppq/repos', 'events_url': 'https://api.github.com/users/bddppq/events{/privacy}', 'received_events_url': 'https://api.github.com/users/bddppq/received_events', 'type': 'User', 'site_admin': False}",referenced,ffb470874c50f73afa04e0bb45e48b9562f143c2,https://api.github.com/repos/pytorch/pytorch/commits/ffb470874c50f73afa04e0bb45e48b9562f143c2,2018-10-15T21:12:37Z,22,12,10
292,1905229412,"{'login': 'bddppq', 'id': 9300575, 'node_id': 'MDQ6VXNlcjkzMDA1NzU=', 'avatar_url': 'https://avatars2.githubusercontent.com/u/9300575?v=4', 'gravatar_id': '', 'url': 'https://api.github.com/users/bddppq', 'html_url': 'https://github.com/bddppq', 'followers_url': 'https://api.github.com/users/bddppq/followers', 'following_url': 'https://api.github.com/users/bddppq/following{/other_user}', 'gists_url': 'https://api.github.com/users/bddppq/gists{/gist_id}', 'starred_url': 'https://api.github.com/users/bddppq/starred{/owner}{/repo}', 'subscriptions_url': 'https://api.github.com/users/bddppq/subscriptions', 'organizations_url': 'https://api.github.com/users/bddppq/orgs', 'repos_url': 'https://api.github.com/users/bddppq/repos', 'events_url': 'https://api.github.com/users/bddppq/events{/privacy}', 'received_events_url': 'https://api.github.com/users/bddppq/received_events', 'type': 'User', 'site_admin': False}",referenced,83f09b9a74a2308ee74fed8f0b4db293df9eee5a,https://api.github.com/repos/pytorch/pytorch/commits/83f09b9a74a2308ee74fed8f0b4db293df9eee5a,2018-10-15T21:12:38Z,143,70,73
291,1905229404,"{'login': 'bddppq', 'id': 9300575, 'node_id': 'MDQ6VXNlcjkzMDA1NzU=', 'avatar_url': 'https://avatars2.githubusercontent.com/u/9300575?v=4', 'gravatar_id': '', 'url': 'https://api.github.com/users/bddppq', 'html_url': 'https://github.com/bddppq', 'followers_url': 'https://api.github.com/users/bddppq/followers', 'following_url': 'https://api.github.com/users/bddppq/following{/other_user}', 'gists_url': 'https://api.github.com/users/bddppq/gists{/gist_id}', 'starred_url': 'https://api.github.com/users/bddppq/starred{/owner}{/repo}', 'subscriptions_url': 'https://api.github.com/users/bddppq/subscriptions', 'organizations_url': 'https://api.github.com/users/bddppq/orgs', 'repos_url': 'https://api.github.com/users/bddppq/repos', 'events_url': 'https://api.github.com/users/bddppq/events{/privacy}', 'received_events_url': 'https://api.github.com/users/bddppq/received_events', 'type': 'User', 'site_admin': False}",referenced,d1bfcebd9c21a836d88b63ea8715c7a5b137ef32,https://api.github.com/repos/pytorch/pytorch/commits/d1bfcebd9c21a836d88b63ea8715c7a5b137ef32,2018-10-15T21:12:37Z,180,146,34
291,3125746986,"{'login': 'ZolotukhinM', 'id': 4588111, 'node_id': 'MDQ6VXNlcjQ1ODgxMTE=', 'avatar_url': 'https://avatars1.githubusercontent.com/u/4588111?v=4', 'gravatar_id': '', 'url': 'https://api.github.com/users/ZolotukhinM', 'html_url': 'https://github.com/ZolotukhinM', 'followers_url': 'https://api.github.com/users/ZolotukhinM/followers', 'following_url': 'https://api.github.com/users/ZolotukhinM/following{/other_user}', 'gists_url': 'https://api.github.com/users/ZolotukhinM/gists{/gist_id}', 'starred_url': 'https://api.github.com/users/ZolotukhinM/starred{/owner}{/repo}', 'subscriptions_url': 'https://api.github.com/users/ZolotukhinM/subscriptions', 'organizations_url': 'https://api.github.com/users/ZolotukhinM/orgs', 'repos_url': 'https://api.github.com/users/ZolotukhinM/repos', 'events_url': 'https://api.github.com/users/ZolotukhinM/events{/privacy}', 'received_events_url': 'https://api.github.com/users/ZolotukhinM/received_events', 'type': 'User', 'site_admin': False}",referenced,35cf05793cc6b09fd9a54a31d32745cbd722e607,https://api.github.com/repos/pytorch/pytorch/commits/35cf05793cc6b09fd9a54a31d32745cbd722e607,2020-03-13T08:01:32Z,1552,883,669
291,3125746990,"{'login': 'ZolotukhinM', 'id': 4588111, 'node_id': 'MDQ6VXNlcjQ1ODgxMTE=', 'avatar_url': 'https://avatars1.githubusercontent.com/u/4588111?v=4', 'gravatar_id': '', 'url': 'https://api.github.com/users/ZolotukhinM', 'html_url': 'https://github.com/ZolotukhinM', 'followers_url': 'https://api.github.com/users/ZolotukhinM/followers', 'following_url': 'https://api.github.com/users/ZolotukhinM/following{/other_user}', 'gists_url': 'https://api.github.com/users/ZolotukhinM/gists{/gist_id}', 'starred_url': 'https://api.github.com/users/ZolotukhinM/starred{/owner}{/repo}', 'subscriptions_url': 'https://api.github.com/users/ZolotukhinM/subscriptions', 'organizations_url': 'https://api.github.com/users/ZolotukhinM/orgs', 'repos_url': 'https://api.github.com/users/ZolotukhinM/repos', 'events_url': 'https://api.github.com/users/ZolotukhinM/events{/privacy}', 'received_events_url': 'https://api.github.com/users/ZolotukhinM/received_events', 'type': 'User', 'site_admin': False}",referenced,21e4cbd1bbb513ad2ae884076a3d545a0602ec82,https://api.github.com/repos/pytorch/pytorch/commits/21e4cbd1bbb513ad2ae884076a3d545a0602ec82,2020-03-13T08:01:32Z,19016,17339,1677
289,1905229414,"{'login': 'bddppq', 'id': 9300575, 'node_id': 'MDQ6VXNlcjkzMDA1NzU=', 'avatar_url': 'https://avatars2.githubusercontent.com/u/9300575?v=4', 'gravatar_id': '', 'url': 'https://api.github.com/users/bddppq', 'html_url': 'https://github.com/bddppq', 'followers_url': 'https://api.github.com/users/bddppq/followers', 'following_url': 'https://api.github.com/users/bddppq/following{/other_user}', 'gists_url': 'https://api.github.com/users/bddppq/gists{/gist_id}', 'starred_url': 'https://api.github.com/users/bddppq/starred{/owner}{/repo}', 'subscriptions_url': 'https://api.github.com/users/bddppq/subscriptions', 'organizations_url': 'https://api.github.com/users/bddppq/orgs', 'repos_url': 'https://api.github.com/users/bddppq/repos', 'events_url': 'https://api.github.com/users/bddppq/events{/privacy}', 'received_events_url': 'https://api.github.com/users/bddppq/received_events', 'type': 'User', 'site_admin': False}",referenced,57c931d9f03d808c65526c1689d4e0a05da59040,https://api.github.com/repos/pytorch/pytorch/commits/57c931d9f03d808c65526c1689d4e0a05da59040,2018-10-15T21:12:38Z,192,167,25
288,1905229401,"{'login': 'bddppq', 'id': 9300575, 'node_id': 'MDQ6VXNlcjkzMDA1NzU=', 'avatar_url': 'https://avatars2.githubusercontent.com/u/9300575?v=4', 'gravatar_id': '', 'url': 'https://api.github.com/users/bddppq', 'html_url': 'https://github.com/bddppq', 'followers_url': 'https://api.github.com/users/bddppq/followers', 'following_url': 'https://api.github.com/users/bddppq/following{/other_user}', 'gists_url': 'https://api.github.com/users/bddppq/gists{/gist_id}', 'starred_url': 'https://api.github.com/users/bddppq/starred{/owner}{/repo}', 'subscriptions_url': 'https://api.github.com/users/bddppq/subscriptions', 'organizations_url': 'https://api.github.com/users/bddppq/orgs', 'repos_url': 'https://api.github.com/users/bddppq/repos', 'events_url': 'https://api.github.com/users/bddppq/events{/privacy}', 'received_events_url': 'https://api.github.com/users/bddppq/received_events', 'type': 'User', 'site_admin': False}",referenced,af29bb23a33dff642b38c15f09837562a003d25a,https://api.github.com/repos/pytorch/pytorch/commits/af29bb23a33dff642b38c15f09837562a003d25a,2018-10-15T21:12:37Z,37,23,14
280,1905229373,"{'login': 'bddppq', 'id': 9300575, 'node_id': 'MDQ6VXNlcjkzMDA1NzU=', 'avatar_url': 'https://avatars2.githubusercontent.com/u/9300575?v=4', 'gravatar_id': '', 'url': 'https://api.github.com/users/bddppq', 'html_url': 'https://github.com/bddppq', 'followers_url': 'https://api.github.com/users/bddppq/followers', 'following_url': 'https://api.github.com/users/bddppq/following{/other_user}', 'gists_url': 'https://api.github.com/users/bddppq/gists{/gist_id}', 'starred_url': 'https://api.github.com/users/bddppq/starred{/owner}{/repo}', 'subscriptions_url': 'https://api.github.com/users/bddppq/subscriptions', 'organizations_url': 'https://api.github.com/users/bddppq/orgs', 'repos_url': 'https://api.github.com/users/bddppq/repos', 'events_url': 'https://api.github.com/users/bddppq/events{/privacy}', 'received_events_url': 'https://api.github.com/users/bddppq/received_events', 'type': 'User', 'site_admin': False}",referenced,b737281824ade8a42a8495e0f1aa9484d1f9a852,https://api.github.com/repos/pytorch/pytorch/commits/b737281824ade8a42a8495e0f1aa9484d1f9a852,2018-10-15T21:12:37Z,14,14,0
279,3131993266,"{'login': 'ZolotukhinM', 'id': 4588111, 'node_id': 'MDQ6VXNlcjQ1ODgxMTE=', 'avatar_url': 'https://avatars1.githubusercontent.com/u/4588111?v=4', 'gravatar_id': '', 'url': 'https://api.github.com/users/ZolotukhinM', 'html_url': 'https://github.com/ZolotukhinM', 'followers_url': 'https://api.github.com/users/ZolotukhinM/followers', 'following_url': 'https://api.github.com/users/ZolotukhinM/following{/other_user}', 'gists_url': 'https://api.github.com/users/ZolotukhinM/gists{/gist_id}', 'starred_url': 'https://api.github.com/users/ZolotukhinM/starred{/owner}{/repo}', 'subscriptions_url': 'https://api.github.com/users/ZolotukhinM/subscriptions', 'organizations_url': 'https://api.github.com/users/ZolotukhinM/orgs', 'repos_url': 'https://api.github.com/users/ZolotukhinM/repos', 'events_url': 'https://api.github.com/users/ZolotukhinM/events{/privacy}', 'received_events_url': 'https://api.github.com/users/ZolotukhinM/received_events', 'type': 'User', 'site_admin': False}",referenced,ba70aba7313a883e735eb94320e97d00c002095d,https://api.github.com/repos/pytorch/pytorch/commits/ba70aba7313a883e735eb94320e97d00c002095d,2020-03-16T08:01:36Z,2134,1572,562
279,3131993270,"{'login': 'ZolotukhinM', 'id': 4588111, 'node_id': 'MDQ6VXNlcjQ1ODgxMTE=', 'avatar_url': 'https://avatars1.githubusercontent.com/u/4588111?v=4', 'gravatar_id': '', 'url': 'https://api.github.com/users/ZolotukhinM', 'html_url': 'https://github.com/ZolotukhinM', 'followers_url': 'https://api.github.com/users/ZolotukhinM/followers', 'following_url': 'https://api.github.com/users/ZolotukhinM/following{/other_user}', 'gists_url': 'https://api.github.com/users/ZolotukhinM/gists{/gist_id}', 'starred_url': 'https://api.github.com/users/ZolotukhinM/starred{/owner}{/repo}', 'subscriptions_url': 'https://api.github.com/users/ZolotukhinM/subscriptions', 'organizations_url': 'https://api.github.com/users/ZolotukhinM/orgs', 'repos_url': 'https://api.github.com/users/ZolotukhinM/repos', 'events_url': 'https://api.github.com/users/ZolotukhinM/events{/privacy}', 'received_events_url': 'https://api.github.com/users/ZolotukhinM/received_events', 'type': 'User', 'site_admin': False}",referenced,de7585f64ce1d97c059211e91db60960081066cc,https://api.github.com/repos/pytorch/pytorch/commits/de7585f64ce1d97c059211e91db60960081066cc,2020-03-16T08:01:36Z,20504,18768,1736
274,1905229370,"{'login': 'bddppq', 'id': 9300575, 'node_id': 'MDQ6VXNlcjkzMDA1NzU=', 'avatar_url': 'https://avatars2.githubusercontent.com/u/9300575?v=4', 'gravatar_id': '', 'url': 'https://api.github.com/users/bddppq', 'html_url': 'https://github.com/bddppq', 'followers_url': 'https://api.github.com/users/bddppq/followers', 'following_url': 'https://api.github.com/users/bddppq/following{/other_user}', 'gists_url': 'https://api.github.com/users/bddppq/gists{/gist_id}', 'starred_url': 'https://api.github.com/users/bddppq/starred{/owner}{/repo}', 'subscriptions_url': 'https://api.github.com/users/bddppq/subscriptions', 'organizations_url': 'https://api.github.com/users/bddppq/orgs', 'repos_url': 'https://api.github.com/users/bddppq/repos', 'events_url': 'https://api.github.com/users/bddppq/events{/privacy}', 'received_events_url': 'https://api.github.com/users/bddppq/received_events', 'type': 'User', 'site_admin': False}",referenced,33722c88716a920f4323045889e44917103e3313,https://api.github.com/repos/pytorch/pytorch/commits/33722c88716a920f4323045889e44917103e3313,2018-10-15T21:12:37Z,167,83,84
274,3113614663,"{'login': 'ZolotukhinM', 'id': 4588111, 'node_id': 'MDQ6VXNlcjQ1ODgxMTE=', 'avatar_url': 'https://avatars1.githubusercontent.com/u/4588111?v=4', 'gravatar_id': '', 'url': 'https://api.github.com/users/ZolotukhinM', 'html_url': 'https://github.com/ZolotukhinM', 'followers_url': 'https://api.github.com/users/ZolotukhinM/followers', 'following_url': 'https://api.github.com/users/ZolotukhinM/following{/other_user}', 'gists_url': 'https://api.github.com/users/ZolotukhinM/gists{/gist_id}', 'starred_url': 'https://api.github.com/users/ZolotukhinM/starred{/owner}{/repo}', 'subscriptions_url': 'https://api.github.com/users/ZolotukhinM/subscriptions', 'organizations_url': 'https://api.github.com/users/ZolotukhinM/orgs', 'repos_url': 'https://api.github.com/users/ZolotukhinM/repos', 'events_url': 'https://api.github.com/users/ZolotukhinM/events{/privacy}', 'received_events_url': 'https://api.github.com/users/ZolotukhinM/received_events', 'type': 'User', 'site_admin': False}",referenced,c4702e767d7ff3d1914cfe4797b8f5e8b099d02f,https://api.github.com/repos/pytorch/pytorch/commits/c4702e767d7ff3d1914cfe4797b8f5e8b099d02f,2020-03-10T08:01:25Z,744,552,192
274,3113614912,"{'login': 'ZolotukhinM', 'id': 4588111, 'node_id': 'MDQ6VXNlcjQ1ODgxMTE=', 'avatar_url': 'https://avatars1.githubusercontent.com/u/4588111?v=4', 'gravatar_id': '', 'url': 'https://api.github.com/users/ZolotukhinM', 'html_url': 'https://github.com/ZolotukhinM', 'followers_url': 'https://api.github.com/users/ZolotukhinM/followers', 'following_url': 'https://api.github.com/users/ZolotukhinM/following{/other_user}', 'gists_url': 'https://api.github.com/users/ZolotukhinM/gists{/gist_id}', 'starred_url': 'https://api.github.com/users/ZolotukhinM/starred{/owner}{/repo}', 'subscriptions_url': 'https://api.github.com/users/ZolotukhinM/subscriptions', 'organizations_url': 'https://api.github.com/users/ZolotukhinM/orgs', 'repos_url': 'https://api.github.com/users/ZolotukhinM/repos', 'events_url': 'https://api.github.com/users/ZolotukhinM/events{/privacy}', 'received_events_url': 'https://api.github.com/users/ZolotukhinM/received_events', 'type': 'User', 'site_admin': False}",referenced,a4926e17a89ca564d8043441572baeb4746460bb,https://api.github.com/repos/pytorch/pytorch/commits/a4926e17a89ca564d8043441572baeb4746460bb,2020-03-10T08:01:31Z,18074,16441,1633
273,1905229364,"{'login': 'bddppq', 'id': 9300575, 'node_id': 'MDQ6VXNlcjkzMDA1NzU=', 'avatar_url': 'https://avatars2.githubusercontent.com/u/9300575?v=4', 'gravatar_id': '', 'url': 'https://api.github.com/users/bddppq', 'html_url': 'https://github.com/bddppq', 'followers_url': 'https://api.github.com/users/bddppq/followers', 'following_url': 'https://api.github.com/users/bddppq/following{/other_user}', 'gists_url': 'https://api.github.com/users/bddppq/gists{/gist_id}', 'starred_url': 'https://api.github.com/users/bddppq/starred{/owner}{/repo}', 'subscriptions_url': 'https://api.github.com/users/bddppq/subscriptions', 'organizations_url': 'https://api.github.com/users/bddppq/orgs', 'repos_url': 'https://api.github.com/users/bddppq/repos', 'events_url': 'https://api.github.com/users/bddppq/events{/privacy}', 'received_events_url': 'https://api.github.com/users/bddppq/received_events', 'type': 'User', 'site_admin': False}",referenced,746f3c77686a9f840ec30fb03a9717e719d51727,https://api.github.com/repos/pytorch/pytorch/commits/746f3c77686a9f840ec30fb03a9717e719d51727,2018-10-15T21:12:37Z,5,4,1
272,1905229358,"{'login': 'bddppq', 'id': 9300575, 'node_id': 'MDQ6VXNlcjkzMDA1NzU=', 'avatar_url': 'https://avatars2.githubusercontent.com/u/9300575?v=4', 'gravatar_id': '', 'url': 'https://api.github.com/users/bddppq', 'html_url': 'https://github.com/bddppq', 'followers_url': 'https://api.github.com/users/bddppq/followers', 'following_url': 'https://api.github.com/users/bddppq/following{/other_user}', 'gists_url': 'https://api.github.com/users/bddppq/gists{/gist_id}', 'starred_url': 'https://api.github.com/users/bddppq/starred{/owner}{/repo}', 'subscriptions_url': 'https://api.github.com/users/bddppq/subscriptions', 'organizations_url': 'https://api.github.com/users/bddppq/orgs', 'repos_url': 'https://api.github.com/users/bddppq/repos', 'events_url': 'https://api.github.com/users/bddppq/events{/privacy}', 'received_events_url': 'https://api.github.com/users/bddppq/received_events', 'type': 'User', 'site_admin': False}",referenced,949b78b0162fef5250b2a93d8ba65fa75c7260ff,https://api.github.com/repos/pytorch/pytorch/commits/949b78b0162fef5250b2a93d8ba65fa75c7260ff,2018-10-15T21:12:37Z,0,0,0
271,1905229353,"{'login': 'bddppq', 'id': 9300575, 'node_id': 'MDQ6VXNlcjkzMDA1NzU=', 'avatar_url': 'https://avatars2.githubusercontent.com/u/9300575?v=4', 'gravatar_id': '', 'url': 'https://api.github.com/users/bddppq', 'html_url': 'https://github.com/bddppq', 'followers_url': 'https://api.github.com/users/bddppq/followers', 'following_url': 'https://api.github.com/users/bddppq/following{/other_user}', 'gists_url': 'https://api.github.com/users/bddppq/gists{/gist_id}', 'starred_url': 'https://api.github.com/users/bddppq/starred{/owner}{/repo}', 'subscriptions_url': 'https://api.github.com/users/bddppq/subscriptions', 'organizations_url': 'https://api.github.com/users/bddppq/orgs', 'repos_url': 'https://api.github.com/users/bddppq/repos', 'events_url': 'https://api.github.com/users/bddppq/events{/privacy}', 'received_events_url': 'https://api.github.com/users/bddppq/received_events', 'type': 'User', 'site_admin': False}",referenced,310415c2ba315c80d2553ec1c74a1ea09227f425,https://api.github.com/repos/pytorch/pytorch/commits/310415c2ba315c80d2553ec1c74a1ea09227f425,2018-10-15T21:12:37Z,61,61,0
270,1905229511,"{'login': 'bddppq', 'id': 9300575, 'node_id': 'MDQ6VXNlcjkzMDA1NzU=', 'avatar_url': 'https://avatars2.githubusercontent.com/u/9300575?v=4', 'gravatar_id': '', 'url': 'https://api.github.com/users/bddppq', 'html_url': 'https://github.com/bddppq', 'followers_url': 'https://api.github.com/users/bddppq/followers', 'following_url': 'https://api.github.com/users/bddppq/following{/other_user}', 'gists_url': 'https://api.github.com/users/bddppq/gists{/gist_id}', 'starred_url': 'https://api.github.com/users/bddppq/starred{/owner}{/repo}', 'subscriptions_url': 'https://api.github.com/users/bddppq/subscriptions', 'organizations_url': 'https://api.github.com/users/bddppq/orgs', 'repos_url': 'https://api.github.com/users/bddppq/repos', 'events_url': 'https://api.github.com/users/bddppq/events{/privacy}', 'received_events_url': 'https://api.github.com/users/bddppq/received_events', 'type': 'User', 'site_admin': False}",referenced,484569ef0b81aa4c2c61d5895cb5aa5c6bbac843,https://api.github.com/repos/pytorch/pytorch/commits/484569ef0b81aa4c2c61d5895cb5aa5c6bbac843,2018-10-15T21:12:39Z,10,10,0
267,1905229328,"{'login': 'bddppq', 'id': 9300575, 'node_id': 'MDQ6VXNlcjkzMDA1NzU=', 'avatar_url': 'https://avatars2.githubusercontent.com/u/9300575?v=4', 'gravatar_id': '', 'url': 'https://api.github.com/users/bddppq', 'html_url': 'https://github.com/bddppq', 'followers_url': 'https://api.github.com/users/bddppq/followers', 'following_url': 'https://api.github.com/users/bddppq/following{/other_user}', 'gists_url': 'https://api.github.com/users/bddppq/gists{/gist_id}', 'starred_url': 'https://api.github.com/users/bddppq/starred{/owner}{/repo}', 'subscriptions_url': 'https://api.github.com/users/bddppq/subscriptions', 'organizations_url': 'https://api.github.com/users/bddppq/orgs', 'repos_url': 'https://api.github.com/users/bddppq/repos', 'events_url': 'https://api.github.com/users/bddppq/events{/privacy}', 'received_events_url': 'https://api.github.com/users/bddppq/received_events', 'type': 'User', 'site_admin': False}",referenced,b84ea9ff08fad8b9a794c388f42c401c3fd9d3c3,https://api.github.com/repos/pytorch/pytorch/commits/b84ea9ff08fad8b9a794c388f42c401c3fd9d3c3,2018-10-15T21:12:36Z,39,28,11
266,1905229343,"{'login': 'bddppq', 'id': 9300575, 'node_id': 'MDQ6VXNlcjkzMDA1NzU=', 'avatar_url': 'https://avatars2.githubusercontent.com/u/9300575?v=4', 'gravatar_id': '', 'url': 'https://api.github.com/users/bddppq', 'html_url': 'https://github.com/bddppq', 'followers_url': 'https://api.github.com/users/bddppq/followers', 'following_url': 'https://api.github.com/users/bddppq/following{/other_user}', 'gists_url': 'https://api.github.com/users/bddppq/gists{/gist_id}', 'starred_url': 'https://api.github.com/users/bddppq/starred{/owner}{/repo}', 'subscriptions_url': 'https://api.github.com/users/bddppq/subscriptions', 'organizations_url': 'https://api.github.com/users/bddppq/orgs', 'repos_url': 'https://api.github.com/users/bddppq/repos', 'events_url': 'https://api.github.com/users/bddppq/events{/privacy}', 'received_events_url': 'https://api.github.com/users/bddppq/received_events', 'type': 'User', 'site_admin': False}",referenced,56d396e835bea5eddad27bbcbafa6b5506afa809,https://api.github.com/repos/pytorch/pytorch/commits/56d396e835bea5eddad27bbcbafa6b5506afa809,2018-10-15T21:12:36Z,139,139,0
262,1905229348,"{'login': 'bddppq', 'id': 9300575, 'node_id': 'MDQ6VXNlcjkzMDA1NzU=', 'avatar_url': 'https://avatars2.githubusercontent.com/u/9300575?v=4', 'gravatar_id': '', 'url': 'https://api.github.com/users/bddppq', 'html_url': 'https://github.com/bddppq', 'followers_url': 'https://api.github.com/users/bddppq/followers', 'following_url': 'https://api.github.com/users/bddppq/following{/other_user}', 'gists_url': 'https://api.github.com/users/bddppq/gists{/gist_id}', 'starred_url': 'https://api.github.com/users/bddppq/starred{/owner}{/repo}', 'subscriptions_url': 'https://api.github.com/users/bddppq/subscriptions', 'organizations_url': 'https://api.github.com/users/bddppq/orgs', 'repos_url': 'https://api.github.com/users/bddppq/repos', 'events_url': 'https://api.github.com/users/bddppq/events{/privacy}', 'received_events_url': 'https://api.github.com/users/bddppq/received_events', 'type': 'User', 'site_admin': False}",referenced,60fd8a2c674faf419df3bde302cfc30e044ab7d2,https://api.github.com/repos/pytorch/pytorch/commits/60fd8a2c674faf419df3bde302cfc30e044ab7d2,2018-10-15T21:12:37Z,99,79,20
234,1905229282,"{'login': 'bddppq', 'id': 9300575, 'node_id': 'MDQ6VXNlcjkzMDA1NzU=', 'avatar_url': 'https://avatars2.githubusercontent.com/u/9300575?v=4', 'gravatar_id': '', 'url': 'https://api.github.com/users/bddppq', 'html_url': 'https://github.com/bddppq', 'followers_url': 'https://api.github.com/users/bddppq/followers', 'following_url': 'https://api.github.com/users/bddppq/following{/other_user}', 'gists_url': 'https://api.github.com/users/bddppq/gists{/gist_id}', 'starred_url': 'https://api.github.com/users/bddppq/starred{/owner}{/repo}', 'subscriptions_url': 'https://api.github.com/users/bddppq/subscriptions', 'organizations_url': 'https://api.github.com/users/bddppq/orgs', 'repos_url': 'https://api.github.com/users/bddppq/repos', 'events_url': 'https://api.github.com/users/bddppq/events{/privacy}', 'received_events_url': 'https://api.github.com/users/bddppq/received_events', 'type': 'User', 'site_admin': False}",referenced,cf5c808b9215af457ead1d56009630354ca2f798,https://api.github.com/repos/pytorch/pytorch/commits/cf5c808b9215af457ead1d56009630354ca2f798,2018-10-15T21:12:35Z,87,82,5
233,1905229269,"{'login': 'bddppq', 'id': 9300575, 'node_id': 'MDQ6VXNlcjkzMDA1NzU=', 'avatar_url': 'https://avatars2.githubusercontent.com/u/9300575?v=4', 'gravatar_id': '', 'url': 'https://api.github.com/users/bddppq', 'html_url': 'https://github.com/bddppq', 'followers_url': 'https://api.github.com/users/bddppq/followers', 'following_url': 'https://api.github.com/users/bddppq/following{/other_user}', 'gists_url': 'https://api.github.com/users/bddppq/gists{/gist_id}', 'starred_url': 'https://api.github.com/users/bddppq/starred{/owner}{/repo}', 'subscriptions_url': 'https://api.github.com/users/bddppq/subscriptions', 'organizations_url': 'https://api.github.com/users/bddppq/orgs', 'repos_url': 'https://api.github.com/users/bddppq/repos', 'events_url': 'https://api.github.com/users/bddppq/events{/privacy}', 'received_events_url': 'https://api.github.com/users/bddppq/received_events', 'type': 'User', 'site_admin': False}",referenced,e25113a37cf37eba270369391585ac8c57a500c9,https://api.github.com/repos/pytorch/pytorch/commits/e25113a37cf37eba270369391585ac8c57a500c9,2018-10-15T21:12:35Z,382,375,7
230,1905229263,"{'login': 'bddppq', 'id': 9300575, 'node_id': 'MDQ6VXNlcjkzMDA1NzU=', 'avatar_url': 'https://avatars2.githubusercontent.com/u/9300575?v=4', 'gravatar_id': '', 'url': 'https://api.github.com/users/bddppq', 'html_url': 'https://github.com/bddppq', 'followers_url': 'https://api.github.com/users/bddppq/followers', 'following_url': 'https://api.github.com/users/bddppq/following{/other_user}', 'gists_url': 'https://api.github.com/users/bddppq/gists{/gist_id}', 'starred_url': 'https://api.github.com/users/bddppq/starred{/owner}{/repo}', 'subscriptions_url': 'https://api.github.com/users/bddppq/subscriptions', 'organizations_url': 'https://api.github.com/users/bddppq/orgs', 'repos_url': 'https://api.github.com/users/bddppq/repos', 'events_url': 'https://api.github.com/users/bddppq/events{/privacy}', 'received_events_url': 'https://api.github.com/users/bddppq/received_events', 'type': 'User', 'site_admin': False}",referenced,23cfc9bd4700c358e0104654b3dd8367024e55c9,https://api.github.com/repos/pytorch/pytorch/commits/23cfc9bd4700c358e0104654b3dd8367024e55c9,2018-10-15T21:12:35Z,211,107,104
222,1255620745,"{'login': 'apaszke', 'id': 4583066, 'node_id': 'MDQ6VXNlcjQ1ODMwNjY=', 'avatar_url': 'https://avatars3.githubusercontent.com/u/4583066?v=4', 'gravatar_id': '', 'url': 'https://api.github.com/users/apaszke', 'html_url': 'https://github.com/apaszke', 'followers_url': 'https://api.github.com/users/apaszke/followers', 'following_url': 'https://api.github.com/users/apaszke/following{/other_user}', 'gists_url': 'https://api.github.com/users/apaszke/gists{/gist_id}', 'starred_url': 'https://api.github.com/users/apaszke/starred{/owner}{/repo}', 'subscriptions_url': 'https://api.github.com/users/apaszke/subscriptions', 'organizations_url': 'https://api.github.com/users/apaszke/orgs', 'repos_url': 'https://api.github.com/users/apaszke/repos', 'events_url': 'https://api.github.com/users/apaszke/events{/privacy}', 'received_events_url': 'https://api.github.com/users/apaszke/received_events', 'type': 'User', 'site_admin': False}",referenced,6855d24ff1071259e1c76e9387d6c1fb4bd21734,https://api.github.com/repos/pytorch/pytorch/commits/6855d24ff1071259e1c76e9387d6c1fb4bd21734,2017-09-19T14:53:41Z,237,126,111
222,1257685690,"{'login': 'apaszke', 'id': 4583066, 'node_id': 'MDQ6VXNlcjQ1ODMwNjY=', 'avatar_url': 'https://avatars3.githubusercontent.com/u/4583066?v=4', 'gravatar_id': '', 'url': 'https://api.github.com/users/apaszke', 'html_url': 'https://github.com/apaszke', 'followers_url': 'https://api.github.com/users/apaszke/followers', 'following_url': 'https://api.github.com/users/apaszke/following{/other_user}', 'gists_url': 'https://api.github.com/users/apaszke/gists{/gist_id}', 'starred_url': 'https://api.github.com/users/apaszke/starred{/owner}{/repo}', 'subscriptions_url': 'https://api.github.com/users/apaszke/subscriptions', 'organizations_url': 'https://api.github.com/users/apaszke/orgs', 'repos_url': 'https://api.github.com/users/apaszke/repos', 'events_url': 'https://api.github.com/users/apaszke/events{/privacy}', 'received_events_url': 'https://api.github.com/users/apaszke/received_events', 'type': 'User', 'site_admin': False}",referenced,4dcfdfe1b876bad690ea6b1fa204081163fa1037,https://api.github.com/repos/pytorch/pytorch/commits/4dcfdfe1b876bad690ea6b1fa204081163fa1037,2017-09-20T15:31:43Z,237,126,111
222,1905229257,"{'login': 'bddppq', 'id': 9300575, 'node_id': 'MDQ6VXNlcjkzMDA1NzU=', 'avatar_url': 'https://avatars2.githubusercontent.com/u/9300575?v=4', 'gravatar_id': '', 'url': 'https://api.github.com/users/bddppq', 'html_url': 'https://github.com/bddppq', 'followers_url': 'https://api.github.com/users/bddppq/followers', 'following_url': 'https://api.github.com/users/bddppq/following{/other_user}', 'gists_url': 'https://api.github.com/users/bddppq/gists{/gist_id}', 'starred_url': 'https://api.github.com/users/bddppq/starred{/owner}{/repo}', 'subscriptions_url': 'https://api.github.com/users/bddppq/subscriptions', 'organizations_url': 'https://api.github.com/users/bddppq/orgs', 'repos_url': 'https://api.github.com/users/bddppq/repos', 'events_url': 'https://api.github.com/users/bddppq/events{/privacy}', 'received_events_url': 'https://api.github.com/users/bddppq/received_events', 'type': 'User', 'site_admin': False}",referenced,06b15bb5a113d8060edc9200048f51d3cac5676f,https://api.github.com/repos/pytorch/pytorch/commits/06b15bb5a113d8060edc9200048f51d3cac5676f,2018-10-15T21:12:35Z,80,79,1
222,3081118517,"{'login': 'ZolotukhinM', 'id': 4588111, 'node_id': 'MDQ6VXNlcjQ1ODgxMTE=', 'avatar_url': 'https://avatars1.githubusercontent.com/u/4588111?v=4', 'gravatar_id': '', 'url': 'https://api.github.com/users/ZolotukhinM', 'html_url': 'https://github.com/ZolotukhinM', 'followers_url': 'https://api.github.com/users/ZolotukhinM/followers', 'following_url': 'https://api.github.com/users/ZolotukhinM/following{/other_user}', 'gists_url': 'https://api.github.com/users/ZolotukhinM/gists{/gist_id}', 'starred_url': 'https://api.github.com/users/ZolotukhinM/starred{/owner}{/repo}', 'subscriptions_url': 'https://api.github.com/users/ZolotukhinM/subscriptions', 'organizations_url': 'https://api.github.com/users/ZolotukhinM/orgs', 'repos_url': 'https://api.github.com/users/ZolotukhinM/repos', 'events_url': 'https://api.github.com/users/ZolotukhinM/events{/privacy}', 'received_events_url': 'https://api.github.com/users/ZolotukhinM/received_events', 'type': 'User', 'site_admin': False}",referenced,587be902af52d78f6d6e45573e15e7e8bbce4f35,https://api.github.com/repos/pytorch/pytorch/commits/587be902af52d78f6d6e45573e15e7e8bbce4f35,2020-02-28T09:01:23Z,418,261,157
222,3081118856,"{'login': 'ZolotukhinM', 'id': 4588111, 'node_id': 'MDQ6VXNlcjQ1ODgxMTE=', 'avatar_url': 'https://avatars1.githubusercontent.com/u/4588111?v=4', 'gravatar_id': '', 'url': 'https://api.github.com/users/ZolotukhinM', 'html_url': 'https://github.com/ZolotukhinM', 'followers_url': 'https://api.github.com/users/ZolotukhinM/followers', 'following_url': 'https://api.github.com/users/ZolotukhinM/following{/other_user}', 'gists_url': 'https://api.github.com/users/ZolotukhinM/gists{/gist_id}', 'starred_url': 'https://api.github.com/users/ZolotukhinM/starred{/owner}{/repo}', 'subscriptions_url': 'https://api.github.com/users/ZolotukhinM/subscriptions', 'organizations_url': 'https://api.github.com/users/ZolotukhinM/orgs', 'repos_url': 'https://api.github.com/users/ZolotukhinM/repos', 'events_url': 'https://api.github.com/users/ZolotukhinM/events{/privacy}', 'received_events_url': 'https://api.github.com/users/ZolotukhinM/received_events', 'type': 'User', 'site_admin': False}",referenced,12001ce77b35753c0a1def566534f851ea4e17a7,https://api.github.com/repos/pytorch/pytorch/commits/12001ce77b35753c0a1def566534f851ea4e17a7,2020-02-28T09:01:27Z,18178,18071,107
221,1905229259,"{'login': 'bddppq', 'id': 9300575, 'node_id': 'MDQ6VXNlcjkzMDA1NzU=', 'avatar_url': 'https://avatars2.githubusercontent.com/u/9300575?v=4', 'gravatar_id': '', 'url': 'https://api.github.com/users/bddppq', 'html_url': 'https://github.com/bddppq', 'followers_url': 'https://api.github.com/users/bddppq/followers', 'following_url': 'https://api.github.com/users/bddppq/following{/other_user}', 'gists_url': 'https://api.github.com/users/bddppq/gists{/gist_id}', 'starred_url': 'https://api.github.com/users/bddppq/starred{/owner}{/repo}', 'subscriptions_url': 'https://api.github.com/users/bddppq/subscriptions', 'organizations_url': 'https://api.github.com/users/bddppq/orgs', 'repos_url': 'https://api.github.com/users/bddppq/repos', 'events_url': 'https://api.github.com/users/bddppq/events{/privacy}', 'received_events_url': 'https://api.github.com/users/bddppq/received_events', 'type': 'User', 'site_admin': False}",referenced,5533e291bd77a69089a68f80339b5ae4c787e30a,https://api.github.com/repos/pytorch/pytorch/commits/5533e291bd77a69089a68f80339b5ae4c787e30a,2018-10-15T21:12:35Z,242,236,6
220,1255620740,"{'login': 'apaszke', 'id': 4583066, 'node_id': 'MDQ6VXNlcjQ1ODMwNjY=', 'avatar_url': 'https://avatars3.githubusercontent.com/u/4583066?v=4', 'gravatar_id': '', 'url': 'https://api.github.com/users/apaszke', 'html_url': 'https://github.com/apaszke', 'followers_url': 'https://api.github.com/users/apaszke/followers', 'following_url': 'https://api.github.com/users/apaszke/following{/other_user}', 'gists_url': 'https://api.github.com/users/apaszke/gists{/gist_id}', 'starred_url': 'https://api.github.com/users/apaszke/starred{/owner}{/repo}', 'subscriptions_url': 'https://api.github.com/users/apaszke/subscriptions', 'organizations_url': 'https://api.github.com/users/apaszke/orgs', 'repos_url': 'https://api.github.com/users/apaszke/repos', 'events_url': 'https://api.github.com/users/apaszke/events{/privacy}', 'received_events_url': 'https://api.github.com/users/apaszke/received_events', 'type': 'User', 'site_admin': False}",referenced,75497d624ed88e4d013591415ae0790eeb1f7f98,https://api.github.com/repos/pytorch/pytorch/commits/75497d624ed88e4d013591415ae0790eeb1f7f98,2017-09-19T14:53:41Z,32,17,15
220,1257685689,"{'login': 'apaszke', 'id': 4583066, 'node_id': 'MDQ6VXNlcjQ1ODMwNjY=', 'avatar_url': 'https://avatars3.githubusercontent.com/u/4583066?v=4', 'gravatar_id': '', 'url': 'https://api.github.com/users/apaszke', 'html_url': 'https://github.com/apaszke', 'followers_url': 'https://api.github.com/users/apaszke/followers', 'following_url': 'https://api.github.com/users/apaszke/following{/other_user}', 'gists_url': 'https://api.github.com/users/apaszke/gists{/gist_id}', 'starred_url': 'https://api.github.com/users/apaszke/starred{/owner}{/repo}', 'subscriptions_url': 'https://api.github.com/users/apaszke/subscriptions', 'organizations_url': 'https://api.github.com/users/apaszke/orgs', 'repos_url': 'https://api.github.com/users/apaszke/repos', 'events_url': 'https://api.github.com/users/apaszke/events{/privacy}', 'received_events_url': 'https://api.github.com/users/apaszke/received_events', 'type': 'User', 'site_admin': False}",referenced,9223a4ae027ef062a01ecfadbfc5002f950217dc,https://api.github.com/repos/pytorch/pytorch/commits/9223a4ae027ef062a01ecfadbfc5002f950217dc,2017-09-20T15:31:43Z,32,17,15
219,1905229250,"{'login': 'bddppq', 'id': 9300575, 'node_id': 'MDQ6VXNlcjkzMDA1NzU=', 'avatar_url': 'https://avatars2.githubusercontent.com/u/9300575?v=4', 'gravatar_id': '', 'url': 'https://api.github.com/users/bddppq', 'html_url': 'https://github.com/bddppq', 'followers_url': 'https://api.github.com/users/bddppq/followers', 'following_url': 'https://api.github.com/users/bddppq/following{/other_user}', 'gists_url': 'https://api.github.com/users/bddppq/gists{/gist_id}', 'starred_url': 'https://api.github.com/users/bddppq/starred{/owner}{/repo}', 'subscriptions_url': 'https://api.github.com/users/bddppq/subscriptions', 'organizations_url': 'https://api.github.com/users/bddppq/orgs', 'repos_url': 'https://api.github.com/users/bddppq/repos', 'events_url': 'https://api.github.com/users/bddppq/events{/privacy}', 'received_events_url': 'https://api.github.com/users/bddppq/received_events', 'type': 'User', 'site_admin': False}",referenced,cfd95c1896894dab46feee209051ad23bc4be52a,https://api.github.com/repos/pytorch/pytorch/commits/cfd95c1896894dab46feee209051ad23bc4be52a,2018-10-15T21:12:35Z,15,10,5
211,3076969093,"{'login': 'ZolotukhinM', 'id': 4588111, 'node_id': 'MDQ6VXNlcjQ1ODgxMTE=', 'avatar_url': 'https://avatars1.githubusercontent.com/u/4588111?v=4', 'gravatar_id': '', 'url': 'https://api.github.com/users/ZolotukhinM', 'html_url': 'https://github.com/ZolotukhinM', 'followers_url': 'https://api.github.com/users/ZolotukhinM/followers', 'following_url': 'https://api.github.com/users/ZolotukhinM/following{/other_user}', 'gists_url': 'https://api.github.com/users/ZolotukhinM/gists{/gist_id}', 'starred_url': 'https://api.github.com/users/ZolotukhinM/starred{/owner}{/repo}', 'subscriptions_url': 'https://api.github.com/users/ZolotukhinM/subscriptions', 'organizations_url': 'https://api.github.com/users/ZolotukhinM/orgs', 'repos_url': 'https://api.github.com/users/ZolotukhinM/repos', 'events_url': 'https://api.github.com/users/ZolotukhinM/events{/privacy}', 'received_events_url': 'https://api.github.com/users/ZolotukhinM/received_events', 'type': 'User', 'site_admin': False}",referenced,85009a1f0d4c79cd1d7e3df8cf9e171ebf259231,https://api.github.com/repos/pytorch/pytorch/commits/85009a1f0d4c79cd1d7e3df8cf9e171ebf259231,2020-02-27T09:01:21Z,4439,2369,2070
211,3076969419,"{'login': 'ZolotukhinM', 'id': 4588111, 'node_id': 'MDQ6VXNlcjQ1ODgxMTE=', 'avatar_url': 'https://avatars1.githubusercontent.com/u/4588111?v=4', 'gravatar_id': '', 'url': 'https://api.github.com/users/ZolotukhinM', 'html_url': 'https://github.com/ZolotukhinM', 'followers_url': 'https://api.github.com/users/ZolotukhinM/followers', 'following_url': 'https://api.github.com/users/ZolotukhinM/following{/other_user}', 'gists_url': 'https://api.github.com/users/ZolotukhinM/gists{/gist_id}', 'starred_url': 'https://api.github.com/users/ZolotukhinM/starred{/owner}{/repo}', 'subscriptions_url': 'https://api.github.com/users/ZolotukhinM/subscriptions', 'organizations_url': 'https://api.github.com/users/ZolotukhinM/orgs', 'repos_url': 'https://api.github.com/users/ZolotukhinM/repos', 'events_url': 'https://api.github.com/users/ZolotukhinM/events{/privacy}', 'received_events_url': 'https://api.github.com/users/ZolotukhinM/received_events', 'type': 'User', 'site_admin': False}",referenced,c830fecbd6f69f37efcb11656b7fb80867b39f60,https://api.github.com/repos/pytorch/pytorch/commits/c830fecbd6f69f37efcb11656b7fb80867b39f60,2020-02-27T09:01:26Z,18074,17967,107
206,1905229274,"{'login': 'bddppq', 'id': 9300575, 'node_id': 'MDQ6VXNlcjkzMDA1NzU=', 'avatar_url': 'https://avatars2.githubusercontent.com/u/9300575?v=4', 'gravatar_id': '', 'url': 'https://api.github.com/users/bddppq', 'html_url': 'https://github.com/bddppq', 'followers_url': 'https://api.github.com/users/bddppq/followers', 'following_url': 'https://api.github.com/users/bddppq/following{/other_user}', 'gists_url': 'https://api.github.com/users/bddppq/gists{/gist_id}', 'starred_url': 'https://api.github.com/users/bddppq/starred{/owner}{/repo}', 'subscriptions_url': 'https://api.github.com/users/bddppq/subscriptions', 'organizations_url': 'https://api.github.com/users/bddppq/orgs', 'repos_url': 'https://api.github.com/users/bddppq/repos', 'events_url': 'https://api.github.com/users/bddppq/events{/privacy}', 'received_events_url': 'https://api.github.com/users/bddppq/received_events', 'type': 'User', 'site_admin': False}",referenced,52dc5aab31b1630b9e0c65892d716f9ff7854c16,https://api.github.com/repos/pytorch/pytorch/commits/52dc5aab31b1630b9e0c65892d716f9ff7854c16,2018-10-15T21:12:35Z,271,236,35
206,3072712906,"{'login': 'ZolotukhinM', 'id': 4588111, 'node_id': 'MDQ6VXNlcjQ1ODgxMTE=', 'avatar_url': 'https://avatars1.githubusercontent.com/u/4588111?v=4', 'gravatar_id': '', 'url': 'https://api.github.com/users/ZolotukhinM', 'html_url': 'https://github.com/ZolotukhinM', 'followers_url': 'https://api.github.com/users/ZolotukhinM/followers', 'following_url': 'https://api.github.com/users/ZolotukhinM/following{/other_user}', 'gists_url': 'https://api.github.com/users/ZolotukhinM/gists{/gist_id}', 'starred_url': 'https://api.github.com/users/ZolotukhinM/starred{/owner}{/repo}', 'subscriptions_url': 'https://api.github.com/users/ZolotukhinM/subscriptions', 'organizations_url': 'https://api.github.com/users/ZolotukhinM/orgs', 'repos_url': 'https://api.github.com/users/ZolotukhinM/repos', 'events_url': 'https://api.github.com/users/ZolotukhinM/events{/privacy}', 'received_events_url': 'https://api.github.com/users/ZolotukhinM/received_events', 'type': 'User', 'site_admin': False}",referenced,018daa7b9f66f025480848fed58e816355b2a279,https://api.github.com/repos/pytorch/pytorch/commits/018daa7b9f66f025480848fed58e816355b2a279,2020-02-26T09:01:18Z,1111,926,185
206,3072713298,"{'login': 'ZolotukhinM', 'id': 4588111, 'node_id': 'MDQ6VXNlcjQ1ODgxMTE=', 'avatar_url': 'https://avatars1.githubusercontent.com/u/4588111?v=4', 'gravatar_id': '', 'url': 'https://api.github.com/users/ZolotukhinM', 'html_url': 'https://github.com/ZolotukhinM', 'followers_url': 'https://api.github.com/users/ZolotukhinM/followers', 'following_url': 'https://api.github.com/users/ZolotukhinM/following{/other_user}', 'gists_url': 'https://api.github.com/users/ZolotukhinM/gists{/gist_id}', 'starred_url': 'https://api.github.com/users/ZolotukhinM/starred{/owner}{/repo}', 'subscriptions_url': 'https://api.github.com/users/ZolotukhinM/subscriptions', 'organizations_url': 'https://api.github.com/users/ZolotukhinM/orgs', 'repos_url': 'https://api.github.com/users/ZolotukhinM/repos', 'events_url': 'https://api.github.com/users/ZolotukhinM/events{/privacy}', 'received_events_url': 'https://api.github.com/users/ZolotukhinM/received_events', 'type': 'User', 'site_admin': False}",referenced,a9659b13e94cec9fa4d79d852a19cd7a12b55505,https://api.github.com/repos/pytorch/pytorch/commits/a9659b13e94cec9fa4d79d852a19cd7a12b55505,2020-02-26T09:01:23Z,17949,17755,194
191,1905229214,"{'login': 'bddppq', 'id': 9300575, 'node_id': 'MDQ6VXNlcjkzMDA1NzU=', 'avatar_url': 'https://avatars2.githubusercontent.com/u/9300575?v=4', 'gravatar_id': '', 'url': 'https://api.github.com/users/bddppq', 'html_url': 'https://github.com/bddppq', 'followers_url': 'https://api.github.com/users/bddppq/followers', 'following_url': 'https://api.github.com/users/bddppq/following{/other_user}', 'gists_url': 'https://api.github.com/users/bddppq/gists{/gist_id}', 'starred_url': 'https://api.github.com/users/bddppq/starred{/owner}{/repo}', 'subscriptions_url': 'https://api.github.com/users/bddppq/subscriptions', 'organizations_url': 'https://api.github.com/users/bddppq/orgs', 'repos_url': 'https://api.github.com/users/bddppq/repos', 'events_url': 'https://api.github.com/users/bddppq/events{/privacy}', 'received_events_url': 'https://api.github.com/users/bddppq/received_events', 'type': 'User', 'site_admin': False}",referenced,92c475fe4e939e66efef6475749b444280cec60a,https://api.github.com/repos/pytorch/pytorch/commits/92c475fe4e939e66efef6475749b444280cec60a,2018-10-15T21:12:34Z,101,101,0
190,1905229212,"{'login': 'bddppq', 'id': 9300575, 'node_id': 'MDQ6VXNlcjkzMDA1NzU=', 'avatar_url': 'https://avatars2.githubusercontent.com/u/9300575?v=4', 'gravatar_id': '', 'url': 'https://api.github.com/users/bddppq', 'html_url': 'https://github.com/bddppq', 'followers_url': 'https://api.github.com/users/bddppq/followers', 'following_url': 'https://api.github.com/users/bddppq/following{/other_user}', 'gists_url': 'https://api.github.com/users/bddppq/gists{/gist_id}', 'starred_url': 'https://api.github.com/users/bddppq/starred{/owner}{/repo}', 'subscriptions_url': 'https://api.github.com/users/bddppq/subscriptions', 'organizations_url': 'https://api.github.com/users/bddppq/orgs', 'repos_url': 'https://api.github.com/users/bddppq/repos', 'events_url': 'https://api.github.com/users/bddppq/events{/privacy}', 'received_events_url': 'https://api.github.com/users/bddppq/received_events', 'type': 'User', 'site_admin': False}",referenced,3d4f1011c369dda25e586337011a9c63dca1e43f,https://api.github.com/repos/pytorch/pytorch/commits/3d4f1011c369dda25e586337011a9c63dca1e43f,2018-10-15T21:12:34Z,50,43,7
186,1905229246,"{'login': 'bddppq', 'id': 9300575, 'node_id': 'MDQ6VXNlcjkzMDA1NzU=', 'avatar_url': 'https://avatars2.githubusercontent.com/u/9300575?v=4', 'gravatar_id': '', 'url': 'https://api.github.com/users/bddppq', 'html_url': 'https://github.com/bddppq', 'followers_url': 'https://api.github.com/users/bddppq/followers', 'following_url': 'https://api.github.com/users/bddppq/following{/other_user}', 'gists_url': 'https://api.github.com/users/bddppq/gists{/gist_id}', 'starred_url': 'https://api.github.com/users/bddppq/starred{/owner}{/repo}', 'subscriptions_url': 'https://api.github.com/users/bddppq/subscriptions', 'organizations_url': 'https://api.github.com/users/bddppq/orgs', 'repos_url': 'https://api.github.com/users/bddppq/repos', 'events_url': 'https://api.github.com/users/bddppq/events{/privacy}', 'received_events_url': 'https://api.github.com/users/bddppq/received_events', 'type': 'User', 'site_admin': False}",referenced,a30709e647ba7683fe047cc188bdba3f28ac1d37,https://api.github.com/repos/pytorch/pytorch/commits/a30709e647ba7683fe047cc188bdba3f28ac1d37,2018-10-15T21:12:35Z,732,688,44
184,1905229218,"{'login': 'bddppq', 'id': 9300575, 'node_id': 'MDQ6VXNlcjkzMDA1NzU=', 'avatar_url': 'https://avatars2.githubusercontent.com/u/9300575?v=4', 'gravatar_id': '', 'url': 'https://api.github.com/users/bddppq', 'html_url': 'https://github.com/bddppq', 'followers_url': 'https://api.github.com/users/bddppq/followers', 'following_url': 'https://api.github.com/users/bddppq/following{/other_user}', 'gists_url': 'https://api.github.com/users/bddppq/gists{/gist_id}', 'starred_url': 'https://api.github.com/users/bddppq/starred{/owner}{/repo}', 'subscriptions_url': 'https://api.github.com/users/bddppq/subscriptions', 'organizations_url': 'https://api.github.com/users/bddppq/orgs', 'repos_url': 'https://api.github.com/users/bddppq/repos', 'events_url': 'https://api.github.com/users/bddppq/events{/privacy}', 'received_events_url': 'https://api.github.com/users/bddppq/received_events', 'type': 'User', 'site_admin': False}",referenced,acf9634b0ff0fb4755fe5e4a460499ecd38abfcf,https://api.github.com/repos/pytorch/pytorch/commits/acf9634b0ff0fb4755fe5e4a460499ecd38abfcf,2018-10-15T21:12:34Z,2631,1925,706
181,1905229207,"{'login': 'bddppq', 'id': 9300575, 'node_id': 'MDQ6VXNlcjkzMDA1NzU=', 'avatar_url': 'https://avatars2.githubusercontent.com/u/9300575?v=4', 'gravatar_id': '', 'url': 'https://api.github.com/users/bddppq', 'html_url': 'https://github.com/bddppq', 'followers_url': 'https://api.github.com/users/bddppq/followers', 'following_url': 'https://api.github.com/users/bddppq/following{/other_user}', 'gists_url': 'https://api.github.com/users/bddppq/gists{/gist_id}', 'starred_url': 'https://api.github.com/users/bddppq/starred{/owner}{/repo}', 'subscriptions_url': 'https://api.github.com/users/bddppq/subscriptions', 'organizations_url': 'https://api.github.com/users/bddppq/orgs', 'repos_url': 'https://api.github.com/users/bddppq/repos', 'events_url': 'https://api.github.com/users/bddppq/events{/privacy}', 'received_events_url': 'https://api.github.com/users/bddppq/received_events', 'type': 'User', 'site_admin': False}",referenced,2358cfccb79f79c6b7d66f3bba7c6c1d0efe373e,https://api.github.com/repos/pytorch/pytorch/commits/2358cfccb79f79c6b7d66f3bba7c6c1d0efe373e,2018-10-15T21:12:34Z,2930,1745,1185
181,3059728005,"{'login': 'ZolotukhinM', 'id': 4588111, 'node_id': 'MDQ6VXNlcjQ1ODgxMTE=', 'avatar_url': 'https://avatars1.githubusercontent.com/u/4588111?v=4', 'gravatar_id': '', 'url': 'https://api.github.com/users/ZolotukhinM', 'html_url': 'https://github.com/ZolotukhinM', 'followers_url': 'https://api.github.com/users/ZolotukhinM/followers', 'following_url': 'https://api.github.com/users/ZolotukhinM/following{/other_user}', 'gists_url': 'https://api.github.com/users/ZolotukhinM/gists{/gist_id}', 'starred_url': 'https://api.github.com/users/ZolotukhinM/starred{/owner}{/repo}', 'subscriptions_url': 'https://api.github.com/users/ZolotukhinM/subscriptions', 'organizations_url': 'https://api.github.com/users/ZolotukhinM/orgs', 'repos_url': 'https://api.github.com/users/ZolotukhinM/repos', 'events_url': 'https://api.github.com/users/ZolotukhinM/events{/privacy}', 'received_events_url': 'https://api.github.com/users/ZolotukhinM/received_events', 'type': 'User', 'site_admin': False}",referenced,2652a97f6d21e2f1494582cb12d9ec92b574638f,https://api.github.com/repos/pytorch/pytorch/commits/2652a97f6d21e2f1494582cb12d9ec92b574638f,2020-02-21T09:01:19Z,482,316,166
181,3059728182,"{'login': 'ZolotukhinM', 'id': 4588111, 'node_id': 'MDQ6VXNlcjQ1ODgxMTE=', 'avatar_url': 'https://avatars1.githubusercontent.com/u/4588111?v=4', 'gravatar_id': '', 'url': 'https://api.github.com/users/ZolotukhinM', 'html_url': 'https://github.com/ZolotukhinM', 'followers_url': 'https://api.github.com/users/ZolotukhinM/followers', 'following_url': 'https://api.github.com/users/ZolotukhinM/following{/other_user}', 'gists_url': 'https://api.github.com/users/ZolotukhinM/gists{/gist_id}', 'starred_url': 'https://api.github.com/users/ZolotukhinM/starred{/owner}{/repo}', 'subscriptions_url': 'https://api.github.com/users/ZolotukhinM/subscriptions', 'organizations_url': 'https://api.github.com/users/ZolotukhinM/orgs', 'repos_url': 'https://api.github.com/users/ZolotukhinM/repos', 'events_url': 'https://api.github.com/users/ZolotukhinM/events{/privacy}', 'received_events_url': 'https://api.github.com/users/ZolotukhinM/received_events', 'type': 'User', 'site_admin': False}",referenced,d8a1ff51834239ae8c271c17fb7b35acb3ec1e18,https://api.github.com/repos/pytorch/pytorch/commits/d8a1ff51834239ae8c271c17fb7b35acb3ec1e18,2020-02-21T09:01:22Z,15831,15828,3
168,3040259295,"{'login': 'ZolotukhinM', 'id': 4588111, 'node_id': 'MDQ6VXNlcjQ1ODgxMTE=', 'avatar_url': 'https://avatars1.githubusercontent.com/u/4588111?v=4', 'gravatar_id': '', 'url': 'https://api.github.com/users/ZolotukhinM', 'html_url': 'https://github.com/ZolotukhinM', 'followers_url': 'https://api.github.com/users/ZolotukhinM/followers', 'following_url': 'https://api.github.com/users/ZolotukhinM/following{/other_user}', 'gists_url': 'https://api.github.com/users/ZolotukhinM/gists{/gist_id}', 'starred_url': 'https://api.github.com/users/ZolotukhinM/starred{/owner}{/repo}', 'subscriptions_url': 'https://api.github.com/users/ZolotukhinM/subscriptions', 'organizations_url': 'https://api.github.com/users/ZolotukhinM/orgs', 'repos_url': 'https://api.github.com/users/ZolotukhinM/repos', 'events_url': 'https://api.github.com/users/ZolotukhinM/events{/privacy}', 'received_events_url': 'https://api.github.com/users/ZolotukhinM/received_events', 'type': 'User', 'site_admin': False}",referenced,573545f99053b54e77360d3abe3c7d9901e75a9c,https://api.github.com/repos/pytorch/pytorch/commits/573545f99053b54e77360d3abe3c7d9901e75a9c,2020-02-14T21:58:11Z,2,1,1
168,3040259454,"{'login': 'ZolotukhinM', 'id': 4588111, 'node_id': 'MDQ6VXNlcjQ1ODgxMTE=', 'avatar_url': 'https://avatars1.githubusercontent.com/u/4588111?v=4', 'gravatar_id': '', 'url': 'https://api.github.com/users/ZolotukhinM', 'html_url': 'https://github.com/ZolotukhinM', 'followers_url': 'https://api.github.com/users/ZolotukhinM/followers', 'following_url': 'https://api.github.com/users/ZolotukhinM/following{/other_user}', 'gists_url': 'https://api.github.com/users/ZolotukhinM/gists{/gist_id}', 'starred_url': 'https://api.github.com/users/ZolotukhinM/starred{/owner}{/repo}', 'subscriptions_url': 'https://api.github.com/users/ZolotukhinM/subscriptions', 'organizations_url': 'https://api.github.com/users/ZolotukhinM/orgs', 'repos_url': 'https://api.github.com/users/ZolotukhinM/repos', 'events_url': 'https://api.github.com/users/ZolotukhinM/events{/privacy}', 'received_events_url': 'https://api.github.com/users/ZolotukhinM/received_events', 'type': 'User', 'site_admin': False}",referenced,65dfe8dfe36cbe1d6e4cdb67928773d4aa4f3283,https://api.github.com/repos/pytorch/pytorch/commits/65dfe8dfe36cbe1d6e4cdb67928773d4aa4f3283,2020-02-14T21:58:15Z,15397,15394,3
166,1905229194,"{'login': 'bddppq', 'id': 9300575, 'node_id': 'MDQ6VXNlcjkzMDA1NzU=', 'avatar_url': 'https://avatars2.githubusercontent.com/u/9300575?v=4', 'gravatar_id': '', 'url': 'https://api.github.com/users/bddppq', 'html_url': 'https://github.com/bddppq', 'followers_url': 'https://api.github.com/users/bddppq/followers', 'following_url': 'https://api.github.com/users/bddppq/following{/other_user}', 'gists_url': 'https://api.github.com/users/bddppq/gists{/gist_id}', 'starred_url': 'https://api.github.com/users/bddppq/starred{/owner}{/repo}', 'subscriptions_url': 'https://api.github.com/users/bddppq/subscriptions', 'organizations_url': 'https://api.github.com/users/bddppq/orgs', 'repos_url': 'https://api.github.com/users/bddppq/repos', 'events_url': 'https://api.github.com/users/bddppq/events{/privacy}', 'received_events_url': 'https://api.github.com/users/bddppq/received_events', 'type': 'User', 'site_admin': False}",referenced,ef05459a045f4aca462545a720c62e4e55d87e7b,https://api.github.com/repos/pytorch/pytorch/commits/ef05459a045f4aca462545a720c62e4e55d87e7b,2018-10-15T21:12:33Z,89,77,12
163,3039811825,"{'login': 'ZolotukhinM', 'id': 4588111, 'node_id': 'MDQ6VXNlcjQ1ODgxMTE=', 'avatar_url': 'https://avatars1.githubusercontent.com/u/4588111?v=4', 'gravatar_id': '', 'url': 'https://api.github.com/users/ZolotukhinM', 'html_url': 'https://github.com/ZolotukhinM', 'followers_url': 'https://api.github.com/users/ZolotukhinM/followers', 'following_url': 'https://api.github.com/users/ZolotukhinM/following{/other_user}', 'gists_url': 'https://api.github.com/users/ZolotukhinM/gists{/gist_id}', 'starred_url': 'https://api.github.com/users/ZolotukhinM/starred{/owner}{/repo}', 'subscriptions_url': 'https://api.github.com/users/ZolotukhinM/subscriptions', 'organizations_url': 'https://api.github.com/users/ZolotukhinM/orgs', 'repos_url': 'https://api.github.com/users/ZolotukhinM/repos', 'events_url': 'https://api.github.com/users/ZolotukhinM/events{/privacy}', 'received_events_url': 'https://api.github.com/users/ZolotukhinM/received_events', 'type': 'User', 'site_admin': False}",referenced,8fa4f6ffa8546e5285454195a39adb8a57832996,https://api.github.com/repos/pytorch/pytorch/commits/8fa4f6ffa8546e5285454195a39adb8a57832996,2020-02-14T19:05:05Z,15397,15394,3
163,3039812163,"{'login': 'ZolotukhinM', 'id': 4588111, 'node_id': 'MDQ6VXNlcjQ1ODgxMTE=', 'avatar_url': 'https://avatars1.githubusercontent.com/u/4588111?v=4', 'gravatar_id': '', 'url': 'https://api.github.com/users/ZolotukhinM', 'html_url': 'https://github.com/ZolotukhinM', 'followers_url': 'https://api.github.com/users/ZolotukhinM/followers', 'following_url': 'https://api.github.com/users/ZolotukhinM/following{/other_user}', 'gists_url': 'https://api.github.com/users/ZolotukhinM/gists{/gist_id}', 'starred_url': 'https://api.github.com/users/ZolotukhinM/starred{/owner}{/repo}', 'subscriptions_url': 'https://api.github.com/users/ZolotukhinM/subscriptions', 'organizations_url': 'https://api.github.com/users/ZolotukhinM/orgs', 'repos_url': 'https://api.github.com/users/ZolotukhinM/repos', 'events_url': 'https://api.github.com/users/ZolotukhinM/events{/privacy}', 'received_events_url': 'https://api.github.com/users/ZolotukhinM/received_events', 'type': 'User', 'site_admin': False}",referenced,91fedcc15d7a2327a72b5298c032e07de45ec8ee,https://api.github.com/repos/pytorch/pytorch/commits/91fedcc15d7a2327a72b5298c032e07de45ec8ee,2020-02-14T19:05:12Z,15397,15394,3
163,3039825059,"{'login': 'ZolotukhinM', 'id': 4588111, 'node_id': 'MDQ6VXNlcjQ1ODgxMTE=', 'avatar_url': 'https://avatars1.githubusercontent.com/u/4588111?v=4', 'gravatar_id': '', 'url': 'https://api.github.com/users/ZolotukhinM', 'html_url': 'https://github.com/ZolotukhinM', 'followers_url': 'https://api.github.com/users/ZolotukhinM/followers', 'following_url': 'https://api.github.com/users/ZolotukhinM/following{/other_user}', 'gists_url': 'https://api.github.com/users/ZolotukhinM/gists{/gist_id}', 'starred_url': 'https://api.github.com/users/ZolotukhinM/starred{/owner}{/repo}', 'subscriptions_url': 'https://api.github.com/users/ZolotukhinM/subscriptions', 'organizations_url': 'https://api.github.com/users/ZolotukhinM/orgs', 'repos_url': 'https://api.github.com/users/ZolotukhinM/repos', 'events_url': 'https://api.github.com/users/ZolotukhinM/events{/privacy}', 'received_events_url': 'https://api.github.com/users/ZolotukhinM/received_events', 'type': 'User', 'site_admin': False}",referenced,bd5df0a47b4640c60e2dacee063c56a1ad95b580,https://api.github.com/repos/pytorch/pytorch/commits/bd5df0a47b4640c60e2dacee063c56a1ad95b580,2020-02-14T19:10:08Z,0,0,0
163,3039825291,"{'login': 'ZolotukhinM', 'id': 4588111, 'node_id': 'MDQ6VXNlcjQ1ODgxMTE=', 'avatar_url': 'https://avatars1.githubusercontent.com/u/4588111?v=4', 'gravatar_id': '', 'url': 'https://api.github.com/users/ZolotukhinM', 'html_url': 'https://github.com/ZolotukhinM', 'followers_url': 'https://api.github.com/users/ZolotukhinM/followers', 'following_url': 'https://api.github.com/users/ZolotukhinM/following{/other_user}', 'gists_url': 'https://api.github.com/users/ZolotukhinM/gists{/gist_id}', 'starred_url': 'https://api.github.com/users/ZolotukhinM/starred{/owner}{/repo}', 'subscriptions_url': 'https://api.github.com/users/ZolotukhinM/subscriptions', 'organizations_url': 'https://api.github.com/users/ZolotukhinM/orgs', 'repos_url': 'https://api.github.com/users/ZolotukhinM/repos', 'events_url': 'https://api.github.com/users/ZolotukhinM/events{/privacy}', 'received_events_url': 'https://api.github.com/users/ZolotukhinM/received_events', 'type': 'User', 'site_admin': False}",referenced,26b66b1d4ed963a8417e52dbaa073e35ccdf5200,https://api.github.com/repos/pytorch/pytorch/commits/26b66b1d4ed963a8417e52dbaa073e35ccdf5200,2020-02-14T19:10:13Z,15397,15394,3
163,3039827149,"{'login': 'ZolotukhinM', 'id': 4588111, 'node_id': 'MDQ6VXNlcjQ1ODgxMTE=', 'avatar_url': 'https://avatars1.githubusercontent.com/u/4588111?v=4', 'gravatar_id': '', 'url': 'https://api.github.com/users/ZolotukhinM', 'html_url': 'https://github.com/ZolotukhinM', 'followers_url': 'https://api.github.com/users/ZolotukhinM/followers', 'following_url': 'https://api.github.com/users/ZolotukhinM/following{/other_user}', 'gists_url': 'https://api.github.com/users/ZolotukhinM/gists{/gist_id}', 'starred_url': 'https://api.github.com/users/ZolotukhinM/starred{/owner}{/repo}', 'subscriptions_url': 'https://api.github.com/users/ZolotukhinM/subscriptions', 'organizations_url': 'https://api.github.com/users/ZolotukhinM/orgs', 'repos_url': 'https://api.github.com/users/ZolotukhinM/repos', 'events_url': 'https://api.github.com/users/ZolotukhinM/events{/privacy}', 'received_events_url': 'https://api.github.com/users/ZolotukhinM/received_events', 'type': 'User', 'site_admin': False}",referenced,7b58c7cf4b3a98072c5db3d3932ff603d1bd7370,https://api.github.com/repos/pytorch/pytorch/commits/7b58c7cf4b3a98072c5db3d3932ff603d1bd7370,2020-02-14T19:10:56Z,0,0,0
163,3039827357,"{'login': 'ZolotukhinM', 'id': 4588111, 'node_id': 'MDQ6VXNlcjQ1ODgxMTE=', 'avatar_url': 'https://avatars1.githubusercontent.com/u/4588111?v=4', 'gravatar_id': '', 'url': 'https://api.github.com/users/ZolotukhinM', 'html_url': 'https://github.com/ZolotukhinM', 'followers_url': 'https://api.github.com/users/ZolotukhinM/followers', 'following_url': 'https://api.github.com/users/ZolotukhinM/following{/other_user}', 'gists_url': 'https://api.github.com/users/ZolotukhinM/gists{/gist_id}', 'starred_url': 'https://api.github.com/users/ZolotukhinM/starred{/owner}{/repo}', 'subscriptions_url': 'https://api.github.com/users/ZolotukhinM/subscriptions', 'organizations_url': 'https://api.github.com/users/ZolotukhinM/orgs', 'repos_url': 'https://api.github.com/users/ZolotukhinM/repos', 'events_url': 'https://api.github.com/users/ZolotukhinM/events{/privacy}', 'received_events_url': 'https://api.github.com/users/ZolotukhinM/received_events', 'type': 'User', 'site_admin': False}",referenced,7bf97de5b80276947e0eda1b6bce928aa6187daf,https://api.github.com/repos/pytorch/pytorch/commits/7bf97de5b80276947e0eda1b6bce928aa6187daf,2020-02-14T19:11:01Z,15397,15394,3
163,3039830529,"{'login': 'ZolotukhinM', 'id': 4588111, 'node_id': 'MDQ6VXNlcjQ1ODgxMTE=', 'avatar_url': 'https://avatars1.githubusercontent.com/u/4588111?v=4', 'gravatar_id': '', 'url': 'https://api.github.com/users/ZolotukhinM', 'html_url': 'https://github.com/ZolotukhinM', 'followers_url': 'https://api.github.com/users/ZolotukhinM/followers', 'following_url': 'https://api.github.com/users/ZolotukhinM/following{/other_user}', 'gists_url': 'https://api.github.com/users/ZolotukhinM/gists{/gist_id}', 'starred_url': 'https://api.github.com/users/ZolotukhinM/starred{/owner}{/repo}', 'subscriptions_url': 'https://api.github.com/users/ZolotukhinM/subscriptions', 'organizations_url': 'https://api.github.com/users/ZolotukhinM/orgs', 'repos_url': 'https://api.github.com/users/ZolotukhinM/repos', 'events_url': 'https://api.github.com/users/ZolotukhinM/events{/privacy}', 'received_events_url': 'https://api.github.com/users/ZolotukhinM/received_events', 'type': 'User', 'site_admin': False}",referenced,146997308b64aac4ed5719fa299f0cdd44de9e5c,https://api.github.com/repos/pytorch/pytorch/commits/146997308b64aac4ed5719fa299f0cdd44de9e5c,2020-02-14T19:12:12Z,0,0,0
163,3039830811,"{'login': 'ZolotukhinM', 'id': 4588111, 'node_id': 'MDQ6VXNlcjQ1ODgxMTE=', 'avatar_url': 'https://avatars1.githubusercontent.com/u/4588111?v=4', 'gravatar_id': '', 'url': 'https://api.github.com/users/ZolotukhinM', 'html_url': 'https://github.com/ZolotukhinM', 'followers_url': 'https://api.github.com/users/ZolotukhinM/followers', 'following_url': 'https://api.github.com/users/ZolotukhinM/following{/other_user}', 'gists_url': 'https://api.github.com/users/ZolotukhinM/gists{/gist_id}', 'starred_url': 'https://api.github.com/users/ZolotukhinM/starred{/owner}{/repo}', 'subscriptions_url': 'https://api.github.com/users/ZolotukhinM/subscriptions', 'organizations_url': 'https://api.github.com/users/ZolotukhinM/orgs', 'repos_url': 'https://api.github.com/users/ZolotukhinM/repos', 'events_url': 'https://api.github.com/users/ZolotukhinM/events{/privacy}', 'received_events_url': 'https://api.github.com/users/ZolotukhinM/received_events', 'type': 'User', 'site_admin': False}",referenced,be8d949770b4c27eb67300026cf63ee4baff1499,https://api.github.com/repos/pytorch/pytorch/commits/be8d949770b4c27eb67300026cf63ee4baff1499,2020-02-14T19:12:19Z,15397,15394,3
163,3039834814,"{'login': 'ZolotukhinM', 'id': 4588111, 'node_id': 'MDQ6VXNlcjQ1ODgxMTE=', 'avatar_url': 'https://avatars1.githubusercontent.com/u/4588111?v=4', 'gravatar_id': '', 'url': 'https://api.github.com/users/ZolotukhinM', 'html_url': 'https://github.com/ZolotukhinM', 'followers_url': 'https://api.github.com/users/ZolotukhinM/followers', 'following_url': 'https://api.github.com/users/ZolotukhinM/following{/other_user}', 'gists_url': 'https://api.github.com/users/ZolotukhinM/gists{/gist_id}', 'starred_url': 'https://api.github.com/users/ZolotukhinM/starred{/owner}{/repo}', 'subscriptions_url': 'https://api.github.com/users/ZolotukhinM/subscriptions', 'organizations_url': 'https://api.github.com/users/ZolotukhinM/orgs', 'repos_url': 'https://api.github.com/users/ZolotukhinM/repos', 'events_url': 'https://api.github.com/users/ZolotukhinM/events{/privacy}', 'received_events_url': 'https://api.github.com/users/ZolotukhinM/received_events', 'type': 'User', 'site_admin': False}",referenced,d38d3cb27a776c0d098cb28de03645b14aa078d2,https://api.github.com/repos/pytorch/pytorch/commits/d38d3cb27a776c0d098cb28de03645b14aa078d2,2020-02-14T19:13:44Z,0,0,0
163,3039834940,"{'login': 'ZolotukhinM', 'id': 4588111, 'node_id': 'MDQ6VXNlcjQ1ODgxMTE=', 'avatar_url': 'https://avatars1.githubusercontent.com/u/4588111?v=4', 'gravatar_id': '', 'url': 'https://api.github.com/users/ZolotukhinM', 'html_url': 'https://github.com/ZolotukhinM', 'followers_url': 'https://api.github.com/users/ZolotukhinM/followers', 'following_url': 'https://api.github.com/users/ZolotukhinM/following{/other_user}', 'gists_url': 'https://api.github.com/users/ZolotukhinM/gists{/gist_id}', 'starred_url': 'https://api.github.com/users/ZolotukhinM/starred{/owner}{/repo}', 'subscriptions_url': 'https://api.github.com/users/ZolotukhinM/subscriptions', 'organizations_url': 'https://api.github.com/users/ZolotukhinM/orgs', 'repos_url': 'https://api.github.com/users/ZolotukhinM/repos', 'events_url': 'https://api.github.com/users/ZolotukhinM/events{/privacy}', 'received_events_url': 'https://api.github.com/users/ZolotukhinM/received_events', 'type': 'User', 'site_admin': False}",referenced,e37362264e6459c4fb948570cebcdfa90d10341a,https://api.github.com/repos/pytorch/pytorch/commits/e37362264e6459c4fb948570cebcdfa90d10341a,2020-02-14T19:13:47Z,15397,15394,3
163,3039904627,"{'login': 'ZolotukhinM', 'id': 4588111, 'node_id': 'MDQ6VXNlcjQ1ODgxMTE=', 'avatar_url': 'https://avatars1.githubusercontent.com/u/4588111?v=4', 'gravatar_id': '', 'url': 'https://api.github.com/users/ZolotukhinM', 'html_url': 'https://github.com/ZolotukhinM', 'followers_url': 'https://api.github.com/users/ZolotukhinM/followers', 'following_url': 'https://api.github.com/users/ZolotukhinM/following{/other_user}', 'gists_url': 'https://api.github.com/users/ZolotukhinM/gists{/gist_id}', 'starred_url': 'https://api.github.com/users/ZolotukhinM/starred{/owner}{/repo}', 'subscriptions_url': 'https://api.github.com/users/ZolotukhinM/subscriptions', 'organizations_url': 'https://api.github.com/users/ZolotukhinM/orgs', 'repos_url': 'https://api.github.com/users/ZolotukhinM/repos', 'events_url': 'https://api.github.com/users/ZolotukhinM/events{/privacy}', 'received_events_url': 'https://api.github.com/users/ZolotukhinM/received_events', 'type': 'User', 'site_admin': False}",referenced,1b766ef050eecac7561964d050a04b0119391a38,https://api.github.com/repos/pytorch/pytorch/commits/1b766ef050eecac7561964d050a04b0119391a38,2020-02-14T19:39:17Z,0,0,0
163,3039904895,"{'login': 'ZolotukhinM', 'id': 4588111, 'node_id': 'MDQ6VXNlcjQ1ODgxMTE=', 'avatar_url': 'https://avatars1.githubusercontent.com/u/4588111?v=4', 'gravatar_id': '', 'url': 'https://api.github.com/users/ZolotukhinM', 'html_url': 'https://github.com/ZolotukhinM', 'followers_url': 'https://api.github.com/users/ZolotukhinM/followers', 'following_url': 'https://api.github.com/users/ZolotukhinM/following{/other_user}', 'gists_url': 'https://api.github.com/users/ZolotukhinM/gists{/gist_id}', 'starred_url': 'https://api.github.com/users/ZolotukhinM/starred{/owner}{/repo}', 'subscriptions_url': 'https://api.github.com/users/ZolotukhinM/subscriptions', 'organizations_url': 'https://api.github.com/users/ZolotukhinM/orgs', 'repos_url': 'https://api.github.com/users/ZolotukhinM/repos', 'events_url': 'https://api.github.com/users/ZolotukhinM/events{/privacy}', 'received_events_url': 'https://api.github.com/users/ZolotukhinM/received_events', 'type': 'User', 'site_admin': False}",referenced,ecd32a93966501d18f5885d171c8b4ba40472f42,https://api.github.com/repos/pytorch/pytorch/commits/ecd32a93966501d18f5885d171c8b4ba40472f42,2020-02-14T19:39:23Z,15397,15394,3
158,1905229183,"{'login': 'bddppq', 'id': 9300575, 'node_id': 'MDQ6VXNlcjkzMDA1NzU=', 'avatar_url': 'https://avatars2.githubusercontent.com/u/9300575?v=4', 'gravatar_id': '', 'url': 'https://api.github.com/users/bddppq', 'html_url': 'https://github.com/bddppq', 'followers_url': 'https://api.github.com/users/bddppq/followers', 'following_url': 'https://api.github.com/users/bddppq/following{/other_user}', 'gists_url': 'https://api.github.com/users/bddppq/gists{/gist_id}', 'starred_url': 'https://api.github.com/users/bddppq/starred{/owner}{/repo}', 'subscriptions_url': 'https://api.github.com/users/bddppq/subscriptions', 'organizations_url': 'https://api.github.com/users/bddppq/orgs', 'repos_url': 'https://api.github.com/users/bddppq/repos', 'events_url': 'https://api.github.com/users/bddppq/events{/privacy}', 'received_events_url': 'https://api.github.com/users/bddppq/received_events', 'type': 'User', 'site_admin': False}",referenced,582fc7f2038ba12af9bd72e87d8febf8a7caa893,https://api.github.com/repos/pytorch/pytorch/commits/582fc7f2038ba12af9bd72e87d8febf8a7caa893,2018-10-15T21:12:33Z,114,114,0
157,1905229173,"{'login': 'bddppq', 'id': 9300575, 'node_id': 'MDQ6VXNlcjkzMDA1NzU=', 'avatar_url': 'https://avatars2.githubusercontent.com/u/9300575?v=4', 'gravatar_id': '', 'url': 'https://api.github.com/users/bddppq', 'html_url': 'https://github.com/bddppq', 'followers_url': 'https://api.github.com/users/bddppq/followers', 'following_url': 'https://api.github.com/users/bddppq/following{/other_user}', 'gists_url': 'https://api.github.com/users/bddppq/gists{/gist_id}', 'starred_url': 'https://api.github.com/users/bddppq/starred{/owner}{/repo}', 'subscriptions_url': 'https://api.github.com/users/bddppq/subscriptions', 'organizations_url': 'https://api.github.com/users/bddppq/orgs', 'repos_url': 'https://api.github.com/users/bddppq/repos', 'events_url': 'https://api.github.com/users/bddppq/events{/privacy}', 'received_events_url': 'https://api.github.com/users/bddppq/received_events', 'type': 'User', 'site_admin': False}",referenced,1794199c16be7c8d238dd94fe40fc3644fe6329c,https://api.github.com/repos/pytorch/pytorch/commits/1794199c16be7c8d238dd94fe40fc3644fe6329c,2018-10-15T21:12:33Z,3,1,2
156,1324121711,"{'login': 'ezyang', 'id': 13564, 'node_id': 'MDQ6VXNlcjEzNTY0', 'avatar_url': 'https://avatars0.githubusercontent.com/u/13564?v=4', 'gravatar_id': '', 'url': 'https://api.github.com/users/ezyang', 'html_url': 'https://github.com/ezyang', 'followers_url': 'https://api.github.com/users/ezyang/followers', 'following_url': 'https://api.github.com/users/ezyang/following{/other_user}', 'gists_url': 'https://api.github.com/users/ezyang/gists{/gist_id}', 'starred_url': 'https://api.github.com/users/ezyang/starred{/owner}{/repo}', 'subscriptions_url': 'https://api.github.com/users/ezyang/subscriptions', 'organizations_url': 'https://api.github.com/users/ezyang/orgs', 'repos_url': 'https://api.github.com/users/ezyang/repos', 'events_url': 'https://api.github.com/users/ezyang/events{/privacy}', 'received_events_url': 'https://api.github.com/users/ezyang/received_events', 'type': 'User', 'site_admin': False}",referenced,c38defd20146bbec47d5ab8a1ae68f5220248c23,https://api.github.com/repos/pytorch/pytorch/commits/c38defd20146bbec47d5ab8a1ae68f5220248c23,2017-11-02T23:53:52Z,2,1,1
156,1905229164,"{'login': 'bddppq', 'id': 9300575, 'node_id': 'MDQ6VXNlcjkzMDA1NzU=', 'avatar_url': 'https://avatars2.githubusercontent.com/u/9300575?v=4', 'gravatar_id': '', 'url': 'https://api.github.com/users/bddppq', 'html_url': 'https://github.com/bddppq', 'followers_url': 'https://api.github.com/users/bddppq/followers', 'following_url': 'https://api.github.com/users/bddppq/following{/other_user}', 'gists_url': 'https://api.github.com/users/bddppq/gists{/gist_id}', 'starred_url': 'https://api.github.com/users/bddppq/starred{/owner}{/repo}', 'subscriptions_url': 'https://api.github.com/users/bddppq/subscriptions', 'organizations_url': 'https://api.github.com/users/bddppq/orgs', 'repos_url': 'https://api.github.com/users/bddppq/repos', 'events_url': 'https://api.github.com/users/bddppq/events{/privacy}', 'received_events_url': 'https://api.github.com/users/bddppq/received_events', 'type': 'User', 'site_admin': False}",referenced,69041e1b55b28860eae1f2056828737862b9bc5e,https://api.github.com/repos/pytorch/pytorch/commits/69041e1b55b28860eae1f2056828737862b9bc5e,2018-10-15T21:12:33Z,3,2,1
153,1324121709,"{'login': 'ezyang', 'id': 13564, 'node_id': 'MDQ6VXNlcjEzNTY0', 'avatar_url': 'https://avatars0.githubusercontent.com/u/13564?v=4', 'gravatar_id': '', 'url': 'https://api.github.com/users/ezyang', 'html_url': 'https://github.com/ezyang', 'followers_url': 'https://api.github.com/users/ezyang/followers', 'following_url': 'https://api.github.com/users/ezyang/following{/other_user}', 'gists_url': 'https://api.github.com/users/ezyang/gists{/gist_id}', 'starred_url': 'https://api.github.com/users/ezyang/starred{/owner}{/repo}', 'subscriptions_url': 'https://api.github.com/users/ezyang/subscriptions', 'organizations_url': 'https://api.github.com/users/ezyang/orgs', 'repos_url': 'https://api.github.com/users/ezyang/repos', 'events_url': 'https://api.github.com/users/ezyang/events{/privacy}', 'received_events_url': 'https://api.github.com/users/ezyang/received_events', 'type': 'User', 'site_admin': False}",referenced,97bc100b920b41740c2e20b8ebf6aeb03676ed5f,https://api.github.com/repos/pytorch/pytorch/commits/97bc100b920b41740c2e20b8ebf6aeb03676ed5f,2017-11-02T23:53:52Z,27,27,0
153,1905229170,"{'login': 'bddppq', 'id': 9300575, 'node_id': 'MDQ6VXNlcjkzMDA1NzU=', 'avatar_url': 'https://avatars2.githubusercontent.com/u/9300575?v=4', 'gravatar_id': '', 'url': 'https://api.github.com/users/bddppq', 'html_url': 'https://github.com/bddppq', 'followers_url': 'https://api.github.com/users/bddppq/followers', 'following_url': 'https://api.github.com/users/bddppq/following{/other_user}', 'gists_url': 'https://api.github.com/users/bddppq/gists{/gist_id}', 'starred_url': 'https://api.github.com/users/bddppq/starred{/owner}{/repo}', 'subscriptions_url': 'https://api.github.com/users/bddppq/subscriptions', 'organizations_url': 'https://api.github.com/users/bddppq/orgs', 'repos_url': 'https://api.github.com/users/bddppq/repos', 'events_url': 'https://api.github.com/users/bddppq/events{/privacy}', 'received_events_url': 'https://api.github.com/users/bddppq/received_events', 'type': 'User', 'site_admin': False}",referenced,639068adcfbfa2105684a1d86bc8718338396d27,https://api.github.com/repos/pytorch/pytorch/commits/639068adcfbfa2105684a1d86bc8718338396d27,2018-10-15T21:12:33Z,17,14,3
149,1905229230,"{'login': 'bddppq', 'id': 9300575, 'node_id': 'MDQ6VXNlcjkzMDA1NzU=', 'avatar_url': 'https://avatars2.githubusercontent.com/u/9300575?v=4', 'gravatar_id': '', 'url': 'https://api.github.com/users/bddppq', 'html_url': 'https://github.com/bddppq', 'followers_url': 'https://api.github.com/users/bddppq/followers', 'following_url': 'https://api.github.com/users/bddppq/following{/other_user}', 'gists_url': 'https://api.github.com/users/bddppq/gists{/gist_id}', 'starred_url': 'https://api.github.com/users/bddppq/starred{/owner}{/repo}', 'subscriptions_url': 'https://api.github.com/users/bddppq/subscriptions', 'organizations_url': 'https://api.github.com/users/bddppq/orgs', 'repos_url': 'https://api.github.com/users/bddppq/repos', 'events_url': 'https://api.github.com/users/bddppq/events{/privacy}', 'received_events_url': 'https://api.github.com/users/bddppq/received_events', 'type': 'User', 'site_admin': False}",referenced,f10a7b9ef2867215dd59dd616307c747d630c6cf,https://api.github.com/repos/pytorch/pytorch/commits/f10a7b9ef2867215dd59dd616307c747d630c6cf,2018-10-15T21:12:34Z,665,429,236
148,1235766066,"{'login': 'soumith', 'id': 1310570, 'node_id': 'MDQ6VXNlcjEzMTA1NzA=', 'avatar_url': 'https://avatars0.githubusercontent.com/u/1310570?v=4', 'gravatar_id': '', 'url': 'https://api.github.com/users/soumith', 'html_url': 'https://github.com/soumith', 'followers_url': 'https://api.github.com/users/soumith/followers', 'following_url': 'https://api.github.com/users/soumith/following{/other_user}', 'gists_url': 'https://api.github.com/users/soumith/gists{/gist_id}', 'starred_url': 'https://api.github.com/users/soumith/starred{/owner}{/repo}', 'subscriptions_url': 'https://api.github.com/users/soumith/subscriptions', 'organizations_url': 'https://api.github.com/users/soumith/orgs', 'repos_url': 'https://api.github.com/users/soumith/repos', 'events_url': 'https://api.github.com/users/soumith/events{/privacy}', 'received_events_url': 'https://api.github.com/users/soumith/received_events', 'type': 'User', 'site_admin': False}",referenced,1e0171f4364d8e26aafc014500532db23002ced7,https://api.github.com/repos/pytorch/pytorch/commits/1e0171f4364d8e26aafc014500532db23002ced7,2017-09-05T21:49:03Z,5,5,0
139,1905229156,"{'login': 'bddppq', 'id': 9300575, 'node_id': 'MDQ6VXNlcjkzMDA1NzU=', 'avatar_url': 'https://avatars2.githubusercontent.com/u/9300575?v=4', 'gravatar_id': '', 'url': 'https://api.github.com/users/bddppq', 'html_url': 'https://github.com/bddppq', 'followers_url': 'https://api.github.com/users/bddppq/followers', 'following_url': 'https://api.github.com/users/bddppq/following{/other_user}', 'gists_url': 'https://api.github.com/users/bddppq/gists{/gist_id}', 'starred_url': 'https://api.github.com/users/bddppq/starred{/owner}{/repo}', 'subscriptions_url': 'https://api.github.com/users/bddppq/subscriptions', 'organizations_url': 'https://api.github.com/users/bddppq/orgs', 'repos_url': 'https://api.github.com/users/bddppq/repos', 'events_url': 'https://api.github.com/users/bddppq/events{/privacy}', 'received_events_url': 'https://api.github.com/users/bddppq/received_events', 'type': 'User', 'site_admin': False}",referenced,5fc6cdb10051ba8a5bdcc16c7c43fceec6f85b8a,https://api.github.com/repos/pytorch/pytorch/commits/5fc6cdb10051ba8a5bdcc16c7c43fceec6f85b8a,2018-10-15T21:12:33Z,8,7,1
94,1905229111,"{'login': 'bddppq', 'id': 9300575, 'node_id': 'MDQ6VXNlcjkzMDA1NzU=', 'avatar_url': 'https://avatars2.githubusercontent.com/u/9300575?v=4', 'gravatar_id': '', 'url': 'https://api.github.com/users/bddppq', 'html_url': 'https://github.com/bddppq', 'followers_url': 'https://api.github.com/users/bddppq/followers', 'following_url': 'https://api.github.com/users/bddppq/following{/other_user}', 'gists_url': 'https://api.github.com/users/bddppq/gists{/gist_id}', 'starred_url': 'https://api.github.com/users/bddppq/starred{/owner}{/repo}', 'subscriptions_url': 'https://api.github.com/users/bddppq/subscriptions', 'organizations_url': 'https://api.github.com/users/bddppq/orgs', 'repos_url': 'https://api.github.com/users/bddppq/repos', 'events_url': 'https://api.github.com/users/bddppq/events{/privacy}', 'received_events_url': 'https://api.github.com/users/bddppq/received_events', 'type': 'User', 'site_admin': False}",referenced,dd73529b6c153a8a4a863b09d81fb8958cbfe4bd,https://api.github.com/repos/pytorch/pytorch/commits/dd73529b6c153a8a4a863b09d81fb8958cbfe4bd,2018-10-15T21:12:32Z,63,42,21
92,1905229074,"{'login': 'bddppq', 'id': 9300575, 'node_id': 'MDQ6VXNlcjkzMDA1NzU=', 'avatar_url': 'https://avatars2.githubusercontent.com/u/9300575?v=4', 'gravatar_id': '', 'url': 'https://api.github.com/users/bddppq', 'html_url': 'https://github.com/bddppq', 'followers_url': 'https://api.github.com/users/bddppq/followers', 'following_url': 'https://api.github.com/users/bddppq/following{/other_user}', 'gists_url': 'https://api.github.com/users/bddppq/gists{/gist_id}', 'starred_url': 'https://api.github.com/users/bddppq/starred{/owner}{/repo}', 'subscriptions_url': 'https://api.github.com/users/bddppq/subscriptions', 'organizations_url': 'https://api.github.com/users/bddppq/orgs', 'repos_url': 'https://api.github.com/users/bddppq/repos', 'events_url': 'https://api.github.com/users/bddppq/events{/privacy}', 'received_events_url': 'https://api.github.com/users/bddppq/received_events', 'type': 'User', 'site_admin': False}",referenced,e2f381767460555081dffd29ed32bb5d2fdd9ef9,https://api.github.com/repos/pytorch/pytorch/commits/e2f381767460555081dffd29ed32bb5d2fdd9ef9,2018-10-15T21:12:31Z,119,118,1
87,1905229068,"{'login': 'bddppq', 'id': 9300575, 'node_id': 'MDQ6VXNlcjkzMDA1NzU=', 'avatar_url': 'https://avatars2.githubusercontent.com/u/9300575?v=4', 'gravatar_id': '', 'url': 'https://api.github.com/users/bddppq', 'html_url': 'https://github.com/bddppq', 'followers_url': 'https://api.github.com/users/bddppq/followers', 'following_url': 'https://api.github.com/users/bddppq/following{/other_user}', 'gists_url': 'https://api.github.com/users/bddppq/gists{/gist_id}', 'starred_url': 'https://api.github.com/users/bddppq/starred{/owner}{/repo}', 'subscriptions_url': 'https://api.github.com/users/bddppq/subscriptions', 'organizations_url': 'https://api.github.com/users/bddppq/orgs', 'repos_url': 'https://api.github.com/users/bddppq/repos', 'events_url': 'https://api.github.com/users/bddppq/events{/privacy}', 'received_events_url': 'https://api.github.com/users/bddppq/received_events', 'type': 'User', 'site_admin': False}",referenced,335cc0962e4ca5151151e79bf39d8d6d0d18e973,https://api.github.com/repos/pytorch/pytorch/commits/335cc0962e4ca5151151e79bf39d8d6d0d18e973,2018-10-15T21:12:31Z,6,3,3
86,1905229063,"{'login': 'bddppq', 'id': 9300575, 'node_id': 'MDQ6VXNlcjkzMDA1NzU=', 'avatar_url': 'https://avatars2.githubusercontent.com/u/9300575?v=4', 'gravatar_id': '', 'url': 'https://api.github.com/users/bddppq', 'html_url': 'https://github.com/bddppq', 'followers_url': 'https://api.github.com/users/bddppq/followers', 'following_url': 'https://api.github.com/users/bddppq/following{/other_user}', 'gists_url': 'https://api.github.com/users/bddppq/gists{/gist_id}', 'starred_url': 'https://api.github.com/users/bddppq/starred{/owner}{/repo}', 'subscriptions_url': 'https://api.github.com/users/bddppq/subscriptions', 'organizations_url': 'https://api.github.com/users/bddppq/orgs', 'repos_url': 'https://api.github.com/users/bddppq/repos', 'events_url': 'https://api.github.com/users/bddppq/events{/privacy}', 'received_events_url': 'https://api.github.com/users/bddppq/received_events', 'type': 'User', 'site_admin': False}",referenced,ead17edcfe4f6da700456c52a0e8505c4a869756,https://api.github.com/repos/pytorch/pytorch/commits/ead17edcfe4f6da700456c52a0e8505c4a869756,2018-10-15T21:12:31Z,118,60,58
82,826435392,"{'login': 'colesbury', 'id': 655866, 'node_id': 'MDQ6VXNlcjY1NTg2Ng==', 'avatar_url': 'https://avatars1.githubusercontent.com/u/655866?v=4', 'gravatar_id': '', 'url': 'https://api.github.com/users/colesbury', 'html_url': 'https://github.com/colesbury', 'followers_url': 'https://api.github.com/users/colesbury/followers', 'following_url': 'https://api.github.com/users/colesbury/following{/other_user}', 'gists_url': 'https://api.github.com/users/colesbury/gists{/gist_id}', 'starred_url': 'https://api.github.com/users/colesbury/starred{/owner}{/repo}', 'subscriptions_url': 'https://api.github.com/users/colesbury/subscriptions', 'organizations_url': 'https://api.github.com/users/colesbury/orgs', 'repos_url': 'https://api.github.com/users/colesbury/repos', 'events_url': 'https://api.github.com/users/colesbury/events{/privacy}', 'received_events_url': 'https://api.github.com/users/colesbury/received_events', 'type': 'User', 'site_admin': False}",referenced,3931beee812cb59904e56f1762cd0acc1fabc32c,https://api.github.com/repos/pytorch/pytorch/commits/3931beee812cb59904e56f1762cd0acc1fabc32c,2016-10-17T19:15:02Z,16,4,12
82,1104268106,"{'login': 'apaszke', 'id': 4583066, 'node_id': 'MDQ6VXNlcjQ1ODMwNjY=', 'avatar_url': 'https://avatars3.githubusercontent.com/u/4583066?v=4', 'gravatar_id': '', 'url': 'https://api.github.com/users/apaszke', 'html_url': 'https://github.com/apaszke', 'followers_url': 'https://api.github.com/users/apaszke/followers', 'following_url': 'https://api.github.com/users/apaszke/following{/other_user}', 'gists_url': 'https://api.github.com/users/apaszke/gists{/gist_id}', 'starred_url': 'https://api.github.com/users/apaszke/starred{/owner}{/repo}', 'subscriptions_url': 'https://api.github.com/users/apaszke/subscriptions', 'organizations_url': 'https://api.github.com/users/apaszke/orgs', 'repos_url': 'https://api.github.com/users/apaszke/repos', 'events_url': 'https://api.github.com/users/apaszke/events{/privacy}', 'received_events_url': 'https://api.github.com/users/apaszke/received_events', 'type': 'User', 'site_admin': False}",referenced,243f912c78a5061ef616c0c6c36041896346ef32,https://api.github.com/repos/pytorch/pytorch/commits/243f912c78a5061ef616c0c6c36041896346ef32,2017-05-31T14:22:29Z,34,28,6
82,1104779641,"{'login': 'apaszke', 'id': 4583066, 'node_id': 'MDQ6VXNlcjQ1ODMwNjY=', 'avatar_url': 'https://avatars3.githubusercontent.com/u/4583066?v=4', 'gravatar_id': '', 'url': 'https://api.github.com/users/apaszke', 'html_url': 'https://github.com/apaszke', 'followers_url': 'https://api.github.com/users/apaszke/followers', 'following_url': 'https://api.github.com/users/apaszke/following{/other_user}', 'gists_url': 'https://api.github.com/users/apaszke/gists{/gist_id}', 'starred_url': 'https://api.github.com/users/apaszke/starred{/owner}{/repo}', 'subscriptions_url': 'https://api.github.com/users/apaszke/subscriptions', 'organizations_url': 'https://api.github.com/users/apaszke/orgs', 'repos_url': 'https://api.github.com/users/apaszke/repos', 'events_url': 'https://api.github.com/users/apaszke/events{/privacy}', 'received_events_url': 'https://api.github.com/users/apaszke/received_events', 'type': 'User', 'site_admin': False}",referenced,3b776738ccc49c6a4ac991b8c22f5c5593c92ac2,https://api.github.com/repos/pytorch/pytorch/commits/3b776738ccc49c6a4ac991b8c22f5c5593c92ac2,2017-05-31T19:07:09Z,34,28,6
82,1108547637,"{'login': 'apaszke', 'id': 4583066, 'node_id': 'MDQ6VXNlcjQ1ODMwNjY=', 'avatar_url': 'https://avatars3.githubusercontent.com/u/4583066?v=4', 'gravatar_id': '', 'url': 'https://api.github.com/users/apaszke', 'html_url': 'https://github.com/apaszke', 'followers_url': 'https://api.github.com/users/apaszke/followers', 'following_url': 'https://api.github.com/users/apaszke/following{/other_user}', 'gists_url': 'https://api.github.com/users/apaszke/gists{/gist_id}', 'starred_url': 'https://api.github.com/users/apaszke/starred{/owner}{/repo}', 'subscriptions_url': 'https://api.github.com/users/apaszke/subscriptions', 'organizations_url': 'https://api.github.com/users/apaszke/orgs', 'repos_url': 'https://api.github.com/users/apaszke/repos', 'events_url': 'https://api.github.com/users/apaszke/events{/privacy}', 'received_events_url': 'https://api.github.com/users/apaszke/received_events', 'type': 'User', 'site_admin': False}",referenced,240384605cc9f7458c84bcc5bf56c608cfeee9d5,https://api.github.com/repos/pytorch/pytorch/commits/240384605cc9f7458c84bcc5bf56c608cfeee9d5,2017-06-02T21:42:17Z,34,28,6
81,826435391,"{'login': 'colesbury', 'id': 655866, 'node_id': 'MDQ6VXNlcjY1NTg2Ng==', 'avatar_url': 'https://avatars1.githubusercontent.com/u/655866?v=4', 'gravatar_id': '', 'url': 'https://api.github.com/users/colesbury', 'html_url': 'https://github.com/colesbury', 'followers_url': 'https://api.github.com/users/colesbury/followers', 'following_url': 'https://api.github.com/users/colesbury/following{/other_user}', 'gists_url': 'https://api.github.com/users/colesbury/gists{/gist_id}', 'starred_url': 'https://api.github.com/users/colesbury/starred{/owner}{/repo}', 'subscriptions_url': 'https://api.github.com/users/colesbury/subscriptions', 'organizations_url': 'https://api.github.com/users/colesbury/orgs', 'repos_url': 'https://api.github.com/users/colesbury/repos', 'events_url': 'https://api.github.com/users/colesbury/events{/privacy}', 'received_events_url': 'https://api.github.com/users/colesbury/received_events', 'type': 'User', 'site_admin': False}",referenced,3931beee812cb59904e56f1762cd0acc1fabc32c,https://api.github.com/repos/pytorch/pytorch/commits/3931beee812cb59904e56f1762cd0acc1fabc32c,2016-10-17T19:15:02Z,16,4,12
81,1324121683,"{'login': 'ezyang', 'id': 13564, 'node_id': 'MDQ6VXNlcjEzNTY0', 'avatar_url': 'https://avatars0.githubusercontent.com/u/13564?v=4', 'gravatar_id': '', 'url': 'https://api.github.com/users/ezyang', 'html_url': 'https://github.com/ezyang', 'followers_url': 'https://api.github.com/users/ezyang/followers', 'following_url': 'https://api.github.com/users/ezyang/following{/other_user}', 'gists_url': 'https://api.github.com/users/ezyang/gists{/gist_id}', 'starred_url': 'https://api.github.com/users/ezyang/starred{/owner}{/repo}', 'subscriptions_url': 'https://api.github.com/users/ezyang/subscriptions', 'organizations_url': 'https://api.github.com/users/ezyang/orgs', 'repos_url': 'https://api.github.com/users/ezyang/repos', 'events_url': 'https://api.github.com/users/ezyang/events{/privacy}', 'received_events_url': 'https://api.github.com/users/ezyang/received_events', 'type': 'User', 'site_admin': False}",referenced,c8c967fa431920cfb232aeabe85ba6b178fa5a78,https://api.github.com/repos/pytorch/pytorch/commits/c8c967fa431920cfb232aeabe85ba6b178fa5a78,2017-11-02T23:53:51Z,33,26,7
81,1905229051,"{'login': 'bddppq', 'id': 9300575, 'node_id': 'MDQ6VXNlcjkzMDA1NzU=', 'avatar_url': 'https://avatars2.githubusercontent.com/u/9300575?v=4', 'gravatar_id': '', 'url': 'https://api.github.com/users/bddppq', 'html_url': 'https://github.com/bddppq', 'followers_url': 'https://api.github.com/users/bddppq/followers', 'following_url': 'https://api.github.com/users/bddppq/following{/other_user}', 'gists_url': 'https://api.github.com/users/bddppq/gists{/gist_id}', 'starred_url': 'https://api.github.com/users/bddppq/starred{/owner}{/repo}', 'subscriptions_url': 'https://api.github.com/users/bddppq/subscriptions', 'organizations_url': 'https://api.github.com/users/bddppq/orgs', 'repos_url': 'https://api.github.com/users/bddppq/repos', 'events_url': 'https://api.github.com/users/bddppq/events{/privacy}', 'received_events_url': 'https://api.github.com/users/bddppq/received_events', 'type': 'User', 'site_admin': False}",referenced,aa07c25edbd08820b5c66b30c2ff31537b258f95,https://api.github.com/repos/pytorch/pytorch/commits/aa07c25edbd08820b5c66b30c2ff31537b258f95,2018-10-15T21:12:31Z,1,1,0
63,1905229124,"{'login': 'bddppq', 'id': 9300575, 'node_id': 'MDQ6VXNlcjkzMDA1NzU=', 'avatar_url': 'https://avatars2.githubusercontent.com/u/9300575?v=4', 'gravatar_id': '', 'url': 'https://api.github.com/users/bddppq', 'html_url': 'https://github.com/bddppq', 'followers_url': 'https://api.github.com/users/bddppq/followers', 'following_url': 'https://api.github.com/users/bddppq/following{/other_user}', 'gists_url': 'https://api.github.com/users/bddppq/gists{/gist_id}', 'starred_url': 'https://api.github.com/users/bddppq/starred{/owner}{/repo}', 'subscriptions_url': 'https://api.github.com/users/bddppq/subscriptions', 'organizations_url': 'https://api.github.com/users/bddppq/orgs', 'repos_url': 'https://api.github.com/users/bddppq/repos', 'events_url': 'https://api.github.com/users/bddppq/events{/privacy}', 'received_events_url': 'https://api.github.com/users/bddppq/received_events', 'type': 'User', 'site_admin': False}",referenced,765542db16eed8d9270c160a34ec23537f4f926c,https://api.github.com/repos/pytorch/pytorch/commits/765542db16eed8d9270c160a34ec23537f4f926c,2018-10-15T21:12:32Z,74,29,45
46,942160438,"{'login': 'apaszke', 'id': 4583066, 'node_id': 'MDQ6VXNlcjQ1ODMwNjY=', 'avatar_url': 'https://avatars3.githubusercontent.com/u/4583066?v=4', 'gravatar_id': '', 'url': 'https://api.github.com/users/apaszke', 'html_url': 'https://github.com/apaszke', 'followers_url': 'https://api.github.com/users/apaszke/followers', 'following_url': 'https://api.github.com/users/apaszke/following{/other_user}', 'gists_url': 'https://api.github.com/users/apaszke/gists{/gist_id}', 'starred_url': 'https://api.github.com/users/apaszke/starred{/owner}{/repo}', 'subscriptions_url': 'https://api.github.com/users/apaszke/subscriptions', 'organizations_url': 'https://api.github.com/users/apaszke/orgs', 'repos_url': 'https://api.github.com/users/apaszke/repos', 'events_url': 'https://api.github.com/users/apaszke/events{/privacy}', 'received_events_url': 'https://api.github.com/users/apaszke/received_events', 'type': 'User', 'site_admin': False}",referenced,02cc73097c3e924b57c640a08610f8619f37500b,https://api.github.com/repos/pytorch/pytorch/commits/02cc73097c3e924b57c640a08610f8619f37500b,2017-01-30T22:09:29Z,662,549,113
46,942351643,"{'login': 'apaszke', 'id': 4583066, 'node_id': 'MDQ6VXNlcjQ1ODMwNjY=', 'avatar_url': 'https://avatars3.githubusercontent.com/u/4583066?v=4', 'gravatar_id': '', 'url': 'https://api.github.com/users/apaszke', 'html_url': 'https://github.com/apaszke', 'followers_url': 'https://api.github.com/users/apaszke/followers', 'following_url': 'https://api.github.com/users/apaszke/following{/other_user}', 'gists_url': 'https://api.github.com/users/apaszke/gists{/gist_id}', 'starred_url': 'https://api.github.com/users/apaszke/starred{/owner}{/repo}', 'subscriptions_url': 'https://api.github.com/users/apaszke/subscriptions', 'organizations_url': 'https://api.github.com/users/apaszke/orgs', 'repos_url': 'https://api.github.com/users/apaszke/repos', 'events_url': 'https://api.github.com/users/apaszke/events{/privacy}', 'received_events_url': 'https://api.github.com/users/apaszke/received_events', 'type': 'User', 'site_admin': False}",referenced,5aaa220d84ca7611e38ad447831d02c9776efd17,https://api.github.com/repos/pytorch/pytorch/commits/5aaa220d84ca7611e38ad447831d02c9776efd17,2017-01-31T00:58:12Z,662,549,113
46,1736415402,"{'login': 'facebook-github-bot', 'id': 6422482, 'node_id': 'MDQ6VXNlcjY0MjI0ODI=', 'avatar_url': 'https://avatars3.githubusercontent.com/u/6422482?v=4', 'gravatar_id': '', 'url': 'https://api.github.com/users/facebook-github-bot', 'html_url': 'https://github.com/facebook-github-bot', 'followers_url': 'https://api.github.com/users/facebook-github-bot/followers', 'following_url': 'https://api.github.com/users/facebook-github-bot/following{/other_user}', 'gists_url': 'https://api.github.com/users/facebook-github-bot/gists{/gist_id}', 'starred_url': 'https://api.github.com/users/facebook-github-bot/starred{/owner}{/repo}', 'subscriptions_url': 'https://api.github.com/users/facebook-github-bot/subscriptions', 'organizations_url': 'https://api.github.com/users/facebook-github-bot/orgs', 'repos_url': 'https://api.github.com/users/facebook-github-bot/repos', 'events_url': 'https://api.github.com/users/facebook-github-bot/events{/privacy}', 'received_events_url': 'https://api.github.com/users/facebook-github-bot/received_events', 'type': 'User', 'site_admin': False}",closed,976f9253a5425918eda7cf865b097cf42b5da8d7,https://api.github.com/repos/pytorch/pytorch/commits/976f9253a5425918eda7cf865b097cf42b5da8d7,2018-07-16T22:41:29Z,332,139,193
46,1905228976,"{'login': 'bddppq', 'id': 9300575, 'node_id': 'MDQ6VXNlcjkzMDA1NzU=', 'avatar_url': 'https://avatars2.githubusercontent.com/u/9300575?v=4', 'gravatar_id': '', 'url': 'https://api.github.com/users/bddppq', 'html_url': 'https://github.com/bddppq', 'followers_url': 'https://api.github.com/users/bddppq/followers', 'following_url': 'https://api.github.com/users/bddppq/following{/other_user}', 'gists_url': 'https://api.github.com/users/bddppq/gists{/gist_id}', 'starred_url': 'https://api.github.com/users/bddppq/starred{/owner}{/repo}', 'subscriptions_url': 'https://api.github.com/users/bddppq/subscriptions', 'organizations_url': 'https://api.github.com/users/bddppq/orgs', 'repos_url': 'https://api.github.com/users/bddppq/repos', 'events_url': 'https://api.github.com/users/bddppq/events{/privacy}', 'received_events_url': 'https://api.github.com/users/bddppq/received_events', 'type': 'User', 'site_admin': False}",referenced,1e01bee476c96c9202410048dfbf50113869b05c,https://api.github.com/repos/pytorch/pytorch/commits/1e01bee476c96c9202410048dfbf50113869b05c,2018-10-15T21:12:30Z,2,1,1
46,2256802518,"{'login': 'facebook-github-bot', 'id': 6422482, 'node_id': 'MDQ6VXNlcjY0MjI0ODI=', 'avatar_url': 'https://avatars3.githubusercontent.com/u/6422482?v=4', 'gravatar_id': '', 'url': 'https://api.github.com/users/facebook-github-bot', 'html_url': 'https://github.com/facebook-github-bot', 'followers_url': 'https://api.github.com/users/facebook-github-bot/followers', 'following_url': 'https://api.github.com/users/facebook-github-bot/following{/other_user}', 'gists_url': 'https://api.github.com/users/facebook-github-bot/gists{/gist_id}', 'starred_url': 'https://api.github.com/users/facebook-github-bot/starred{/owner}{/repo}', 'subscriptions_url': 'https://api.github.com/users/facebook-github-bot/subscriptions', 'organizations_url': 'https://api.github.com/users/facebook-github-bot/orgs', 'repos_url': 'https://api.github.com/users/facebook-github-bot/repos', 'events_url': 'https://api.github.com/users/facebook-github-bot/events{/privacy}', 'received_events_url': 'https://api.github.com/users/facebook-github-bot/received_events', 'type': 'User', 'site_admin': False}",referenced,b90cbb841d98aeae435b1d02b1ff211e028cdf5b,https://api.github.com/repos/pytorch/pytorch/commits/b90cbb841d98aeae435b1d02b1ff211e028cdf5b,2019-04-05T20:02:17Z,2,1,1
43,942160434,"{'login': 'apaszke', 'id': 4583066, 'node_id': 'MDQ6VXNlcjQ1ODMwNjY=', 'avatar_url': 'https://avatars3.githubusercontent.com/u/4583066?v=4', 'gravatar_id': '', 'url': 'https://api.github.com/users/apaszke', 'html_url': 'https://github.com/apaszke', 'followers_url': 'https://api.github.com/users/apaszke/followers', 'following_url': 'https://api.github.com/users/apaszke/following{/other_user}', 'gists_url': 'https://api.github.com/users/apaszke/gists{/gist_id}', 'starred_url': 'https://api.github.com/users/apaszke/starred{/owner}{/repo}', 'subscriptions_url': 'https://api.github.com/users/apaszke/subscriptions', 'organizations_url': 'https://api.github.com/users/apaszke/orgs', 'repos_url': 'https://api.github.com/users/apaszke/repos', 'events_url': 'https://api.github.com/users/apaszke/events{/privacy}', 'received_events_url': 'https://api.github.com/users/apaszke/received_events', 'type': 'User', 'site_admin': False}",referenced,17f1b42742a73e5872ef02195f41d85162b5a859,https://api.github.com/repos/pytorch/pytorch/commits/17f1b42742a73e5872ef02195f41d85162b5a859,2017-01-30T22:09:28Z,54,20,34
43,942351639,"{'login': 'apaszke', 'id': 4583066, 'node_id': 'MDQ6VXNlcjQ1ODMwNjY=', 'avatar_url': 'https://avatars3.githubusercontent.com/u/4583066?v=4', 'gravatar_id': '', 'url': 'https://api.github.com/users/apaszke', 'html_url': 'https://github.com/apaszke', 'followers_url': 'https://api.github.com/users/apaszke/followers', 'following_url': 'https://api.github.com/users/apaszke/following{/other_user}', 'gists_url': 'https://api.github.com/users/apaszke/gists{/gist_id}', 'starred_url': 'https://api.github.com/users/apaszke/starred{/owner}{/repo}', 'subscriptions_url': 'https://api.github.com/users/apaszke/subscriptions', 'organizations_url': 'https://api.github.com/users/apaszke/orgs', 'repos_url': 'https://api.github.com/users/apaszke/repos', 'events_url': 'https://api.github.com/users/apaszke/events{/privacy}', 'received_events_url': 'https://api.github.com/users/apaszke/received_events', 'type': 'User', 'site_admin': False}",referenced,10d32fb0b7e1e4686ee4686001b49f1e24fa5349,https://api.github.com/repos/pytorch/pytorch/commits/10d32fb0b7e1e4686ee4686001b49f1e24fa5349,2017-01-31T00:58:12Z,54,20,34
43,1176992892,"{'login': 'soumith', 'id': 1310570, 'node_id': 'MDQ6VXNlcjEzMTA1NzA=', 'avatar_url': 'https://avatars0.githubusercontent.com/u/1310570?v=4', 'gravatar_id': '', 'url': 'https://api.github.com/users/soumith', 'html_url': 'https://github.com/soumith', 'followers_url': 'https://api.github.com/users/soumith/followers', 'following_url': 'https://api.github.com/users/soumith/following{/other_user}', 'gists_url': 'https://api.github.com/users/soumith/gists{/gist_id}', 'starred_url': 'https://api.github.com/users/soumith/starred{/owner}{/repo}', 'subscriptions_url': 'https://api.github.com/users/soumith/subscriptions', 'organizations_url': 'https://api.github.com/users/soumith/orgs', 'repos_url': 'https://api.github.com/users/soumith/repos', 'events_url': 'https://api.github.com/users/soumith/events{/privacy}', 'received_events_url': 'https://api.github.com/users/soumith/received_events', 'type': 'User', 'site_admin': False}",referenced,e50d59924026abbc2c01d49055bba697ea273898,https://api.github.com/repos/pytorch/pytorch/commits/e50d59924026abbc2c01d49055bba697ea273898,2017-07-24T22:13:18Z,33,20,13
43,2256802515,"{'login': 'facebook-github-bot', 'id': 6422482, 'node_id': 'MDQ6VXNlcjY0MjI0ODI=', 'avatar_url': 'https://avatars3.githubusercontent.com/u/6422482?v=4', 'gravatar_id': '', 'url': 'https://api.github.com/users/facebook-github-bot', 'html_url': 'https://github.com/facebook-github-bot', 'followers_url': 'https://api.github.com/users/facebook-github-bot/followers', 'following_url': 'https://api.github.com/users/facebook-github-bot/following{/other_user}', 'gists_url': 'https://api.github.com/users/facebook-github-bot/gists{/gist_id}', 'starred_url': 'https://api.github.com/users/facebook-github-bot/starred{/owner}{/repo}', 'subscriptions_url': 'https://api.github.com/users/facebook-github-bot/subscriptions', 'organizations_url': 'https://api.github.com/users/facebook-github-bot/orgs', 'repos_url': 'https://api.github.com/users/facebook-github-bot/repos', 'events_url': 'https://api.github.com/users/facebook-github-bot/events{/privacy}', 'received_events_url': 'https://api.github.com/users/facebook-github-bot/received_events', 'type': 'User', 'site_admin': False}",referenced,b90cbb841d98aeae435b1d02b1ff211e028cdf5b,https://api.github.com/repos/pytorch/pytorch/commits/b90cbb841d98aeae435b1d02b1ff211e028cdf5b,2019-04-05T20:02:17Z,2,1,1
42,942160436,"{'login': 'apaszke', 'id': 4583066, 'node_id': 'MDQ6VXNlcjQ1ODMwNjY=', 'avatar_url': 'https://avatars3.githubusercontent.com/u/4583066?v=4', 'gravatar_id': '', 'url': 'https://api.github.com/users/apaszke', 'html_url': 'https://github.com/apaszke', 'followers_url': 'https://api.github.com/users/apaszke/followers', 'following_url': 'https://api.github.com/users/apaszke/following{/other_user}', 'gists_url': 'https://api.github.com/users/apaszke/gists{/gist_id}', 'starred_url': 'https://api.github.com/users/apaszke/starred{/owner}{/repo}', 'subscriptions_url': 'https://api.github.com/users/apaszke/subscriptions', 'organizations_url': 'https://api.github.com/users/apaszke/orgs', 'repos_url': 'https://api.github.com/users/apaszke/repos', 'events_url': 'https://api.github.com/users/apaszke/events{/privacy}', 'received_events_url': 'https://api.github.com/users/apaszke/received_events', 'type': 'User', 'site_admin': False}",referenced,d13175a270a552c8f5651331adc6a7a0a2b20c0d,https://api.github.com/repos/pytorch/pytorch/commits/d13175a270a552c8f5651331adc6a7a0a2b20c0d,2017-01-30T22:09:29Z,2302,1491,811
42,942351641,"{'login': 'apaszke', 'id': 4583066, 'node_id': 'MDQ6VXNlcjQ1ODMwNjY=', 'avatar_url': 'https://avatars3.githubusercontent.com/u/4583066?v=4', 'gravatar_id': '', 'url': 'https://api.github.com/users/apaszke', 'html_url': 'https://github.com/apaszke', 'followers_url': 'https://api.github.com/users/apaszke/followers', 'following_url': 'https://api.github.com/users/apaszke/following{/other_user}', 'gists_url': 'https://api.github.com/users/apaszke/gists{/gist_id}', 'starred_url': 'https://api.github.com/users/apaszke/starred{/owner}{/repo}', 'subscriptions_url': 'https://api.github.com/users/apaszke/subscriptions', 'organizations_url': 'https://api.github.com/users/apaszke/orgs', 'repos_url': 'https://api.github.com/users/apaszke/repos', 'events_url': 'https://api.github.com/users/apaszke/events{/privacy}', 'received_events_url': 'https://api.github.com/users/apaszke/received_events', 'type': 'User', 'site_admin': False}",referenced,76520512e7e267dfeb610cfcc3d5ce2f50c3c351,https://api.github.com/repos/pytorch/pytorch/commits/76520512e7e267dfeb610cfcc3d5ce2f50c3c351,2017-01-31T00:58:12Z,2302,1491,811
42,2256802513,"{'login': 'facebook-github-bot', 'id': 6422482, 'node_id': 'MDQ6VXNlcjY0MjI0ODI=', 'avatar_url': 'https://avatars3.githubusercontent.com/u/6422482?v=4', 'gravatar_id': '', 'url': 'https://api.github.com/users/facebook-github-bot', 'html_url': 'https://github.com/facebook-github-bot', 'followers_url': 'https://api.github.com/users/facebook-github-bot/followers', 'following_url': 'https://api.github.com/users/facebook-github-bot/following{/other_user}', 'gists_url': 'https://api.github.com/users/facebook-github-bot/gists{/gist_id}', 'starred_url': 'https://api.github.com/users/facebook-github-bot/starred{/owner}{/repo}', 'subscriptions_url': 'https://api.github.com/users/facebook-github-bot/subscriptions', 'organizations_url': 'https://api.github.com/users/facebook-github-bot/orgs', 'repos_url': 'https://api.github.com/users/facebook-github-bot/repos', 'events_url': 'https://api.github.com/users/facebook-github-bot/events{/privacy}', 'received_events_url': 'https://api.github.com/users/facebook-github-bot/received_events', 'type': 'User', 'site_admin': False}",referenced,b90cbb841d98aeae435b1d02b1ff211e028cdf5b,https://api.github.com/repos/pytorch/pytorch/commits/b90cbb841d98aeae435b1d02b1ff211e028cdf5b,2019-04-05T20:02:17Z,2,1,1
41,942160435,"{'login': 'apaszke', 'id': 4583066, 'node_id': 'MDQ6VXNlcjQ1ODMwNjY=', 'avatar_url': 'https://avatars3.githubusercontent.com/u/4583066?v=4', 'gravatar_id': '', 'url': 'https://api.github.com/users/apaszke', 'html_url': 'https://github.com/apaszke', 'followers_url': 'https://api.github.com/users/apaszke/followers', 'following_url': 'https://api.github.com/users/apaszke/following{/other_user}', 'gists_url': 'https://api.github.com/users/apaszke/gists{/gist_id}', 'starred_url': 'https://api.github.com/users/apaszke/starred{/owner}{/repo}', 'subscriptions_url': 'https://api.github.com/users/apaszke/subscriptions', 'organizations_url': 'https://api.github.com/users/apaszke/orgs', 'repos_url': 'https://api.github.com/users/apaszke/repos', 'events_url': 'https://api.github.com/users/apaszke/events{/privacy}', 'received_events_url': 'https://api.github.com/users/apaszke/received_events', 'type': 'User', 'site_admin': False}",referenced,d74865f7aee40c9f63d09f49d81f43111804a5bf,https://api.github.com/repos/pytorch/pytorch/commits/d74865f7aee40c9f63d09f49d81f43111804a5bf,2017-01-30T22:09:29Z,555,350,205
41,942351640,"{'login': 'apaszke', 'id': 4583066, 'node_id': 'MDQ6VXNlcjQ1ODMwNjY=', 'avatar_url': 'https://avatars3.githubusercontent.com/u/4583066?v=4', 'gravatar_id': '', 'url': 'https://api.github.com/users/apaszke', 'html_url': 'https://github.com/apaszke', 'followers_url': 'https://api.github.com/users/apaszke/followers', 'following_url': 'https://api.github.com/users/apaszke/following{/other_user}', 'gists_url': 'https://api.github.com/users/apaszke/gists{/gist_id}', 'starred_url': 'https://api.github.com/users/apaszke/starred{/owner}{/repo}', 'subscriptions_url': 'https://api.github.com/users/apaszke/subscriptions', 'organizations_url': 'https://api.github.com/users/apaszke/orgs', 'repos_url': 'https://api.github.com/users/apaszke/repos', 'events_url': 'https://api.github.com/users/apaszke/events{/privacy}', 'received_events_url': 'https://api.github.com/users/apaszke/received_events', 'type': 'User', 'site_admin': False}",referenced,66de96588216b945fc475f52e353cdf915d2c52f,https://api.github.com/repos/pytorch/pytorch/commits/66de96588216b945fc475f52e353cdf915d2c52f,2017-01-31T00:58:12Z,555,350,205
41,1214327290,"{'login': 'apaszke', 'id': 4583066, 'node_id': 'MDQ6VXNlcjQ1ODMwNjY=', 'avatar_url': 'https://avatars3.githubusercontent.com/u/4583066?v=4', 'gravatar_id': '', 'url': 'https://api.github.com/users/apaszke', 'html_url': 'https://github.com/apaszke', 'followers_url': 'https://api.github.com/users/apaszke/followers', 'following_url': 'https://api.github.com/users/apaszke/following{/other_user}', 'gists_url': 'https://api.github.com/users/apaszke/gists{/gist_id}', 'starred_url': 'https://api.github.com/users/apaszke/starred{/owner}{/repo}', 'subscriptions_url': 'https://api.github.com/users/apaszke/subscriptions', 'organizations_url': 'https://api.github.com/users/apaszke/orgs', 'repos_url': 'https://api.github.com/users/apaszke/repos', 'events_url': 'https://api.github.com/users/apaszke/events{/privacy}', 'received_events_url': 'https://api.github.com/users/apaszke/received_events', 'type': 'User', 'site_admin': False}",referenced,9d8abbd5530d33cae8e4c90d8c910ccd657737fa,https://api.github.com/repos/pytorch/pytorch/commits/9d8abbd5530d33cae8e4c90d8c910ccd657737fa,2017-08-21T15:12:42Z,90,85,5
41,1235766047,"{'login': 'soumith', 'id': 1310570, 'node_id': 'MDQ6VXNlcjEzMTA1NzA=', 'avatar_url': 'https://avatars0.githubusercontent.com/u/1310570?v=4', 'gravatar_id': '', 'url': 'https://api.github.com/users/soumith', 'html_url': 'https://github.com/soumith', 'followers_url': 'https://api.github.com/users/soumith/followers', 'following_url': 'https://api.github.com/users/soumith/following{/other_user}', 'gists_url': 'https://api.github.com/users/soumith/gists{/gist_id}', 'starred_url': 'https://api.github.com/users/soumith/starred{/owner}{/repo}', 'subscriptions_url': 'https://api.github.com/users/soumith/subscriptions', 'organizations_url': 'https://api.github.com/users/soumith/orgs', 'repos_url': 'https://api.github.com/users/soumith/repos', 'events_url': 'https://api.github.com/users/soumith/events{/privacy}', 'received_events_url': 'https://api.github.com/users/soumith/received_events', 'type': 'User', 'site_admin': False}",referenced,4a1bbc01ac71e7410ddcca9a947964a6819b4bdb,https://api.github.com/repos/pytorch/pytorch/commits/4a1bbc01ac71e7410ddcca9a947964a6819b4bdb,2017-09-05T21:49:03Z,90,85,5
41,2256802510,"{'login': 'facebook-github-bot', 'id': 6422482, 'node_id': 'MDQ6VXNlcjY0MjI0ODI=', 'avatar_url': 'https://avatars3.githubusercontent.com/u/6422482?v=4', 'gravatar_id': '', 'url': 'https://api.github.com/users/facebook-github-bot', 'html_url': 'https://github.com/facebook-github-bot', 'followers_url': 'https://api.github.com/users/facebook-github-bot/followers', 'following_url': 'https://api.github.com/users/facebook-github-bot/following{/other_user}', 'gists_url': 'https://api.github.com/users/facebook-github-bot/gists{/gist_id}', 'starred_url': 'https://api.github.com/users/facebook-github-bot/starred{/owner}{/repo}', 'subscriptions_url': 'https://api.github.com/users/facebook-github-bot/subscriptions', 'organizations_url': 'https://api.github.com/users/facebook-github-bot/orgs', 'repos_url': 'https://api.github.com/users/facebook-github-bot/repos', 'events_url': 'https://api.github.com/users/facebook-github-bot/events{/privacy}', 'received_events_url': 'https://api.github.com/users/facebook-github-bot/received_events', 'type': 'User', 'site_admin': False}",referenced,b90cbb841d98aeae435b1d02b1ff211e028cdf5b,https://api.github.com/repos/pytorch/pytorch/commits/b90cbb841d98aeae435b1d02b1ff211e028cdf5b,2019-04-05T20:02:17Z,2,1,1
35,1180739213,"{'login': 'soumith', 'id': 1310570, 'node_id': 'MDQ6VXNlcjEzMTA1NzA=', 'avatar_url': 'https://avatars0.githubusercontent.com/u/1310570?v=4', 'gravatar_id': '', 'url': 'https://api.github.com/users/soumith', 'html_url': 'https://github.com/soumith', 'followers_url': 'https://api.github.com/users/soumith/followers', 'following_url': 'https://api.github.com/users/soumith/following{/other_user}', 'gists_url': 'https://api.github.com/users/soumith/gists{/gist_id}', 'starred_url': 'https://api.github.com/users/soumith/starred{/owner}{/repo}', 'subscriptions_url': 'https://api.github.com/users/soumith/subscriptions', 'organizations_url': 'https://api.github.com/users/soumith/orgs', 'repos_url': 'https://api.github.com/users/soumith/repos', 'events_url': 'https://api.github.com/users/soumith/events{/privacy}', 'received_events_url': 'https://api.github.com/users/soumith/received_events', 'type': 'User', 'site_admin': False}",referenced,be9ef9283f297997afd3bf8e21147ec6bf09ebbf,https://api.github.com/repos/pytorch/pytorch/commits/be9ef9283f297997afd3bf8e21147ec6bf09ebbf,2017-07-26T21:41:32Z,11,11,0
35,1905228962,"{'login': 'bddppq', 'id': 9300575, 'node_id': 'MDQ6VXNlcjkzMDA1NzU=', 'avatar_url': 'https://avatars2.githubusercontent.com/u/9300575?v=4', 'gravatar_id': '', 'url': 'https://api.github.com/users/bddppq', 'html_url': 'https://github.com/bddppq', 'followers_url': 'https://api.github.com/users/bddppq/followers', 'following_url': 'https://api.github.com/users/bddppq/following{/other_user}', 'gists_url': 'https://api.github.com/users/bddppq/gists{/gist_id}', 'starred_url': 'https://api.github.com/users/bddppq/starred{/owner}{/repo}', 'subscriptions_url': 'https://api.github.com/users/bddppq/subscriptions', 'organizations_url': 'https://api.github.com/users/bddppq/orgs', 'repos_url': 'https://api.github.com/users/bddppq/repos', 'events_url': 'https://api.github.com/users/bddppq/events{/privacy}', 'received_events_url': 'https://api.github.com/users/bddppq/received_events', 'type': 'User', 'site_admin': False}",referenced,e556e1c2f791721b2924701615cff51edcfe80c9,https://api.github.com/repos/pytorch/pytorch/commits/e556e1c2f791721b2924701615cff51edcfe80c9,2018-10-15T21:12:30Z,28,26,2
32,1905228952,"{'login': 'bddppq', 'id': 9300575, 'node_id': 'MDQ6VXNlcjkzMDA1NzU=', 'avatar_url': 'https://avatars2.githubusercontent.com/u/9300575?v=4', 'gravatar_id': '', 'url': 'https://api.github.com/users/bddppq', 'html_url': 'https://github.com/bddppq', 'followers_url': 'https://api.github.com/users/bddppq/followers', 'following_url': 'https://api.github.com/users/bddppq/following{/other_user}', 'gists_url': 'https://api.github.com/users/bddppq/gists{/gist_id}', 'starred_url': 'https://api.github.com/users/bddppq/starred{/owner}{/repo}', 'subscriptions_url': 'https://api.github.com/users/bddppq/subscriptions', 'organizations_url': 'https://api.github.com/users/bddppq/orgs', 'repos_url': 'https://api.github.com/users/bddppq/repos', 'events_url': 'https://api.github.com/users/bddppq/events{/privacy}', 'received_events_url': 'https://api.github.com/users/bddppq/received_events', 'type': 'User', 'site_admin': False}",referenced,7f583291c1a93bf6eb36875190b88b5424733886,https://api.github.com/repos/pytorch/pytorch/commits/7f583291c1a93bf6eb36875190b88b5424733886,2018-10-15T21:12:29Z,43,29,14
31,1905228949,"{'login': 'bddppq', 'id': 9300575, 'node_id': 'MDQ6VXNlcjkzMDA1NzU=', 'avatar_url': 'https://avatars2.githubusercontent.com/u/9300575?v=4', 'gravatar_id': '', 'url': 'https://api.github.com/users/bddppq', 'html_url': 'https://github.com/bddppq', 'followers_url': 'https://api.github.com/users/bddppq/followers', 'following_url': 'https://api.github.com/users/bddppq/following{/other_user}', 'gists_url': 'https://api.github.com/users/bddppq/gists{/gist_id}', 'starred_url': 'https://api.github.com/users/bddppq/starred{/owner}{/repo}', 'subscriptions_url': 'https://api.github.com/users/bddppq/subscriptions', 'organizations_url': 'https://api.github.com/users/bddppq/orgs', 'repos_url': 'https://api.github.com/users/bddppq/repos', 'events_url': 'https://api.github.com/users/bddppq/events{/privacy}', 'received_events_url': 'https://api.github.com/users/bddppq/received_events', 'type': 'User', 'site_admin': False}",referenced,367516446e5ee903ae0fd857104153e6457a1105,https://api.github.com/repos/pytorch/pytorch/commits/367516446e5ee903ae0fd857104153e6457a1105,2018-10-15T21:12:29Z,36,27,9
30,1905228945,"{'login': 'bddppq', 'id': 9300575, 'node_id': 'MDQ6VXNlcjkzMDA1NzU=', 'avatar_url': 'https://avatars2.githubusercontent.com/u/9300575?v=4', 'gravatar_id': '', 'url': 'https://api.github.com/users/bddppq', 'html_url': 'https://github.com/bddppq', 'followers_url': 'https://api.github.com/users/bddppq/followers', 'following_url': 'https://api.github.com/users/bddppq/following{/other_user}', 'gists_url': 'https://api.github.com/users/bddppq/gists{/gist_id}', 'starred_url': 'https://api.github.com/users/bddppq/starred{/owner}{/repo}', 'subscriptions_url': 'https://api.github.com/users/bddppq/subscriptions', 'organizations_url': 'https://api.github.com/users/bddppq/orgs', 'repos_url': 'https://api.github.com/users/bddppq/repos', 'events_url': 'https://api.github.com/users/bddppq/events{/privacy}', 'received_events_url': 'https://api.github.com/users/bddppq/received_events', 'type': 'User', 'site_admin': False}",referenced,663c7435835cd4935daa16269d8d880ab1ce4d36,https://api.github.com/repos/pytorch/pytorch/commits/663c7435835cd4935daa16269d8d880ab1ce4d36,2018-10-15T21:12:29Z,42,23,19
29,1208594456,"{'login': 'yogi81', 'id': 9338561, 'node_id': 'MDQ6VXNlcjkzMzg1NjE=', 'avatar_url': 'https://avatars3.githubusercontent.com/u/9338561?v=4', 'gravatar_id': '', 'url': 'https://api.github.com/users/yogi81', 'html_url': 'https://github.com/yogi81', 'followers_url': 'https://api.github.com/users/yogi81/followers', 'following_url': 'https://api.github.com/users/yogi81/following{/other_user}', 'gists_url': 'https://api.github.com/users/yogi81/gists{/gist_id}', 'starred_url': 'https://api.github.com/users/yogi81/starred{/owner}{/repo}', 'subscriptions_url': 'https://api.github.com/users/yogi81/subscriptions', 'organizations_url': 'https://api.github.com/users/yogi81/orgs', 'repos_url': 'https://api.github.com/users/yogi81/repos', 'events_url': 'https://api.github.com/users/yogi81/events{/privacy}', 'received_events_url': 'https://api.github.com/users/yogi81/received_events', 'type': 'User', 'site_admin': False}",referenced,1d9b10d312fe5e6325e399277e28aeb78fd2ddf7,https://api.github.com/repos/pytorch/pytorch/commits/1d9b10d312fe5e6325e399277e28aeb78fd2ddf7,2017-08-16T16:07:19Z,5,5,0
29,1905228942,"{'login': 'bddppq', 'id': 9300575, 'node_id': 'MDQ6VXNlcjkzMDA1NzU=', 'avatar_url': 'https://avatars2.githubusercontent.com/u/9300575?v=4', 'gravatar_id': '', 'url': 'https://api.github.com/users/bddppq', 'html_url': 'https://github.com/bddppq', 'followers_url': 'https://api.github.com/users/bddppq/followers', 'following_url': 'https://api.github.com/users/bddppq/following{/other_user}', 'gists_url': 'https://api.github.com/users/bddppq/gists{/gist_id}', 'starred_url': 'https://api.github.com/users/bddppq/starred{/owner}{/repo}', 'subscriptions_url': 'https://api.github.com/users/bddppq/subscriptions', 'organizations_url': 'https://api.github.com/users/bddppq/orgs', 'repos_url': 'https://api.github.com/users/bddppq/repos', 'events_url': 'https://api.github.com/users/bddppq/events{/privacy}', 'received_events_url': 'https://api.github.com/users/bddppq/received_events', 'type': 'User', 'site_admin': False}",referenced,a8f9452e10bcf4e023434631c2d72659ded9548e,https://api.github.com/repos/pytorch/pytorch/commits/a8f9452e10bcf4e023434631c2d72659ded9548e,2018-10-15T21:12:29Z,8,8,0
28,942160429,"{'login': 'apaszke', 'id': 4583066, 'node_id': 'MDQ6VXNlcjQ1ODMwNjY=', 'avatar_url': 'https://avatars3.githubusercontent.com/u/4583066?v=4', 'gravatar_id': '', 'url': 'https://api.github.com/users/apaszke', 'html_url': 'https://github.com/apaszke', 'followers_url': 'https://api.github.com/users/apaszke/followers', 'following_url': 'https://api.github.com/users/apaszke/following{/other_user}', 'gists_url': 'https://api.github.com/users/apaszke/gists{/gist_id}', 'starred_url': 'https://api.github.com/users/apaszke/starred{/owner}{/repo}', 'subscriptions_url': 'https://api.github.com/users/apaszke/subscriptions', 'organizations_url': 'https://api.github.com/users/apaszke/orgs', 'repos_url': 'https://api.github.com/users/apaszke/repos', 'events_url': 'https://api.github.com/users/apaszke/events{/privacy}', 'received_events_url': 'https://api.github.com/users/apaszke/received_events', 'type': 'User', 'site_admin': False}",referenced,ef8d4b619f642a50ecb14b6977f04c668a3dfc8d,https://api.github.com/repos/pytorch/pytorch/commits/ef8d4b619f642a50ecb14b6977f04c668a3dfc8d,2017-01-30T22:09:28Z,313,312,1
28,942351635,"{'login': 'apaszke', 'id': 4583066, 'node_id': 'MDQ6VXNlcjQ1ODMwNjY=', 'avatar_url': 'https://avatars3.githubusercontent.com/u/4583066?v=4', 'gravatar_id': '', 'url': 'https://api.github.com/users/apaszke', 'html_url': 'https://github.com/apaszke', 'followers_url': 'https://api.github.com/users/apaszke/followers', 'following_url': 'https://api.github.com/users/apaszke/following{/other_user}', 'gists_url': 'https://api.github.com/users/apaszke/gists{/gist_id}', 'starred_url': 'https://api.github.com/users/apaszke/starred{/owner}{/repo}', 'subscriptions_url': 'https://api.github.com/users/apaszke/subscriptions', 'organizations_url': 'https://api.github.com/users/apaszke/orgs', 'repos_url': 'https://api.github.com/users/apaszke/repos', 'events_url': 'https://api.github.com/users/apaszke/events{/privacy}', 'received_events_url': 'https://api.github.com/users/apaszke/received_events', 'type': 'User', 'site_admin': False}",referenced,3e3501c98d6c0b118fbaa665c72866ad6ee83af2,https://api.github.com/repos/pytorch/pytorch/commits/3e3501c98d6c0b118fbaa665c72866ad6ee83af2,2017-01-31T00:58:12Z,313,312,1
28,1062871832,"{'login': 'apaszke', 'id': 4583066, 'node_id': 'MDQ6VXNlcjQ1ODMwNjY=', 'avatar_url': 'https://avatars3.githubusercontent.com/u/4583066?v=4', 'gravatar_id': '', 'url': 'https://api.github.com/users/apaszke', 'html_url': 'https://github.com/apaszke', 'followers_url': 'https://api.github.com/users/apaszke/followers', 'following_url': 'https://api.github.com/users/apaszke/following{/other_user}', 'gists_url': 'https://api.github.com/users/apaszke/gists{/gist_id}', 'starred_url': 'https://api.github.com/users/apaszke/starred{/owner}{/repo}', 'subscriptions_url': 'https://api.github.com/users/apaszke/subscriptions', 'organizations_url': 'https://api.github.com/users/apaszke/orgs', 'repos_url': 'https://api.github.com/users/apaszke/repos', 'events_url': 'https://api.github.com/users/apaszke/events{/privacy}', 'received_events_url': 'https://api.github.com/users/apaszke/received_events', 'type': 'User', 'site_admin': False}",referenced,d95feb3feb940da1488c71088cf1ec05083a24f7,https://api.github.com/repos/pytorch/pytorch/commits/d95feb3feb940da1488c71088cf1ec05083a24f7,2017-04-28T22:00:49Z,5,5,0
28,1177193992,"{'login': 'soumith', 'id': 1310570, 'node_id': 'MDQ6VXNlcjEzMTA1NzA=', 'avatar_url': 'https://avatars0.githubusercontent.com/u/1310570?v=4', 'gravatar_id': '', 'url': 'https://api.github.com/users/soumith', 'html_url': 'https://github.com/soumith', 'followers_url': 'https://api.github.com/users/soumith/followers', 'following_url': 'https://api.github.com/users/soumith/following{/other_user}', 'gists_url': 'https://api.github.com/users/soumith/gists{/gist_id}', 'starred_url': 'https://api.github.com/users/soumith/starred{/owner}{/repo}', 'subscriptions_url': 'https://api.github.com/users/soumith/subscriptions', 'organizations_url': 'https://api.github.com/users/soumith/orgs', 'repos_url': 'https://api.github.com/users/soumith/repos', 'events_url': 'https://api.github.com/users/soumith/events{/privacy}', 'received_events_url': 'https://api.github.com/users/soumith/received_events', 'type': 'User', 'site_admin': False}",closed,d95feb3feb940da1488c71088cf1ec05083a24f7,https://api.github.com/repos/pytorch/pytorch/commits/d95feb3feb940da1488c71088cf1ec05083a24f7,2017-07-25T02:00:17Z,5,5,0
28,1208594455,"{'login': 'yogi81', 'id': 9338561, 'node_id': 'MDQ6VXNlcjkzMzg1NjE=', 'avatar_url': 'https://avatars3.githubusercontent.com/u/9338561?v=4', 'gravatar_id': '', 'url': 'https://api.github.com/users/yogi81', 'html_url': 'https://github.com/yogi81', 'followers_url': 'https://api.github.com/users/yogi81/followers', 'following_url': 'https://api.github.com/users/yogi81/following{/other_user}', 'gists_url': 'https://api.github.com/users/yogi81/gists{/gist_id}', 'starred_url': 'https://api.github.com/users/yogi81/starred{/owner}{/repo}', 'subscriptions_url': 'https://api.github.com/users/yogi81/subscriptions', 'organizations_url': 'https://api.github.com/users/yogi81/orgs', 'repos_url': 'https://api.github.com/users/yogi81/repos', 'events_url': 'https://api.github.com/users/yogi81/events{/privacy}', 'received_events_url': 'https://api.github.com/users/yogi81/received_events', 'type': 'User', 'site_admin': False}",referenced,1d9b10d312fe5e6325e399277e28aeb78fd2ddf7,https://api.github.com/repos/pytorch/pytorch/commits/1d9b10d312fe5e6325e399277e28aeb78fd2ddf7,2017-08-16T16:07:18Z,5,5,0
27,1208594454,"{'login': 'yogi81', 'id': 9338561, 'node_id': 'MDQ6VXNlcjkzMzg1NjE=', 'avatar_url': 'https://avatars3.githubusercontent.com/u/9338561?v=4', 'gravatar_id': '', 'url': 'https://api.github.com/users/yogi81', 'html_url': 'https://github.com/yogi81', 'followers_url': 'https://api.github.com/users/yogi81/followers', 'following_url': 'https://api.github.com/users/yogi81/following{/other_user}', 'gists_url': 'https://api.github.com/users/yogi81/gists{/gist_id}', 'starred_url': 'https://api.github.com/users/yogi81/starred{/owner}{/repo}', 'subscriptions_url': 'https://api.github.com/users/yogi81/subscriptions', 'organizations_url': 'https://api.github.com/users/yogi81/orgs', 'repos_url': 'https://api.github.com/users/yogi81/repos', 'events_url': 'https://api.github.com/users/yogi81/events{/privacy}', 'received_events_url': 'https://api.github.com/users/yogi81/received_events', 'type': 'User', 'site_admin': False}",referenced,1d9b10d312fe5e6325e399277e28aeb78fd2ddf7,https://api.github.com/repos/pytorch/pytorch/commits/1d9b10d312fe5e6325e399277e28aeb78fd2ddf7,2017-08-16T16:07:18Z,5,5,0
26,1208594453,"{'login': 'yogi81', 'id': 9338561, 'node_id': 'MDQ6VXNlcjkzMzg1NjE=', 'avatar_url': 'https://avatars3.githubusercontent.com/u/9338561?v=4', 'gravatar_id': '', 'url': 'https://api.github.com/users/yogi81', 'html_url': 'https://github.com/yogi81', 'followers_url': 'https://api.github.com/users/yogi81/followers', 'following_url': 'https://api.github.com/users/yogi81/following{/other_user}', 'gists_url': 'https://api.github.com/users/yogi81/gists{/gist_id}', 'starred_url': 'https://api.github.com/users/yogi81/starred{/owner}{/repo}', 'subscriptions_url': 'https://api.github.com/users/yogi81/subscriptions', 'organizations_url': 'https://api.github.com/users/yogi81/orgs', 'repos_url': 'https://api.github.com/users/yogi81/repos', 'events_url': 'https://api.github.com/users/yogi81/events{/privacy}', 'received_events_url': 'https://api.github.com/users/yogi81/received_events', 'type': 'User', 'site_admin': False}",referenced,1d9b10d312fe5e6325e399277e28aeb78fd2ddf7,https://api.github.com/repos/pytorch/pytorch/commits/1d9b10d312fe5e6325e399277e28aeb78fd2ddf7,2017-08-16T16:07:18Z,5,5,0
25,942160428,"{'login': 'apaszke', 'id': 4583066, 'node_id': 'MDQ6VXNlcjQ1ODMwNjY=', 'avatar_url': 'https://avatars3.githubusercontent.com/u/4583066?v=4', 'gravatar_id': '', 'url': 'https://api.github.com/users/apaszke', 'html_url': 'https://github.com/apaszke', 'followers_url': 'https://api.github.com/users/apaszke/followers', 'following_url': 'https://api.github.com/users/apaszke/following{/other_user}', 'gists_url': 'https://api.github.com/users/apaszke/gists{/gist_id}', 'starred_url': 'https://api.github.com/users/apaszke/starred{/owner}{/repo}', 'subscriptions_url': 'https://api.github.com/users/apaszke/subscriptions', 'organizations_url': 'https://api.github.com/users/apaszke/orgs', 'repos_url': 'https://api.github.com/users/apaszke/repos', 'events_url': 'https://api.github.com/users/apaszke/events{/privacy}', 'received_events_url': 'https://api.github.com/users/apaszke/received_events', 'type': 'User', 'site_admin': False}",referenced,a5a4322b07114176cb981fc6fff2ec5915e36b41,https://api.github.com/repos/pytorch/pytorch/commits/a5a4322b07114176cb981fc6fff2ec5915e36b41,2017-01-30T22:09:28Z,564,467,97
25,942351634,"{'login': 'apaszke', 'id': 4583066, 'node_id': 'MDQ6VXNlcjQ1ODMwNjY=', 'avatar_url': 'https://avatars3.githubusercontent.com/u/4583066?v=4', 'gravatar_id': '', 'url': 'https://api.github.com/users/apaszke', 'html_url': 'https://github.com/apaszke', 'followers_url': 'https://api.github.com/users/apaszke/followers', 'following_url': 'https://api.github.com/users/apaszke/following{/other_user}', 'gists_url': 'https://api.github.com/users/apaszke/gists{/gist_id}', 'starred_url': 'https://api.github.com/users/apaszke/starred{/owner}{/repo}', 'subscriptions_url': 'https://api.github.com/users/apaszke/subscriptions', 'organizations_url': 'https://api.github.com/users/apaszke/orgs', 'repos_url': 'https://api.github.com/users/apaszke/repos', 'events_url': 'https://api.github.com/users/apaszke/events{/privacy}', 'received_events_url': 'https://api.github.com/users/apaszke/received_events', 'type': 'User', 'site_admin': False}",referenced,5e6fcd02b5d5db9c2bb9e4bfce7e5774aae67825,https://api.github.com/repos/pytorch/pytorch/commits/5e6fcd02b5d5db9c2bb9e4bfce7e5774aae67825,2017-01-31T00:58:12Z,564,467,97
25,1169359233,"{'login': 'soumith', 'id': 1310570, 'node_id': 'MDQ6VXNlcjEzMTA1NzA=', 'avatar_url': 'https://avatars0.githubusercontent.com/u/1310570?v=4', 'gravatar_id': '', 'url': 'https://api.github.com/users/soumith', 'html_url': 'https://github.com/soumith', 'followers_url': 'https://api.github.com/users/soumith/followers', 'following_url': 'https://api.github.com/users/soumith/following{/other_user}', 'gists_url': 'https://api.github.com/users/soumith/gists{/gist_id}', 'starred_url': 'https://api.github.com/users/soumith/starred{/owner}{/repo}', 'subscriptions_url': 'https://api.github.com/users/soumith/subscriptions', 'organizations_url': 'https://api.github.com/users/soumith/orgs', 'repos_url': 'https://api.github.com/users/soumith/repos', 'events_url': 'https://api.github.com/users/soumith/events{/privacy}', 'received_events_url': 'https://api.github.com/users/soumith/received_events', 'type': 'User', 'site_admin': False}",referenced,567d95fa096f557e45f4f6cd22b18c0d3c782d0a,https://api.github.com/repos/pytorch/pytorch/commits/567d95fa096f557e45f4f6cd22b18c0d3c782d0a,2017-07-19T00:17:40Z,48,39,9
25,1208594452,"{'login': 'yogi81', 'id': 9338561, 'node_id': 'MDQ6VXNlcjkzMzg1NjE=', 'avatar_url': 'https://avatars3.githubusercontent.com/u/9338561?v=4', 'gravatar_id': '', 'url': 'https://api.github.com/users/yogi81', 'html_url': 'https://github.com/yogi81', 'followers_url': 'https://api.github.com/users/yogi81/followers', 'following_url': 'https://api.github.com/users/yogi81/following{/other_user}', 'gists_url': 'https://api.github.com/users/yogi81/gists{/gist_id}', 'starred_url': 'https://api.github.com/users/yogi81/starred{/owner}{/repo}', 'subscriptions_url': 'https://api.github.com/users/yogi81/subscriptions', 'organizations_url': 'https://api.github.com/users/yogi81/orgs', 'repos_url': 'https://api.github.com/users/yogi81/repos', 'events_url': 'https://api.github.com/users/yogi81/events{/privacy}', 'received_events_url': 'https://api.github.com/users/yogi81/received_events', 'type': 'User', 'site_admin': False}",referenced,1d9b10d312fe5e6325e399277e28aeb78fd2ddf7,https://api.github.com/repos/pytorch/pytorch/commits/1d9b10d312fe5e6325e399277e28aeb78fd2ddf7,2017-08-16T16:07:18Z,5,5,0
23,1208594449,"{'login': 'yogi81', 'id': 9338561, 'node_id': 'MDQ6VXNlcjkzMzg1NjE=', 'avatar_url': 'https://avatars3.githubusercontent.com/u/9338561?v=4', 'gravatar_id': '', 'url': 'https://api.github.com/users/yogi81', 'html_url': 'https://github.com/yogi81', 'followers_url': 'https://api.github.com/users/yogi81/followers', 'following_url': 'https://api.github.com/users/yogi81/following{/other_user}', 'gists_url': 'https://api.github.com/users/yogi81/gists{/gist_id}', 'starred_url': 'https://api.github.com/users/yogi81/starred{/owner}{/repo}', 'subscriptions_url': 'https://api.github.com/users/yogi81/subscriptions', 'organizations_url': 'https://api.github.com/users/yogi81/orgs', 'repos_url': 'https://api.github.com/users/yogi81/repos', 'events_url': 'https://api.github.com/users/yogi81/events{/privacy}', 'received_events_url': 'https://api.github.com/users/yogi81/received_events', 'type': 'User', 'site_admin': False}",referenced,1d9b10d312fe5e6325e399277e28aeb78fd2ddf7,https://api.github.com/repos/pytorch/pytorch/commits/1d9b10d312fe5e6325e399277e28aeb78fd2ddf7,2017-08-16T16:07:18Z,5,5,0
23,1905228940,"{'login': 'bddppq', 'id': 9300575, 'node_id': 'MDQ6VXNlcjkzMDA1NzU=', 'avatar_url': 'https://avatars2.githubusercontent.com/u/9300575?v=4', 'gravatar_id': '', 'url': 'https://api.github.com/users/bddppq', 'html_url': 'https://github.com/bddppq', 'followers_url': 'https://api.github.com/users/bddppq/followers', 'following_url': 'https://api.github.com/users/bddppq/following{/other_user}', 'gists_url': 'https://api.github.com/users/bddppq/gists{/gist_id}', 'starred_url': 'https://api.github.com/users/bddppq/starred{/owner}{/repo}', 'subscriptions_url': 'https://api.github.com/users/bddppq/subscriptions', 'organizations_url': 'https://api.github.com/users/bddppq/orgs', 'repos_url': 'https://api.github.com/users/bddppq/repos', 'events_url': 'https://api.github.com/users/bddppq/events{/privacy}', 'received_events_url': 'https://api.github.com/users/bddppq/received_events', 'type': 'User', 'site_admin': False}",referenced,ced1b662e2efe4a8ace673938ed6a771406ca3e5,https://api.github.com/repos/pytorch/pytorch/commits/ced1b662e2efe4a8ace673938ed6a771406ca3e5,2018-10-15T21:12:29Z,4,2,2
21,1062871826,"{'login': 'apaszke', 'id': 4583066, 'node_id': 'MDQ6VXNlcjQ1ODMwNjY=', 'avatar_url': 'https://avatars3.githubusercontent.com/u/4583066?v=4', 'gravatar_id': '', 'url': 'https://api.github.com/users/apaszke', 'html_url': 'https://github.com/apaszke', 'followers_url': 'https://api.github.com/users/apaszke/followers', 'following_url': 'https://api.github.com/users/apaszke/following{/other_user}', 'gists_url': 'https://api.github.com/users/apaszke/gists{/gist_id}', 'starred_url': 'https://api.github.com/users/apaszke/starred{/owner}{/repo}', 'subscriptions_url': 'https://api.github.com/users/apaszke/subscriptions', 'organizations_url': 'https://api.github.com/users/apaszke/orgs', 'repos_url': 'https://api.github.com/users/apaszke/repos', 'events_url': 'https://api.github.com/users/apaszke/events{/privacy}', 'received_events_url': 'https://api.github.com/users/apaszke/received_events', 'type': 'User', 'site_admin': False}",referenced,8a822d48f50694010c347add0deebfbe76a3be01,https://api.github.com/repos/pytorch/pytorch/commits/8a822d48f50694010c347add0deebfbe76a3be01,2017-04-28T22:00:49Z,2,1,1
21,1208594447,"{'login': 'yogi81', 'id': 9338561, 'node_id': 'MDQ6VXNlcjkzMzg1NjE=', 'avatar_url': 'https://avatars3.githubusercontent.com/u/9338561?v=4', 'gravatar_id': '', 'url': 'https://api.github.com/users/yogi81', 'html_url': 'https://github.com/yogi81', 'followers_url': 'https://api.github.com/users/yogi81/followers', 'following_url': 'https://api.github.com/users/yogi81/following{/other_user}', 'gists_url': 'https://api.github.com/users/yogi81/gists{/gist_id}', 'starred_url': 'https://api.github.com/users/yogi81/starred{/owner}{/repo}', 'subscriptions_url': 'https://api.github.com/users/yogi81/subscriptions', 'organizations_url': 'https://api.github.com/users/yogi81/orgs', 'repos_url': 'https://api.github.com/users/yogi81/repos', 'events_url': 'https://api.github.com/users/yogi81/events{/privacy}', 'received_events_url': 'https://api.github.com/users/yogi81/received_events', 'type': 'User', 'site_admin': False}",referenced,1d9b10d312fe5e6325e399277e28aeb78fd2ddf7,https://api.github.com/repos/pytorch/pytorch/commits/1d9b10d312fe5e6325e399277e28aeb78fd2ddf7,2017-08-16T16:07:18Z,5,5,0
20,840374237,"{'login': 'apaszke', 'id': 4583066, 'node_id': 'MDQ6VXNlcjQ1ODMwNjY=', 'avatar_url': 'https://avatars3.githubusercontent.com/u/4583066?v=4', 'gravatar_id': '', 'url': 'https://api.github.com/users/apaszke', 'html_url': 'https://github.com/apaszke', 'followers_url': 'https://api.github.com/users/apaszke/followers', 'following_url': 'https://api.github.com/users/apaszke/following{/other_user}', 'gists_url': 'https://api.github.com/users/apaszke/gists{/gist_id}', 'starred_url': 'https://api.github.com/users/apaszke/starred{/owner}{/repo}', 'subscriptions_url': 'https://api.github.com/users/apaszke/subscriptions', 'organizations_url': 'https://api.github.com/users/apaszke/orgs', 'repos_url': 'https://api.github.com/users/apaszke/repos', 'events_url': 'https://api.github.com/users/apaszke/events{/privacy}', 'received_events_url': 'https://api.github.com/users/apaszke/received_events', 'type': 'User', 'site_admin': False}",referenced,f2d7e949484826d5c1103d4c3be7736039a92b48,https://api.github.com/repos/pytorch/pytorch/commits/f2d7e949484826d5c1103d4c3be7736039a92b48,2016-10-28T17:37:10Z,1060,588,472
20,1169359231,"{'login': 'soumith', 'id': 1310570, 'node_id': 'MDQ6VXNlcjEzMTA1NzA=', 'avatar_url': 'https://avatars0.githubusercontent.com/u/1310570?v=4', 'gravatar_id': '', 'url': 'https://api.github.com/users/soumith', 'html_url': 'https://github.com/soumith', 'followers_url': 'https://api.github.com/users/soumith/followers', 'following_url': 'https://api.github.com/users/soumith/following{/other_user}', 'gists_url': 'https://api.github.com/users/soumith/gists{/gist_id}', 'starred_url': 'https://api.github.com/users/soumith/starred{/owner}{/repo}', 'subscriptions_url': 'https://api.github.com/users/soumith/subscriptions', 'organizations_url': 'https://api.github.com/users/soumith/orgs', 'repos_url': 'https://api.github.com/users/soumith/repos', 'events_url': 'https://api.github.com/users/soumith/events{/privacy}', 'received_events_url': 'https://api.github.com/users/soumith/received_events', 'type': 'User', 'site_admin': False}",referenced,7914d67ce378d64d2a9cf257bf9ebdd065ba3b9f,https://api.github.com/repos/pytorch/pytorch/commits/7914d67ce378d64d2a9cf257bf9ebdd065ba3b9f,2017-07-19T00:17:40Z,7,7,0
18,1164984211,"{'login': 'soumith', 'id': 1310570, 'node_id': 'MDQ6VXNlcjEzMTA1NzA=', 'avatar_url': 'https://avatars0.githubusercontent.com/u/1310570?v=4', 'gravatar_id': '', 'url': 'https://api.github.com/users/soumith', 'html_url': 'https://github.com/soumith', 'followers_url': 'https://api.github.com/users/soumith/followers', 'following_url': 'https://api.github.com/users/soumith/following{/other_user}', 'gists_url': 'https://api.github.com/users/soumith/gists{/gist_id}', 'starred_url': 'https://api.github.com/users/soumith/starred{/owner}{/repo}', 'subscriptions_url': 'https://api.github.com/users/soumith/subscriptions', 'organizations_url': 'https://api.github.com/users/soumith/orgs', 'repos_url': 'https://api.github.com/users/soumith/repos', 'events_url': 'https://api.github.com/users/soumith/events{/privacy}', 'received_events_url': 'https://api.github.com/users/soumith/received_events', 'type': 'User', 'site_admin': False}",referenced,f3f8ce44bd4a9aae1bbdc289b71cfe23982188ab,https://api.github.com/repos/pytorch/pytorch/commits/f3f8ce44bd4a9aae1bbdc289b71cfe23982188ab,2017-07-14T21:21:46Z,19,16,3
18,1208594443,"{'login': 'yogi81', 'id': 9338561, 'node_id': 'MDQ6VXNlcjkzMzg1NjE=', 'avatar_url': 'https://avatars3.githubusercontent.com/u/9338561?v=4', 'gravatar_id': '', 'url': 'https://api.github.com/users/yogi81', 'html_url': 'https://github.com/yogi81', 'followers_url': 'https://api.github.com/users/yogi81/followers', 'following_url': 'https://api.github.com/users/yogi81/following{/other_user}', 'gists_url': 'https://api.github.com/users/yogi81/gists{/gist_id}', 'starred_url': 'https://api.github.com/users/yogi81/starred{/owner}{/repo}', 'subscriptions_url': 'https://api.github.com/users/yogi81/subscriptions', 'organizations_url': 'https://api.github.com/users/yogi81/orgs', 'repos_url': 'https://api.github.com/users/yogi81/repos', 'events_url': 'https://api.github.com/users/yogi81/events{/privacy}', 'received_events_url': 'https://api.github.com/users/yogi81/received_events', 'type': 'User', 'site_admin': False}",referenced,1d9b10d312fe5e6325e399277e28aeb78fd2ddf7,https://api.github.com/repos/pytorch/pytorch/commits/1d9b10d312fe5e6325e399277e28aeb78fd2ddf7,2017-08-16T16:07:18Z,5,5,0
17,1208594441,"{'login': 'yogi81', 'id': 9338561, 'node_id': 'MDQ6VXNlcjkzMzg1NjE=', 'avatar_url': 'https://avatars3.githubusercontent.com/u/9338561?v=4', 'gravatar_id': '', 'url': 'https://api.github.com/users/yogi81', 'html_url': 'https://github.com/yogi81', 'followers_url': 'https://api.github.com/users/yogi81/followers', 'following_url': 'https://api.github.com/users/yogi81/following{/other_user}', 'gists_url': 'https://api.github.com/users/yogi81/gists{/gist_id}', 'starred_url': 'https://api.github.com/users/yogi81/starred{/owner}{/repo}', 'subscriptions_url': 'https://api.github.com/users/yogi81/subscriptions', 'organizations_url': 'https://api.github.com/users/yogi81/orgs', 'repos_url': 'https://api.github.com/users/yogi81/repos', 'events_url': 'https://api.github.com/users/yogi81/events{/privacy}', 'received_events_url': 'https://api.github.com/users/yogi81/received_events', 'type': 'User', 'site_admin': False}",referenced,1d9b10d312fe5e6325e399277e28aeb78fd2ddf7,https://api.github.com/repos/pytorch/pytorch/commits/1d9b10d312fe5e6325e399277e28aeb78fd2ddf7,2017-08-16T16:07:18Z,5,5,0
17,1905228926,"{'login': 'bddppq', 'id': 9300575, 'node_id': 'MDQ6VXNlcjkzMDA1NzU=', 'avatar_url': 'https://avatars2.githubusercontent.com/u/9300575?v=4', 'gravatar_id': '', 'url': 'https://api.github.com/users/bddppq', 'html_url': 'https://github.com/bddppq', 'followers_url': 'https://api.github.com/users/bddppq/followers', 'following_url': 'https://api.github.com/users/bddppq/following{/other_user}', 'gists_url': 'https://api.github.com/users/bddppq/gists{/gist_id}', 'starred_url': 'https://api.github.com/users/bddppq/starred{/owner}{/repo}', 'subscriptions_url': 'https://api.github.com/users/bddppq/subscriptions', 'organizations_url': 'https://api.github.com/users/bddppq/orgs', 'repos_url': 'https://api.github.com/users/bddppq/repos', 'events_url': 'https://api.github.com/users/bddppq/events{/privacy}', 'received_events_url': 'https://api.github.com/users/bddppq/received_events', 'type': 'User', 'site_admin': False}",referenced,1c7ff6e49f9684abc6454aa9c6159246d3a60617,https://api.github.com/repos/pytorch/pytorch/commits/1c7ff6e49f9684abc6454aa9c6159246d3a60617,2018-10-15T21:12:29Z,7,5,2
16,1208594439,"{'login': 'yogi81', 'id': 9338561, 'node_id': 'MDQ6VXNlcjkzMzg1NjE=', 'avatar_url': 'https://avatars3.githubusercontent.com/u/9338561?v=4', 'gravatar_id': '', 'url': 'https://api.github.com/users/yogi81', 'html_url': 'https://github.com/yogi81', 'followers_url': 'https://api.github.com/users/yogi81/followers', 'following_url': 'https://api.github.com/users/yogi81/following{/other_user}', 'gists_url': 'https://api.github.com/users/yogi81/gists{/gist_id}', 'starred_url': 'https://api.github.com/users/yogi81/starred{/owner}{/repo}', 'subscriptions_url': 'https://api.github.com/users/yogi81/subscriptions', 'organizations_url': 'https://api.github.com/users/yogi81/orgs', 'repos_url': 'https://api.github.com/users/yogi81/repos', 'events_url': 'https://api.github.com/users/yogi81/events{/privacy}', 'received_events_url': 'https://api.github.com/users/yogi81/received_events', 'type': 'User', 'site_admin': False}",referenced,1d9b10d312fe5e6325e399277e28aeb78fd2ddf7,https://api.github.com/repos/pytorch/pytorch/commits/1d9b10d312fe5e6325e399277e28aeb78fd2ddf7,2017-08-16T16:07:18Z,5,5,0
16,1837217794,"{'login': 'facebook-github-bot', 'id': 6422482, 'node_id': 'MDQ6VXNlcjY0MjI0ODI=', 'avatar_url': 'https://avatars3.githubusercontent.com/u/6422482?v=4', 'gravatar_id': '', 'url': 'https://api.github.com/users/facebook-github-bot', 'html_url': 'https://github.com/facebook-github-bot', 'followers_url': 'https://api.github.com/users/facebook-github-bot/followers', 'following_url': 'https://api.github.com/users/facebook-github-bot/following{/other_user}', 'gists_url': 'https://api.github.com/users/facebook-github-bot/gists{/gist_id}', 'starred_url': 'https://api.github.com/users/facebook-github-bot/starred{/owner}{/repo}', 'subscriptions_url': 'https://api.github.com/users/facebook-github-bot/subscriptions', 'organizations_url': 'https://api.github.com/users/facebook-github-bot/orgs', 'repos_url': 'https://api.github.com/users/facebook-github-bot/repos', 'events_url': 'https://api.github.com/users/facebook-github-bot/events{/privacy}', 'received_events_url': 'https://api.github.com/users/facebook-github-bot/received_events', 'type': 'User', 'site_admin': False}",referenced,0b78ae86c59e7372f0b9d4cadcd0e50bc76f8667,https://api.github.com/repos/pytorch/pytorch/commits/0b78ae86c59e7372f0b9d4cadcd0e50bc76f8667,2018-09-10T22:41:38Z,106,77,29
13,1208594431,"{'login': 'yogi81', 'id': 9338561, 'node_id': 'MDQ6VXNlcjkzMzg1NjE=', 'avatar_url': 'https://avatars3.githubusercontent.com/u/9338561?v=4', 'gravatar_id': '', 'url': 'https://api.github.com/users/yogi81', 'html_url': 'https://github.com/yogi81', 'followers_url': 'https://api.github.com/users/yogi81/followers', 'following_url': 'https://api.github.com/users/yogi81/following{/other_user}', 'gists_url': 'https://api.github.com/users/yogi81/gists{/gist_id}', 'starred_url': 'https://api.github.com/users/yogi81/starred{/owner}{/repo}', 'subscriptions_url': 'https://api.github.com/users/yogi81/subscriptions', 'organizations_url': 'https://api.github.com/users/yogi81/orgs', 'repos_url': 'https://api.github.com/users/yogi81/repos', 'events_url': 'https://api.github.com/users/yogi81/events{/privacy}', 'received_events_url': 'https://api.github.com/users/yogi81/received_events', 'type': 'User', 'site_admin': False}",referenced,1d9b10d312fe5e6325e399277e28aeb78fd2ddf7,https://api.github.com/repos/pytorch/pytorch/commits/1d9b10d312fe5e6325e399277e28aeb78fd2ddf7,2017-08-16T16:07:18Z,5,5,0
13,1755590703,"{'login': 'facebook-github-bot', 'id': 6422482, 'node_id': 'MDQ6VXNlcjY0MjI0ODI=', 'avatar_url': 'https://avatars3.githubusercontent.com/u/6422482?v=4', 'gravatar_id': '', 'url': 'https://api.github.com/users/facebook-github-bot', 'html_url': 'https://github.com/facebook-github-bot', 'followers_url': 'https://api.github.com/users/facebook-github-bot/followers', 'following_url': 'https://api.github.com/users/facebook-github-bot/following{/other_user}', 'gists_url': 'https://api.github.com/users/facebook-github-bot/gists{/gist_id}', 'starred_url': 'https://api.github.com/users/facebook-github-bot/starred{/owner}{/repo}', 'subscriptions_url': 'https://api.github.com/users/facebook-github-bot/subscriptions', 'organizations_url': 'https://api.github.com/users/facebook-github-bot/orgs', 'repos_url': 'https://api.github.com/users/facebook-github-bot/repos', 'events_url': 'https://api.github.com/users/facebook-github-bot/events{/privacy}', 'received_events_url': 'https://api.github.com/users/facebook-github-bot/received_events', 'type': 'User', 'site_admin': False}",referenced,cd5adc7b5f7a5d4415a936c5ceca219f14dbb319,https://api.github.com/repos/pytorch/pytorch/commits/cd5adc7b5f7a5d4415a936c5ceca219f14dbb319,2018-07-26T17:26:31Z,7658,4167,3491
10,781221917,"{'login': 'apaszke', 'id': 4583066, 'node_id': 'MDQ6VXNlcjQ1ODMwNjY=', 'avatar_url': 'https://avatars3.githubusercontent.com/u/4583066?v=4', 'gravatar_id': '', 'url': 'https://api.github.com/users/apaszke', 'html_url': 'https://github.com/apaszke', 'followers_url': 'https://api.github.com/users/apaszke/followers', 'following_url': 'https://api.github.com/users/apaszke/following{/other_user}', 'gists_url': 'https://api.github.com/users/apaszke/gists{/gist_id}', 'starred_url': 'https://api.github.com/users/apaszke/starred{/owner}{/repo}', 'subscriptions_url': 'https://api.github.com/users/apaszke/subscriptions', 'organizations_url': 'https://api.github.com/users/apaszke/orgs', 'repos_url': 'https://api.github.com/users/apaszke/repos', 'events_url': 'https://api.github.com/users/apaszke/events{/privacy}', 'received_events_url': 'https://api.github.com/users/apaszke/received_events', 'type': 'User', 'site_admin': False}",referenced,ab1382b6529fe5c8480c711289c9cbb7f58b400d,https://api.github.com/repos/pytorch/pytorch/commits/ab1382b6529fe5c8480c711289c9cbb7f58b400d,2016-09-07T16:56:50Z,22,18,4
10,1208594426,"{'login': 'yogi81', 'id': 9338561, 'node_id': 'MDQ6VXNlcjkzMzg1NjE=', 'avatar_url': 'https://avatars3.githubusercontent.com/u/9338561?v=4', 'gravatar_id': '', 'url': 'https://api.github.com/users/yogi81', 'html_url': 'https://github.com/yogi81', 'followers_url': 'https://api.github.com/users/yogi81/followers', 'following_url': 'https://api.github.com/users/yogi81/following{/other_user}', 'gists_url': 'https://api.github.com/users/yogi81/gists{/gist_id}', 'starred_url': 'https://api.github.com/users/yogi81/starred{/owner}{/repo}', 'subscriptions_url': 'https://api.github.com/users/yogi81/subscriptions', 'organizations_url': 'https://api.github.com/users/yogi81/orgs', 'repos_url': 'https://api.github.com/users/yogi81/repos', 'events_url': 'https://api.github.com/users/yogi81/events{/privacy}', 'received_events_url': 'https://api.github.com/users/yogi81/received_events', 'type': 'User', 'site_admin': False}",referenced,1d9b10d312fe5e6325e399277e28aeb78fd2ddf7,https://api.github.com/repos/pytorch/pytorch/commits/1d9b10d312fe5e6325e399277e28aeb78fd2ddf7,2017-08-16T16:07:18Z,5,5,0
10,1905228920,"{'login': 'bddppq', 'id': 9300575, 'node_id': 'MDQ6VXNlcjkzMDA1NzU=', 'avatar_url': 'https://avatars2.githubusercontent.com/u/9300575?v=4', 'gravatar_id': '', 'url': 'https://api.github.com/users/bddppq', 'html_url': 'https://github.com/bddppq', 'followers_url': 'https://api.github.com/users/bddppq/followers', 'following_url': 'https://api.github.com/users/bddppq/following{/other_user}', 'gists_url': 'https://api.github.com/users/bddppq/gists{/gist_id}', 'starred_url': 'https://api.github.com/users/bddppq/starred{/owner}{/repo}', 'subscriptions_url': 'https://api.github.com/users/bddppq/subscriptions', 'organizations_url': 'https://api.github.com/users/bddppq/orgs', 'repos_url': 'https://api.github.com/users/bddppq/repos', 'events_url': 'https://api.github.com/users/bddppq/events{/privacy}', 'received_events_url': 'https://api.github.com/users/bddppq/received_events', 'type': 'User', 'site_admin': False}",referenced,fbc294eeda722f6d06b119ef7542d2e9ae52bdc0,https://api.github.com/repos/pytorch/pytorch/commits/fbc294eeda722f6d06b119ef7542d2e9ae52bdc0,2018-10-15T21:12:29Z,4,2,2
10,2158251527,"{'login': 'facebook-github-bot', 'id': 6422482, 'node_id': 'MDQ6VXNlcjY0MjI0ODI=', 'avatar_url': 'https://avatars3.githubusercontent.com/u/6422482?v=4', 'gravatar_id': '', 'url': 'https://api.github.com/users/facebook-github-bot', 'html_url': 'https://github.com/facebook-github-bot', 'followers_url': 'https://api.github.com/users/facebook-github-bot/followers', 'following_url': 'https://api.github.com/users/facebook-github-bot/following{/other_user}', 'gists_url': 'https://api.github.com/users/facebook-github-bot/gists{/gist_id}', 'starred_url': 'https://api.github.com/users/facebook-github-bot/starred{/owner}{/repo}', 'subscriptions_url': 'https://api.github.com/users/facebook-github-bot/subscriptions', 'organizations_url': 'https://api.github.com/users/facebook-github-bot/orgs', 'repos_url': 'https://api.github.com/users/facebook-github-bot/repos', 'events_url': 'https://api.github.com/users/facebook-github-bot/events{/privacy}', 'received_events_url': 'https://api.github.com/users/facebook-github-bot/received_events', 'type': 'User', 'site_admin': False}",referenced,be6ad7ddde64cebeec4cd9537ddc3bca9cbe18e5,https://api.github.com/repos/pytorch/pytorch/commits/be6ad7ddde64cebeec4cd9537ddc3bca9cbe18e5,2019-02-22T16:02:12Z,16,8,8
10,2256802504,"{'login': 'facebook-github-bot', 'id': 6422482, 'node_id': 'MDQ6VXNlcjY0MjI0ODI=', 'avatar_url': 'https://avatars3.githubusercontent.com/u/6422482?v=4', 'gravatar_id': '', 'url': 'https://api.github.com/users/facebook-github-bot', 'html_url': 'https://github.com/facebook-github-bot', 'followers_url': 'https://api.github.com/users/facebook-github-bot/followers', 'following_url': 'https://api.github.com/users/facebook-github-bot/following{/other_user}', 'gists_url': 'https://api.github.com/users/facebook-github-bot/gists{/gist_id}', 'starred_url': 'https://api.github.com/users/facebook-github-bot/starred{/owner}{/repo}', 'subscriptions_url': 'https://api.github.com/users/facebook-github-bot/subscriptions', 'organizations_url': 'https://api.github.com/users/facebook-github-bot/orgs', 'repos_url': 'https://api.github.com/users/facebook-github-bot/repos', 'events_url': 'https://api.github.com/users/facebook-github-bot/events{/privacy}', 'received_events_url': 'https://api.github.com/users/facebook-github-bot/received_events', 'type': 'User', 'site_admin': False}",referenced,b90cbb841d98aeae435b1d02b1ff211e028cdf5b,https://api.github.com/repos/pytorch/pytorch/commits/b90cbb841d98aeae435b1d02b1ff211e028cdf5b,2019-04-05T20:02:17Z,2,1,1
10,2302017445,"{'login': 'facebook-github-bot', 'id': 6422482, 'node_id': 'MDQ6VXNlcjY0MjI0ODI=', 'avatar_url': 'https://avatars3.githubusercontent.com/u/6422482?v=4', 'gravatar_id': '', 'url': 'https://api.github.com/users/facebook-github-bot', 'html_url': 'https://github.com/facebook-github-bot', 'followers_url': 'https://api.github.com/users/facebook-github-bot/followers', 'following_url': 'https://api.github.com/users/facebook-github-bot/following{/other_user}', 'gists_url': 'https://api.github.com/users/facebook-github-bot/gists{/gist_id}', 'starred_url': 'https://api.github.com/users/facebook-github-bot/starred{/owner}{/repo}', 'subscriptions_url': 'https://api.github.com/users/facebook-github-bot/subscriptions', 'organizations_url': 'https://api.github.com/users/facebook-github-bot/orgs', 'repos_url': 'https://api.github.com/users/facebook-github-bot/repos', 'events_url': 'https://api.github.com/users/facebook-github-bot/events{/privacy}', 'received_events_url': 'https://api.github.com/users/facebook-github-bot/received_events', 'type': 'User', 'site_admin': False}",referenced,48d5ab54a842cf1e6893f4e3b896c37088eb6616,https://api.github.com/repos/pytorch/pytorch/commits/48d5ab54a842cf1e6893f4e3b896c37088eb6616,2019-04-26T04:05:38Z,16,9,7
10,2696422170,"{'login': 'gottbrath', 'id': 45861273, 'node_id': 'MDQ6VXNlcjQ1ODYxMjcz', 'avatar_url': 'https://avatars0.githubusercontent.com/u/45861273?v=4', 'gravatar_id': '', 'url': 'https://api.github.com/users/gottbrath', 'html_url': 'https://github.com/gottbrath', 'followers_url': 'https://api.github.com/users/gottbrath/followers', 'following_url': 'https://api.github.com/users/gottbrath/following{/other_user}', 'gists_url': 'https://api.github.com/users/gottbrath/gists{/gist_id}', 'starred_url': 'https://api.github.com/users/gottbrath/starred{/owner}{/repo}', 'subscriptions_url': 'https://api.github.com/users/gottbrath/subscriptions', 'organizations_url': 'https://api.github.com/users/gottbrath/orgs', 'repos_url': 'https://api.github.com/users/gottbrath/repos', 'events_url': 'https://api.github.com/users/gottbrath/events{/privacy}', 'received_events_url': 'https://api.github.com/users/gottbrath/received_events', 'type': 'User', 'site_admin': False}",referenced,8a93b05114aa4a5bfb0a3d5c281c9b9a1cb9e124,https://api.github.com/repos/pytorch/pytorch/commits/8a93b05114aa4a5bfb0a3d5c281c9b9a1cb9e124,2019-10-08T18:24:59Z,4,3,1
7,1062871819,"{'login': 'apaszke', 'id': 4583066, 'node_id': 'MDQ6VXNlcjQ1ODMwNjY=', 'avatar_url': 'https://avatars3.githubusercontent.com/u/4583066?v=4', 'gravatar_id': '', 'url': 'https://api.github.com/users/apaszke', 'html_url': 'https://github.com/apaszke', 'followers_url': 'https://api.github.com/users/apaszke/followers', 'following_url': 'https://api.github.com/users/apaszke/following{/other_user}', 'gists_url': 'https://api.github.com/users/apaszke/gists{/gist_id}', 'starred_url': 'https://api.github.com/users/apaszke/starred{/owner}{/repo}', 'subscriptions_url': 'https://api.github.com/users/apaszke/subscriptions', 'organizations_url': 'https://api.github.com/users/apaszke/orgs', 'repos_url': 'https://api.github.com/users/apaszke/repos', 'events_url': 'https://api.github.com/users/apaszke/events{/privacy}', 'received_events_url': 'https://api.github.com/users/apaszke/received_events', 'type': 'User', 'site_admin': False}",referenced,4bd220d91a8ba0c629785bcbe18842d1f5e2cfaa,https://api.github.com/repos/pytorch/pytorch/commits/4bd220d91a8ba0c629785bcbe18842d1f5e2cfaa,2017-04-28T22:00:48Z,70,68,2
7,1208594423,"{'login': 'yogi81', 'id': 9338561, 'node_id': 'MDQ6VXNlcjkzMzg1NjE=', 'avatar_url': 'https://avatars3.githubusercontent.com/u/9338561?v=4', 'gravatar_id': '', 'url': 'https://api.github.com/users/yogi81', 'html_url': 'https://github.com/yogi81', 'followers_url': 'https://api.github.com/users/yogi81/followers', 'following_url': 'https://api.github.com/users/yogi81/following{/other_user}', 'gists_url': 'https://api.github.com/users/yogi81/gists{/gist_id}', 'starred_url': 'https://api.github.com/users/yogi81/starred{/owner}{/repo}', 'subscriptions_url': 'https://api.github.com/users/yogi81/subscriptions', 'organizations_url': 'https://api.github.com/users/yogi81/orgs', 'repos_url': 'https://api.github.com/users/yogi81/repos', 'events_url': 'https://api.github.com/users/yogi81/events{/privacy}', 'received_events_url': 'https://api.github.com/users/yogi81/received_events', 'type': 'User', 'site_admin': False}",referenced,1d9b10d312fe5e6325e399277e28aeb78fd2ddf7,https://api.github.com/repos/pytorch/pytorch/commits/1d9b10d312fe5e6325e399277e28aeb78fd2ddf7,2017-08-16T16:07:18Z,5,5,0
7,2158251516,"{'login': 'facebook-github-bot', 'id': 6422482, 'node_id': 'MDQ6VXNlcjY0MjI0ODI=', 'avatar_url': 'https://avatars3.githubusercontent.com/u/6422482?v=4', 'gravatar_id': '', 'url': 'https://api.github.com/users/facebook-github-bot', 'html_url': 'https://github.com/facebook-github-bot', 'followers_url': 'https://api.github.com/users/facebook-github-bot/followers', 'following_url': 'https://api.github.com/users/facebook-github-bot/following{/other_user}', 'gists_url': 'https://api.github.com/users/facebook-github-bot/gists{/gist_id}', 'starred_url': 'https://api.github.com/users/facebook-github-bot/starred{/owner}{/repo}', 'subscriptions_url': 'https://api.github.com/users/facebook-github-bot/subscriptions', 'organizations_url': 'https://api.github.com/users/facebook-github-bot/orgs', 'repos_url': 'https://api.github.com/users/facebook-github-bot/repos', 'events_url': 'https://api.github.com/users/facebook-github-bot/events{/privacy}', 'received_events_url': 'https://api.github.com/users/facebook-github-bot/received_events', 'type': 'User', 'site_admin': False}",referenced,be6ad7ddde64cebeec4cd9537ddc3bca9cbe18e5,https://api.github.com/repos/pytorch/pytorch/commits/be6ad7ddde64cebeec4cd9537ddc3bca9cbe18e5,2019-02-22T16:02:12Z,16,8,8
7,2207852902,"{'login': 'facebook-github-bot', 'id': 6422482, 'node_id': 'MDQ6VXNlcjY0MjI0ODI=', 'avatar_url': 'https://avatars3.githubusercontent.com/u/6422482?v=4', 'gravatar_id': '', 'url': 'https://api.github.com/users/facebook-github-bot', 'html_url': 'https://github.com/facebook-github-bot', 'followers_url': 'https://api.github.com/users/facebook-github-bot/followers', 'following_url': 'https://api.github.com/users/facebook-github-bot/following{/other_user}', 'gists_url': 'https://api.github.com/users/facebook-github-bot/gists{/gist_id}', 'starred_url': 'https://api.github.com/users/facebook-github-bot/starred{/owner}{/repo}', 'subscriptions_url': 'https://api.github.com/users/facebook-github-bot/subscriptions', 'organizations_url': 'https://api.github.com/users/facebook-github-bot/orgs', 'repos_url': 'https://api.github.com/users/facebook-github-bot/repos', 'events_url': 'https://api.github.com/users/facebook-github-bot/events{/privacy}', 'received_events_url': 'https://api.github.com/users/facebook-github-bot/received_events', 'type': 'User', 'site_admin': False}",referenced,cb2ea1770791ac5a942f51d1cb1268e288abe86b,https://api.github.com/repos/pytorch/pytorch/commits/cb2ea1770791ac5a942f51d1cb1268e288abe86b,2019-03-15T23:51:05Z,8,5,3
6,1208594422,"{'login': 'yogi81', 'id': 9338561, 'node_id': 'MDQ6VXNlcjkzMzg1NjE=', 'avatar_url': 'https://avatars3.githubusercontent.com/u/9338561?v=4', 'gravatar_id': '', 'url': 'https://api.github.com/users/yogi81', 'html_url': 'https://github.com/yogi81', 'followers_url': 'https://api.github.com/users/yogi81/followers', 'following_url': 'https://api.github.com/users/yogi81/following{/other_user}', 'gists_url': 'https://api.github.com/users/yogi81/gists{/gist_id}', 'starred_url': 'https://api.github.com/users/yogi81/starred{/owner}{/repo}', 'subscriptions_url': 'https://api.github.com/users/yogi81/subscriptions', 'organizations_url': 'https://api.github.com/users/yogi81/orgs', 'repos_url': 'https://api.github.com/users/yogi81/repos', 'events_url': 'https://api.github.com/users/yogi81/events{/privacy}', 'received_events_url': 'https://api.github.com/users/yogi81/received_events', 'type': 'User', 'site_admin': False}",referenced,1d9b10d312fe5e6325e399277e28aeb78fd2ddf7,https://api.github.com/repos/pytorch/pytorch/commits/1d9b10d312fe5e6325e399277e28aeb78fd2ddf7,2017-08-16T16:07:18Z,5,5,0
6,2158251512,"{'login': 'facebook-github-bot', 'id': 6422482, 'node_id': 'MDQ6VXNlcjY0MjI0ODI=', 'avatar_url': 'https://avatars3.githubusercontent.com/u/6422482?v=4', 'gravatar_id': '', 'url': 'https://api.github.com/users/facebook-github-bot', 'html_url': 'https://github.com/facebook-github-bot', 'followers_url': 'https://api.github.com/users/facebook-github-bot/followers', 'following_url': 'https://api.github.com/users/facebook-github-bot/following{/other_user}', 'gists_url': 'https://api.github.com/users/facebook-github-bot/gists{/gist_id}', 'starred_url': 'https://api.github.com/users/facebook-github-bot/starred{/owner}{/repo}', 'subscriptions_url': 'https://api.github.com/users/facebook-github-bot/subscriptions', 'organizations_url': 'https://api.github.com/users/facebook-github-bot/orgs', 'repos_url': 'https://api.github.com/users/facebook-github-bot/repos', 'events_url': 'https://api.github.com/users/facebook-github-bot/events{/privacy}', 'received_events_url': 'https://api.github.com/users/facebook-github-bot/received_events', 'type': 'User', 'site_admin': False}",referenced,be6ad7ddde64cebeec4cd9537ddc3bca9cbe18e5,https://api.github.com/repos/pytorch/pytorch/commits/be6ad7ddde64cebeec4cd9537ddc3bca9cbe18e5,2019-02-22T16:02:12Z,16,8,8
6,2205038491,"{'login': 'facebook-github-bot', 'id': 6422482, 'node_id': 'MDQ6VXNlcjY0MjI0ODI=', 'avatar_url': 'https://avatars3.githubusercontent.com/u/6422482?v=4', 'gravatar_id': '', 'url': 'https://api.github.com/users/facebook-github-bot', 'html_url': 'https://github.com/facebook-github-bot', 'followers_url': 'https://api.github.com/users/facebook-github-bot/followers', 'following_url': 'https://api.github.com/users/facebook-github-bot/following{/other_user}', 'gists_url': 'https://api.github.com/users/facebook-github-bot/gists{/gist_id}', 'starred_url': 'https://api.github.com/users/facebook-github-bot/starred{/owner}{/repo}', 'subscriptions_url': 'https://api.github.com/users/facebook-github-bot/subscriptions', 'organizations_url': 'https://api.github.com/users/facebook-github-bot/orgs', 'repos_url': 'https://api.github.com/users/facebook-github-bot/repos', 'events_url': 'https://api.github.com/users/facebook-github-bot/events{/privacy}', 'received_events_url': 'https://api.github.com/users/facebook-github-bot/received_events', 'type': 'User', 'site_admin': False}",referenced,9de4350b77cd7f257c1c60d325f267d50965531e,https://api.github.com/repos/pytorch/pytorch/commits/9de4350b77cd7f257c1c60d325f267d50965531e,2019-03-14T22:49:48Z,2,1,1
6,2256802493,"{'login': 'facebook-github-bot', 'id': 6422482, 'node_id': 'MDQ6VXNlcjY0MjI0ODI=', 'avatar_url': 'https://avatars3.githubusercontent.com/u/6422482?v=4', 'gravatar_id': '', 'url': 'https://api.github.com/users/facebook-github-bot', 'html_url': 'https://github.com/facebook-github-bot', 'followers_url': 'https://api.github.com/users/facebook-github-bot/followers', 'following_url': 'https://api.github.com/users/facebook-github-bot/following{/other_user}', 'gists_url': 'https://api.github.com/users/facebook-github-bot/gists{/gist_id}', 'starred_url': 'https://api.github.com/users/facebook-github-bot/starred{/owner}{/repo}', 'subscriptions_url': 'https://api.github.com/users/facebook-github-bot/subscriptions', 'organizations_url': 'https://api.github.com/users/facebook-github-bot/orgs', 'repos_url': 'https://api.github.com/users/facebook-github-bot/repos', 'events_url': 'https://api.github.com/users/facebook-github-bot/events{/privacy}', 'received_events_url': 'https://api.github.com/users/facebook-github-bot/received_events', 'type': 'User', 'site_admin': False}",referenced,b90cbb841d98aeae435b1d02b1ff211e028cdf5b,https://api.github.com/repos/pytorch/pytorch/commits/b90cbb841d98aeae435b1d02b1ff211e028cdf5b,2019-04-05T20:02:17Z,2,1,1
6,2392920347,"{'login': 'facebook-github-bot', 'id': 6422482, 'node_id': 'MDQ6VXNlcjY0MjI0ODI=', 'avatar_url': 'https://avatars3.githubusercontent.com/u/6422482?v=4', 'gravatar_id': '', 'url': 'https://api.github.com/users/facebook-github-bot', 'html_url': 'https://github.com/facebook-github-bot', 'followers_url': 'https://api.github.com/users/facebook-github-bot/followers', 'following_url': 'https://api.github.com/users/facebook-github-bot/following{/other_user}', 'gists_url': 'https://api.github.com/users/facebook-github-bot/gists{/gist_id}', 'starred_url': 'https://api.github.com/users/facebook-github-bot/starred{/owner}{/repo}', 'subscriptions_url': 'https://api.github.com/users/facebook-github-bot/subscriptions', 'organizations_url': 'https://api.github.com/users/facebook-github-bot/orgs', 'repos_url': 'https://api.github.com/users/facebook-github-bot/repos', 'events_url': 'https://api.github.com/users/facebook-github-bot/events{/privacy}', 'received_events_url': 'https://api.github.com/users/facebook-github-bot/received_events', 'type': 'User', 'site_admin': False}",referenced,7e6d932208a866551ca1b9ea7f149d48eb3ad413,https://api.github.com/repos/pytorch/pytorch/commits/7e6d932208a866551ca1b9ea7f149d48eb3ad413,2019-06-06T01:12:37Z,8,7,1
5,1208594420,"{'login': 'yogi81', 'id': 9338561, 'node_id': 'MDQ6VXNlcjkzMzg1NjE=', 'avatar_url': 'https://avatars3.githubusercontent.com/u/9338561?v=4', 'gravatar_id': '', 'url': 'https://api.github.com/users/yogi81', 'html_url': 'https://github.com/yogi81', 'followers_url': 'https://api.github.com/users/yogi81/followers', 'following_url': 'https://api.github.com/users/yogi81/following{/other_user}', 'gists_url': 'https://api.github.com/users/yogi81/gists{/gist_id}', 'starred_url': 'https://api.github.com/users/yogi81/starred{/owner}{/repo}', 'subscriptions_url': 'https://api.github.com/users/yogi81/subscriptions', 'organizations_url': 'https://api.github.com/users/yogi81/orgs', 'repos_url': 'https://api.github.com/users/yogi81/repos', 'events_url': 'https://api.github.com/users/yogi81/events{/privacy}', 'received_events_url': 'https://api.github.com/users/yogi81/received_events', 'type': 'User', 'site_admin': False}",referenced,1d9b10d312fe5e6325e399277e28aeb78fd2ddf7,https://api.github.com/repos/pytorch/pytorch/commits/1d9b10d312fe5e6325e399277e28aeb78fd2ddf7,2017-08-16T16:07:18Z,5,5,0
5,2158251511,"{'login': 'facebook-github-bot', 'id': 6422482, 'node_id': 'MDQ6VXNlcjY0MjI0ODI=', 'avatar_url': 'https://avatars3.githubusercontent.com/u/6422482?v=4', 'gravatar_id': '', 'url': 'https://api.github.com/users/facebook-github-bot', 'html_url': 'https://github.com/facebook-github-bot', 'followers_url': 'https://api.github.com/users/facebook-github-bot/followers', 'following_url': 'https://api.github.com/users/facebook-github-bot/following{/other_user}', 'gists_url': 'https://api.github.com/users/facebook-github-bot/gists{/gist_id}', 'starred_url': 'https://api.github.com/users/facebook-github-bot/starred{/owner}{/repo}', 'subscriptions_url': 'https://api.github.com/users/facebook-github-bot/subscriptions', 'organizations_url': 'https://api.github.com/users/facebook-github-bot/orgs', 'repos_url': 'https://api.github.com/users/facebook-github-bot/repos', 'events_url': 'https://api.github.com/users/facebook-github-bot/events{/privacy}', 'received_events_url': 'https://api.github.com/users/facebook-github-bot/received_events', 'type': 'User', 'site_admin': False}",referenced,be6ad7ddde64cebeec4cd9537ddc3bca9cbe18e5,https://api.github.com/repos/pytorch/pytorch/commits/be6ad7ddde64cebeec4cd9537ddc3bca9cbe18e5,2019-02-22T16:02:12Z,16,8,8
5,2207852903,"{'login': 'facebook-github-bot', 'id': 6422482, 'node_id': 'MDQ6VXNlcjY0MjI0ODI=', 'avatar_url': 'https://avatars3.githubusercontent.com/u/6422482?v=4', 'gravatar_id': '', 'url': 'https://api.github.com/users/facebook-github-bot', 'html_url': 'https://github.com/facebook-github-bot', 'followers_url': 'https://api.github.com/users/facebook-github-bot/followers', 'following_url': 'https://api.github.com/users/facebook-github-bot/following{/other_user}', 'gists_url': 'https://api.github.com/users/facebook-github-bot/gists{/gist_id}', 'starred_url': 'https://api.github.com/users/facebook-github-bot/starred{/owner}{/repo}', 'subscriptions_url': 'https://api.github.com/users/facebook-github-bot/subscriptions', 'organizations_url': 'https://api.github.com/users/facebook-github-bot/orgs', 'repos_url': 'https://api.github.com/users/facebook-github-bot/repos', 'events_url': 'https://api.github.com/users/facebook-github-bot/events{/privacy}', 'received_events_url': 'https://api.github.com/users/facebook-github-bot/received_events', 'type': 'User', 'site_admin': False}",referenced,cb2ea1770791ac5a942f51d1cb1268e288abe86b,https://api.github.com/repos/pytorch/pytorch/commits/cb2ea1770791ac5a942f51d1cb1268e288abe86b,2019-03-15T23:51:05Z,8,5,3
5,2256802490,"{'login': 'facebook-github-bot', 'id': 6422482, 'node_id': 'MDQ6VXNlcjY0MjI0ODI=', 'avatar_url': 'https://avatars3.githubusercontent.com/u/6422482?v=4', 'gravatar_id': '', 'url': 'https://api.github.com/users/facebook-github-bot', 'html_url': 'https://github.com/facebook-github-bot', 'followers_url': 'https://api.github.com/users/facebook-github-bot/followers', 'following_url': 'https://api.github.com/users/facebook-github-bot/following{/other_user}', 'gists_url': 'https://api.github.com/users/facebook-github-bot/gists{/gist_id}', 'starred_url': 'https://api.github.com/users/facebook-github-bot/starred{/owner}{/repo}', 'subscriptions_url': 'https://api.github.com/users/facebook-github-bot/subscriptions', 'organizations_url': 'https://api.github.com/users/facebook-github-bot/orgs', 'repos_url': 'https://api.github.com/users/facebook-github-bot/repos', 'events_url': 'https://api.github.com/users/facebook-github-bot/events{/privacy}', 'received_events_url': 'https://api.github.com/users/facebook-github-bot/received_events', 'type': 'User', 'site_admin': False}",referenced,b90cbb841d98aeae435b1d02b1ff211e028cdf5b,https://api.github.com/repos/pytorch/pytorch/commits/b90cbb841d98aeae435b1d02b1ff211e028cdf5b,2019-04-05T20:02:17Z,2,1,1
5,2392920346,"{'login': 'facebook-github-bot', 'id': 6422482, 'node_id': 'MDQ6VXNlcjY0MjI0ODI=', 'avatar_url': 'https://avatars3.githubusercontent.com/u/6422482?v=4', 'gravatar_id': '', 'url': 'https://api.github.com/users/facebook-github-bot', 'html_url': 'https://github.com/facebook-github-bot', 'followers_url': 'https://api.github.com/users/facebook-github-bot/followers', 'following_url': 'https://api.github.com/users/facebook-github-bot/following{/other_user}', 'gists_url': 'https://api.github.com/users/facebook-github-bot/gists{/gist_id}', 'starred_url': 'https://api.github.com/users/facebook-github-bot/starred{/owner}{/repo}', 'subscriptions_url': 'https://api.github.com/users/facebook-github-bot/subscriptions', 'organizations_url': 'https://api.github.com/users/facebook-github-bot/orgs', 'repos_url': 'https://api.github.com/users/facebook-github-bot/repos', 'events_url': 'https://api.github.com/users/facebook-github-bot/events{/privacy}', 'received_events_url': 'https://api.github.com/users/facebook-github-bot/received_events', 'type': 'User', 'site_admin': False}",referenced,7e6d932208a866551ca1b9ea7f149d48eb3ad413,https://api.github.com/repos/pytorch/pytorch/commits/7e6d932208a866551ca1b9ea7f149d48eb3ad413,2019-06-06T01:12:37Z,8,7,1
3,1208594418,"{'login': 'yogi81', 'id': 9338561, 'node_id': 'MDQ6VXNlcjkzMzg1NjE=', 'avatar_url': 'https://avatars3.githubusercontent.com/u/9338561?v=4', 'gravatar_id': '', 'url': 'https://api.github.com/users/yogi81', 'html_url': 'https://github.com/yogi81', 'followers_url': 'https://api.github.com/users/yogi81/followers', 'following_url': 'https://api.github.com/users/yogi81/following{/other_user}', 'gists_url': 'https://api.github.com/users/yogi81/gists{/gist_id}', 'starred_url': 'https://api.github.com/users/yogi81/starred{/owner}{/repo}', 'subscriptions_url': 'https://api.github.com/users/yogi81/subscriptions', 'organizations_url': 'https://api.github.com/users/yogi81/orgs', 'repos_url': 'https://api.github.com/users/yogi81/repos', 'events_url': 'https://api.github.com/users/yogi81/events{/privacy}', 'received_events_url': 'https://api.github.com/users/yogi81/received_events', 'type': 'User', 'site_admin': False}",referenced,1d9b10d312fe5e6325e399277e28aeb78fd2ddf7,https://api.github.com/repos/pytorch/pytorch/commits/1d9b10d312fe5e6325e399277e28aeb78fd2ddf7,2017-08-16T16:07:18Z,5,5,0
3,1837217789,"{'login': 'facebook-github-bot', 'id': 6422482, 'node_id': 'MDQ6VXNlcjY0MjI0ODI=', 'avatar_url': 'https://avatars3.githubusercontent.com/u/6422482?v=4', 'gravatar_id': '', 'url': 'https://api.github.com/users/facebook-github-bot', 'html_url': 'https://github.com/facebook-github-bot', 'followers_url': 'https://api.github.com/users/facebook-github-bot/followers', 'following_url': 'https://api.github.com/users/facebook-github-bot/following{/other_user}', 'gists_url': 'https://api.github.com/users/facebook-github-bot/gists{/gist_id}', 'starred_url': 'https://api.github.com/users/facebook-github-bot/starred{/owner}{/repo}', 'subscriptions_url': 'https://api.github.com/users/facebook-github-bot/subscriptions', 'organizations_url': 'https://api.github.com/users/facebook-github-bot/orgs', 'repos_url': 'https://api.github.com/users/facebook-github-bot/repos', 'events_url': 'https://api.github.com/users/facebook-github-bot/events{/privacy}', 'received_events_url': 'https://api.github.com/users/facebook-github-bot/received_events', 'type': 'User', 'site_admin': False}",referenced,0b78ae86c59e7372f0b9d4cadcd0e50bc76f8667,https://api.github.com/repos/pytorch/pytorch/commits/0b78ae86c59e7372f0b9d4cadcd0e50bc76f8667,2018-09-10T22:41:38Z,106,77,29
3,2158251508,"{'login': 'facebook-github-bot', 'id': 6422482, 'node_id': 'MDQ6VXNlcjY0MjI0ODI=', 'avatar_url': 'https://avatars3.githubusercontent.com/u/6422482?v=4', 'gravatar_id': '', 'url': 'https://api.github.com/users/facebook-github-bot', 'html_url': 'https://github.com/facebook-github-bot', 'followers_url': 'https://api.github.com/users/facebook-github-bot/followers', 'following_url': 'https://api.github.com/users/facebook-github-bot/following{/other_user}', 'gists_url': 'https://api.github.com/users/facebook-github-bot/gists{/gist_id}', 'starred_url': 'https://api.github.com/users/facebook-github-bot/starred{/owner}{/repo}', 'subscriptions_url': 'https://api.github.com/users/facebook-github-bot/subscriptions', 'organizations_url': 'https://api.github.com/users/facebook-github-bot/orgs', 'repos_url': 'https://api.github.com/users/facebook-github-bot/repos', 'events_url': 'https://api.github.com/users/facebook-github-bot/events{/privacy}', 'received_events_url': 'https://api.github.com/users/facebook-github-bot/received_events', 'type': 'User', 'site_admin': False}",referenced,be6ad7ddde64cebeec4cd9537ddc3bca9cbe18e5,https://api.github.com/repos/pytorch/pytorch/commits/be6ad7ddde64cebeec4cd9537ddc3bca9cbe18e5,2019-02-22T16:02:11Z,16,8,8
3,2205038493,"{'login': 'facebook-github-bot', 'id': 6422482, 'node_id': 'MDQ6VXNlcjY0MjI0ODI=', 'avatar_url': 'https://avatars3.githubusercontent.com/u/6422482?v=4', 'gravatar_id': '', 'url': 'https://api.github.com/users/facebook-github-bot', 'html_url': 'https://github.com/facebook-github-bot', 'followers_url': 'https://api.github.com/users/facebook-github-bot/followers', 'following_url': 'https://api.github.com/users/facebook-github-bot/following{/other_user}', 'gists_url': 'https://api.github.com/users/facebook-github-bot/gists{/gist_id}', 'starred_url': 'https://api.github.com/users/facebook-github-bot/starred{/owner}{/repo}', 'subscriptions_url': 'https://api.github.com/users/facebook-github-bot/subscriptions', 'organizations_url': 'https://api.github.com/users/facebook-github-bot/orgs', 'repos_url': 'https://api.github.com/users/facebook-github-bot/repos', 'events_url': 'https://api.github.com/users/facebook-github-bot/events{/privacy}', 'received_events_url': 'https://api.github.com/users/facebook-github-bot/received_events', 'type': 'User', 'site_admin': False}",referenced,9de4350b77cd7f257c1c60d325f267d50965531e,https://api.github.com/repos/pytorch/pytorch/commits/9de4350b77cd7f257c1c60d325f267d50965531e,2019-03-14T22:49:48Z,2,1,1
3,2256802487,"{'login': 'facebook-github-bot', 'id': 6422482, 'node_id': 'MDQ6VXNlcjY0MjI0ODI=', 'avatar_url': 'https://avatars3.githubusercontent.com/u/6422482?v=4', 'gravatar_id': '', 'url': 'https://api.github.com/users/facebook-github-bot', 'html_url': 'https://github.com/facebook-github-bot', 'followers_url': 'https://api.github.com/users/facebook-github-bot/followers', 'following_url': 'https://api.github.com/users/facebook-github-bot/following{/other_user}', 'gists_url': 'https://api.github.com/users/facebook-github-bot/gists{/gist_id}', 'starred_url': 'https://api.github.com/users/facebook-github-bot/starred{/owner}{/repo}', 'subscriptions_url': 'https://api.github.com/users/facebook-github-bot/subscriptions', 'organizations_url': 'https://api.github.com/users/facebook-github-bot/orgs', 'repos_url': 'https://api.github.com/users/facebook-github-bot/repos', 'events_url': 'https://api.github.com/users/facebook-github-bot/events{/privacy}', 'received_events_url': 'https://api.github.com/users/facebook-github-bot/received_events', 'type': 'User', 'site_admin': False}",referenced,b90cbb841d98aeae435b1d02b1ff211e028cdf5b,https://api.github.com/repos/pytorch/pytorch/commits/b90cbb841d98aeae435b1d02b1ff211e028cdf5b,2019-04-05T20:02:17Z,2,1,1
3,2392920343,"{'login': 'facebook-github-bot', 'id': 6422482, 'node_id': 'MDQ6VXNlcjY0MjI0ODI=', 'avatar_url': 'https://avatars3.githubusercontent.com/u/6422482?v=4', 'gravatar_id': '', 'url': 'https://api.github.com/users/facebook-github-bot', 'html_url': 'https://github.com/facebook-github-bot', 'followers_url': 'https://api.github.com/users/facebook-github-bot/followers', 'following_url': 'https://api.github.com/users/facebook-github-bot/following{/other_user}', 'gists_url': 'https://api.github.com/users/facebook-github-bot/gists{/gist_id}', 'starred_url': 'https://api.github.com/users/facebook-github-bot/starred{/owner}{/repo}', 'subscriptions_url': 'https://api.github.com/users/facebook-github-bot/subscriptions', 'organizations_url': 'https://api.github.com/users/facebook-github-bot/orgs', 'repos_url': 'https://api.github.com/users/facebook-github-bot/repos', 'events_url': 'https://api.github.com/users/facebook-github-bot/events{/privacy}', 'received_events_url': 'https://api.github.com/users/facebook-github-bot/received_events', 'type': 'User', 'site_admin': False}",referenced,7e6d932208a866551ca1b9ea7f149d48eb3ad413,https://api.github.com/repos/pytorch/pytorch/commits/7e6d932208a866551ca1b9ea7f149d48eb3ad413,2019-06-06T01:12:37Z,8,7,1
3,2688277161,"{'login': 'soumith', 'id': 1310570, 'node_id': 'MDQ6VXNlcjEzMTA1NzA=', 'avatar_url': 'https://avatars0.githubusercontent.com/u/1310570?v=4', 'gravatar_id': '', 'url': 'https://api.github.com/users/soumith', 'html_url': 'https://github.com/soumith', 'followers_url': 'https://api.github.com/users/soumith/followers', 'following_url': 'https://api.github.com/users/soumith/following{/other_user}', 'gists_url': 'https://api.github.com/users/soumith/gists{/gist_id}', 'starred_url': 'https://api.github.com/users/soumith/starred{/owner}{/repo}', 'subscriptions_url': 'https://api.github.com/users/soumith/subscriptions', 'organizations_url': 'https://api.github.com/users/soumith/orgs', 'repos_url': 'https://api.github.com/users/soumith/repos', 'events_url': 'https://api.github.com/users/soumith/events{/privacy}', 'received_events_url': 'https://api.github.com/users/soumith/received_events', 'type': 'User', 'site_admin': False}",referenced,1f8a610feb6523a22b572a736bf589bbfe47ae0a,https://api.github.com/repos/pytorch/pytorch/commits/1f8a610feb6523a22b572a736bf589bbfe47ae0a,2019-10-04T18:18:44Z,12,2,10
2,1062809143,"{'login': 'apaszke', 'id': 4583066, 'node_id': 'MDQ6VXNlcjQ1ODMwNjY=', 'avatar_url': 'https://avatars3.githubusercontent.com/u/4583066?v=4', 'gravatar_id': '', 'url': 'https://api.github.com/users/apaszke', 'html_url': 'https://github.com/apaszke', 'followers_url': 'https://api.github.com/users/apaszke/followers', 'following_url': 'https://api.github.com/users/apaszke/following{/other_user}', 'gists_url': 'https://api.github.com/users/apaszke/gists{/gist_id}', 'starred_url': 'https://api.github.com/users/apaszke/starred{/owner}{/repo}', 'subscriptions_url': 'https://api.github.com/users/apaszke/subscriptions', 'organizations_url': 'https://api.github.com/users/apaszke/orgs', 'repos_url': 'https://api.github.com/users/apaszke/repos', 'events_url': 'https://api.github.com/users/apaszke/events{/privacy}', 'received_events_url': 'https://api.github.com/users/apaszke/received_events', 'type': 'User', 'site_admin': False}",referenced,112760448b108e4a293aca77fdd4c1dbcf29e8eb,https://api.github.com/repos/pytorch/pytorch/commits/112760448b108e4a293aca77fdd4c1dbcf29e8eb,2017-04-28T21:03:16Z,665,402,263
2,1062871835,"{'login': 'apaszke', 'id': 4583066, 'node_id': 'MDQ6VXNlcjQ1ODMwNjY=', 'avatar_url': 'https://avatars3.githubusercontent.com/u/4583066?v=4', 'gravatar_id': '', 'url': 'https://api.github.com/users/apaszke', 'html_url': 'https://github.com/apaszke', 'followers_url': 'https://api.github.com/users/apaszke/followers', 'following_url': 'https://api.github.com/users/apaszke/following{/other_user}', 'gists_url': 'https://api.github.com/users/apaszke/gists{/gist_id}', 'starred_url': 'https://api.github.com/users/apaszke/starred{/owner}{/repo}', 'subscriptions_url': 'https://api.github.com/users/apaszke/subscriptions', 'organizations_url': 'https://api.github.com/users/apaszke/orgs', 'repos_url': 'https://api.github.com/users/apaszke/repos', 'events_url': 'https://api.github.com/users/apaszke/events{/privacy}', 'received_events_url': 'https://api.github.com/users/apaszke/received_events', 'type': 'User', 'site_admin': False}",referenced,21b173663df240e452c7da95997a59851e2c8bf8,https://api.github.com/repos/pytorch/pytorch/commits/21b173663df240e452c7da95997a59851e2c8bf8,2017-04-28T22:00:49Z,665,402,263
2,1062898384,"{'login': 'apaszke', 'id': 4583066, 'node_id': 'MDQ6VXNlcjQ1ODMwNjY=', 'avatar_url': 'https://avatars3.githubusercontent.com/u/4583066?v=4', 'gravatar_id': '', 'url': 'https://api.github.com/users/apaszke', 'html_url': 'https://github.com/apaszke', 'followers_url': 'https://api.github.com/users/apaszke/followers', 'following_url': 'https://api.github.com/users/apaszke/following{/other_user}', 'gists_url': 'https://api.github.com/users/apaszke/gists{/gist_id}', 'starred_url': 'https://api.github.com/users/apaszke/starred{/owner}{/repo}', 'subscriptions_url': 'https://api.github.com/users/apaszke/subscriptions', 'organizations_url': 'https://api.github.com/users/apaszke/orgs', 'repos_url': 'https://api.github.com/users/apaszke/repos', 'events_url': 'https://api.github.com/users/apaszke/events{/privacy}', 'received_events_url': 'https://api.github.com/users/apaszke/received_events', 'type': 'User', 'site_admin': False}",referenced,ed0c11a33f90e29090a2f2aeb1b08943b1c281b5,https://api.github.com/repos/pytorch/pytorch/commits/ed0c11a33f90e29090a2f2aeb1b08943b1c281b5,2017-04-28T22:31:19Z,665,402,263
2,1063812955,"{'login': 'apaszke', 'id': 4583066, 'node_id': 'MDQ6VXNlcjQ1ODMwNjY=', 'avatar_url': 'https://avatars3.githubusercontent.com/u/4583066?v=4', 'gravatar_id': '', 'url': 'https://api.github.com/users/apaszke', 'html_url': 'https://github.com/apaszke', 'followers_url': 'https://api.github.com/users/apaszke/followers', 'following_url': 'https://api.github.com/users/apaszke/following{/other_user}', 'gists_url': 'https://api.github.com/users/apaszke/gists{/gist_id}', 'starred_url': 'https://api.github.com/users/apaszke/starred{/owner}{/repo}', 'subscriptions_url': 'https://api.github.com/users/apaszke/subscriptions', 'organizations_url': 'https://api.github.com/users/apaszke/orgs', 'repos_url': 'https://api.github.com/users/apaszke/repos', 'events_url': 'https://api.github.com/users/apaszke/events{/privacy}', 'received_events_url': 'https://api.github.com/users/apaszke/received_events', 'type': 'User', 'site_admin': False}",referenced,98d8e0b0402e757083574eb6bc59cd3b77d925a3,https://api.github.com/repos/pytorch/pytorch/commits/98d8e0b0402e757083574eb6bc59cd3b77d925a3,2017-05-01T08:49:36Z,665,402,263
2,1208594417,"{'login': 'yogi81', 'id': 9338561, 'node_id': 'MDQ6VXNlcjkzMzg1NjE=', 'avatar_url': 'https://avatars3.githubusercontent.com/u/9338561?v=4', 'gravatar_id': '', 'url': 'https://api.github.com/users/yogi81', 'html_url': 'https://github.com/yogi81', 'followers_url': 'https://api.github.com/users/yogi81/followers', 'following_url': 'https://api.github.com/users/yogi81/following{/other_user}', 'gists_url': 'https://api.github.com/users/yogi81/gists{/gist_id}', 'starred_url': 'https://api.github.com/users/yogi81/starred{/owner}{/repo}', 'subscriptions_url': 'https://api.github.com/users/yogi81/subscriptions', 'organizations_url': 'https://api.github.com/users/yogi81/orgs', 'repos_url': 'https://api.github.com/users/yogi81/repos', 'events_url': 'https://api.github.com/users/yogi81/events{/privacy}', 'received_events_url': 'https://api.github.com/users/yogi81/received_events', 'type': 'User', 'site_admin': False}",referenced,1d9b10d312fe5e6325e399277e28aeb78fd2ddf7,https://api.github.com/repos/pytorch/pytorch/commits/1d9b10d312fe5e6325e399277e28aeb78fd2ddf7,2017-08-16T16:07:18Z,5,5,0
2,1279080262,"{'login': 'soumith', 'id': 1310570, 'node_id': 'MDQ6VXNlcjEzMTA1NzA=', 'avatar_url': 'https://avatars0.githubusercontent.com/u/1310570?v=4', 'gravatar_id': '', 'url': 'https://api.github.com/users/soumith', 'html_url': 'https://github.com/soumith', 'followers_url': 'https://api.github.com/users/soumith/followers', 'following_url': 'https://api.github.com/users/soumith/following{/other_user}', 'gists_url': 'https://api.github.com/users/soumith/gists{/gist_id}', 'starred_url': 'https://api.github.com/users/soumith/starred{/owner}{/repo}', 'subscriptions_url': 'https://api.github.com/users/soumith/subscriptions', 'organizations_url': 'https://api.github.com/users/soumith/orgs', 'repos_url': 'https://api.github.com/users/soumith/repos', 'events_url': 'https://api.github.com/users/soumith/events{/privacy}', 'received_events_url': 'https://api.github.com/users/soumith/received_events', 'type': 'User', 'site_admin': False}",referenced,d66fb63679cc9dbbaefc09d227e98f39d43a1f21,https://api.github.com/repos/pytorch/pytorch/commits/d66fb63679cc9dbbaefc09d227e98f39d43a1f21,2017-10-05T01:27:45Z,5,3,2
2,1621259722,"{'login': 'pjh5', 'id': 6456020, 'node_id': 'MDQ6VXNlcjY0NTYwMjA=', 'avatar_url': 'https://avatars1.githubusercontent.com/u/6456020?v=4', 'gravatar_id': '', 'url': 'https://api.github.com/users/pjh5', 'html_url': 'https://github.com/pjh5', 'followers_url': 'https://api.github.com/users/pjh5/followers', 'following_url': 'https://api.github.com/users/pjh5/following{/other_user}', 'gists_url': 'https://api.github.com/users/pjh5/gists{/gist_id}', 'starred_url': 'https://api.github.com/users/pjh5/starred{/owner}{/repo}', 'subscriptions_url': 'https://api.github.com/users/pjh5/subscriptions', 'organizations_url': 'https://api.github.com/users/pjh5/orgs', 'repos_url': 'https://api.github.com/users/pjh5/repos', 'events_url': 'https://api.github.com/users/pjh5/events{/privacy}', 'received_events_url': 'https://api.github.com/users/pjh5/received_events', 'type': 'User', 'site_admin': False}",referenced,b875fb281c92dbe88da279a0ff7ad342e7b28b9e,https://api.github.com/repos/pytorch/pytorch/commits/b875fb281c92dbe88da279a0ff7ad342e7b28b9e,2018-05-11T06:14:55Z,3328,2549,779
2,1837217790,"{'login': 'facebook-github-bot', 'id': 6422482, 'node_id': 'MDQ6VXNlcjY0MjI0ODI=', 'avatar_url': 'https://avatars3.githubusercontent.com/u/6422482?v=4', 'gravatar_id': '', 'url': 'https://api.github.com/users/facebook-github-bot', 'html_url': 'https://github.com/facebook-github-bot', 'followers_url': 'https://api.github.com/users/facebook-github-bot/followers', 'following_url': 'https://api.github.com/users/facebook-github-bot/following{/other_user}', 'gists_url': 'https://api.github.com/users/facebook-github-bot/gists{/gist_id}', 'starred_url': 'https://api.github.com/users/facebook-github-bot/starred{/owner}{/repo}', 'subscriptions_url': 'https://api.github.com/users/facebook-github-bot/subscriptions', 'organizations_url': 'https://api.github.com/users/facebook-github-bot/orgs', 'repos_url': 'https://api.github.com/users/facebook-github-bot/repos', 'events_url': 'https://api.github.com/users/facebook-github-bot/events{/privacy}', 'received_events_url': 'https://api.github.com/users/facebook-github-bot/received_events', 'type': 'User', 'site_admin': False}",referenced,0b78ae86c59e7372f0b9d4cadcd0e50bc76f8667,https://api.github.com/repos/pytorch/pytorch/commits/0b78ae86c59e7372f0b9d4cadcd0e50bc76f8667,2018-09-10T22:41:38Z,106,77,29
2,1898771370,"{'login': 'facebook-github-bot', 'id': 6422482, 'node_id': 'MDQ6VXNlcjY0MjI0ODI=', 'avatar_url': 'https://avatars3.githubusercontent.com/u/6422482?v=4', 'gravatar_id': '', 'url': 'https://api.github.com/users/facebook-github-bot', 'html_url': 'https://github.com/facebook-github-bot', 'followers_url': 'https://api.github.com/users/facebook-github-bot/followers', 'following_url': 'https://api.github.com/users/facebook-github-bot/following{/other_user}', 'gists_url': 'https://api.github.com/users/facebook-github-bot/gists{/gist_id}', 'starred_url': 'https://api.github.com/users/facebook-github-bot/starred{/owner}{/repo}', 'subscriptions_url': 'https://api.github.com/users/facebook-github-bot/subscriptions', 'organizations_url': 'https://api.github.com/users/facebook-github-bot/orgs', 'repos_url': 'https://api.github.com/users/facebook-github-bot/repos', 'events_url': 'https://api.github.com/users/facebook-github-bot/events{/privacy}', 'received_events_url': 'https://api.github.com/users/facebook-github-bot/received_events', 'type': 'User', 'site_admin': False}",referenced,cee19eb31cb661a0f7fb44b31ef5cc8fc9fabf15,https://api.github.com/repos/pytorch/pytorch/commits/cee19eb31cb661a0f7fb44b31ef5cc8fc9fabf15,2018-10-11T16:55:09Z,2057,1024,1033
2,1905228907,"{'login': 'bddppq', 'id': 9300575, 'node_id': 'MDQ6VXNlcjkzMDA1NzU=', 'avatar_url': 'https://avatars2.githubusercontent.com/u/9300575?v=4', 'gravatar_id': '', 'url': 'https://api.github.com/users/bddppq', 'html_url': 'https://github.com/bddppq', 'followers_url': 'https://api.github.com/users/bddppq/followers', 'following_url': 'https://api.github.com/users/bddppq/following{/other_user}', 'gists_url': 'https://api.github.com/users/bddppq/gists{/gist_id}', 'starred_url': 'https://api.github.com/users/bddppq/starred{/owner}{/repo}', 'subscriptions_url': 'https://api.github.com/users/bddppq/subscriptions', 'organizations_url': 'https://api.github.com/users/bddppq/orgs', 'repos_url': 'https://api.github.com/users/bddppq/repos', 'events_url': 'https://api.github.com/users/bddppq/events{/privacy}', 'received_events_url': 'https://api.github.com/users/bddppq/received_events', 'type': 'User', 'site_admin': False}",referenced,27fc24ad88c3c685305d8932b793cda4f976b3ab,https://api.github.com/repos/pytorch/pytorch/commits/27fc24ad88c3c685305d8932b793cda4f976b3ab,2018-10-15T21:12:28Z,44,1,43
1,1062809142,"{'login': 'apaszke', 'id': 4583066, 'node_id': 'MDQ6VXNlcjQ1ODMwNjY=', 'avatar_url': 'https://avatars3.githubusercontent.com/u/4583066?v=4', 'gravatar_id': '', 'url': 'https://api.github.com/users/apaszke', 'html_url': 'https://github.com/apaszke', 'followers_url': 'https://api.github.com/users/apaszke/followers', 'following_url': 'https://api.github.com/users/apaszke/following{/other_user}', 'gists_url': 'https://api.github.com/users/apaszke/gists{/gist_id}', 'starred_url': 'https://api.github.com/users/apaszke/starred{/owner}{/repo}', 'subscriptions_url': 'https://api.github.com/users/apaszke/subscriptions', 'organizations_url': 'https://api.github.com/users/apaszke/orgs', 'repos_url': 'https://api.github.com/users/apaszke/repos', 'events_url': 'https://api.github.com/users/apaszke/events{/privacy}', 'received_events_url': 'https://api.github.com/users/apaszke/received_events', 'type': 'User', 'site_admin': False}",referenced,4703281905695412992b78e63122d1777b9022a5,https://api.github.com/repos/pytorch/pytorch/commits/4703281905695412992b78e63122d1777b9022a5,2017-04-28T21:03:16Z,365,358,7
1,1062871834,"{'login': 'apaszke', 'id': 4583066, 'node_id': 'MDQ6VXNlcjQ1ODMwNjY=', 'avatar_url': 'https://avatars3.githubusercontent.com/u/4583066?v=4', 'gravatar_id': '', 'url': 'https://api.github.com/users/apaszke', 'html_url': 'https://github.com/apaszke', 'followers_url': 'https://api.github.com/users/apaszke/followers', 'following_url': 'https://api.github.com/users/apaszke/following{/other_user}', 'gists_url': 'https://api.github.com/users/apaszke/gists{/gist_id}', 'starred_url': 'https://api.github.com/users/apaszke/starred{/owner}{/repo}', 'subscriptions_url': 'https://api.github.com/users/apaszke/subscriptions', 'organizations_url': 'https://api.github.com/users/apaszke/orgs', 'repos_url': 'https://api.github.com/users/apaszke/repos', 'events_url': 'https://api.github.com/users/apaszke/events{/privacy}', 'received_events_url': 'https://api.github.com/users/apaszke/received_events', 'type': 'User', 'site_admin': False}",referenced,3514465720ca9508521c06b1e412e2397d72576b,https://api.github.com/repos/pytorch/pytorch/commits/3514465720ca9508521c06b1e412e2397d72576b,2017-04-28T22:00:49Z,365,358,7
1,1062898383,"{'login': 'apaszke', 'id': 4583066, 'node_id': 'MDQ6VXNlcjQ1ODMwNjY=', 'avatar_url': 'https://avatars3.githubusercontent.com/u/4583066?v=4', 'gravatar_id': '', 'url': 'https://api.github.com/users/apaszke', 'html_url': 'https://github.com/apaszke', 'followers_url': 'https://api.github.com/users/apaszke/followers', 'following_url': 'https://api.github.com/users/apaszke/following{/other_user}', 'gists_url': 'https://api.github.com/users/apaszke/gists{/gist_id}', 'starred_url': 'https://api.github.com/users/apaszke/starred{/owner}{/repo}', 'subscriptions_url': 'https://api.github.com/users/apaszke/subscriptions', 'organizations_url': 'https://api.github.com/users/apaszke/orgs', 'repos_url': 'https://api.github.com/users/apaszke/repos', 'events_url': 'https://api.github.com/users/apaszke/events{/privacy}', 'received_events_url': 'https://api.github.com/users/apaszke/received_events', 'type': 'User', 'site_admin': False}",referenced,617a3bf9d7e9c7d9413a8439f8872bbb94154114,https://api.github.com/repos/pytorch/pytorch/commits/617a3bf9d7e9c7d9413a8439f8872bbb94154114,2017-04-28T22:31:19Z,365,358,7
1,1063812954,"{'login': 'apaszke', 'id': 4583066, 'node_id': 'MDQ6VXNlcjQ1ODMwNjY=', 'avatar_url': 'https://avatars3.githubusercontent.com/u/4583066?v=4', 'gravatar_id': '', 'url': 'https://api.github.com/users/apaszke', 'html_url': 'https://github.com/apaszke', 'followers_url': 'https://api.github.com/users/apaszke/followers', 'following_url': 'https://api.github.com/users/apaszke/following{/other_user}', 'gists_url': 'https://api.github.com/users/apaszke/gists{/gist_id}', 'starred_url': 'https://api.github.com/users/apaszke/starred{/owner}{/repo}', 'subscriptions_url': 'https://api.github.com/users/apaszke/subscriptions', 'organizations_url': 'https://api.github.com/users/apaszke/orgs', 'repos_url': 'https://api.github.com/users/apaszke/repos', 'events_url': 'https://api.github.com/users/apaszke/events{/privacy}', 'received_events_url': 'https://api.github.com/users/apaszke/received_events', 'type': 'User', 'site_admin': False}",referenced,fe2c360eda650a485adca3d0629a8ef23cd2d3ab,https://api.github.com/repos/pytorch/pytorch/commits/fe2c360eda650a485adca3d0629a8ef23cd2d3ab,2017-05-01T08:49:36Z,365,358,7
1,1208594416,"{'login': 'yogi81', 'id': 9338561, 'node_id': 'MDQ6VXNlcjkzMzg1NjE=', 'avatar_url': 'https://avatars3.githubusercontent.com/u/9338561?v=4', 'gravatar_id': '', 'url': 'https://api.github.com/users/yogi81', 'html_url': 'https://github.com/yogi81', 'followers_url': 'https://api.github.com/users/yogi81/followers', 'following_url': 'https://api.github.com/users/yogi81/following{/other_user}', 'gists_url': 'https://api.github.com/users/yogi81/gists{/gist_id}', 'starred_url': 'https://api.github.com/users/yogi81/starred{/owner}{/repo}', 'subscriptions_url': 'https://api.github.com/users/yogi81/subscriptions', 'organizations_url': 'https://api.github.com/users/yogi81/orgs', 'repos_url': 'https://api.github.com/users/yogi81/repos', 'events_url': 'https://api.github.com/users/yogi81/events{/privacy}', 'received_events_url': 'https://api.github.com/users/yogi81/received_events', 'type': 'User', 'site_admin': False}",referenced,1d9b10d312fe5e6325e399277e28aeb78fd2ddf7,https://api.github.com/repos/pytorch/pytorch/commits/1d9b10d312fe5e6325e399277e28aeb78fd2ddf7,2017-08-16T16:07:18Z,5,5,0
1,1340066781,"{'login': 'soumith', 'id': 1310570, 'node_id': 'MDQ6VXNlcjEzMTA1NzA=', 'avatar_url': 'https://avatars0.githubusercontent.com/u/1310570?v=4', 'gravatar_id': '', 'url': 'https://api.github.com/users/soumith', 'html_url': 'https://github.com/soumith', 'followers_url': 'https://api.github.com/users/soumith/followers', 'following_url': 'https://api.github.com/users/soumith/following{/other_user}', 'gists_url': 'https://api.github.com/users/soumith/gists{/gist_id}', 'starred_url': 'https://api.github.com/users/soumith/starred{/owner}{/repo}', 'subscriptions_url': 'https://api.github.com/users/soumith/subscriptions', 'organizations_url': 'https://api.github.com/users/soumith/orgs', 'repos_url': 'https://api.github.com/users/soumith/repos', 'events_url': 'https://api.github.com/users/soumith/events{/privacy}', 'received_events_url': 'https://api.github.com/users/soumith/received_events', 'type': 'User', 'site_admin': False}",referenced,83b36175fc0c6209e74592065aa4cbaa2fc825c9,https://api.github.com/repos/pytorch/pytorch/commits/83b36175fc0c6209e74592065aa4cbaa2fc825c9,2017-11-14T03:43:10Z,18,16,2
1,1436411941,"{'login': 'soumith', 'id': 1310570, 'node_id': 'MDQ6VXNlcjEzMTA1NzA=', 'avatar_url': 'https://avatars0.githubusercontent.com/u/1310570?v=4', 'gravatar_id': '', 'url': 'https://api.github.com/users/soumith', 'html_url': 'https://github.com/soumith', 'followers_url': 'https://api.github.com/users/soumith/followers', 'following_url': 'https://api.github.com/users/soumith/following{/other_user}', 'gists_url': 'https://api.github.com/users/soumith/gists{/gist_id}', 'starred_url': 'https://api.github.com/users/soumith/starred{/owner}{/repo}', 'subscriptions_url': 'https://api.github.com/users/soumith/subscriptions', 'organizations_url': 'https://api.github.com/users/soumith/orgs', 'repos_url': 'https://api.github.com/users/soumith/repos', 'events_url': 'https://api.github.com/users/soumith/events{/privacy}', 'received_events_url': 'https://api.github.com/users/soumith/received_events', 'type': 'User', 'site_admin': False}",referenced,966db35dd9422c0da8595548d595dd2979c8c4fc,https://api.github.com/repos/pytorch/pytorch/commits/966db35dd9422c0da8595548d595dd2979c8c4fc,2018-01-23T01:47:29Z,233,178,55
1,1463382693,"{'login': 'soumith', 'id': 1310570, 'node_id': 'MDQ6VXNlcjEzMTA1NzA=', 'avatar_url': 'https://avatars0.githubusercontent.com/u/1310570?v=4', 'gravatar_id': '', 'url': 'https://api.github.com/users/soumith', 'html_url': 'https://github.com/soumith', 'followers_url': 'https://api.github.com/users/soumith/followers', 'following_url': 'https://api.github.com/users/soumith/following{/other_user}', 'gists_url': 'https://api.github.com/users/soumith/gists{/gist_id}', 'starred_url': 'https://api.github.com/users/soumith/starred{/owner}{/repo}', 'subscriptions_url': 'https://api.github.com/users/soumith/subscriptions', 'organizations_url': 'https://api.github.com/users/soumith/orgs', 'repos_url': 'https://api.github.com/users/soumith/repos', 'events_url': 'https://api.github.com/users/soumith/events{/privacy}', 'received_events_url': 'https://api.github.com/users/soumith/received_events', 'type': 'User', 'site_admin': False}",referenced,26f038a557ae4fa9eb856b286c31f4f9ec2b27f3,https://api.github.com/repos/pytorch/pytorch/commits/26f038a557ae4fa9eb856b286c31f4f9ec2b27f3,2018-02-07T21:58:22Z,233,178,55
1,1837217793,"{'login': 'facebook-github-bot', 'id': 6422482, 'node_id': 'MDQ6VXNlcjY0MjI0ODI=', 'avatar_url': 'https://avatars3.githubusercontent.com/u/6422482?v=4', 'gravatar_id': '', 'url': 'https://api.github.com/users/facebook-github-bot', 'html_url': 'https://github.com/facebook-github-bot', 'followers_url': 'https://api.github.com/users/facebook-github-bot/followers', 'following_url': 'https://api.github.com/users/facebook-github-bot/following{/other_user}', 'gists_url': 'https://api.github.com/users/facebook-github-bot/gists{/gist_id}', 'starred_url': 'https://api.github.com/users/facebook-github-bot/starred{/owner}{/repo}', 'subscriptions_url': 'https://api.github.com/users/facebook-github-bot/subscriptions', 'organizations_url': 'https://api.github.com/users/facebook-github-bot/orgs', 'repos_url': 'https://api.github.com/users/facebook-github-bot/repos', 'events_url': 'https://api.github.com/users/facebook-github-bot/events{/privacy}', 'received_events_url': 'https://api.github.com/users/facebook-github-bot/received_events', 'type': 'User', 'site_admin': False}",referenced,0b78ae86c59e7372f0b9d4cadcd0e50bc76f8667,https://api.github.com/repos/pytorch/pytorch/commits/0b78ae86c59e7372f0b9d4cadcd0e50bc76f8667,2018-09-10T22:41:38Z,106,77,29
1,1905228903,"{'login': 'bddppq', 'id': 9300575, 'node_id': 'MDQ6VXNlcjkzMDA1NzU=', 'avatar_url': 'https://avatars2.githubusercontent.com/u/9300575?v=4', 'gravatar_id': '', 'url': 'https://api.github.com/users/bddppq', 'html_url': 'https://github.com/bddppq', 'followers_url': 'https://api.github.com/users/bddppq/followers', 'following_url': 'https://api.github.com/users/bddppq/following{/other_user}', 'gists_url': 'https://api.github.com/users/bddppq/gists{/gist_id}', 'starred_url': 'https://api.github.com/users/bddppq/starred{/owner}{/repo}', 'subscriptions_url': 'https://api.github.com/users/bddppq/subscriptions', 'organizations_url': 'https://api.github.com/users/bddppq/orgs', 'repos_url': 'https://api.github.com/users/bddppq/repos', 'events_url': 'https://api.github.com/users/bddppq/events{/privacy}', 'received_events_url': 'https://api.github.com/users/bddppq/received_events', 'type': 'User', 'site_admin': False}",referenced,a95219ffcd25b6f5b90d862b29d36a03fb17673c,https://api.github.com/repos/pytorch/pytorch/commits/a95219ffcd25b6f5b90d862b29d36a03fb17673c,2018-10-15T21:12:28Z,12,12,0
1,1970032123,"{'login': 'facebook-github-bot', 'id': 6422482, 'node_id': 'MDQ6VXNlcjY0MjI0ODI=', 'avatar_url': 'https://avatars3.githubusercontent.com/u/6422482?v=4', 'gravatar_id': '', 'url': 'https://api.github.com/users/facebook-github-bot', 'html_url': 'https://github.com/facebook-github-bot', 'followers_url': 'https://api.github.com/users/facebook-github-bot/followers', 'following_url': 'https://api.github.com/users/facebook-github-bot/following{/other_user}', 'gists_url': 'https://api.github.com/users/facebook-github-bot/gists{/gist_id}', 'starred_url': 'https://api.github.com/users/facebook-github-bot/starred{/owner}{/repo}', 'subscriptions_url': 'https://api.github.com/users/facebook-github-bot/subscriptions', 'organizations_url': 'https://api.github.com/users/facebook-github-bot/orgs', 'repos_url': 'https://api.github.com/users/facebook-github-bot/repos', 'events_url': 'https://api.github.com/users/facebook-github-bot/events{/privacy}', 'received_events_url': 'https://api.github.com/users/facebook-github-bot/received_events', 'type': 'User', 'site_admin': False}",referenced,84d464f8f9ef470e7720b20ee297d07c512bfc82,https://api.github.com/repos/pytorch/pytorch/commits/84d464f8f9ef470e7720b20ee297d07c512bfc82,2018-11-15T23:35:40Z,2,1,1
1,2158251504,"{'login': 'facebook-github-bot', 'id': 6422482, 'node_id': 'MDQ6VXNlcjY0MjI0ODI=', 'avatar_url': 'https://avatars3.githubusercontent.com/u/6422482?v=4', 'gravatar_id': '', 'url': 'https://api.github.com/users/facebook-github-bot', 'html_url': 'https://github.com/facebook-github-bot', 'followers_url': 'https://api.github.com/users/facebook-github-bot/followers', 'following_url': 'https://api.github.com/users/facebook-github-bot/following{/other_user}', 'gists_url': 'https://api.github.com/users/facebook-github-bot/gists{/gist_id}', 'starred_url': 'https://api.github.com/users/facebook-github-bot/starred{/owner}{/repo}', 'subscriptions_url': 'https://api.github.com/users/facebook-github-bot/subscriptions', 'organizations_url': 'https://api.github.com/users/facebook-github-bot/orgs', 'repos_url': 'https://api.github.com/users/facebook-github-bot/repos', 'events_url': 'https://api.github.com/users/facebook-github-bot/events{/privacy}', 'received_events_url': 'https://api.github.com/users/facebook-github-bot/received_events', 'type': 'User', 'site_admin': False}",referenced,be6ad7ddde64cebeec4cd9537ddc3bca9cbe18e5,https://api.github.com/repos/pytorch/pytorch/commits/be6ad7ddde64cebeec4cd9537ddc3bca9cbe18e5,2019-02-22T16:02:11Z,16,8,8
1,2256802482,"{'login': 'facebook-github-bot', 'id': 6422482, 'node_id': 'MDQ6VXNlcjY0MjI0ODI=', 'avatar_url': 'https://avatars3.githubusercontent.com/u/6422482?v=4', 'gravatar_id': '', 'url': 'https://api.github.com/users/facebook-github-bot', 'html_url': 'https://github.com/facebook-github-bot', 'followers_url': 'https://api.github.com/users/facebook-github-bot/followers', 'following_url': 'https://api.github.com/users/facebook-github-bot/following{/other_user}', 'gists_url': 'https://api.github.com/users/facebook-github-bot/gists{/gist_id}', 'starred_url': 'https://api.github.com/users/facebook-github-bot/starred{/owner}{/repo}', 'subscriptions_url': 'https://api.github.com/users/facebook-github-bot/subscriptions', 'organizations_url': 'https://api.github.com/users/facebook-github-bot/orgs', 'repos_url': 'https://api.github.com/users/facebook-github-bot/repos', 'events_url': 'https://api.github.com/users/facebook-github-bot/events{/privacy}', 'received_events_url': 'https://api.github.com/users/facebook-github-bot/received_events', 'type': 'User', 'site_admin': False}",referenced,b90cbb841d98aeae435b1d02b1ff211e028cdf5b,https://api.github.com/repos/pytorch/pytorch/commits/b90cbb841d98aeae435b1d02b1ff211e028cdf5b,2019-04-05T20:02:17Z,2,1,1
1,2392920339,"{'login': 'facebook-github-bot', 'id': 6422482, 'node_id': 'MDQ6VXNlcjY0MjI0ODI=', 'avatar_url': 'https://avatars3.githubusercontent.com/u/6422482?v=4', 'gravatar_id': '', 'url': 'https://api.github.com/users/facebook-github-bot', 'html_url': 'https://github.com/facebook-github-bot', 'followers_url': 'https://api.github.com/users/facebook-github-bot/followers', 'following_url': 'https://api.github.com/users/facebook-github-bot/following{/other_user}', 'gists_url': 'https://api.github.com/users/facebook-github-bot/gists{/gist_id}', 'starred_url': 'https://api.github.com/users/facebook-github-bot/starred{/owner}{/repo}', 'subscriptions_url': 'https://api.github.com/users/facebook-github-bot/subscriptions', 'organizations_url': 'https://api.github.com/users/facebook-github-bot/orgs', 'repos_url': 'https://api.github.com/users/facebook-github-bot/repos', 'events_url': 'https://api.github.com/users/facebook-github-bot/events{/privacy}', 'received_events_url': 'https://api.github.com/users/facebook-github-bot/received_events', 'type': 'User', 'site_admin': False}",referenced,7e6d932208a866551ca1b9ea7f149d48eb3ad413,https://api.github.com/repos/pytorch/pytorch/commits/7e6d932208a866551ca1b9ea7f149d48eb3ad413,2019-06-06T01:12:37Z,8,7,1
1,2396101912,"{'login': 'facebook-github-bot', 'id': 6422482, 'node_id': 'MDQ6VXNlcjY0MjI0ODI=', 'avatar_url': 'https://avatars3.githubusercontent.com/u/6422482?v=4', 'gravatar_id': '', 'url': 'https://api.github.com/users/facebook-github-bot', 'html_url': 'https://github.com/facebook-github-bot', 'followers_url': 'https://api.github.com/users/facebook-github-bot/followers', 'following_url': 'https://api.github.com/users/facebook-github-bot/following{/other_user}', 'gists_url': 'https://api.github.com/users/facebook-github-bot/gists{/gist_id}', 'starred_url': 'https://api.github.com/users/facebook-github-bot/starred{/owner}{/repo}', 'subscriptions_url': 'https://api.github.com/users/facebook-github-bot/subscriptions', 'organizations_url': 'https://api.github.com/users/facebook-github-bot/orgs', 'repos_url': 'https://api.github.com/users/facebook-github-bot/repos', 'events_url': 'https://api.github.com/users/facebook-github-bot/events{/privacy}', 'received_events_url': 'https://api.github.com/users/facebook-github-bot/received_events', 'type': 'User', 'site_admin': False}",referenced,bad67015fedfa9de0e75999f89a7b661bd6a860f,https://api.github.com/repos/pytorch/pytorch/commits/bad67015fedfa9de0e75999f89a7b661bd6a860f,2019-06-07T02:35:32Z,,,